System Time:,Simulation Time:,AnimalType:,overall,alive,puppy,juvenile,young_adult,adult,aged_adult,elder,overall_puppy,overall_juvenile,overall_young_adult,overall_adult,overall_aged_adult,overall_elder,female,male,overall_female,overall_male,thirstDeath,hungerDeath,ageDeath,predatorDeath
16:11:23,5.94316,Dog,50,50,0,0,0,0,0,0,0,0,0,0,0,0,26,24,26,24,0,0,0,0
16:11:30,18.97206,Dog,50,50,50,0,0,0,0,0,50,0,0,0,0,0,26,24,26,24,0,0,0,0
16:11:37,32.8466,Dog,50,49,49,0,0,0,0,0,50,0,0,0,0,0,25,24,26,24,0,0,0,1
16:12:03,84.5734,Dog,50,48,48,0,0,0,0,0,50,0,0,0,0,0,24,24,26,24,0,0,0,2
16:12:28,135.9685,Dog,50,48,0,48,0,0,0,0,50,48,0,0,0,0,24,24,26,24,0,0,0,2
16:12:37,152.5322,Dog,50,47,0,47,0,0,0,0,50,48,0,0,0,0,23,24,26,24,0,0,0,3
16:13:46,291.9648,Dog,50,47,0,0,47,0,0,0,50,48,47,0,0,0,23,24,26,24,0,0,0,3
16:14:58,434.9499,Dog,50,47,0,0,0,47,0,0,50,48,47,47,0,0,23,24,26,24,0,0,0,3
16:15:50,540.1116,Dog,50,46,0,0,0,46,0,0,50,48,47,47,0,0,23,23,26,24,0,0,0,4
16:16:00,559.3555,Dog,52,48,0,0,0,46,0,0,50,48,47,47,0,0,25,23,28,24,0,0,0,4
16:16:00,559.6154,Dog,54,50,0,0,0,46,0,0,50,48,47,47,0,0,27,23,30,24,0,0,0,4
16:16:01,561.3516,Dog,58,54,0,0,0,46,0,0,50,48,47,47,0,0,29,25,32,26,0,0,0,4
16:16:03,564.4109,Dog,60,56,0,0,0,46,0,0,50,48,47,47,0,0,30,26,33,27,0,0,0,4
16:16:06,572.256,Dog,60,56,2,0,0,46,0,0,52,48,47,47,0,0,30,26,33,27,0,0,0,4
16:16:07,572.6592,Dog,62,58,4,0,0,46,0,0,54,48,47,47,0,0,30,28,33,29,0,0,0,4
16:16:07,574.2567,Dog,62,58,8,0,0,46,0,0,58,48,47,47,0,0,30,28,33,29,0,0,0,4
16:16:08,575.2903,Dog,64,60,8,0,0,46,0,0,58,48,47,47,0,0,31,29,34,30,0,0,0,4
16:16:09,577.4291,Dog,64,60,10,0,0,46,0,0,60,48,47,47,0,0,31,29,34,30,0,0,0,4
16:16:09,578.1134,Dog,66,62,10,0,0,46,0,0,60,48,47,47,0,0,32,30,35,31,0,0,0,4
16:16:13,585.6718,Dog,66,62,12,0,0,46,0,0,62,48,47,47,0,0,32,30,35,31,0,0,0,4
16:16:14,588.2068,Dog,66,62,14,0,0,46,0,0,64,48,47,47,0,0,32,30,35,31,0,0,0,4
16:16:16,591.0633,Dog,66,62,16,0,0,46,0,0,66,48,47,47,0,0,32,30,35,31,0,0,0,4
16:16:32,623.9093,Dog,66,61,16,0,0,45,0,0,66,48,47,47,0,0,31,30,35,31,0,0,0,5
16:16:34,628.1563,Dog,68,63,16,0,0,45,0,0,66,48,47,47,0,0,32,31,36,32,0,0,0,5
16:16:37,633.5991,Dog,70,65,16,0,0,45,0,0,66,48,47,47,0,0,33,32,37,33,0,0,0,5
16:16:38,635.869,Dog,72,67,16,0,0,45,0,0,66,48,47,47,0,0,34,33,38,34,0,0,0,5
16:16:41,641.0217,Dog,72,67,18,0,0,45,0,0,68,48,47,47,0,0,34,33,38,34,0,0,0,5
16:16:42,644.0659,Dog,74,69,18,0,0,45,0,0,68,48,47,47,0,0,36,33,40,34,0,0,0,5
16:16:44,646.4994,Dog,74,69,20,0,0,45,0,0,70,48,47,47,0,0,36,33,40,34,0,0,0,5
16:16:45,648.7446,Dog,74,69,22,0,0,45,0,0,72,48,47,47,0,0,36,33,40,34,0,0,0,5
16:16:46,651.0241,Dog,76,71,22,0,0,45,0,0,72,48,47,47,0,0,37,34,41,35,0,0,0,5
16:16:48,655.9844,Dog,76,71,22,0,0,0,45,0,72,48,47,47,45,0,37,34,41,35,0,0,0,5
16:16:49,657.0297,Dog,76,71,24,0,0,0,45,0,74,48,47,47,45,0,37,34,41,35,0,0,0,5
16:16:52,663.8854,Dog,76,71,26,0,0,0,45,0,76,48,47,47,45,0,37,34,41,35,0,0,0,5
16:16:56,670.6968,Dog,78,73,26,0,0,0,45,0,76,48,47,47,45,0,37,36,41,37,0,0,0,5
16:16:59,676.8449,Dog,80,75,26,0,0,0,45,0,76,48,47,47,45,0,38,37,42,38,0,0,0,5
16:17:02,683.5709,Dog,80,75,28,0,0,0,45,0,78,48,47,47,45,0,38,37,42,38,0,0,0,5
16:17:04,687.6113,Dog,82,77,28,0,0,0,45,0,78,48,47,47,45,0,38,39,42,40,0,0,0,5
16:17:04,688.2642,Dog,84,79,28,0,0,0,45,0,78,48,47,47,45,0,40,39,44,40,0,0,0,5
16:17:05,689.5214,Dog,84,79,24,4,0,0,45,0,78,52,47,47,45,0,40,39,44,40,0,0,0,5
16:17:05,689.7046,Dog,84,79,26,4,0,0,45,0,80,52,47,47,45,0,40,39,44,40,0,0,0,5
16:17:05,690.0477,Dog,86,81,26,4,0,0,45,0,80,52,47,47,45,0,42,39,46,40,0,0,0,5
16:17:06,691.3497,Dog,86,81,22,8,0,0,45,0,80,56,47,47,45,0,42,39,46,40,0,0,0,5
16:17:08,694.3749,Dog,86,81,20,10,0,0,45,0,80,58,47,47,45,0,42,39,46,40,0,0,0,5
16:17:11,700.485,Dog,86,81,22,10,0,0,45,0,82,58,47,47,45,0,42,39,46,40,0,0,0,5
16:17:11,701.1243,Dog,86,81,24,10,0,0,45,0,84,58,47,47,45,0,42,39,46,40,0,0,0,5
16:17:12,702.5988,Dog,86,81,22,12,0,0,45,0,84,60,47,47,45,0,42,39,46,40,0,0,0,5
16:17:12,702.9217,Dog,86,81,24,12,0,0,45,0,86,60,47,47,45,0,42,39,46,40,0,0,0,5
16:17:13,705.3112,Dog,86,81,22,14,0,0,45,0,86,62,47,47,45,0,42,39,46,40,0,0,0,5
16:17:14,708.1206,Dog,86,81,20,16,0,0,45,0,86,64,47,47,45,0,42,39,46,40,0,0,0,5
16:17:40,758.1765,Dog,86,81,18,18,0,0,45,0,86,66,47,47,45,0,42,39,46,40,0,0,0,5
16:17:42,763.6506,Dog,86,81,16,20,0,0,45,0,86,68,47,47,45,0,42,39,46,40,0,0,0,5
16:17:44,765.7615,Dog,86,81,14,22,0,0,45,0,86,70,47,47,45,0,42,39,46,40,0,0,0,5
16:17:48,774.046,Dog,86,81,12,24,0,0,45,0,86,72,47,47,45,0,42,39,46,40,0,0,0,5
16:17:51,780.973,Dog,86,81,10,26,0,0,45,0,86,74,47,47,45,0,42,39,46,40,0,0,0,5
16:18:01,800.5756,Dog,86,81,8,28,0,0,45,0,86,76,47,47,45,0,42,39,46,40,0,0,0,5
16:18:05,806.7482,Dog,86,81,6,30,0,0,45,0,86,78,47,47,45,0,42,39,46,40,0,0,0,5
16:18:10,817.5065,Dog,86,81,4,32,0,0,45,0,86,80,47,47,45,0,42,39,46,40,0,0,0,5
16:18:11,818.1063,Dog,86,81,2,34,0,0,45,0,86,82,47,47,45,0,42,39,46,40,0,0,0,5
16:18:12,819.9063,Dog,86,81,0,36,0,0,45,0,86,84,47,47,45,0,42,39,46,40,0,0,0,5
16:18:16,828.903,Dog,88,83,0,36,0,0,45,0,86,84,47,47,45,0,43,40,47,41,0,0,0,5
16:18:18,832.2903,Dog,90,85,0,36,0,0,45,0,86,84,47,47,45,0,43,42,47,43,0,0,0,5
16:18:23,841.8652,Dog,90,85,2,36,0,0,45,0,88,84,47,47,45,0,43,42,47,43,0,0,0,5
16:18:25,845.2635,Dog,90,85,4,34,2,0,45,0,90,84,49,47,45,0,43,42,47,43,0,0,0,5
16:18:25,845.6635,Dog,90,85,4,32,4,0,45,0,90,84,51,47,45,0,43,42,47,43,0,0,0,5
16:18:26,847.2635,Dog,90,85,4,28,8,0,45,0,90,84,55,47,45,0,43,42,47,43,0,0,0,5
16:18:28,850.4636,Dog,90,85,4,26,10,0,45,0,90,84,57,47,45,0,43,42,47,43,0,0,0,5
16:18:31,856.0635,Dog,92,87,4,26,10,0,45,0,90,84,57,47,45,0,44,43,48,44,0,0,0,5
16:18:32,858.6635,Dog,92,87,4,24,12,0,45,0,90,84,59,47,45,0,44,43,48,44,0,0,0,5
16:18:34,861.2635,Dog,92,87,4,22,14,0,45,0,90,84,61,47,45,0,44,43,48,44,0,0,0,5
16:18:35,863.0635,Dog,94,89,4,22,14,0,45,0,90,84,61,47,45,0,44,45,48,46,0,0,0,5
16:18:36,864.0635,Dog,94,89,4,20,16,0,45,0,90,84,63,47,45,0,44,45,48,46,0,0,0,5
16:18:39,869.0635,Dog,94,89,6,20,16,0,45,0,92,84,63,47,45,0,44,45,48,46,0,0,0,5
16:18:43,876.0635,Dog,94,89,8,20,16,0,45,0,94,84,63,47,45,0,44,45,48,46,0,0,0,5
16:19:01,903.6635,Dog,96,91,8,20,16,0,45,0,94,84,63,47,45,0,45,46,49,47,0,0,0,5
16:19:09,914.0635,Dog,96,91,8,18,18,0,45,0,94,84,65,47,45,0,45,46,49,47,0,0,0,5
16:19:11,916.6635,Dog,96,91,10,18,18,0,45,0,96,84,65,47,45,0,45,46,49,47,0,0,0,5
16:19:13,919.6635,Dog,98,93,10,16,20,0,45,0,96,84,67,47,45,0,46,47,50,48,0,0,0,5
16:19:14,921.8635,Dog,98,93,10,14,22,0,45,0,96,84,69,47,45,0,46,47,50,48,0,0,0,5
16:19:20,930.0635,Dog,98,93,10,12,24,0,45,0,96,84,71,47,45,0,46,47,50,48,0,0,0,5
16:19:22,932.6635,Dog,98,93,12,12,24,0,45,0,98,84,71,47,45,0,46,47,50,48,0,0,0,5
16:19:26,937.0635,Dog,98,93,12,10,26,0,45,0,98,84,73,47,45,0,46,47,50,48,0,0,0,5
16:19:29,940.8635,Dog,100,95,12,10,26,0,45,0,98,84,73,47,45,0,47,48,51,49,0,0,0,5
16:19:29,941.4636,Dog,102,97,12,10,26,0,45,0,98,84,73,47,45,0,48,49,52,50,0,0,0,5
16:19:34,947.2635,Dog,104,99,12,10,26,0,45,0,98,84,73,47,45,0,49,50,53,51,0,0,0,5
16:19:35,949.2635,Dog,106,101,12,10,26,0,45,0,98,84,73,47,45,0,50,51,54,52,0,0,0,5
16:19:39,953.8635,Dog,106,101,14,10,26,0,45,0,100,84,73,47,45,0,50,51,54,52,0,0,0,5
16:19:39,954.4636,Dog,106,101,16,10,26,0,45,0,102,84,73,47,45,0,50,51,54,52,0,0,0,5
16:19:41,956.6635,Dog,106,101,16,8,28,0,45,0,102,84,75,47,45,0,50,51,54,52,0,0,0,5
16:19:43,958.8635,Dog,106,101,14,10,28,0,45,0,102,86,75,47,45,0,50,51,54,52,0,0,0,5
16:19:44,959.8635,Dog,106,100,14,10,28,0,44,0,102,86,75,47,45,0,50,50,54,52,0,0,0,6
16:19:44,960.2635,Dog,106,100,16,10,28,0,44,0,104,86,75,47,45,0,50,50,54,52,0,0,0,6
16:19:46,962.2635,Dog,106,100,16,12,28,0,44,0,106,88,75,47,45,0,50,50,54,52,0,0,0,6
16:19:47,963.0635,Dog,108,102,16,10,30,0,44,0,106,88,77,47,45,0,51,51,55,53,0,0,0,6
16:19:56,973.6635,Dog,108,102,16,8,32,0,44,0,106,88,79,47,45,0,51,51,55,53,0,0,0,6
16:19:57,974.2635,Dog,108,102,16,6,34,0,44,0,106,88,81,47,45,0,51,51,55,53,0,0,0,6
16:19:58,976.0635,Dog,108,102,18,4,36,0,44,0,108,88,83,47,45,0,51,51,55,53,0,0,0,6
16:20:03,981.0635,Dog,108,102,18,4,36,0,0,44,108,88,83,47,45,44,51,51,55,53,0,0,0,6
16:20:05,982.8635,Dog,110,104,18,4,36,0,0,44,108,88,83,47,45,44,52,52,56,54,0,0,0,6