System Time:,Simulation Time:,AnimalType:,overall,alive,puppy,juvenile,young_adult,adult,aged_adult,elder,overall_puppy,overall_juvenile,overall_young_adult,overall_adult,overall_aged_adult,overall_elder,female,male,overall_female,overall_male,thirstDeath,hungerDeath,ageDeath,predatorDeath,,
14:32:50,1.890826,Fox,18,18,18,0,0,0,0,0,18,0,0,0,0,0,8,10,8,10,0,0,0,0,,18
14:33:18,84.19951,Fox,18,18,0,18,0,0,0,0,18,18,0,0,0,0,8,10,8,10,0,0,0,0,,18
14:33:30,122.7347,Fox,18,18,0,0,18,0,0,0,18,18,18,0,0,0,8,10,8,10,0,0,0,0,,18
14:33:43,160.5977,Fox,20,20,2,0,18,0,0,0,20,18,18,0,0,0,9,11,9,11,0,0,0,0,,20
14:33:43,160.8412,Fox,22,22,4,0,18,0,0,0,22,18,18,0,0,0,10,12,10,12,0,0,0,0,,22
14:33:51,183.2082,Fox,22,22,4,0,0,18,0,0,22,18,18,18,0,0,10,12,10,12,0,0,0,0,,22
14:34:08,234.5548,Fox,24,24,6,0,0,18,0,0,24,18,18,18,0,0,12,12,12,12,0,0,0,0,,24
14:34:10,240.3558,Fox,26,26,8,0,0,18,0,0,26,18,18,18,0,0,14,12,14,12,0,0,0,0,,26
14:34:11,243.1556,Fox,26,26,6,2,0,18,0,0,26,20,18,18,0,0,14,12,14,12,0,0,0,0,,26
14:34:11,243.4203,Fox,26,26,4,4,0,18,0,0,26,22,18,18,0,0,14,12,14,12,0,0,0,0,,26
14:34:16,259.5083,Fox,28,28,6,4,0,18,0,0,28,22,18,18,0,0,15,13,15,13,0,0,0,0,,28
14:34:22,276.7306,Fox,28,28,6,4,0,0,18,0,28,22,18,18,18,0,15,13,15,13,0,0,0,0,,28
14:34:23,281.6845,Fox,28,28,6,2,2,0,18,0,28,22,20,18,18,0,15,13,15,13,0,0,0,0,,28
14:34:23,281.846,Fox,28,28,6,0,4,0,18,0,28,22,22,18,18,0,15,13,15,13,0,0,0,0,,28
14:34:26,288.0119,Fox,30,30,8,0,4,0,18,0,30,22,22,18,18,0,16,14,16,14,0,0,0,0,,30
14:34:28,296.6703,Fox,32,32,10,0,4,0,18,0,32,22,22,18,18,0,17,15,17,15,0,0,0,0,,32
14:34:32,308.4493,Fox,34,33,12,0,4,0,17,0,34,22,22,18,18,0,17,16,18,16,0,1,0,0,,33
14:34:33,310.1052,Fox,34,32,12,0,4,0,16,0,34,22,22,18,18,0,16,16,18,16,0,2,0,0,,32
14:34:35,316.6151,Fox,36,34,14,0,4,0,16,0,36,22,22,18,18,0,17,17,19,17,0,2,0,0,,34
14:34:35,317.0967,Fox,36,34,12,2,4,0,16,0,36,24,22,18,18,0,17,17,19,17,0,2,0,0,,34
14:34:37,322.9446,Fox,36,34,10,4,4,0,16,0,36,26,22,18,18,0,17,17,19,17,0,2,0,0,,34
14:34:39,327.8354,Fox,38,36,12,4,4,0,16,0,38,26,22,18,18,0,17,19,19,19,0,2,0,0,,36
14:34:44,342.1788,Fox,38,36,10,6,2,2,16,0,38,28,22,20,18,0,17,19,19,19,0,2,0,0,,36
14:34:44,342.3514,Fox,38,36,10,6,0,4,16,0,38,28,22,22,18,0,17,19,19,19,0,2,0,0,,36
14:34:47,353.0378,Fox,38,34,10,6,0,2,16,0,38,28,22,22,18,0,16,18,19,19,1,3,0,0,,34
14:34:48,355.652,Fox,38,34,10,4,2,2,16,0,38,28,24,22,18,0,16,18,19,19,1,3,0,0,,34
14:34:50,361.3803,Fox,38,34,10,2,4,2,16,0,38,28,26,22,18,0,16,18,19,19,1,3,0,0,,34
14:34:51,363.8868,Fox,40,36,12,2,4,2,16,0,40,28,26,22,18,0,17,19,20,20,1,3,0,0,,36
14:34:53,370.5081,Fox,40,36,10,4,4,2,16,0,40,30,26,22,18,0,17,19,20,20,1,3,0,0,,36
14:34:56,379.2874,Fox,40,36,8,6,4,2,16,0,40,32,26,22,18,0,17,19,20,20,1,3,0,0,,36
14:34:56,380.5971,Fox,40,36,8,4,6,2,16,0,40,32,28,22,18,0,17,19,20,20,1,3,0,0,,36
14:35:00,390.0942,Fox,42,38,10,4,6,2,16,0,42,32,28,22,18,0,18,20,21,21,1,3,0,0,,38
14:35:00,390.9921,Fox,42,38,8,6,6,2,16,0,42,34,28,22,18,0,18,20,21,21,1,3,0,0,,38
14:35:02,397.1466,Fox,42,33,8,6,6,2,11,0,42,34,28,22,18,0,16,17,21,21,1,8,0,0,,33
14:35:03,399.1531,Fox,42,33,6,8,6,2,11,0,42,36,28,22,18,0,16,17,21,21,1,8,0,0,,33
14:35:06,409.0952,Fox,42,33,6,6,8,2,11,0,42,36,30,22,18,0,16,17,21,21,1,8,0,0,,33
14:35:06,410.3333,Fox,42,33,4,8,8,2,11,0,42,38,30,22,18,0,16,17,21,21,1,8,0,0,,33
14:35:08,414.1966,Fox,42,33,4,8,8,2,0,11,42,38,30,22,18,11,16,17,21,21,1,8,0,0,,33
14:35:08,416.1101,Fox,42,33,4,8,6,4,0,11,42,38,30,24,18,11,16,17,21,21,1,8,0,0,,33
14:35:09,417.6767,Fox,42,33,4,6,8,4,0,11,42,38,32,24,18,11,16,17,21,21,1,8,0,0,,33
14:35:10,421.8698,Fox,42,33,4,6,6,6,0,11,42,38,32,26,18,11,16,17,21,21,1,8,0,0,,33
14:35:13,429.5067,Fox,42,33,4,4,8,6,0,11,42,38,34,26,18,11,16,17,21,21,1,8,0,0,,33
14:35:14,432.5976,Fox,42,31,4,4,8,4,0,11,42,38,34,26,18,11,14,17,21,21,1,10,0,0,,31
14:35:14,434.2959,Fox,42,28,4,4,8,4,0,8,42,38,34,26,18,11,12,16,21,21,1,10,3,0,,28
14:35:15,435.6515,Fox,42,28,4,4,8,2,2,8,42,38,34,26,20,11,12,16,21,21,1,10,3,0,,28
14:35:15,437.621,Fox,42,28,4,2,10,2,2,8,42,38,36,26,20,11,12,16,21,21,1,10,3,0,,28
14:35:17,441.0329,Fox,42,28,4,2,8,4,2,8,42,38,36,28,20,11,12,16,21,21,1,10,3,0,,28
14:35:18,446.3777,Fox,42,28,2,4,8,4,2,8,42,40,36,28,20,11,12,16,21,21,1,10,3,0,,28
14:35:19,446.9077,Fox,44,29,4,4,7,4,2,8,44,40,36,28,20,11,11,18,21,23,1,11,3,0,,29
14:35:19,448.8529,Fox,44,29,4,2,9,4,2,8,44,40,38,28,20,11,11,18,21,23,1,11,3,0,,29
14:35:20,451.7531,Fox,44,28,4,2,9,3,2,8,44,40,38,28,20,11,10,18,21,23,1,12,3,0,,28
14:35:22,456.9155,Fox,46,30,6,2,9,3,2,8,46,40,38,28,20,11,10,20,21,25,1,12,3,0,,30
14:35:24,464.4265,Fox,46,29,6,2,9,3,2,7,46,40,38,28,20,11,9,20,21,25,1,12,4,0,,29
14:35:26,469.5093,Fox,46,29,6,2,8,4,2,7,46,40,38,29,20,11,9,20,21,25,1,12,4,0,,29
14:35:27,472.6546,Fox,46,29,4,4,8,4,2,7,46,42,38,29,20,11,9,20,21,25,1,12,4,0,,29
14:35:28,474.5009,Fox,46,28,4,4,8,4,2,6,46,42,38,29,20,11,9,19,21,25,1,12,5,0,,28
14:35:29,478.2111,Fox,46,28,4,4,6,6,2,6,46,42,38,31,20,11,9,19,21,25,1,12,5,0,,28
14:35:30,480.3029,Fox,46,27,4,4,6,5,2,6,46,42,38,31,20,11,9,18,21,25,1,13,5,0,,27
14:35:31,484.5439,Fox,46,26,4,4,6,5,2,5,46,42,38,31,20,11,8,18,21,25,1,13,6,0,,26
14:35:31,484.8874,Fox,46,26,4,2,8,5,2,5,46,42,40,31,20,11,8,18,21,25,1,13,6,0,,26
14:35:33,489.9775,Fox,46,26,4,2,6,7,2,5,46,42,40,33,20,11,8,18,21,25,1,13,6,0,,26
14:35:34,494.5824,Fox,46,24,4,2,6,7,2,3,46,42,40,33,20,11,8,16,21,25,1,13,8,0,,24
14:35:36,498.1642,Fox,46,24,4,2,4,9,2,3,46,42,40,35,20,11,8,16,21,25,1,13,8,0,,24
14:35:36,500.7622,Fox,46,22,4,2,4,7,2,3,46,42,40,35,20,11,7,15,21,25,1,15,8,0,,22
14:35:39,508.9492,Fox,46,21,4,2,4,6,2,3,46,42,40,35,20,11,7,14,21,25,1,16,8,0,,21
14:35:39,509.3817,Fox,46,21,4,2,2,8,2,3,46,42,40,37,20,11,7,14,21,25,1,16,8,0,,21
14:35:39,509.6478,Fox,46,21,4,2,2,6,4,3,46,42,40,37,22,11,7,14,21,25,1,16,8,0,,21
14:35:40,511.1522,Fox,46,21,4,0,4,6,4,3,46,42,42,37,22,11,7,14,21,25,1,16,8,0,,21
14:35:41,514.6705,Fox,46,20,4,0,4,6,4,2,46,42,42,37,22,11,7,13,21,25,1,16,9,0,,20
14:35:44,524.7763,Fox,46,19,4,0,4,6,4,1,46,42,42,37,22,11,7,12,21,25,1,16,10,0,,19
14:35:46,529.4333,Fox,46,19,2,2,4,6,4,1,46,44,42,37,22,11,7,12,21,25,1,16,10,0,,19
14:35:47,533.1479,Fox,48,21,4,2,4,6,4,1,48,44,42,37,22,11,7,14,21,27,1,16,10,0,,21
14:35:48,534.5436,Fox,48,21,4,2,4,5,5,1,48,44,42,37,23,11,7,14,21,27,1,16,10,0,,21
14:35:49,539.4634,Fox,48,21,2,4,4,5,5,1,48,46,42,37,23,11,7,14,21,27,1,16,10,0,,21
14:35:50,540.3174,Fox,50,22,4,4,3,5,5,1,50,46,42,37,23,11,6,16,21,29,1,17,10,0,,22
14:35:51,545.4286,Fox,50,22,4,4,2,6,5,1,50,46,42,38,23,11,6,16,21,29,1,17,10,0,,22
14:35:55,556.1759,Fox,50,21,4,4,2,5,5,1,50,46,42,38,23,11,6,15,21,29,2,17,10,0,,21
14:35:59,567.905,Fox,50,21,4,2,4,5,5,1,50,46,44,38,23,11,6,15,21,29,2,17,10,0,,21
14:36:00,571.689,Fox,50,21,4,2,2,5,7,1,50,46,44,40,25,11,6,15,21,29,2,17,10,0,,21
14:36:01,573.116,Fox,50,21,4,2,2,5,5,3,50,46,44,40,25,13,6,15,21,29,2,17,10,0,,21
14:36:01,574.8742,Fox,50,20,4,2,2,5,5,2,50,46,44,40,25,13,6,14,21,29,2,17,11,0,,20
14:36:02,577.929,Fox,50,20,4,0,4,5,5,2,50,46,46,40,25,13,6,14,21,29,2,17,11,0,,20
14:36:04,582.4208,Fox,50,19,4,0,4,4,5,2,50,46,46,40,25,13,6,13,21,29,2,18,11,0,,19
14:36:07,591.6395,Fox,50,19,4,0,4,3,6,2,50,46,46,40,26,13,6,13,21,29,2,18,11,0,,19
14:36:10,602.0902,Fox,52,21,6,0,4,3,6,2,52,46,46,40,26,13,7,14,22,30,2,18,11,0,,21
14:36:11,602.8784,Fox,52,21,6,0,4,1,8,2,52,46,46,40,28,13,7,14,22,30,2,18,11,0,,21
14:36:15,615.6445,Fox,52,21,4,2,4,1,8,2,52,48,46,40,28,13,7,14,22,30,2,18,11,0,,21
14:36:16,619.3864,Fox,54,23,6,2,4,1,8,2,54,48,46,40,28,13,8,15,23,31,2,18,11,0,,23
14:36:17,622.8641,Fox,54,23,4,4,4,1,8,2,54,50,46,40,28,13,8,15,23,31,2,18,11,0,,23
14:36:18,624.321,Fox,54,22,4,4,4,1,7,2,54,50,46,40,28,13,8,14,23,31,2,19,11,0,,22
14:36:19,628.4023,Fox,54,22,4,4,2,3,7,2,54,50,46,42,28,13,8,14,23,31,2,19,11,0,,22
14:36:20,632.3929,Fox,56,23,6,4,2,3,6,2,56,50,46,42,28,13,7,16,23,33,2,20,11,0,,23
14:36:22,638.468,Fox,56,23,6,4,0,5,6,2,56,50,46,44,28,13,7,16,23,33,2,20,11,0,,23
14:36:24,643.4747,Fox,56,22,6,4,0,5,6,1,56,50,46,44,28,13,6,16,23,33,2,20,12,0,,22
14:36:25,646.2948,Fox,58,24,8,4,0,5,6,1,58,50,46,44,28,13,6,18,23,35,2,20,12,0,,24
14:36:25,647.0981,Fox,58,24,8,4,0,5,5,2,58,50,46,44,28,14,6,18,23,35,2,20,12,0,,24
14:36:26,649.5063,Fox,58,23,8,4,0,4,5,2,58,50,46,44,28,14,6,17,23,35,2,21,12,0,,23
14:36:28,654.1819,Fox,58,23,8,2,2,4,5,2,58,50,48,44,28,14,6,17,23,35,2,21,12,0,,23
14:36:30,661.3254,Fox,58,23,8,0,4,4,5,2,58,50,50,44,28,14,6,17,23,35,2,21,12,0,,23
14:36:31,665.1631,Fox,58,23,8,0,4,3,6,2,58,50,50,44,29,14,6,17,23,35,2,21,12,0,,23
14:36:34,672.0968,Fox,58,23,8,0,4,3,5,3,58,50,50,44,29,15,6,17,23,35,2,21,12,0,,23
14:36:38,684.6439,Fox,58,23,6,2,4,3,5,3,58,52,50,44,29,15,6,17,23,35,2,21,12,0,,23
14:36:39,687.304,Fox,58,22,6,2,4,3,5,2,58,52,50,44,29,15,5,17,23,35,2,21,13,0,,22
14:36:41,694.5853,Fox,60,24,8,2,4,3,5,2,60,52,50,44,29,15,5,19,23,37,2,21,13,0,,24
14:36:43,699.1288,Fox,62,26,10,2,4,3,5,2,62,52,50,44,29,15,5,21,23,39,2,21,13,0,,26
14:36:44,701.9141,Fox,62,26,8,4,4,3,5,2,62,54,50,44,29,15,5,21,23,39,2,21,13,0,,26
14:36:44,703.7796,Fox,62,25,8,4,4,3,5,1,62,54,50,44,29,15,5,20,23,39,2,21,14,0,,25
14:36:46,709.2357,Fox,62,25,8,4,4,3,3,3,62,54,50,44,29,17,5,20,23,39,2,21,14,0,,25
14:36:48,714.722,Fox,62,25,8,4,2,5,3,3,62,54,50,46,29,17,5,20,23,39,2,21,14,0,,25
14:36:48,714.9212,Fox,62,25,6,6,2,5,3,3,62,56,50,46,29,17,5,20,23,39,2,21,14,0,,25
14:36:50,722.006,Fox,62,25,6,6,0,5,5,3,62,56,50,48,31,17,5,20,23,39,2,21,14,0,,25
14:36:50,722.4923,Fox,62,24,6,6,0,5,5,2,62,56,50,48,31,17,5,19,23,39,2,21,15,0,,24
14:36:51,723.0955,Fox,62,24,6,4,2,5,5,2,62,56,52,48,31,17,5,19,23,39,2,21,15,0,,24
14:36:51,725.3521,Fox,62,23,6,4,2,4,5,2,62,56,52,48,31,17,5,18,23,39,2,22,15,0,,23
14:36:52,728.7917,Fox,62,23,4,6,2,4,5,2,62,58,52,48,31,17,5,18,23,39,2,22,15,0,,23
14:36:53,729.1758,Fox,62,23,4,6,2,4,4,3,62,58,52,48,31,18,5,18,23,39,2,22,15,0,,23
14:36:54,731.9647,Fox,62,23,4,6,2,3,5,3,62,58,52,48,32,18,5,18,23,39,2,22,15,0,,23
14:36:54,732.6148,Fox,62,22,4,6,2,2,5,3,62,58,52,48,32,18,5,17,23,39,2,23,15,0,,22
14:36:56,740.4682,Fox,62,22,4,4,4,2,4,4,62,58,54,48,32,19,5,17,23,39,2,23,15,0,,22
14:37:01,753.45,Fox,62,22,4,2,6,2,4,4,62,58,56,48,32,19,5,17,23,39,2,23,15,0,,22
14:37:03,759.5581,Fox,64,23,6,2,5,2,4,4,64,58,56,48,32,19,6,17,25,39,2,24,15,0,,23
14:37:05,767.3137,Fox,64,23,6,0,7,2,4,4,64,58,58,48,32,19,6,17,25,39,2,24,15,0,,23
14:37:06,769.4581,Fox,64,22,6,0,7,2,4,3,64,58,58,48,32,19,5,17,25,39,2,24,16,0,,22
14:37:08,775.9726,Fox,66,23,8,0,6,2,4,3,66,58,58,48,32,19,4,19,25,41,3,24,16,0,,23
14:37:08,776.6405,Fox,66,22,8,0,6,2,4,2,66,58,58,48,32,19,4,18,25,41,3,25,16,0,,22
14:37:09,777.1426,Fox,66,22,6,2,6,2,4,2,66,60,58,48,32,19,4,18,25,41,3,25,16,0,,22
14:37:10,781.6378,Fox,66,22,4,4,6,2,4,2,66,62,58,48,32,19,4,18,25,41,3,25,16,0,,22
14:37:11,783.5826,Fox,66,22,4,4,5,3,4,2,66,62,58,49,32,19,4,18,25,41,3,25,16,0,,22
14:37:14,794.3625,Fox,66,21,4,4,5,2,4,2,66,62,58,49,32,19,4,17,25,41,3,26,16,0,,21
14:37:16,799.7081,Fox,66,20,4,4,5,2,4,1,66,62,58,49,32,19,4,16,25,41,3,26,17,0,,20
14:37:17,800.986,Fox,66,20,4,4,4,3,4,1,66,62,58,50,32,19,4,16,25,41,3,26,17,0,,20
14:37:17,802.6176,Fox,66,20,4,4,4,3,3,2,66,62,58,50,32,20,4,16,25,41,3,26,17,0,,20
14:37:19,808.1478,Fox,66,20,4,4,4,2,4,2,66,62,58,50,33,20,4,16,25,41,3,26,17,0,,20
14:37:20,811.6181,Fox,66,19,4,4,4,1,4,2,66,62,58,50,33,20,4,15,25,41,4,26,17,0,,19
14:37:21,813.9075,Fox,66,19,4,4,2,3,4,2,66,62,58,52,33,20,4,15,25,41,4,26,17,0,,19
14:37:21,815.3183,Fox,66,19,4,4,2,2,5,2,66,62,58,52,34,20,4,15,25,41,4,26,17,0,,19
14:37:21,815.5762,Fox,66,19,4,2,4,2,5,2,66,62,60,52,34,20,4,15,25,41,4,26,17,0,,19
14:37:23,820.1348,Fox,66,19,4,0,6,2,5,2,66,62,62,52,34,20,4,15,25,41,4,26,17,0,,19
14:37:24,824.6177,Fox,66,17,4,0,6,0,5,2,66,62,62,52,34,20,4,13,25,41,4,28,17,0,,17
14:37:25,827.8065,Fox,66,17,4,0,4,2,5,2,66,62,62,54,34,20,4,13,25,41,4,28,17,0,,17
14:37:26,829.4921,Fox,66,16,4,0,4,2,5,1,66,62,62,54,34,20,3,13,25,41,4,28,18,0,,16
14:37:29,838.5064,Fox,66,15,4,0,4,1,5,1,66,62,62,54,34,20,3,12,25,41,4,29,18,0,,15
14:37:30,842.0729,Fox,66,15,2,2,4,1,5,1,66,64,62,54,34,20,3,12,25,41,4,29,18,0,,15
14:37:36,858.5221,Fox,66,15,0,4,4,1,5,1,66,66,62,54,34,20,3,12,25,41,4,29,18,0,,15
14:37:36,859.4357,Fox,66,15,0,4,4,1,3,3,66,66,62,54,34,22,3,12,25,41,4,29,18,0,,15
14:37:37,862.8792,Fox,66,14,0,4,4,1,3,2,66,66,62,54,34,22,2,12,25,41,4,29,19,0,,14
14:37:39,869.5002,Fox,66,14,0,4,4,1,2,3,66,66,62,54,34,23,2,12,25,41,4,29,19,0,,14
14:37:42,876.1658,Fox,66,14,0,4,2,3,2,3,66,66,62,56,34,23,2,12,25,41,4,29,19,0,,14
14:37:43,880.6061,Fox,66,14,0,2,2,5,2,3,66,66,64,58,34,23,2,12,25,41,4,29,19,0,,14
14:37:45,886.7853,Fox,66,12,0,2,2,3,2,3,66,66,64,58,34,23,2,10,25,41,4,31,19,0,,12
14:37:49,896.9838,Fox,66,12,0,0,4,3,2,3,66,66,66,58,34,23,2,10,25,41,4,31,19,0,,12
14:37:57,921.2826,Fox,66,12,0,0,4,2,3,3,66,66,66,58,35,23,2,10,25,41,4,31,19,0,,12
14:38:00,931.2493,Fox,68,13,2,0,3,2,3,3,68,66,66,58,35,23,2,11,26,42,4,32,19,0,,13
14:38:03,939.7299,Fox,68,12,2,0,3,2,3,2,68,66,66,58,35,23,2,10,26,42,4,32,20,0,,12
14:38:03,941.0726,Fox,68,12,2,0,2,3,3,2,68,66,66,59,35,23,2,10,26,42,4,32,20,0,,12
14:38:05,945.7162,Fox,68,12,2,0,2,3,2,3,68,66,66,59,35,24,2,10,26,42,4,32,20,0,,12
14:38:07,952.8859,Fox,68,12,2,0,2,3,1,4,68,66,66,59,35,25,2,10,26,42,4,32,20,0,,12
14:38:07,953.7116,Fox,68,12,3,0,2,3,1,4,69,66,66,59,35,25,2,10,26,42,4,32,20,0,,12
14:38:09,957.5278,Fox,68,12,3,0,0,5,1,4,69,66,66,61,35,25,2,10,26,42,4,32,20,0,,12
14:38:10,959.9012,Fox,68,11,3,0,0,5,1,3,69,66,66,61,35,25,2,9,26,42,4,32,21,0,,11
14:38:12,968.4618,Fox,68,9,3,0,0,3,1,3,69,66,66,61,35,25,2,7,26,42,6,32,21,0,,9
14:38:14,974.1309,Fox,68,9,3,0,0,1,3,3,69,66,66,61,37,25,2,7,26,42,6,32,21,0,,9
14:38:15,975.8524,Fox,68,8,3,0,0,1,3,2,69,66,66,61,37,25,2,6,26,42,6,32,22,0,,8
14:38:23,1000.126,Fox,68,7,3,0,0,1,3,1,69,66,66,61,37,25,2,5,26,42,6,32,23,0,,7
14:38:27,1013.747,Fox,68,7,1,2,0,1,3,1,69,68,66,61,37,25,2,5,26,42,6,32,23,0,,7
14:38:34,1033.29,Fox,68,6,1,2,0,1,3,0,69,68,66,61,37,25,2,4,26,42,6,32,24,0,,6
14:38:34,1034.547,Fox,68,6,1,2,0,0,4,0,69,68,66,61,38,25,2,4,26,42,6,32,24,0,,6
14:38:35,1036.238,Fox,68,6,0,3,0,0,4,0,69,69,66,61,38,25,2,4,26,42,6,32,24,0,,6
14:38:40,1052.294,Fox,68,6,0,1,2,0,4,0,69,69,68,61,38,25,2,4,26,42,6,32,24,0,,6
14:38:42,1058.825,Fox,68,6,0,1,2,0,3,1,69,69,68,61,38,26,2,4,26,42,6,32,24,0,,6
14:38:48,1074.752,Fox,68,6,0,0,3,0,3,1,69,69,69,61,38,26,2,4,26,42,6,32,24,0,,6
14:38:52,1087.152,Fox,70,7,2,0,2,0,3,1,71,69,69,61,38,26,2,5,27,43,7,32,24,0,,7
14:38:56,1099.053,Fox,70,6,2,0,2,0,3,0,71,69,69,61,38,26,2,4,27,43,7,32,25,0,,6
14:39:00,1111.695,Fox,70,6,2,0,2,0,1,2,71,69,69,61,38,28,2,4,27,43,7,32,25,0,,6
14:39:00,1112.808,Fox,70,6,2,0,1,1,1,2,71,69,69,62,38,28,2,4,27,43,7,32,25,0,,6
14:39:04,1123.85,Fox,70,5,2,0,1,0,1,2,71,69,69,62,38,28,2,3,27,43,8,32,25,0,,5
14:39:08,1135.304,Fox,70,5,2,0,0,1,1,2,71,69,69,63,38,28,2,3,27,43,8,32,25,0,,5
14:39:19,1169.684,Fox,70,5,0,2,0,1,1,2,71,71,69,63,38,28,2,3,27,43,8,32,25,0,,5
14:39:20,1172.117,Fox,70,4,0,2,0,1,0,2,71,71,69,63,38,29,2,2,27,43,8,32,26,0,,4
14:39:24,1182.236,Fox,70,3,0,2,0,1,0,1,71,71,69,63,38,29,2,1,27,43,8,32,27,0,,3
14:39:32,1208.256,Fox,70,3,0,0,2,1,0,1,71,71,71,63,38,29,2,1,27,43,8,32,27,0,,3
14:39:37,1222.569,Fox,70,2,0,0,2,1,0,0,71,71,71,63,38,29,1,1,27,43,8,32,28,0,,2
14:39:39,1228.81,Fox,70,2,0,0,2,0,1,0,71,71,71,63,39,29,1,1,27,43,8,32,28,0,,2
14:39:53,1268.708,Fox,70,2,0,0,0,2,1,0,71,71,71,65,39,29,1,1,27,43,8,32,28,0,,2
14:40:05,1304.969,Fox,72,4,2,0,0,2,1,0,73,71,71,65,39,29,3,1,29,43,8,32,28,0,,4
14:40:24,1362.199,Fox,72,4,2,0,0,0,3,0,73,71,71,65,41,29,3,1,29,43,8,32,28,0,,4
14:40:25,1366.277,Fox,72,4,2,0,0,0,2,1,73,71,71,65,41,30,3,1,29,43,8,32,28,0,,4
14:40:32,1387.483,Fox,72,4,0,2,0,0,2,1,73,73,71,65,41,30,3,1,29,43,8,32,28,0,,4
14:40:40,1411.117,Fox,74,6,2,2,0,0,2,1,75,73,71,65,41,30,3,3,29,45,8,32,28,0,,6
14:40:45,1426.049,Fox,74,6,2,0,2,0,2,1,75,73,73,65,41,30,3,3,29,45,8,32,28,0,,6
14:40:45,1426.612,Fox,74,5,2,0,2,0,2,0,75,73,73,65,41,30,3,2,29,45,8,32,29,0,,5
14:40:59,1467.884,Fox,78,9,6,0,2,0,2,0,79,73,73,65,41,30,7,2,33,45,8,32,29,0,,9
14:41:05,1486.558,Fox,78,9,6,0,0,2,2,0,79,73,73,67,41,30,7,2,33,45,8,32,29,0,,9
14:41:08,1493.742,Fox,78,9,4,2,0,2,2,0,79,75,73,67,41,30,7,2,33,45,8,32,29,0,,9
14:41:10,1499.802,Fox,78,9,4,2,0,2,0,2,79,75,73,67,41,32,7,2,33,45,8,32,29,0,,9
14:41:20,1532.237,Fox,78,9,4,0,2,2,0,2,79,75,75,67,41,32,7,2,33,45,8,32,29,0,,9
14:41:23,1540.026,Fox,78,8,4,0,2,2,0,1,79,75,75,67,41,32,6,2,33,45,8,32,30,0,,8
14:41:26,1550.167,Fox,78,7,4,0,2,2,0,0,79,75,75,67,41,32,6,1,33,45,8,32,31,0,,7
14:41:26,1550.437,Fox,78,7,0,4,2,2,0,0,79,79,75,67,41,32,6,1,33,45,8,32,31,0,,7
14:41:36,1580.033,Fox,78,7,0,4,2,0,2,0,79,79,75,67,43,32,6,1,33,45,8,32,31,0,,7
14:41:39,1588.324,Fox,80,9,2,4,2,0,2,0,81,79,75,67,43,32,8,1,35,45,8,32,31,0,,9
14:41:39,1589.223,Fox,82,11,2,0,6,0,2,0,81,79,79,67,43,32,8,3,35,47,8,32,31,0,,11
14:41:39,1589.486,Fox,82,11,4,0,6,0,2,0,83,79,79,67,43,32,8,3,35,47,8,32,31,0,,11
14:41:41,1592.78,Fox,82,11,4,0,4,2,2,0,83,79,79,69,43,32,8,3,35,47,8,32,31,0,,11
14:41:59,1649.412,Fox,82,11,4,0,0,6,2,0,83,79,79,73,43,32,8,3,35,47,8,32,31,0,,11
14:42:04,1661.671,Fox,82,9,4,0,0,4,2,0,83,79,79,73,43,32,6,3,35,47,10,32,31,0,,9
14:42:07,1670.886,Fox,82,9,2,2,0,4,2,0,83,81,79,73,43,32,6,3,35,47,10,32,31,0,,9
14:42:07,1671.973,Fox,82,9,0,4,0,4,2,0,83,83,79,73,43,32,6,3,35,47,10,32,31,0,,9
14:42:12,1686.286,Fox,82,9,0,4,0,2,4,0,83,83,79,73,45,32,6,3,35,47,10,32,31,0,,9
14:42:19,1709.48,Fox,84,11,2,2,2,2,4,0,85,83,81,73,45,32,7,4,36,48,10,32,31,0,,11
14:42:20,1710.489,Fox,84,11,2,0,4,2,4,0,85,83,83,73,45,32,7,4,36,48,10,32,31,0,,11
14:42:22,1717.631,Fox,84,11,2,0,4,2,2,2,85,83,83,73,45,34,7,4,36,48,10,32,31,0,,11
14:42:31,1743.044,Fox,84,11,2,0,4,0,4,2,85,83,83,73,47,34,7,4,36,48,10,32,31,0,,11
14:42:32,1745.998,Fox,86,13,4,0,4,0,4,2,87,83,83,73,47,34,9,4,38,48,10,32,31,0,,13
14:42:32,1746.838,Fox,88,15,6,0,4,0,4,2,89,83,83,73,47,34,10,5,39,49,10,32,31,0,,15
14:42:36,1758.03,Fox,88,14,6,0,4,0,4,1,89,83,83,73,47,34,9,5,39,49,10,32,32,0,,14
14:42:40,1769.901,Fox,88,14,6,0,2,2,4,1,89,83,83,75,47,34,9,5,39,49,10,32,32,0,,14
14:42:40,1771.108,Fox,88,14,6,0,0,4,4,1,89,83,83,77,47,34,9,5,39,49,10,32,32,0,,14
14:42:42,1778.299,Fox,88,13,6,0,0,4,4,0,89,83,83,77,47,34,8,5,39,49,10,32,33,0,,13
14:42:44,1783.834,Fox,88,12,6,0,0,3,4,0,89,83,83,77,47,34,8,4,39,49,11,32,33,0,,12
14:42:47,1792.223,Fox,88,12,4,2,0,3,4,0,89,85,83,77,47,34,8,4,39,49,11,32,33,0,,12
14:42:58,1823.702,Fox,88,12,4,2,0,3,2,2,89,85,83,77,47,36,8,4,39,49,11,32,33,0,,12
14:42:59,1828.681,Fox,88,12,2,4,0,3,2,2,89,87,83,77,47,36,8,4,39,49,11,32,33,0,,12
14:42:59,1829.38,Fox,88,12,0,6,0,3,2,2,89,89,83,77,47,36,8,4,39,49,11,32,33,0,,12
14:43:00,1830.572,Fox,88,12,0,4,2,3,2,2,89,89,85,77,47,36,8,4,39,49,11,32,33,0,,12
14:43:07,1852.293,Fox,90,14,2,4,2,3,2,2,91,89,85,77,47,36,9,5,40,50,11,32,33,0,,14
14:43:11,1863.428,Fox,90,14,2,4,2,1,4,2,91,89,85,77,49,36,9,5,40,50,11,32,33,0,,14
14:43:11,1864.602,Fox,90,14,2,4,2,0,5,2,91,89,85,77,50,36,9,5,40,50,11,32,33,0,,14
14:43:12,1867.008,Fox,90,14,2,2,4,0,5,2,91,89,87,77,50,36,9,5,40,50,11,32,33,0,,14
14:43:12,1867.98,Fox,90,14,2,0,6,0,5,2,91,89,89,77,50,36,9,5,40,50,11,32,33,0,,14
14:43:17,1880.594,Fox,90,14,2,0,6,0,3,4,91,89,89,77,50,38,9,5,40,50,11,32,33,0,,14
14:43:17,1881.897,Fox,92,16,4,0,6,0,3,4,93,89,89,77,50,38,10,6,41,51,11,32,33,0,,16
14:43:20,1891.119,Fox,92,16,4,0,4,2,3,4,93,89,89,79,50,38,10,6,41,51,11,32,33,0,,16
14:43:21,1893.347,Fox,94,18,6,0,4,2,3,4,95,89,89,79,50,38,10,8,41,53,11,32,33,0,,18
14:43:31,1924.484,Fox,94,17,6,0,4,2,3,3,95,89,89,79,50,38,10,7,41,53,11,32,34,0,,17
14:43:32,1927.553,Fox,94,17,6,0,2,4,3,3,95,89,89,81,50,38,10,7,41,53,11,32,34,0,,17
14:43:32,1928.365,Fox,94,17,6,0,0,6,3,3,95,89,89,83,50,38,10,7,41,53,11,32,34,0,,17
14:43:34,1934.07,Fox,96,19,8,0,0,6,3,3,97,89,89,83,50,38,11,8,42,54,11,32,34,0,,19
14:43:35,1934.859,Fox,96,19,6,2,0,6,3,3,97,91,89,83,50,38,11,8,42,54,11,32,34,0,,19
14:43:37,1941.322,Fox,96,18,6,2,0,6,3,2,97,91,89,83,50,38,10,8,42,54,11,32,35,0,,18
14:43:38,1944.856,Fox,96,17,6,2,0,6,3,1,97,91,89,83,50,38,10,7,42,54,11,32,36,0,,17
14:43:40,1951.434,Fox,96,16,6,2,0,6,3,0,97,91,89,83,50,38,9,7,42,54,11,32,37,0,,16
14:43:42,1957.972,Fox,98,18,8,2,0,6,3,0,99,91,89,83,50,38,10,8,43,55,11,32,37,0,,18
14:43:45,1964.545,Fox,98,18,6,4,0,6,3,0,99,93,89,83,50,38,10,8,43,55,11,32,37,0,,18
14:43:48,1973.492,Fox,98,18,6,2,2,6,3,0,99,93,91,83,50,38,10,8,43,55,11,32,37,0,,18
14:43:48,1975.924,Fox,98,18,4,4,2,6,3,0,99,95,91,83,50,38,10,8,43,55,11,32,37,0,,18
14:43:51,1984.623,Fox,98,18,4,4,2,4,5,0,99,95,91,83,52,38,10,8,43,55,11,32,37,0,,18
14:43:54,1993.08,Fox,100,20,6,4,2,4,5,0,101,95,91,83,52,38,12,8,45,55,11,32,37,0,,20
14:43:57,2001.015,Fox,100,20,6,4,2,4,3,2,101,95,91,83,52,40,12,8,45,55,11,32,37,0,,20
14:43:57,2002.173,Fox,100,20,6,4,2,4,2,3,101,95,91,83,52,41,12,8,45,55,11,32,37,0,,20
14:43:57,2003.057,Fox,100,20,6,2,4,4,2,3,101,95,93,83,52,41,12,8,45,55,11,32,37,0,,20
14:43:59,2008.767,Fox,102,22,8,2,4,4,2,3,103,95,93,83,52,41,13,9,46,56,11,32,37,0,,22
14:44:00,2010.156,Fox,104,24,10,2,4,4,2,3,105,95,93,83,52,41,15,9,48,56,11,32,37,0,,24
14:44:01,2014.453,Fox,104,24,10,0,6,4,2,3,105,95,95,83,52,41,15,9,48,56,11,32,37,0,,24
14:44:02,2016.724,Fox,104,24,8,2,6,4,2,3,105,97,95,83,52,41,15,9,48,56,11,32,37,0,,24
14:44:03,2021.099,Fox,104,24,8,2,6,2,4,3,105,97,95,83,54,41,15,9,48,56,11,32,37,0,,24
14:44:04,2022.03,Fox,104,24,8,2,6,0,6,3,105,97,95,83,56,41,15,9,48,56,11,32,37,0,,24
14:44:08,2034.149,Fox,106,26,8,2,4,2,6,3,105,97,95,85,56,41,16,10,49,57,11,32,37,0,,26
14:44:08,2034.373,Fox,106,26,10,2,4,2,6,3,107,97,95,85,56,41,16,10,49,57,11,32,37,0,,26
14:44:10,2040.744,Fox,108,28,10,4,4,2,6,3,109,99,95,85,56,41,17,11,50,58,11,32,37,0,,28
14:44:11,2042.548,Fox,108,27,10,4,4,2,6,2,109,99,95,85,56,41,17,10,50,58,11,32,38,0,,27
14:44:14,2051.537,Fox,108,26,10,4,4,2,6,1,109,99,95,85,56,41,16,10,50,58,11,32,39,0,,26
14:44:15,2055.113,Fox,108,26,10,2,6,2,6,1,109,99,97,85,56,41,16,10,50,58,11,32,39,0,,26
14:44:17,2063.474,Fox,108,26,10,2,4,4,6,1,109,99,97,87,56,41,16,10,50,58,11,32,39,0,,26
14:44:20,2071.757,Fox,108,25,10,2,4,4,6,0,109,99,97,87,56,41,15,10,50,58,11,32,40,0,,25
14:44:21,2074.978,Fox,108,25,10,2,2,6,6,0,109,99,97,89,56,41,15,10,50,58,11,32,40,0,,25
14:44:22,2075.579,Fox,108,25,8,4,2,6,6,0,109,101,97,89,56,41,15,10,50,58,11,32,40,0,,25
14:44:23,2079.123,Fox,108,25,8,2,4,6,6,0,109,101,99,89,56,41,15,10,50,58,11,32,40,0,,25
14:44:25,2084.932,Fox,110,27,10,2,4,6,6,0,111,101,99,89,56,41,16,11,51,59,11,32,40,0,,27
14:44:27,2091.439,Fox,110,27,8,4,4,6,6,0,111,103,99,89,56,41,16,11,51,59,11,32,40,0,,27
14:44:27,2092.874,Fox,110,27,6,6,4,6,6,0,111,105,99,89,56,41,16,11,51,59,11,32,40,0,,27
14:44:35,2114.238,Fox,110,27,6,4,6,6,6,0,111,105,101,89,56,41,16,11,51,59,11,32,40,0,,27
14:44:35,2115.156,Fox,114,30,10,4,5,6,6,0,115,105,101,89,56,41,18,12,54,60,11,33,40,0,,30
14:44:35,2115.632,Fox,114,30,10,4,3,8,6,0,115,105,101,91,56,41,18,12,54,60,11,33,40,0,,30
14:44:36,2117.153,Fox,114,30,8,6,3,8,6,0,115,107,101,91,56,41,18,12,54,60,11,33,40,0,,30
14:44:37,2122.324,Fox,114,30,8,6,3,8,4,2,115,107,101,91,56,43,18,12,54,60,11,33,40,0,,30
14:44:38,2123.385,Fox,114,30,6,8,3,8,4,2,115,109,101,91,56,43,18,12,54,60,11,33,40,0,,30
14:44:39,2127.453,Fox,114,30,6,8,3,6,6,2,115,109,101,91,58,43,18,12,54,60,11,33,40,0,,30
14:44:40,2129.927,Fox,114,30,6,6,5,6,6,2,115,109,103,91,58,43,18,12,54,60,11,33,40,0,,30
14:44:40,2131.226,Fox,114,30,6,4,7,6,6,2,115,109,105,91,58,43,18,12,54,60,11,33,40,0,,30
14:44:43,2139.787,Fox,114,30,6,4,6,7,6,2,115,109,105,92,58,43,18,12,54,60,11,33,40,0,,30
14:44:48,2155.471,Fox,114,30,6,2,8,7,6,2,115,109,107,92,58,43,18,12,54,60,11,33,40,0,,30
14:44:49,2156.969,Fox,114,30,6,2,8,5,8,2,115,109,107,92,60,43,18,12,54,60,11,33,40,0,,30
14:44:49,2158.724,Fox,114,30,6,2,8,5,6,4,115,109,107,92,60,45,18,12,54,60,11,33,40,0,,30
14:44:50,2159.466,Fox,114,30,6,2,8,5,4,6,115,109,107,92,60,47,18,12,54,60,11,33,40,0,,30
14:44:50,2161.792,Fox,116,32,8,2,8,5,4,6,117,109,107,92,60,47,19,13,55,61,11,33,40,0,,32
14:44:51,2162.05,Fox,116,32,8,0,10,5,4,6,117,109,109,92,60,47,19,13,55,61,11,33,40,0,,32
14:44:51,2164.136,Fox,118,34,10,0,10,5,4,6,119,109,109,92,60,47,19,15,55,63,11,33,40,0,,34
14:44:52,2167.55,Fox,118,34,8,2,10,5,4,6,119,111,109,92,60,47,19,15,55,63,11,33,40,0,,34
14:44:53,2168.514,Fox,118,34,8,2,10,3,6,6,119,111,109,92,62,47,19,15,55,63,11,33,40,0,,34
14:44:55,2174.802,Fox,118,34,8,2,8,5,6,6,119,111,109,94,62,47,19,15,55,63,11,33,40,0,,34
14:44:58,2183.307,Fox,120,35,10,2,8,5,6,5,121,111,109,94,62,47,19,16,56,64,11,33,41,0,,35
14:45:00,2189.281,Fox,122,36,10,2,8,5,6,4,121,111,109,94,62,47,18,18,56,66,11,33,42,0,,36
14:45:00,2189.571,Fox,122,36,12,2,8,5,6,4,123,111,109,94,62,47,18,18,56,66,11,33,42,0,,36
14:45:00,2190.458,Fox,122,36,12,2,6,7,6,4,123,111,109,96,62,47,18,18,56,66,11,33,42,0,,36
14:45:01,2191.849,Fox,122,36,12,2,4,9,6,4,123,111,109,98,62,47,18,18,56,66,11,33,42,0,,36
14:45:02,2196.366,Fox,124,37,14,2,3,9,6,4,125,111,109,98,62,47,19,18,58,66,12,33,42,0,,37
14:45:03,2197.729,Fox,124,37,10,6,3,9,6,4,125,115,109,98,62,47,19,18,58,66,12,33,42,0,,37
14:45:05,2204.097,Fox,124,36,10,6,3,8,6,4,125,115,109,98,62,47,19,17,58,66,13,33,42,0,,36
14:45:05,2205.917,Fox,126,38,12,4,5,8,6,4,127,115,111,98,62,47,19,19,58,68,13,33,42,0,,38
14:45:06,2209.205,Fox,126,38,12,4,5,6,8,4,127,115,111,98,64,47,19,19,58,68,13,33,42,0,,38
14:45:07,2209.973,Fox,126,37,12,4,5,6,8,3,127,115,111,98,64,47,18,19,58,68,13,33,43,0,,37
14:45:09,2216.029,Fox,126,37,12,4,4,7,8,3,127,115,111,99,64,47,18,19,58,68,13,33,43,0,,37
14:45:11,2222.448,Fox,126,37,12,4,2,9,8,3,127,115,111,101,64,47,18,19,58,68,13,33,43,0,,37
14:45:14,2230.536,Fox,126,36,12,4,2,8,8,3,127,115,111,101,64,47,18,18,58,68,14,33,43,0,,36
14:45:14,2233.205,Fox,126,36,12,4,2,7,9,3,127,115,111,101,65,47,18,18,58,68,14,33,43,0,,36
14:45:15,2233.789,Fox,126,35,12,4,2,7,9,2,127,115,111,101,65,47,18,17,58,68,14,33,44,0,,35
14:45:16,2236.457,Fox,126,35,12,0,6,7,9,2,127,115,115,101,65,47,18,17,58,68,14,33,44,0,,35
14:45:16,2237.327,Fox,126,34,12,0,6,6,9,2,127,115,115,101,65,47,18,16,58,68,14,34,44,0,,34
14:45:17,2240.49,Fox,126,33,12,0,6,6,9,1,127,115,115,101,65,47,18,15,58,68,14,34,45,0,,33
14:45:18,2244.334,Fox,126,33,10,2,6,6,9,1,127,117,115,101,65,47,18,15,58,68,14,34,45,0,,33
14:45:19,2246.874,Fox,126,33,8,4,6,6,9,1,127,119,115,101,65,47,18,15,58,68,14,34,45,0,,33
14:45:20,2249.38,Fox,128,35,10,4,6,6,9,1,129,119,115,101,65,47,19,16,59,69,14,34,45,0,,35
14:45:20,2249.68,Fox,128,34,10,4,6,6,9,0,129,119,115,101,65,47,18,16,59,69,14,34,46,0,,34
14:45:24,2260.895,Fox,130,36,12,4,6,6,9,0,131,119,115,101,65,47,19,17,60,70,14,34,46,0,,36
14:45:25,2265.053,Fox,130,36,12,4,6,6,7,2,131,119,115,101,65,49,19,17,60,70,14,34,46,0,,36
14:45:26,2265.953,Fox,130,36,10,6,6,6,7,2,131,121,115,101,65,49,19,17,60,70,14,34,46,0,,36
14:45:26,2266.553,Fox,130,36,10,6,4,8,7,2,131,121,115,103,65,49,19,17,60,70,14,34,46,0,,36
14:45:26,2267.453,Fox,132,38,12,6,4,8,7,2,133,121,115,103,65,49,21,17,62,70,14,34,46,0,,38
14:45:27,2268.342,Fox,132,38,12,6,4,6,9,2,133,121,115,103,67,49,21,17,62,70,14,34,46,0,,38
14:45:28,2272.164,Fox,132,38,10,8,4,6,9,2,133,123,115,103,67,49,21,17,62,70,14,34,46,0,,38
14:45:29,2274.552,Fox,134,39,12,8,3,6,9,2,135,123,115,103,67,49,21,18,63,71,15,34,46,0,,39
14:45:30,2279.176,Fox,136,41,12,10,3,6,9,2,137,125,115,103,67,49,21,20,63,73,15,34,46,0,,41
14:45:31,2280.374,Fox,138,43,14,10,3,6,9,2,139,125,115,103,67,49,23,20,65,73,15,34,46,0,,43
14:45:32,2282.983,Fox,138,43,14,8,5,6,9,2,139,125,117,103,67,49,23,20,65,73,15,34,46,0,,43
14:45:32,2283.712,Fox,138,43,14,8,5,5,10,2,139,125,117,103,68,49,23,20,65,73,15,34,46,0,,43
14:45:32,2285.267,Fox,138,43,14,6,7,3,12,2,139,125,119,103,70,49,23,20,65,73,15,34,46,0,,43
14:45:34,2288.828,Fox,138,43,12,8,7,3,12,2,139,127,119,103,70,49,23,20,65,73,15,34,46,0,,43
14:45:36,2294.521,Fox,138,43,12,8,7,3,10,4,139,127,119,103,70,51,23,20,65,73,15,34,46,0,,43
14:45:37,2296.921,Fox,138,43,12,8,4,6,10,4,139,127,119,106,70,51,23,20,65,73,15,34,46,0,,43
14:45:39,2304.42,Fox,138,43,12,6,6,6,10,4,139,127,121,106,70,51,23,20,65,73,15,34,46,0,,43
14:45:40,2306.22,Fox,138,42,12,6,6,6,8,5,139,127,121,106,70,53,22,20,65,73,15,34,47,0,,42
14:45:40,2307.72,Fox,140,44,14,6,6,6,8,5,141,127,121,106,70,53,24,20,67,73,15,34,47,0,,44
14:45:42,2310.72,Fox,140,43,14,4,8,5,8,5,141,127,123,106,70,53,24,19,67,73,16,34,47,0,,43
14:45:43,2316.115,Fox,140,43,14,4,8,4,9,5,141,127,123,106,71,53,24,19,67,73,16,34,47,0,,43
14:45:44,2317.014,Fox,142,45,16,4,8,4,9,5,143,127,123,106,71,53,24,21,67,75,16,34,47,0,,45
14:45:44,2317.615,Fox,142,45,16,2,10,4,9,5,143,127,125,106,71,53,24,21,67,75,16,34,47,0,,45
14:45:44,2318.4,Fox,144,46,18,2,9,4,9,5,145,127,125,106,71,53,25,21,69,75,17,34,47,0,,46
14:45:48,2327.1,Fox,144,46,18,0,11,4,9,5,145,127,127,106,71,53,25,21,69,75,17,34,47,0,,46
14:45:49,2331.892,Fox,144,46,16,2,11,4,9,5,145,129,127,106,71,53,25,21,69,75,17,34,47,0,,46
14:45:50,2334.592,Fox,146,48,18,2,11,4,9,5,147,129,127,106,71,53,26,22,70,76,17,34,47,0,,48
14:45:51,2335.192,Fox,146,47,18,2,11,4,9,4,147,129,127,106,71,53,26,21,70,76,17,34,48,0,,47
14:45:51,2336.555,Fox,146,44,18,2,11,4,9,1,147,129,127,106,71,53,26,18,70,76,17,34,51,0,,44
14:45:52,2340.336,Fox,148,45,20,2,10,4,9,1,149,129,127,106,71,53,25,20,70,78,18,34,51,0,,45
14:45:54,2343.636,Fox,148,45,18,4,9,5,9,1,149,131,127,107,71,53,25,20,70,78,18,34,51,0,,45
14:45:54,2345.736,Fox,148,45,18,4,7,7,9,1,149,131,127,109,71,53,25,20,70,78,18,34,51,0,,45
14:45:55,2346.936,Fox,148,45,18,4,7,7,7,3,149,131,127,109,71,55,25,20,70,78,18,34,51,0,,45
14:45:56,2350.236,Fox,148,45,16,6,7,7,7,3,149,133,127,109,71,55,25,20,70,78,18,34,51,0,,45
14:45:57,2351.436,Fox,150,47,18,6,7,7,7,3,151,133,127,109,71,55,25,22,70,80,18,34,51,0,,47
14:45:58,2355.636,Fox,150,46,18,6,7,7,7,2,151,133,127,109,71,55,24,22,70,80,18,34,52,0,,46
14:45:59,2357.136,Fox,150,45,16,8,7,7,7,1,151,135,127,109,71,55,23,22,70,80,18,34,53,0,,45
14:46:00,2359.236,Fox,150,44,16,8,7,6,7,1,151,135,127,109,71,55,23,21,70,80,19,34,53,0,,44
14:46:00,2360.136,Fox,150,44,16,8,7,4,9,1,151,135,127,109,73,55,23,21,70,80,19,34,53,0,,44
14:46:01,2361.936,Fox,150,44,14,10,7,4,9,1,151,137,127,109,73,55,23,21,70,80,19,34,53,0,,44
14:46:02,2363.136,Fox,150,44,12,12,7,4,9,1,151,139,127,109,73,55,23,21,70,80,19,34,53,0,,44
14:46:02,2364.92,Fox,150,44,12,12,6,5,9,1,151,139,127,110,73,55,23,21,70,80,19,34,53,0,,44
14:46:05,2370.92,Fox,152,46,12,10,8,5,8,2,151,139,129,110,73,56,25,21,72,80,19,34,53,0,,46
14:46:05,2371.22,Fox,152,46,14,10,6,7,8,2,153,139,129,112,73,56,25,21,72,80,19,34,53,0,,46
14:46:08,2378.12,Fox,152,46,14,10,4,9,8,2,153,139,129,114,73,56,25,21,72,80,19,34,53,0,,46
14:46:09,2380.82,Fox,154,48,16,10,4,9,8,2,155,139,129,114,73,56,27,21,74,80,19,34,53,0,,48
14:46:10,2382.02,Fox,154,48,16,8,6,9,8,2,155,139,131,114,73,56,27,21,74,80,19,34,53,0,,48
14:46:12,2387.72,Fox,154,48,16,8,4,11,8,2,155,139,131,116,73,56,27,21,74,80,19,34,53,0,,48
14:46:12,2388.62,Fox,154,48,16,6,6,11,8,2,155,139,133,116,73,56,27,21,74,80,19,34,53,0,,48
14:46:13,2390.42,Fox,154,48,14,8,6,9,10,2,155,141,133,116,75,56,27,21,74,80,19,34,53,0,,48
14:46:16,2395.82,Fox,154,48,14,6,8,9,10,2,155,141,135,116,75,56,27,21,74,80,19,34,53,0,,48
14:46:17,2399.72,Fox,154,48,12,8,8,9,10,2,155,143,135,116,75,56,27,21,74,80,19,34,53,0,,48
14:46:17,2400.32,Fox,154,48,12,6,10,9,10,2,155,143,137,116,75,56,27,21,74,80,19,34,53,0,,48
14:46:18,2401.52,Fox,154,48,10,6,12,9,10,2,155,145,139,116,75,56,27,21,74,80,19,34,53,0,,48
14:46:19,2403.62,Fox,156,50,12,6,12,9,10,2,157,145,139,116,75,56,29,21,76,80,19,34,53,0,,50
14:46:20,2405.72,Fox,156,50,12,6,12,9,8,4,157,145,139,116,75,58,29,21,76,80,19,34,53,0,,50
14:46:21,2408.12,Fox,156,49,12,6,12,9,8,3,157,145,139,116,75,58,29,20,76,80,19,34,54,0,,49
14:46:25,2417.367,Fox,156,49,10,8,12,9,8,3,157,147,139,116,75,58,29,20,76,80,19,34,54,0,,49
14:46:25,2418.267,Fox,158,50,12,8,11,9,8,3,159,147,139,116,75,58,30,20,78,80,20,34,54,0,,50
14:46:27,2421.567,Fox,158,50,12,8,11,9,7,4,159,147,139,116,75,59,30,20,78,80,20,34,54,0,,50
14:46:27,2423.067,Fox,158,50,10,10,11,9,5,6,159,149,139,116,75,61,30,20,78,80,20,34,54,0,,50
14:46:29,2426.967,Fox,162,54,12,10,11,9,5,6,161,149,139,116,75,61,33,21,81,81,20,34,54,0,,54
14:46:29,2427.267,Fox,162,54,14,10,11,9,5,6,163,149,139,116,75,61,33,21,81,81,20,34,54,0,,54
14:46:30,2428.767,Fox,162,54,14,8,13,9,5,6,163,149,141,116,75,61,33,21,81,81,20,34,54,0,,54
14:46:31,2431.167,Fox,162,54,14,8,12,10,5,6,163,149,141,117,75,61,33,21,81,81,20,34,54,0,,54
14:46:33,2434.167,Fox,162,54,12,10,12,10,5,6,163,151,141,117,75,61,33,21,81,81,20,34,54,0,,54
14:46:34,2436.567,Fox,164,56,14,10,12,10,5,6,165,151,141,117,75,61,35,21,83,81,20,34,54,0,,56
14:46:35,2438.067,Fox,164,56,14,8,14,10,5,6,165,151,143,117,75,61,35,21,83,81,20,34,54,0,,56
14:46:35,2439.567,Fox,164,56,14,6,16,8,7,6,165,151,145,117,77,61,35,21,83,81,20,34,54,0,,56
14:46:37,2442.567,Fox,164,56,14,6,14,10,7,6,165,151,145,119,77,61,35,21,83,81,20,34,54,0,,56
14:46:39,2446.767,Fox,166,57,14,6,14,10,7,5,165,151,145,119,77,61,34,23,83,83,20,34,55,0,,57
14:46:39,2447.067,Fox,166,57,16,6,14,10,7,5,167,151,145,119,77,61,34,23,83,83,20,34,55,0,,57
14:46:40,2449.167,Fox,166,57,16,6,12,12,7,5,167,151,145,121,77,61,34,23,83,83,20,34,55,0,,57
14:46:41,2452.163,Fox,166,56,16,6,12,12,7,4,167,151,145,121,77,61,34,22,83,83,20,34,56,0,,56
14:46:42,2453.363,Fox,166,56,16,6,12,12,6,5,167,151,145,121,77,62,34,22,83,83,20,34,56,0,,56
14:46:42,2453.963,Fox,166,56,14,8,12,12,6,5,167,153,145,121,77,62,34,22,83,83,20,34,56,0,,56
14:46:43,2456.063,Fox,166,56,14,6,12,14,6,5,167,153,147,123,77,62,34,22,83,83,20,34,56,0,,56
14:46:43,2456.663,Fox,166,55,14,6,12,14,6,4,167,153,147,123,77,62,33,22,83,83,20,34,57,0,,55
14:46:44,2458.463,Fox,166,55,14,6,12,13,7,4,167,153,147,123,78,62,33,22,83,83,20,34,57,0,,55
14:46:46,2460.863,Fox,166,55,14,6,10,15,7,4,167,153,147,125,78,62,33,22,83,83,20,34,57,0,,55
14:46:46,2461.243,Fox,166,55,14,4,12,15,7,4,167,153,149,125,78,62,33,22,83,83,20,34,57,0,,55
14:46:46,2462.143,Fox,166,55,14,4,10,17,7,4,167,153,149,127,78,62,33,22,83,83,20,34,57,0,,55
14:46:47,2463.643,Fox,166,54,12,6,10,17,7,3,167,155,149,127,78,62,32,22,83,83,20,34,58,0,,54
14:46:47,2464.843,Fox,166,54,12,6,10,15,9,3,167,155,149,127,80,62,32,22,83,83,20,34,58,0,,54
14:46:51,2471.66,Fox,166,54,12,6,10,13,11,3,167,155,149,127,82,62,32,22,83,83,20,34,58,0,,54
14:46:51,2472.86,Fox,168,55,12,4,12,13,11,2,167,155,151,127,82,62,33,22,85,83,20,34,59,0,,55
14:46:51,2473.16,Fox,168,55,14,4,12,13,11,2,169,155,151,127,82,62,33,22,85,83,20,34,59,0,,55
14:46:53,2477.06,Fox,170,57,16,4,12,13,11,2,171,155,151,127,82,62,33,24,85,85,20,34,59,0,,57
14:46:55,2481.041,Fox,170,57,16,4,12,11,13,2,171,155,151,127,84,62,33,24,85,85,20,34,59,0,,57
14:46:57,2486.26,Fox,170,57,14,6,12,11,13,2,171,157,151,127,84,62,33,24,85,85,20,34,59,0,,57
14:46:59,2489.26,Fox,170,57,14,6,10,13,13,2,171,157,151,129,84,62,33,24,85,85,20,34,59,0,,57
14:46:59,2490.46,Fox,172,59,16,6,10,13,13,2,173,157,151,129,84,62,34,25,86,86,20,34,59,0,,59
14:47:00,2492.26,Fox,172,59,16,4,12,13,13,2,173,157,153,129,84,62,34,25,86,86,20,34,59,0,,59
14:47:01,2494.06,Fox,172,58,16,4,12,13,13,1,173,157,153,129,84,62,33,25,86,86,20,34,60,0,,58
14:47:03,2497.943,Fox,174,60,18,4,12,13,11,3,175,157,153,129,84,64,34,26,87,87,20,34,60,0,,60
14:47:03,2498.543,Fox,174,60,18,4,10,15,11,3,175,157,153,131,84,64,34,26,87,87,20,34,60,0,,60
14:47:04,2500.043,Fox,174,60,18,4,8,17,11,3,175,157,153,133,84,64,34,26,87,87,20,34,60,0,,60
14:47:04,2500.943,Fox,174,60,16,6,8,17,11,3,175,159,153,133,84,64,34,26,87,87,20,34,60,0,,60
14:47:05,2501.843,Fox,174,60,16,4,10,17,11,3,175,159,155,133,84,64,34,26,87,87,20,34,60,0,,60
14:47:05,2503.043,Fox,176,62,18,4,10,17,11,3,177,159,155,133,84,64,35,27,88,88,20,34,60,0,,62
14:47:08,2509.854,Fox,176,62,14,8,10,17,11,3,177,163,155,133,84,64,35,27,88,88,20,34,60,0,,62
14:47:09,2511.354,Fox,178,64,16,8,10,17,11,3,179,163,155,133,84,64,37,27,90,88,20,34,60,0,,64
14:47:10,2514.354,Fox,180,65,16,8,10,16,11,3,179,163,155,133,84,64,38,27,91,89,20,35,60,0,,65
14:47:11,2514.654,Fox,180,65,18,8,10,16,11,3,181,163,155,133,84,64,38,27,91,89,20,35,60,0,,65
14:47:11,2516.154,Fox,180,65,18,8,8,18,11,3,181,163,155,135,84,64,38,27,91,89,20,35,60,0,,65
14:47:13,2519.154,Fox,180,65,16,10,8,18,11,3,181,165,155,135,84,64,38,27,91,89,20,35,60,0,,65
14:47:15,2521.854,Fox,180,65,16,10,6,20,11,3,181,165,155,137,84,64,38,27,91,89,20,35,60,0,,65
14:47:15,2522.454,Fox,180,64,16,10,6,20,10,3,181,165,155,137,84,64,38,26,91,89,20,36,60,0,,64
14:47:16,2524.854,Fox,180,63,16,8,8,19,11,2,181,165,157,137,85,64,37,26,91,89,20,36,61,0,,63
14:47:18,2527.854,Fox,180,63,16,8,8,19,9,4,181,165,157,137,85,66,37,26,91,89,20,36,61,0,,63
14:47:19,2529.654,Fox,180,63,14,10,8,19,9,4,181,167,157,137,85,66,37,26,91,89,20,36,61,0,,63
14:47:19,2530.554,Fox,182,65,16,10,8,19,9,4,183,167,157,137,85,66,38,27,92,90,20,36,61,0,,65
14:47:20,2532.954,Fox,182,65,16,10,6,21,9,4,183,167,157,139,85,66,38,27,92,90,20,36,61,0,,65
14:47:21,2534.882,Fox,182,64,16,10,6,20,9,4,183,167,157,139,85,66,38,26,92,90,21,36,61,0,,64
14:47:22,2536.082,Fox,184,66,18,10,6,18,11,4,185,167,157,139,87,66,40,26,94,90,21,36,61,0,,66
14:47:23,2538.182,Fox,184,65,18,10,6,18,11,3,185,167,157,139,87,66,40,25,94,90,21,36,62,0,,65
14:47:24,2539.682,Fox,186,67,18,8,8,18,11,3,185,167,159,139,87,66,41,26,95,91,21,36,62,0,,67
14:47:25,2540.282,Fox,190,71,22,8,8,18,11,3,189,167,159,139,87,66,42,29,96,94,21,36,62,0,,71
14:47:25,2540.582,Fox,190,71,24,8,8,18,11,3,191,167,159,139,87,66,42,29,96,94,21,36,62,0,,71
14:47:26,2542.682,Fox,190,71,24,8,8,16,13,3,191,167,159,139,89,66,42,29,96,94,21,36,62,0,,71
14:47:29,2548.382,Fox,190,69,24,4,12,16,13,1,191,167,163,139,89,66,40,29,96,94,21,36,64,0,,69
14:47:30,2549.582,Fox,190,69,24,4,12,14,15,1,191,167,163,139,91,66,40,29,96,94,21,36,64,0,,69
14:47:32,2552.875,Fox,190,69,24,4,10,16,15,1,191,167,163,141,91,66,40,29,96,94,21,36,64,0,,69
14:47:32,2554.375,Fox,190,68,24,4,10,13,17,1,191,167,163,141,93,66,40,28,96,94,21,37,64,0,,68
14:47:33,2555.875,Fox,190,68,22,6,10,11,19,1,191,169,163,141,95,66,40,28,96,94,21,37,64,0,,68
14:47:34,2557.075,Fox,192,70,24,6,10,11,19,1,193,169,163,141,95,66,41,29,97,95,21,37,64,0,,70
14:47:34,2557.675,Fox,192,70,24,4,12,11,19,1,193,169,165,141,95,66,41,29,97,95,21,37,64,0,,70
14:47:35,2559.775,Fox,192,70,22,6,12,11,19,1,193,171,165,141,95,66,41,29,97,95,21,37,64,0,,70
14:47:37,2562.475,Fox,192,70,22,6,10,13,19,1,193,171,165,143,95,66,41,29,97,95,21,37,64,0,,70
14:47:38,2564.875,Fox,194,71,24,6,9,13,19,1,195,171,165,143,95,66,40,31,97,97,22,37,64,0,,71
14:47:40,2568.175,Fox,194,71,24,4,11,13,19,1,195,171,167,143,95,66,40,31,97,97,22,37,64,0,,71
14:47:41,2569.075,Fox,196,73,26,4,11,13,19,1,197,171,167,143,95,66,40,33,97,99,22,37,64,0,,73
14:47:43,2572.975,Fox,196,73,24,6,11,13,19,1,197,173,167,143,95,66,40,33,97,99,22,37,64,0,,73
14:47:44,2574.775,Fox,198,75,26,6,11,13,19,1,199,173,167,143,95,66,41,34,98,100,22,37,64,0,,75
14:47:45,2576.875,Fox,198,75,26,6,11,13,17,3,199,173,167,143,95,68,41,34,98,100,22,37,64,0,,75
14:47:47,2580.475,Fox,198,75,24,8,11,13,17,3,199,175,167,143,95,68,41,34,98,100,22,37,64,0,,75
14:47:48,2582.875,Fox,198,75,24,8,11,11,19,3,199,175,167,143,97,68,41,34,98,100,22,37,64,0,,75
14:47:49,2584.975,Fox,200,76,26,8,10,11,19,3,201,175,167,143,97,68,41,35,99,101,23,37,64,0,,76
14:47:50,2585.575,Fox,200,76,24,10,9,12,19,3,201,177,167,144,97,68,41,35,99,101,23,37,64,0,,76
14:47:52,2588.875,Fox,200,75,24,10,9,12,19,2,201,177,167,144,97,68,40,35,99,101,23,37,65,0,,75
14:47:53,2592.175,Fox,200,75,24,10,9,11,20,2,201,177,167,144,98,68,40,35,99,101,23,37,65,0,,75
14:47:54,2593.54,Fox,200,75,24,10,9,9,22,2,201,177,167,144,100,68,40,35,99,101,23,37,65,0,,75
14:47:54,2594.439,Fox,200,75,22,10,11,9,22,2,201,179,169,144,100,68,40,35,99,101,23,37,65,0,,75
14:47:55,2595.939,Fox,202,77,24,10,11,9,21,3,203,179,169,144,100,69,41,36,100,102,23,37,65,0,,77
14:47:56,2597.439,Fox,202,76,22,12,11,9,21,2,203,181,169,144,100,69,41,35,100,102,23,37,66,0,,76
14:47:56,2598.04,Fox,204,78,24,12,11,9,21,2,205,181,169,144,100,69,42,36,101,103,23,37,66,0,,78
14:47:56,2598.34,Fox,204,78,24,10,13,9,21,2,205,181,171,144,100,69,42,36,101,103,23,37,66,0,,78
14:47:57,2599.84,Fox,204,78,24,10,11,11,21,2,205,181,171,146,100,69,42,36,101,103,23,37,66,0,,78
14:47:59,2602.24,Fox,204,78,24,10,11,11,20,3,205,181,171,146,100,70,42,36,101,103,23,37,66,0,,78
14:48:02,2609.045,Fox,204,78,24,10,8,14,18,5,205,181,171,149,100,72,42,36,101,103,23,37,66,0,,78
14:48:02,2609.645,Fox,204,78,24,10,8,13,19,5,205,181,171,149,101,72,42,36,101,103,23,37,66,0,,78
14:48:03,2611.745,Fox,204,78,24,8,10,13,19,5,205,181,173,149,101,72,42,36,101,103,23,37,66,0,,78
14:48:04,2613.245,Fox,206,80,24,10,10,13,19,5,207,183,173,149,101,72,43,37,102,104,23,37,66,0,,80
14:48:05,2615.345,Fox,206,80,24,10,10,11,21,5,207,183,173,149,103,72,43,37,102,104,23,37,66,0,,80
14:48:07,2618.645,Fox,206,80,22,12,8,13,19,7,207,185,173,151,103,74,43,37,102,104,23,37,66,0,,80
14:48:07,2618.945,Fox,206,80,22,10,10,13,19,7,207,185,175,151,103,74,43,37,102,104,23,37,66,0,,80
14:48:08,2620.445,Fox,208,82,24,10,10,13,19,7,209,185,175,151,103,74,43,39,102,106,23,37,66,0,,82
14:48:09,2622.845,Fox,210,83,22,14,10,13,19,6,211,189,175,151,103,74,44,39,103,107,23,37,67,0,,83
14:48:09,2623.145,Fox,210,83,20,16,10,13,19,6,211,191,175,151,103,74,44,39,103,107,23,37,67,0,,83
14:48:10,2624.045,Fox,210,83,20,14,12,13,19,6,211,191,177,151,103,74,44,39,103,107,23,37,67,0,,83
14:48:11,2626.445,Fox,210,83,20,14,12,12,20,6,211,191,177,151,104,74,44,39,103,107,23,37,67,0,,83
14:48:13,2628.845,Fox,210,83,20,14,10,14,20,6,211,191,177,153,104,74,44,39,103,107,23,37,67,0,,83
14:48:14,2631.851,Fox,210,82,20,14,10,13,20,6,211,191,177,153,104,74,44,38,103,107,24,37,67,0,,82
14:48:14,2632.45,Fox,210,82,20,12,12,13,20,6,211,191,179,153,104,74,44,38,103,107,24,37,67,0,,82
14:48:16,2635.75,Fox,210,82,20,10,14,13,20,6,211,191,181,153,104,74,44,38,103,107,24,37,67,0,,82
14:48:17,2636.95,Fox,212,83,22,10,14,13,20,5,213,191,181,153,104,74,45,38,104,108,24,37,68,0,,83
14:48:18,2637.851,Fox,212,82,22,10,14,13,20,4,213,191,181,153,104,74,45,37,104,108,24,37,69,0,,82
14:48:19,2639.65,Fox,212,82,20,12,14,13,20,4,213,193,181,153,104,74,45,37,104,108,24,37,69,0,,82
14:48:23,2646.551,Fox,214,84,20,12,14,11,22,4,213,193,181,153,106,74,46,38,105,109,24,37,69,0,,84
14:48:23,2646.851,Fox,214,84,22,12,14,11,22,4,215,193,181,153,106,74,46,38,105,109,24,37,69,0,,84
14:48:23,2647.38,Fox,214,84,20,14,14,11,22,4,215,195,181,153,106,74,46,38,105,109,24,37,69,0,,84
14:48:25,2650.38,Fox,216,85,22,14,13,11,22,4,217,195,181,153,106,74,46,39,106,110,25,37,69,0,,85
14:48:26,2651.58,Fox,216,85,20,14,15,11,22,4,217,197,183,153,106,74,46,39,106,110,25,37,69,0,,85
14:48:26,2652.48,Fox,216,83,20,14,15,9,22,4,217,197,183,153,106,74,46,37,106,110,27,37,69,0,,83
14:48:27,2653.98,Fox,218,85,22,14,15,9,22,4,219,197,183,153,106,74,46,39,106,112,27,37,69,0,,85
14:48:28,2654.88,Fox,218,85,22,14,13,11,22,4,219,197,183,155,106,74,46,39,106,112,27,37,69,0,,85
14:48:28,2655.831,Fox,218,85,22,14,13,9,24,4,219,197,183,155,108,74,46,39,106,112,27,37,69,0,,85
14:48:29,2657.631,Fox,220,87,20,14,15,9,24,4,219,199,185,155,108,74,46,41,106,114,27,37,69,0,,87
14:48:29,2657.931,Fox,220,87,22,14,15,9,24,4,221,199,185,155,108,74,46,41,106,114,27,37,69,0,,87
14:48:30,2658.831,Fox,220,87,22,14,13,11,24,4,221,199,185,157,108,74,46,41,106,114,27,37,69,0,,87
14:48:31,2660.331,Fox,222,88,22,14,13,11,24,3,221,199,185,157,108,74,46,42,107,115,27,37,70,0,,88
14:48:31,2660.631,Fox,222,88,24,14,13,11,24,3,223,199,185,157,108,74,46,42,107,115,27,37,70,0,,88
14:48:31,2661.531,Fox,222,88,24,10,17,11,24,3,223,199,189,157,108,74,46,42,107,115,27,37,70,0,,88
14:48:32,2662.131,Fox,222,88,24,8,19,11,23,4,223,199,191,157,108,75,46,42,107,115,27,37,70,0,,88
14:48:33,2663.631,Fox,228,94,28,8,19,11,23,4,227,199,191,157,108,75,49,45,110,118,27,37,70,0,,94
14:48:33,2663.931,Fox,228,94,30,8,19,11,23,4,229,199,191,157,108,75,49,45,110,118,27,37,70,0,,94
14:48:35,2667.531,Fox,228,94,28,10,19,11,23,4,229,201,191,157,108,75,49,45,110,118,27,37,70,0,,94
14:48:36,2669.631,Fox,228,93,28,10,19,11,23,3,229,201,191,157,108,75,49,44,110,118,27,37,71,0,,93
14:48:38,2672.031,Fox,228,93,28,10,18,12,23,3,229,201,191,158,108,75,49,44,110,118,27,37,71,0,,93
14:48:39,2673.531,Fox,228,93,28,10,18,12,21,5,229,201,191,158,108,77,49,44,110,118,27,37,71,0,,93
14:48:41,2678.631,Fox,228,93,26,10,20,11,22,5,229,203,193,158,109,77,49,44,110,118,27,37,71,0,,93
14:48:42,2679.831,Fox,230,95,26,10,18,13,22,5,229,203,193,160,109,77,50,45,111,119,27,37,71,0,,95
14:48:42,2680.131,Fox,230,95,28,10,18,13,20,7,231,203,193,160,109,79,50,45,111,119,27,37,71,0,,95
14:48:43,2680.731,Fox,230,95,26,12,18,13,20,7,231,205,193,160,109,79,50,45,111,119,27,37,71,0,,95
14:48:43,2681.931,Fox,232,96,28,12,18,12,20,7,233,205,193,160,109,79,49,47,111,121,28,37,71,0,,96
14:48:44,2682.531,Fox,234,98,30,12,18,12,20,7,235,205,193,160,109,79,50,48,112,122,28,37,71,0,,98
14:48:45,2684.031,Fox,236,98,30,12,18,10,20,7,235,205,193,160,109,79,52,46,114,122,30,37,71,0,,98
14:48:45,2684.631,Fox,236,98,32,12,16,12,20,7,237,205,193,162,109,79,52,46,114,122,30,37,71,0,,98
14:48:46,2686.131,Fox,236,98,32,10,18,12,20,7,237,205,195,162,109,79,52,46,114,122,30,37,71,0,,98
14:48:47,2687.331,Fox,236,98,32,10,18,12,18,9,237,205,195,162,109,81,52,46,114,122,30,37,71,0,,98
14:48:48,2690.331,Fox,236,98,32,8,20,12,18,9,237,205,197,162,109,81,52,46,114,122,30,37,71,0,,98
14:48:49,2691.531,Fox,240,101,34,8,19,12,18,9,239,205,197,162,109,81,52,49,115,125,30,38,71,0,,101
14:48:49,2691.831,Fox,240,100,36,8,19,11,16,11,241,205,197,162,109,83,51,49,115,125,30,39,71,0,,100
14:48:49,2693.031,Fox,240,99,36,8,17,12,14,13,241,205,197,164,109,85,51,48,115,125,31,39,71,0,,99
14:48:50,2693.331,Fox,240,99,36,8,17,10,16,13,241,205,197,164,111,85,51,48,115,125,31,39,71,0,,99
14:48:51,2696.331,Fox,240,99,34,8,17,12,16,13,241,207,199,166,111,85,51,48,115,125,31,39,71,0,,99
14:48:52,2697.831,Fox,244,101,34,8,17,11,16,12,241,207,199,166,111,85,51,50,116,128,31,40,72,0,,101
14:48:52,2698.131,Fox,244,101,38,8,17,11,16,12,245,207,199,166,111,85,51,50,116,128,31,40,72,0,,101
14:48:53,2699.031,Fox,244,100,38,8,17,10,16,12,245,207,199,166,111,85,50,50,116,128,31,41,72,0,,100
14:48:54,2700.831,Fox,244,99,38,8,17,10,16,11,245,207,199,166,111,85,49,50,116,128,31,41,73,0,,99
14:48:56,2703.231,Fox,244,99,36,10,17,10,16,11,245,209,199,166,111,85,49,50,116,128,31,41,73,0,,99
14:48:57,2705.631,Fox,244,99,34,12,17,10,16,11,245,211,199,166,111,85,49,50,116,128,31,41,73,0,,99
14:48:57,2706.231,Fox,244,99,34,10,19,10,16,11,245,211,201,166,111,85,49,50,116,128,31,41,73,0,,99
14:48:58,2707.731,Fox,246,101,36,10,19,10,16,11,247,211,201,166,111,85,49,52,116,130,31,41,73,0,,101
14:49:00,2711.492,Fox,246,101,36,10,19,8,18,11,247,211,201,166,113,85,49,52,116,130,31,41,73,0,,101
14:49:00,2711.963,Fox,246,101,36,10,18,9,18,11,247,211,201,167,113,85,49,52,116,130,31,41,73,0,,101
14:49:01,2714.596,Fox,248,101,36,10,18,7,18,11,247,211,201,167,113,85,48,53,117,131,31,43,73,0,,101
14:49:01,2714.896,Fox,248,101,38,10,18,7,18,11,249,211,201,167,113,85,48,53,117,131,31,43,73,0,,101
14:49:02,2716.096,Fox,250,103,40,10,18,7,18,11,251,211,201,167,113,85,49,54,118,132,31,43,73,0,,103
14:49:02,2716.996,Fox,250,103,40,8,20,7,18,11,251,211,203,167,113,85,49,54,118,132,31,43,73,0,,103
14:49:03,2717.596,Fox,250,102,40,8,18,8,18,11,251,211,203,169,113,85,48,54,118,132,32,43,73,0,,102
14:49:04,2719.096,Fox,250,102,40,6,20,8,18,11,251,211,205,169,113,85,48,54,118,132,32,43,73,0,,102
14:49:04,2719.696,Fox,250,102,38,8,20,8,18,11,251,213,205,169,113,85,48,54,118,132,32,43,73,0,,102
14:49:04,2720.296,Fox,250,102,38,8,20,8,16,13,251,213,205,169,113,87,48,54,118,132,32,43,73,0,,102
14:49:05,2721.196,Fox,252,103,40,8,20,8,16,12,253,213,205,169,113,87,47,56,118,134,32,43,74,0,,103
14:49:05,2721.796,Fox,252,103,40,8,16,12,16,12,253,213,205,173,113,87,47,56,118,134,32,43,74,0,,103
14:49:05,2722.096,Fox,252,103,40,8,14,14,16,12,253,213,205,175,113,87,47,56,118,134,32,43,74,0,,103
14:49:07,2724.796,Fox,254,105,42,8,14,14,16,12,255,213,205,175,113,87,47,58,118,136,32,43,74,0,,105
14:49:08,2725.996,Fox,256,107,44,8,14,14,16,12,257,213,205,175,113,87,48,59,119,137,32,43,74,0,,107
14:49:10,2729.596,Fox,256,107,42,10,14,14,15,13,257,215,205,175,113,88,48,59,119,137,32,43,74,0,,107
14:49:11,2731.096,Fox,256,106,42,10,14,14,13,14,257,215,205,175,113,90,48,58,119,137,32,43,75,0,,106
14:49:12,2732.596,Fox,258,108,44,10,14,14,13,14,259,215,205,175,113,90,48,60,119,139,32,43,75,0,,108
14:49:12,2733.196,Fox,258,107,42,12,14,13,13,14,259,217,205,175,113,90,48,59,119,139,32,44,75,0,,107
14:49:13,2734.396,Fox,258,107,42,10,16,13,13,14,259,217,207,175,113,90,48,59,119,139,32,44,75,0,,107
14:49:14,2736.701,Fox,260,109,42,12,16,13,13,14,261,219,207,175,113,90,49,60,120,140,32,44,75,0,,109
14:49:15,2738.801,Fox,260,109,42,12,14,15,13,14,261,219,207,177,113,90,49,60,120,140,32,44,75,0,,109
14:49:16,2740.001,Fox,264,112,44,12,14,14,13,14,263,219,207,177,113,90,49,63,121,143,32,45,75,0,,112
14:49:16,2740.601,Fox,264,112,44,14,14,14,13,14,265,221,207,177,113,90,49,63,121,143,32,45,75,0,,112
14:49:17,2741.501,Fox,264,112,44,12,16,14,13,14,265,221,209,177,113,90,49,63,121,143,32,45,75,0,,112
14:49:17,2742.401,Fox,266,113,46,12,16,13,13,14,267,221,209,177,113,90,50,63,123,143,32,46,75,0,,113
14:49:18,2743.301,Fox,266,113,44,14,16,13,13,14,267,223,209,177,113,90,50,63,123,143,32,46,75,0,,113
14:49:18,2743.901,Fox,266,113,44,12,18,13,13,14,267,223,211,177,113,90,50,63,123,143,32,46,75,0,,113
14:49:19,2744.801,Fox,266,111,44,12,18,13,13,12,267,223,211,177,113,90,49,62,123,143,32,46,77,0,,111
14:49:19,2746.301,Fox,266,109,40,16,18,11,13,12,267,227,211,177,113,90,49,60,123,143,32,48,77,0,,109
14:49:20,2746.601,Fox,266,109,38,18,16,13,13,12,267,229,211,179,113,90,49,60,123,143,32,48,77,0,,109
14:49:20,2747.201,Fox,266,109,38,18,16,13,12,13,267,229,211,179,113,91,49,60,123,143,32,48,77,0,,109
14:49:20,2748.325,Fox,266,108,38,18,16,12,13,12,267,229,211,179,114,91,48,60,123,143,32,48,78,0,,108
14:49:21,2750.125,Fox,268,109,40,18,16,11,13,12,269,229,211,179,114,91,49,60,125,143,32,49,78,0,,109
14:49:22,2750.725,Fox,268,109,40,18,14,13,13,12,269,229,211,181,114,91,49,60,125,143,32,49,78,0,,109
14:49:23,2753.125,Fox,268,109,40,18,14,13,11,14,269,229,211,181,114,93,49,60,125,143,32,49,78,0,,109
14:49:24,2755.225,Fox,270,111,42,18,14,13,11,14,271,229,211,181,114,93,50,61,126,144,32,49,78,0,,111
14:49:25,2756.125,Fox,272,112,44,18,13,13,11,14,273,229,211,181,114,93,49,63,126,146,32,50,78,0,,112
14:49:25,2756.425,Fox,272,112,44,18,11,15,11,14,273,229,211,183,114,93,49,63,126,146,32,50,78,0,,112
14:49:26,2758.225,Fox,272,112,44,16,13,15,11,14,273,229,213,183,114,93,49,63,126,146,32,50,78,0,,112
14:49:28,2761.525,Fox,272,111,44,16,13,15,11,13,273,229,213,183,114,93,48,63,126,146,32,50,79,0,,111
14:49:29,2762.725,Fox,272,111,42,18,13,15,11,13,273,231,213,183,114,93,48,63,126,146,32,50,79,0,,111
14:49:29,2764.225,Fox,272,109,42,18,13,14,10,13,273,231,213,183,114,94,47,62,126,146,32,51,80,0,,109
14:49:30,2764.525,Fox,272,109,40,20,13,14,10,13,273,233,213,183,114,94,47,62,126,146,32,51,80,0,,109
14:49:30,2765.125,Fox,272,109,38,22,13,14,10,13,273,235,213,183,114,94,47,62,126,146,32,51,80,0,,109
14:49:31,2767.049,Fox,272,109,36,24,11,16,10,13,273,237,213,185,114,94,47,62,126,146,32,51,80,0,,109
14:49:31,2767.963,Fox,272,109,36,22,13,16,10,13,273,237,215,185,114,94,47,62,126,146,32,51,80,0,,109
14:49:33,2771.471,Fox,272,109,36,20,15,16,10,13,273,237,217,185,114,94,47,62,126,146,32,51,80,0,,109
14:49:34,2772.371,Fox,274,110,36,20,15,15,10,13,273,237,217,185,114,94,47,63,126,148,32,52,80,0,,110
14:49:34,2772.971,Fox,274,110,38,20,15,14,11,13,275,237,217,185,115,94,47,63,126,148,32,52,80,0,,110
14:49:34,2774.171,Fox,276,111,38,22,14,14,11,13,277,239,217,185,115,94,46,65,126,150,32,53,80,0,,111
14:49:35,2774.471,Fox,276,111,36,24,14,14,11,13,277,241,217,185,115,94,46,65,126,150,32,53,80,0,,111
14:49:35,2775.071,Fox,276,111,36,22,16,14,11,13,277,241,219,185,115,94,46,65,126,150,32,53,80,0,,111
14:49:35,2776.271,Fox,276,109,36,22,16,12,11,13,277,241,219,185,115,94,46,63,126,150,32,55,80,0,,109
14:49:36,2777.471,Fox,276,109,36,22,14,14,11,13,277,241,219,187,115,94,46,63,126,150,32,55,80,0,,109
14:49:36,2778.071,Fox,276,109,36,22,14,12,13,13,277,241,219,187,117,94,46,63,126,150,32,55,80,0,,109
14:49:37,2778.971,Fox,276,109,36,20,16,12,13,13,277,241,221,187,117,94,46,63,126,150,32,55,80,0,,109
14:49:37,2779.452,Fox,276,109,36,20,15,13,13,13,277,241,221,188,117,94,46,63,126,150,32,55,80,0,,109
14:49:38,2780.398,Fox,278,110,38,20,15,13,13,12,279,241,221,188,117,94,48,62,128,150,32,55,81,0,,110
14:49:38,2780.698,Fox,278,110,34,24,15,13,13,12,279,245,221,188,117,94,48,62,128,150,32,55,81,0,,110
14:49:38,2781.898,Fox,278,110,34,22,17,13,13,12,279,245,223,188,117,94,48,62,128,150,32,55,81,0,,110
14:49:39,2783.398,Fox,278,109,34,22,17,13,13,11,279,245,223,188,117,94,48,61,128,150,32,55,82,0,,109
14:49:39,2783.998,Fox,278,109,34,22,17,13,11,13,279,245,223,188,117,96,48,61,128,150,32,55,82,0,,109
14:49:40,2784.898,Fox,278,108,34,18,21,13,11,12,279,245,227,188,117,96,47,61,128,150,32,55,83,0,,108
14:49:40,2785.198,Fox,278,108,34,16,23,13,11,12,279,245,229,188,117,96,47,61,128,150,32,55,83,0,,108
14:49:40,2786.098,Fox,280,110,36,16,23,13,11,12,281,245,229,188,117,96,48,62,129,151,32,55,83,0,,110
14:49:42,2788.798,Fox,280,109,36,16,23,12,11,12,281,245,229,188,117,96,47,62,129,151,32,56,83,0,,109
14:49:42,2789.698,Fox,280,109,36,16,23,11,12,12,281,245,229,188,118,96,47,62,129,151,32,56,83,0,,109
14:49:42,2790.298,Fox,280,109,34,18,23,11,12,12,281,247,229,188,118,96,47,62,129,151,32,56,83,0,,109
14:49:44,2793.58,Fox,280,107,34,18,23,9,10,14,281,247,229,188,118,98,46,61,129,151,33,57,83,0,,107
14:49:44,2793.88,Fox,280,105,34,18,23,9,10,12,281,247,229,188,118,98,46,59,129,151,33,57,85,0,,105
14:49:45,2794.78,Fox,280,103,34,18,22,10,10,10,281,247,229,189,118,98,46,57,129,151,33,57,87,0,,103
14:49:46,2797.479,Fox,282,105,34,20,22,10,10,10,283,249,229,189,118,98,47,58,130,152,33,57,87,0,,105
14:49:47,2798.679,Fox,282,105,32,22,22,10,10,10,283,251,229,189,118,98,47,58,130,152,33,57,87,0,,105
14:49:48,2801.679,Fox,282,104,32,20,24,10,10,9,283,251,231,189,118,98,46,58,130,152,33,57,88,0,,104
14:49:49,2802.28,Fox,282,103,32,20,22,12,10,8,283,251,231,191,118,98,45,58,130,152,33,57,89,0,,103
14:49:49,2803.138,Fox,282,101,32,18,24,10,10,8,283,251,233,191,118,98,44,57,130,152,33,59,89,0,,101
14:49:49,2803.854,Fox,282,101,30,18,26,10,10,8,283,253,235,191,118,98,44,57,130,152,33,59,89,0,,101
14:49:49,2804.373,Fox,282,100,30,18,24,12,10,7,283,253,235,193,118,98,43,57,130,152,33,59,90,0,,100
14:49:49,2804.834,Fox,282,99,30,18,24,11,10,7,283,253,235,193,118,98,43,56,130,152,34,59,90,0,,99
14:49:50,2805.308,Fox,282,99,30,16,26,11,10,7,283,253,237,193,118,98,43,56,130,152,34,59,90,0,,99
14:49:51,2807.708,Fox,284,101,28,18,26,11,10,7,283,255,237,193,118,98,45,56,132,152,34,59,90,0,,101
14:49:51,2808.008,Fox,284,101,30,18,26,11,10,7,285,255,237,193,118,98,45,56,132,152,34,59,90,0,,101
14:49:51,2808.608,Fox,284,101,28,20,26,11,10,7,285,257,237,193,118,98,45,56,132,152,34,59,90,0,,101
14:49:54,2813.102,Fox,284,101,28,16,30,11,10,7,285,257,241,193,118,98,45,56,132,152,34,59,90,0,,101
14:49:54,2813.702,Fox,284,100,28,16,30,11,10,6,285,257,241,193,118,98,44,56,132,152,34,59,91,0,,100
14:49:54,2814.602,Fox,286,101,30,16,29,11,10,6,287,257,241,193,118,98,43,58,132,154,35,59,91,0,,101
14:49:55,2815.502,Fox,286,101,28,18,29,10,11,6,287,259,241,193,119,98,43,58,132,154,35,59,91,0,,101
14:49:55,2815.802,Fox,286,101,28,18,29,8,13,6,287,259,241,193,121,98,43,58,132,154,35,59,91,0,,101
14:49:55,2816.702,Fox,286,99,28,18,29,7,11,7,287,259,241,193,121,99,43,56,132,154,35,61,91,0,,99
14:49:56,2818.406,Fox,286,99,28,18,27,9,11,7,287,259,241,195,121,99,43,56,132,154,35,61,91,0,,99
14:49:57,2819.5,Fox,286,99,26,16,31,9,11,7,287,261,245,195,121,99,43,56,132,154,35,61,91,0,,99
14:49:57,2820.101,Fox,288,100,28,16,30,9,11,7,289,261,245,195,121,99,42,58,132,156,36,61,91,0,,100
14:49:58,2821.9,Fox,290,102,30,16,30,9,11,7,291,261,245,195,121,99,44,58,134,156,36,61,91,0,,102
14:49:58,2822.5,Fox,292,102,32,16,29,9,11,6,293,261,245,195,121,99,43,59,135,157,37,61,92,0,,102
14:49:58,2823.101,Fox,292,102,28,20,29,9,11,6,293,265,245,195,121,99,43,59,135,157,37,61,92,0,,102
14:49:59,2823.936,Fox,292,101,28,20,29,9,11,5,293,265,245,195,121,99,43,58,135,157,37,61,93,0,,101
14:49:59,2825.135,Fox,292,99,26,22,29,7,11,5,293,267,245,195,121,99,43,56,135,157,37,63,93,0,,99
14:50:00,2827.235,Fox,292,98,26,22,29,6,11,5,293,267,245,195,121,99,42,56,135,157,37,64,93,0,,98
14:50:01,2828.735,Fox,292,97,26,20,29,8,11,4,293,267,247,197,121,99,41,56,135,157,37,64,94,0,,97
14:50:02,2830.985,Fox,292,97,26,20,29,8,9,6,293,267,247,197,121,101,41,56,135,157,37,64,94,0,,97
14:50:03,2831.885,Fox,292,97,26,20,28,9,9,6,293,267,247,198,121,101,41,56,135,157,37,64,94,0,,97
14:50:03,2833.085,Fox,292,96,24,22,28,9,9,5,293,269,247,198,121,101,40,56,135,157,37,64,95,0,,96
14:50:05,2835.485,Fox,292,96,24,22,26,11,9,5,293,269,247,200,121,101,40,56,135,157,37,64,95,0,,96
14:50:05,2836.085,Fox,292,96,24,20,28,11,9,5,293,269,249,200,121,101,40,56,135,157,37,64,95,0,,96
14:50:06,2837.285,Fox,292,96,24,18,30,11,9,5,293,269,251,200,121,101,40,56,135,157,37,64,95,0,,96
14:50:06,2837.885,Fox,292,96,22,20,30,11,9,5,293,271,251,200,121,101,40,56,135,157,37,64,95,0,,96
14:50:06,2838.785,Fox,292,96,20,22,30,11,9,5,293,273,251,200,121,101,40,56,135,157,37,64,95,0,,96
14:50:07,2839.685,Fox,294,97,22,22,28,12,9,5,295,273,251,202,121,101,41,56,137,157,37,65,95,0,,97
14:50:07,2839.985,Fox,294,97,22,22,28,11,10,5,295,273,251,202,122,101,41,56,137,157,37,65,95,0,,97
14:50:08,2842.085,Fox,296,98,24,22,27,11,10,5,297,273,251,202,122,101,41,57,138,158,37,66,95,0,,98
14:50:08,2842.385,Fox,296,98,24,20,28,12,10,5,297,273,253,203,122,101,41,57,138,158,37,66,95,0,,98
14:50:09,2844.185,Fox,296,97,24,20,28,11,10,5,297,273,253,203,122,101,41,56,138,158,37,67,95,0,,97
14:50:10,2845.385,Fox,298,97,26,20,23,15,10,4,299,273,253,207,122,101,41,56,140,158,37,68,96,0,,97
14:50:10,2845.985,Fox,298,97,26,18,24,16,10,4,299,273,255,208,122,101,41,56,140,158,37,68,96,0,,97
14:50:10,2846.891,Fox,298,96,26,16,26,16,10,3,299,273,257,208,122,101,40,56,140,158,37,68,97,0,,96
14:50:11,2849.185,Fox,298,96,26,16,26,16,8,5,299,273,257,208,122,103,40,56,140,158,37,68,97,0,,96
14:50:12,2849.785,Fox,298,96,26,16,26,14,10,5,299,273,257,208,124,103,40,56,140,158,37,68,97,0,,96
14:50:14,2853.804,Fox,298,96,26,14,28,14,10,5,299,273,259,208,124,103,40,56,140,158,37,68,97,0,,96
14:50:14,2855.304,Fox,298,96,24,16,28,14,10,5,299,275,259,208,124,103,40,56,140,158,37,68,97,0,,96
14:50:15,2856.804,Fox,298,96,22,18,28,14,10,5,299,277,259,208,124,103,40,56,140,158,37,68,97,0,,96
14:50:16,2857.704,Fox,298,96,22,16,30,14,10,5,299,277,261,208,124,103,40,56,140,158,37,68,97,0,,96
14:50:17,2861.304,Fox,298,96,22,12,34,14,10,5,299,277,265,208,124,103,40,56,140,158,37,68,97,0,,96
14:50:18,2861.905,Fox,298,96,22,12,32,16,10,5,299,277,265,210,124,103,40,56,140,158,37,68,97,0,,96
14:50:18,2863.405,Fox,298,96,20,12,34,16,10,5,299,279,267,210,124,103,40,56,140,158,37,68,97,0,,96
14:50:19,2863.896,Fox,300,98,22,12,32,18,10,5,301,279,267,212,124,103,41,57,141,159,37,68,97,0,,98
14:50:19,2864.196,Fox,300,98,22,12,31,19,10,5,301,279,267,213,124,103,41,57,141,159,37,68,97,0,,98
14:50:20,2865.996,Fox,300,98,22,12,29,21,10,5,301,279,267,215,124,103,41,57,141,159,37,68,97,0,,98
14:50:21,2868.856,Fox,300,98,20,14,29,21,10,5,301,281,267,215,124,103,41,57,141,159,37,68,97,0,,98
14:50:22,2871.256,Fox,300,98,20,12,31,21,10,5,301,281,269,215,124,103,41,57,141,159,37,68,97,0,,98
14:50:23,2873.356,Fox,300,98,20,12,27,25,10,5,301,281,269,219,124,103,41,57,141,159,37,68,97,0,,98
14:50:23,2873.656,Fox,300,97,20,12,27,24,10,5,301,281,269,219,124,103,41,56,141,159,37,69,97,0,,97
14:50:24,2874.856,Fox,302,98,22,12,27,24,9,5,303,281,269,219,124,103,42,56,143,159,37,70,97,0,,98
14:50:25,2876.356,Fox,302,98,22,10,29,24,9,5,303,281,271,219,124,103,42,56,143,159,37,70,97,0,,98
14:50:25,2877.256,Fox,302,96,22,8,31,22,9,5,303,281,273,219,124,103,42,54,143,159,37,72,97,0,,96
14:50:26,2879.656,Fox,302,96,22,8,27,26,9,5,303,281,273,223,124,103,42,54,143,159,37,72,97,0,,96
14:50:26,2880.256,Fox,302,96,20,10,27,26,9,5,303,283,273,223,124,103,42,54,143,159,37,72,97,0,,96
14:50:27,2881.33,Fox,302,94,20,10,27,24,9,5,303,283,273,223,124,103,42,52,143,159,39,72,97,0,,94
14:50:27,2882.23,Fox,304,96,22,10,27,24,9,5,305,283,273,223,124,103,44,52,145,159,39,72,97,0,,96
14:50:28,2884.997,Fox,306,97,24,10,27,23,9,5,307,283,273,223,124,103,45,52,147,159,39,73,97,0,,97
14:50:29,2886.197,Fox,306,95,24,10,27,21,8,6,307,283,273,223,124,104,44,51,147,159,39,75,97,0,,95
14:50:31,2889.673,Fox,308,96,26,10,25,22,8,6,309,283,273,225,124,104,44,52,148,160,39,76,97,0,,96
14:50:31,2890.573,Fox,308,96,24,12,25,22,8,6,309,285,273,225,124,104,44,52,148,160,39,76,97,0,,96
14:50:33,2893.273,Fox,310,98,26,12,25,22,8,6,311,285,273,225,124,104,45,53,149,161,39,76,97,0,,98
14:50:33,2893.873,Fox,310,98,26,10,27,22,8,6,311,285,275,225,124,104,45,53,149,161,39,76,97,0,,98
14:50:34,2895.373,Fox,310,98,26,8,29,22,8,6,311,285,277,225,124,104,45,53,149,161,39,76,97,0,,98
14:50:34,2896.273,Fox,312,99,28,8,28,22,8,6,313,285,277,225,124,104,46,53,151,161,40,76,97,0,,99
14:50:34,2896.573,Fox,312,99,28,8,26,24,8,6,313,285,277,227,124,104,46,53,151,161,40,76,97,0,,99
14:50:34,2897.168,Fox,312,99,26,10,26,24,8,6,313,287,277,227,124,104,46,53,151,161,40,76,97,0,,99
14:50:35,2898.068,Fox,312,99,26,10,25,24,9,6,313,287,277,228,125,104,46,53,151,161,40,76,97,0,,99
14:50:37,2901.668,Fox,312,99,26,8,27,24,9,6,313,287,279,228,125,104,46,53,151,161,40,76,97,0,,99
14:50:37,2902.268,Fox,312,98,26,8,27,24,9,5,313,287,279,228,125,104,45,53,151,161,40,76,98,0,,98
14:50:37,2902.868,Fox,312,98,24,10,25,26,9,5,313,289,279,230,125,104,45,53,151,161,40,76,98,0,,98
14:50:37,2903.468,Fox,312,97,24,10,25,25,9,5,313,289,279,230,125,104,45,52,151,161,40,77,98,0,,97
14:50:38,2904.668,Fox,312,97,22,12,25,25,9,5,313,291,279,230,125,104,45,52,151,161,40,77,98,0,,97
14:50:38,2905.568,Fox,314,96,22,14,25,22,9,5,315,293,279,230,125,104,44,52,151,163,42,78,98,0,,96
14:50:38,2905.868,Fox,314,95,22,14,25,21,9,5,315,293,279,230,125,104,44,51,151,163,43,78,98,0,,95
14:50:39,2906.468,Fox,314,95,22,14,23,23,9,5,315,293,279,232,125,104,44,51,151,163,43,78,98,0,,95
14:50:39,2907.668,Fox,314,95,22,12,23,25,9,5,315,293,281,234,125,104,44,51,151,163,43,78,98,0,,95
14:50:40,2909.768,Fox,316,96,24,12,22,25,9,5,317,293,281,234,125,104,45,51,153,163,43,79,98,0,,96
14:50:41,2911.563,Fox,316,94,24,12,22,23,9,5,317,293,281,234,125,104,45,49,153,163,43,81,98,0,,94
14:50:41,2912.464,Fox,316,93,24,12,22,23,9,4,317,293,281,234,125,104,44,49,153,163,43,81,99,0,,93
14:50:42,2914.264,Fox,316,93,24,12,20,25,9,4,317,293,281,236,125,104,44,49,153,163,43,81,99,0,,93
14:50:43,2915.764,Fox,316,93,24,12,20,25,7,6,317,293,281,236,125,106,44,49,153,163,43,81,99,0,,93
14:50:44,2918.536,Fox,316,90,24,10,20,24,7,6,317,293,283,238,125,106,44,46,153,163,43,84,99,0,,90
14:50:46,2921.836,Fox,316,90,24,10,16,28,7,6,317,293,283,242,125,106,44,46,153,163,43,84,99,0,,90
14:50:46,2922.224,Fox,316,90,22,12,16,26,9,6,317,295,283,242,127,106,44,46,153,163,43,84,99,0,,90
14:50:47,2923.942,Fox,316,90,22,12,14,28,9,6,317,295,283,244,127,106,44,46,153,163,43,84,99,0,,90
14:50:47,2924.842,Fox,318,91,22,14,14,27,9,6,319,297,283,244,127,106,43,48,153,165,43,85,99,0,,91
14:50:47,2925.442,Fox,318,90,22,14,14,27,9,5,319,297,283,244,127,106,42,48,153,165,43,85,100,0,,90
14:50:48,2927.135,Fox,318,90,22,14,14,27,8,6,319,297,283,244,127,107,42,48,153,165,43,85,100,0,,90
14:50:49,2928.035,Fox,318,90,20,16,14,27,8,6,319,299,283,244,127,107,42,48,153,165,43,85,100,0,,90
14:50:49,2929.235,Fox,320,91,22,14,16,26,8,6,321,299,285,244,127,107,41,50,153,167,44,85,100,0,,91
14:50:50,2931.035,Fox,320,90,22,14,16,25,8,6,321,299,285,244,127,107,41,49,153,167,44,86,100,0,,90
14:50:50,2931.635,Fox,320,90,22,14,15,26,8,6,321,299,285,245,127,107,41,49,153,167,44,86,100,0,,90
14:50:52,2935.695,Fox,320,90,22,12,17,25,9,6,321,299,287,245,128,107,41,49,153,167,44,86,100,0,,90
14:50:52,2936.319,Fox,320,89,22,12,17,25,8,6,321,299,287,245,128,107,40,49,153,167,44,87,100,0,,89
14:50:53,2936.901,Fox,320,89,22,12,15,27,8,6,321,299,287,247,128,107,40,49,153,167,44,87,100,0,,89
14:50:53,2937.801,Fox,320,87,22,12,13,27,8,6,321,299,287,249,128,107,40,47,153,167,46,87,100,0,,87
14:50:53,2938.701,Fox,320,87,22,12,13,25,10,6,321,299,287,249,130,107,40,47,153,167,46,87,100,0,,87
14:50:54,2940.533,Fox,320,85,22,12,13,23,10,6,321,299,287,249,130,107,40,45,153,167,46,89,100,0,,85
14:50:54,2941.133,Fox,320,85,22,10,15,23,10,6,321,299,289,249,130,107,40,45,153,167,46,89,100,0,,85
14:50:55,2942.933,Fox,320,85,22,8,17,23,10,6,321,299,291,249,130,107,40,45,153,167,46,89,100,0,,85
14:50:56,2943.533,Fox,320,85,22,6,19,23,10,6,321,299,293,249,130,107,40,45,153,167,46,89,100,0,,85
14:50:57,2946.533,Fox,320,85,20,8,19,23,10,6,321,301,293,249,130,107,40,45,153,167,46,89,100,0,,85
14:50:59,2949.833,Fox,322,86,22,8,19,22,10,6,323,301,293,249,130,107,40,46,154,168,46,90,100,0,,86
14:51:00,2953.133,Fox,324,87,24,8,19,21,8,8,325,301,293,249,130,109,41,46,156,168,46,91,100,0,,87
14:51:01,2954.333,Fox,324,87,24,8,17,23,8,8,325,301,293,251,130,109,41,46,156,168,46,91,100,0,,87
14:51:01,2955.833,Fox,326,88,26,8,15,24,8,8,327,301,293,253,130,109,42,46,158,168,46,92,100,0,,88
14:51:02,2957.933,Fox,326,87,24,10,15,23,8,8,327,303,293,253,130,109,42,45,158,168,46,93,100,0,,87
14:51:03,2959.433,Fox,326,87,24,10,15,22,9,8,327,303,293,253,131,109,42,45,158,168,46,93,100,0,,87
14:51:04,2960.933,Fox,326,85,24,8,17,22,9,6,327,303,295,253,131,109,40,45,158,168,46,93,102,0,,85
14:51:04,2962.021,Fox,326,84,24,8,15,23,9,6,327,303,295,255,131,109,39,45,158,168,47,93,102,0,,84
14:51:05,2963.222,Fox,326,84,24,6,17,23,9,6,327,303,297,255,131,109,39,45,158,168,47,93,102,0,,84
14:51:05,2965.021,Fox,326,84,22,8,17,23,9,6,327,305,297,255,131,109,39,45,158,168,47,93,102,0,,84
14:51:06,2966.822,Fox,326,83,22,6,19,22,10,5,327,305,299,255,132,109,39,44,158,168,47,93,103,0,,83
14:51:07,2967.897,Fox,328,84,20,8,16,24,10,5,327,307,299,257,132,109,39,45,159,169,48,93,103,0,,84
14:51:07,2968.198,Fox,328,84,22,8,16,24,10,5,329,307,299,257,132,109,39,45,159,169,48,93,103,0,,84
14:51:07,2969.097,Fox,330,85,24,8,15,24,10,5,331,307,299,257,132,109,39,46,160,170,49,93,103,0,,85
14:51:09,2972.425,Fox,330,85,22,10,15,24,10,5,331,309,299,257,132,109,39,46,160,170,49,93,103,0,,85
14:51:09,2973.625,Fox,332,87,24,10,15,23,11,5,333,309,299,257,133,109,39,48,160,172,49,93,103,0,,87
14:51:11,2976.025,Fox,332,85,22,12,15,21,11,5,333,311,299,257,133,109,39,46,160,172,50,94,103,0,,85
14:51:11,2977.525,Fox,332,85,22,12,15,21,10,6,333,311,299,257,133,110,39,46,160,172,50,94,103,0,,85
14:51:12,2979.251,Fox,332,85,20,14,13,23,10,6,333,313,299,259,133,110,39,46,160,172,50,94,103,0,,85
14:51:14,2982.853,Fox,332,85,20,14,13,21,12,6,333,313,299,259,135,110,39,46,160,172,50,94,103,0,,85
14:51:15,2985.253,Fox,332,85,20,12,15,21,12,6,333,313,301,259,135,110,39,46,160,172,50,94,103,0,,85
14:51:16,2987.353,Fox,332,85,20,12,15,21,11,7,333,313,301,259,135,111,39,46,160,172,50,94,103,0,,85
14:51:16,2987.984,Fox,332,85,18,14,15,21,11,7,333,315,301,259,135,111,39,46,160,172,50,94,103,0,,85
14:51:16,2988.884,Fox,334,87,20,14,15,21,11,7,335,315,301,259,135,111,40,47,161,173,50,94,103,0,,87
14:51:17,2989.855,Fox,334,87,20,14,15,19,13,7,335,315,301,259,137,111,40,47,161,173,50,94,103,0,,87
14:51:17,2990.964,Fox,336,89,22,14,15,19,13,7,337,315,301,259,137,111,41,48,162,174,50,94,103,0,,89
14:51:18,2992.322,Fox,336,89,20,16,15,19,13,7,337,317,301,259,137,111,41,48,162,174,50,94,103,0,,89
14:51:18,2993.222,Fox,336,86,20,16,15,17,13,6,337,317,301,259,137,111,41,45,162,174,50,96,104,0,,86
14:51:19,2994.422,Fox,336,85,20,16,15,16,13,6,337,317,301,259,137,111,41,44,162,174,51,96,104,0,,85
14:51:19,2996.222,Fox,336,85,20,14,15,18,13,6,337,317,303,261,137,111,41,44,162,174,51,96,104,0,,85
14:51:20,2998.322,Fox,340,87,22,14,13,18,13,6,339,317,303,261,137,111,40,47,163,177,51,98,104,0,,87
14:51:20,2998.622,Fox,340,87,24,14,13,18,13,6,341,317,303,261,137,111,40,47,163,177,51,98,104,0,,87
14:51:21,3000.422,Fox,340,86,24,14,13,17,13,6,341,317,303,261,137,111,39,47,163,177,51,99,104,0,,86
14:51:21,3001.022,Fox,340,86,24,14,13,16,14,6,341,317,303,261,138,111,39,47,163,177,51,99,104,0,,86
14:51:22,3001.622,Fox,340,86,24,14,11,18,14,6,341,317,303,263,138,111,39,47,163,177,51,99,104,0,,86
14:51:22,3002.222,Fox,340,85,24,14,11,17,14,6,341,317,303,263,138,111,38,47,163,177,51,100,104,0,,85
14:51:22,3003.422,Fox,340,83,24,12,11,17,14,6,341,317,305,265,138,111,37,46,163,177,53,100,104,0,,83
14:51:23,3004.022,Fox,340,83,24,12,9,19,14,6,341,317,305,267,138,111,37,46,163,177,53,100,104,0,,83
14:51:24,3006.122,Fox,340,83,24,10,11,19,14,6,341,317,307,267,138,111,37,46,163,177,53,100,104,0,,83
14:51:24,3007.573,Fox,340,83,22,12,11,17,16,6,341,319,307,267,140,111,37,46,163,177,53,100,104,0,,83
14:51:24,3008.172,Fox,340,82,22,12,11,17,16,5,341,319,307,267,140,111,37,45,163,177,53,100,105,0,,82
14:51:25,3010.865,Fox,340,82,22,10,13,17,16,5,341,319,309,267,140,111,37,45,163,177,53,100,105,0,,82
14:51:26,3011.765,Fox,340,82,20,12,13,16,17,5,341,321,309,267,141,111,37,45,163,177,53,100,105,0,,82
14:51:26,3013.865,Fox,342,82,22,12,13,14,17,5,343,321,309,267,141,111,38,44,165,177,53,102,105,0,,82
14:51:27,3014.465,Fox,342,82,22,10,15,14,17,5,343,321,311,267,141,111,38,44,165,177,53,102,105,0,,82
14:51:27,3015.037,Fox,342,82,22,10,15,12,19,5,343,321,311,267,143,111,38,44,165,177,53,102,105,0,,82
14:51:28,3017.328,Fox,342,82,22,8,17,12,19,5,343,321,313,267,143,111,38,44,165,177,53,102,105,0,,82
14:51:28,3017.928,Fox,342,81,22,8,17,12,19,4,343,321,313,267,143,111,37,44,165,177,53,102,106,0,,81
14:51:29,3020.602,Fox,344,82,24,8,16,12,19,4,345,321,313,267,143,111,38,44,167,177,53,103,106,0,,82
14:51:30,3023.602,Fox,344,82,24,8,14,14,19,4,345,321,313,269,143,111,38,44,167,177,53,103,106,0,,82
14:51:32,3026.902,Fox,344,82,24,6,14,16,19,4,345,321,315,271,143,111,38,44,167,177,53,103,106,0,,82
14:51:32,3027.502,Fox,346,82,24,6,14,15,19,3,345,321,315,271,143,111,36,46,167,179,53,104,107,0,,82
14:51:32,3027.713,Fox,346,81,26,6,14,15,19,2,347,321,315,271,143,111,36,45,167,179,53,104,108,0,,81
14:51:33,3031.112,Fox,346,81,26,4,16,14,20,2,347,321,317,271,144,111,36,45,167,179,53,104,108,0,,81
14:51:34,3032.612,Fox,346,79,24,6,16,12,20,2,347,323,317,271,144,111,36,43,167,179,54,105,108,0,,79
14:51:35,3035.912,Fox,346,79,22,8,16,12,19,3,347,325,317,271,144,112,36,43,167,179,54,105,108,0,,79
14:51:36,3037.112,Fox,346,78,22,8,16,11,19,3,347,325,317,271,144,112,36,42,167,179,54,106,108,0,,78
14:51:36,3038.612,Fox,346,78,20,10,16,11,19,3,347,327,317,271,144,112,36,42,167,179,54,106,108,0,,78
14:51:37,3039.512,Fox,348,80,22,10,16,11,19,3,349,327,317,271,144,112,38,42,169,179,54,106,108,0,,80
14:51:39,3044.34,Fox,352,81,22,10,14,11,19,2,349,327,317,271,144,112,39,42,172,180,55,107,109,0,,81
14:51:39,3044.548,Fox,352,81,26,10,14,11,19,2,353,327,317,271,144,112,39,42,172,180,55,107,109,0,,81
14:51:39,3045.878,Fox,352,81,26,8,15,12,19,2,353,327,319,272,144,112,39,42,172,180,55,107,109,0,,81
14:51:40,3047.378,Fox,354,82,28,8,14,12,19,2,355,327,319,272,144,112,39,43,173,181,55,108,109,0,,82
14:51:40,3048.579,Fox,354,81,28,8,14,12,19,1,355,327,319,272,144,112,39,42,173,181,55,108,110,0,,81
14:51:41,3049.178,Fox,354,81,28,8,14,11,20,1,355,327,319,272,145,112,39,42,173,181,55,108,110,0,,81
14:51:41,3050.769,Fox,354,81,26,8,16,11,20,1,355,329,321,272,145,112,39,42,173,181,55,108,110,0,,81
14:51:42,3051.669,Fox,354,81,24,10,16,11,20,1,355,331,321,272,145,112,39,42,173,181,55,108,110,0,,81
14:51:43,3055.415,Fox,354,81,24,10,16,10,21,1,355,331,321,272,146,112,39,42,173,181,55,108,110,0,,81
14:51:44,3056.615,Fox,358,84,26,12,13,12,21,1,359,333,321,274,146,112,38,46,173,185,56,108,110,0,,84
14:51:44,3058.715,Fox,360,86,28,12,13,12,21,1,361,333,321,274,146,112,39,47,174,186,56,108,110,0,,86
14:51:45,3059.328,Fox,360,86,28,12,13,12,19,3,361,333,321,274,146,114,39,47,174,186,56,108,110,0,,86
14:51:45,3060.03,Fox,360,85,28,12,13,11,19,3,361,333,321,274,146,114,38,47,174,186,56,109,110,0,,85
14:51:46,3063.795,Fox,360,85,28,12,12,12,19,3,361,333,321,275,146,114,38,47,174,186,56,109,110,0,,85
14:51:47,3064.995,Fox,362,86,30,12,12,11,19,3,363,333,321,275,146,114,39,47,176,186,56,110,110,0,,86
14:51:47,3066.195,Fox,364,87,32,12,11,11,19,3,365,333,321,275,146,114,39,48,177,187,57,110,110,0,,87
14:51:49,3071.295,Fox,364,87,32,10,12,12,19,3,365,333,323,276,146,114,39,48,177,187,57,110,110,0,,87
14:51:49,3071.895,Fox,366,88,32,12,12,11,19,3,367,335,323,276,146,114,39,49,178,188,57,111,110,0,,88
14:51:50,3073.695,Fox,366,88,30,14,12,11,18,4,367,337,323,276,146,115,39,49,178,188,57,111,110,0,,88
14:51:51,3074.295,Fox,366,88,30,12,14,11,18,4,367,337,325,276,146,115,39,49,178,188,57,111,110,0,,88
14:51:51,3074.895,Fox,366,88,30,12,13,12,18,4,367,337,325,277,146,115,39,49,178,188,57,111,110,0,,88
14:51:51,3076.395,Fox,366,88,30,12,13,12,16,6,367,337,325,277,146,117,39,49,178,188,57,111,110,0,,88
14:51:52,3076.995,Fox,366,88,30,10,15,12,16,6,367,337,327,277,146,117,39,49,178,188,57,111,110,0,,88
14:51:52,3077.754,Fox,366,88,30,10,13,14,16,6,367,337,327,279,146,117,39,49,178,188,57,111,110,0,,88
14:51:52,3079.516,Fox,366,87,30,10,13,13,16,6,367,337,327,279,146,117,39,48,178,188,57,112,110,0,,87
14:51:53,3081.316,Fox,368,89,28,14,13,13,16,6,369,341,327,279,146,117,40,49,179,189,57,112,110,0,,89
14:51:54,3083.296,Fox,368,88,28,14,13,12,16,6,369,341,327,279,146,117,39,49,179,189,57,113,110,0,,88
14:51:55,3085.696,Fox,370,89,30,14,13,11,16,6,371,341,327,279,146,117,39,50,180,190,57,114,110,0,,89
14:51:56,3087.196,Fox,370,89,30,14,11,13,16,6,371,341,327,281,146,117,39,50,180,190,57,114,110,0,,89
14:51:56,3089.535,Fox,372,90,30,12,13,13,16,5,371,341,329,281,146,117,40,50,181,191,57,114,111,0,,90
14:51:57,3089.979,Fox,372,90,32,10,15,11,18,5,373,341,331,281,148,117,40,50,181,191,57,114,111,0,,90
14:51:57,3091.01,Fox,374,91,34,10,14,11,18,5,375,341,331,281,148,117,39,52,181,193,58,114,111,0,,91
14:51:57,3091.31,Fox,374,91,34,10,13,12,18,5,375,341,331,282,148,117,39,52,181,193,58,114,111,0,,91
14:51:59,3094.852,Fox,374,91,34,8,15,12,18,5,375,341,333,282,148,117,39,52,181,193,58,114,111,0,,91
14:51:59,3096.952,Fox,374,91,32,10,15,10,19,6,375,343,333,282,150,118,39,52,181,193,58,114,111,0,,91
14:52:01,3100.33,Fox,376,93,34,10,15,10,19,6,377,343,333,282,150,118,40,53,182,194,58,114,111,0,,93
14:52:02,3103.085,Fox,376,93,32,12,15,10,19,6,377,345,333,282,150,118,40,53,182,194,58,114,111,0,,93
14:52:02,3104.311,Fox,376,93,32,12,15,10,18,7,377,345,333,282,150,119,40,53,182,194,58,114,111,0,,93
14:52:03,3106.205,Fox,376,93,32,12,13,12,18,7,377,345,333,284,150,119,40,53,182,194,58,114,111,0,,93
14:52:03,3106.952,Fox,376,92,32,12,13,12,18,6,377,345,333,284,150,119,40,52,182,194,58,114,112,0,,92
14:52:05,3110.443,Fox,376,92,30,12,15,12,18,6,377,347,335,284,150,119,40,52,182,194,58,114,112,0,,92
14:52:05,3110.743,Fox,376,92,30,12,13,14,17,7,377,347,335,286,150,120,40,52,182,194,58,114,112,0,,92
14:52:05,3112.243,Fox,376,91,30,10,15,13,17,7,377,347,337,286,150,120,40,51,182,194,58,115,112,0,,91
14:52:07,3117.007,Fox,376,90,30,10,15,12,18,6,377,347,337,286,151,120,40,50,182,194,58,115,113,0,,90
14:52:07,3117.73,Fox,376,89,30,10,15,11,18,6,377,347,337,286,151,120,40,49,182,194,59,115,113,0,,89
14:52:08,3119.792,Fox,376,89,30,6,19,11,18,6,377,347,341,286,151,120,40,49,182,194,59,115,113,0,,89
14:52:08,3120.392,Fox,376,88,30,6,19,10,17,7,377,347,341,286,152,122,39,49,182,194,59,115,114,0,,88
14:52:08,3120.692,Fox,376,87,30,6,19,9,17,7,377,347,341,286,152,122,38,49,182,194,59,116,114,0,,87
14:52:09,3122.192,Fox,376,87,28,8,19,9,17,7,377,349,341,286,152,122,38,49,182,194,59,116,114,0,,87
14:52:11,3127.062,Fox,376,86,24,12,19,9,17,6,377,353,341,286,152,122,38,48,182,194,59,116,115,0,,86
14:52:11,3127.266,Fox,376,86,24,12,19,9,15,8,377,353,341,286,152,124,38,48,182,194,59,116,115,0,,86
14:52:12,3130.013,Fox,376,86,22,14,19,9,15,8,377,355,341,286,152,124,38,48,182,194,59,116,115,0,,86
14:52:13,3131.429,Fox,376,86,22,14,17,11,15,8,377,355,341,288,152,124,38,48,182,194,59,116,115,0,,86
14:52:13,3132.029,Fox,376,85,22,14,17,10,15,8,377,355,341,288,152,124,38,47,182,194,59,117,115,0,,85
14:52:14,3133.529,Fox,378,86,24,14,16,10,15,8,379,355,341,288,152,124,38,48,183,195,59,118,115,0,,86
14:52:14,3135.029,Fox,378,85,24,12,16,11,15,8,379,355,343,290,152,124,37,48,183,195,59,119,115,0,,85
14:52:16,3137.429,Fox,378,85,24,12,15,12,15,8,379,355,343,291,152,124,37,48,183,195,59,119,115,0,,85
14:52:16,3138.629,Fox,378,85,24,12,15,12,14,9,379,355,343,291,152,125,37,48,183,195,59,119,115,0,,85
14:52:16,3139.229,Fox,378,85,20,16,15,12,14,9,379,359,343,291,152,125,37,48,183,195,59,119,115,0,,85
14:52:17,3141.629,Fox,378,85,18,16,17,12,14,9,379,361,345,291,152,125,37,48,183,195,59,119,115,0,,85
14:52:19,3144.329,Fox,380,86,20,16,17,11,14,9,381,361,345,291,152,125,37,49,184,196,59,120,115,0,,86
14:52:19,3145.229,Fox,380,86,20,16,17,11,12,11,381,361,345,291,152,127,37,49,184,196,59,120,115,0,,86
14:52:20,3147.629,Fox,380,86,18,18,17,11,12,11,381,363,345,291,152,127,37,49,184,196,59,120,115,0,,86
14:52:20,3148.862,Fox,380,86,16,18,19,11,12,11,381,365,347,291,152,127,37,49,184,196,59,120,115,0,,86
14:52:21,3149.76,Fox,380,86,16,18,17,13,11,12,381,365,347,293,152,128,37,49,184,196,59,120,115,0,,86
14:52:21,3150.06,Fox,380,86,16,18,17,12,12,12,381,365,347,293,153,128,37,49,184,196,59,120,115,0,,86
14:52:21,3150.659,Fox,380,86,16,18,15,14,12,12,381,365,347,295,153,128,37,49,184,196,59,120,115,0,,86
14:52:22,3152.76,Fox,380,86,16,18,15,14,10,14,381,365,347,295,153,130,37,49,184,196,59,120,115,0,,86
14:52:22,3153.659,Fox,380,84,16,18,15,12,10,14,381,365,347,295,153,130,37,47,184,196,59,122,115,0,,84
14:52:23,3154.56,Fox,380,83,14,20,15,12,10,13,381,367,347,295,153,130,37,46,184,196,59,122,116,0,,83
14:52:23,3155.159,Fox,380,83,14,20,13,14,10,13,381,367,347,297,153,130,37,46,184,196,59,122,116,0,,83
14:52:24,3156.36,Fox,382,84,16,20,12,14,10,13,383,367,347,297,153,130,36,48,184,198,59,123,116,0,,84
14:52:24,3157.86,Fox,382,82,16,20,12,14,10,11,383,367,347,297,153,130,34,48,184,198,59,123,118,0,,82
14:52:25,3159.06,Fox,384,84,18,20,12,14,10,11,385,367,347,297,153,130,35,49,185,199,59,123,118,0,,84
14:52:25,3160.454,Fox,384,84,18,18,14,14,10,11,385,367,349,297,153,130,35,49,185,199,59,123,118,0,,84
14:52:26,3161.054,Fox,384,83,18,18,14,14,10,10,385,367,349,297,153,130,35,48,185,199,59,123,119,0,,83
14:52:27,3163.931,Fox,384,83,16,20,14,14,10,10,385,369,349,297,153,130,35,48,185,199,59,123,119,0,,83
14:52:28,3165.731,Fox,384,83,16,16,18,14,10,10,385,369,353,297,153,130,35,48,185,199,59,123,119,0,,83
14:52:29,3168.731,Fox,384,83,14,16,20,14,9,11,385,371,355,297,153,131,35,48,185,199,59,123,119,0,,83
14:52:30,3170.531,Fox,384,83,14,16,18,16,9,11,385,371,355,299,153,131,35,48,185,199,59,123,119,0,,83
14:52:30,3172.031,Fox,386,84,16,16,18,15,9,11,387,371,355,299,153,131,35,49,186,200,59,124,119,0,,84
14:52:30,3172.631,Fox,386,84,14,18,16,17,9,11,387,373,355,301,153,131,35,49,186,200,59,124,119,0,,84
14:52:31,3173.739,Fox,386,84,12,20,16,17,9,11,387,375,355,301,153,131,35,49,186,200,59,124,119,0,,84
14:52:32,3176.439,Fox,386,83,12,20,16,16,9,11,387,375,355,301,153,131,35,48,186,200,59,125,119,0,,83
14:52:33,3177.639,Fox,386,83,12,16,20,16,9,11,387,375,359,301,153,131,35,48,186,200,59,125,119,0,,83
14:52:33,3178.839,Fox,388,85,14,16,20,16,9,11,389,375,359,301,153,131,36,49,187,201,59,125,119,0,,85
14:52:34,3180.121,Fox,388,84,14,14,21,16,9,11,389,375,361,302,153,131,35,49,187,201,59,126,119,0,,84
14:52:34,3180.528,Fox,390,86,14,14,19,17,10,11,389,375,361,304,154,131,36,50,188,202,59,126,119,0,,86
14:52:34,3180.726,Fox,390,86,16,14,19,17,10,11,391,375,361,304,154,131,36,50,188,202,59,126,119,0,,86
14:52:34,3181.852,Fox,390,85,16,14,19,17,10,10,391,375,361,304,154,131,35,50,188,202,59,126,120,0,,85
14:52:35,3183.241,Fox,390,84,14,16,19,17,10,9,391,377,361,304,154,131,35,49,188,202,59,126,121,0,,84
14:52:35,3184.141,Fox,392,86,16,16,19,17,10,9,393,377,361,304,154,131,36,50,189,203,59,126,121,0,,86
14:52:36,3186.241,Fox,392,85,16,14,21,17,10,8,393,377,363,304,154,131,36,49,189,203,59,126,122,0,,85
14:52:36,3186.841,Fox,392,85,16,14,21,17,9,9,393,377,363,304,154,132,36,49,189,203,59,126,122,0,,85
14:52:37,3187.441,Fox,392,85,16,12,23,17,9,9,393,377,365,304,154,132,36,49,189,203,59,126,122,0,,85
14:52:37,3188.341,Fox,392,84,16,12,23,17,9,8,393,377,365,304,154,132,36,48,189,203,59,126,123,0,,84
14:52:38,3190.141,Fox,392,83,16,12,23,17,9,7,393,377,365,304,154,132,36,47,189,203,59,126,124,0,,83
14:52:38,3191.375,Fox,392,82,16,12,23,17,9,6,393,377,365,304,154,132,36,46,189,203,59,126,125,0,,82
14:52:39,3193.175,Fox,394,83,18,10,24,17,8,7,395,377,367,304,154,133,35,48,189,205,59,127,125,0,,83
14:52:39,3194.075,Fox,394,82,18,10,24,16,8,7,395,377,367,304,154,133,35,47,189,205,60,127,125,0,,82
14:52:39,3194.675,Fox,394,81,18,10,24,15,8,7,395,377,367,304,154,133,35,46,189,205,61,127,125,0,,81
14:52:40,3195.575,Fox,394,81,18,10,23,16,8,7,395,377,367,305,154,133,35,46,189,205,61,127,125,0,,81
14:52:41,3199.87,Fox,394,80,18,10,23,14,10,6,395,377,367,305,156,133,35,45,189,205,61,127,126,0,,80
14:52:43,3202.57,Fox,394,80,18,8,23,16,10,6,395,377,369,307,156,133,35,45,189,205,61,127,126,0,,80
14:52:43,3203.47,Fox,396,81,20,8,22,16,10,6,397,377,369,307,156,133,36,45,191,205,62,127,126,0,,81
14:52:44,3205.27,Fox,398,82,22,8,21,16,10,6,399,377,369,307,156,133,36,46,192,206,63,127,126,0,,82
14:52:44,3206.47,Fox,400,82,24,8,20,16,10,5,401,377,369,307,156,133,35,47,192,208,64,127,127,0,,82
14:52:44,3206.77,Fox,400,82,24,6,22,16,10,5,401,377,371,307,156,133,35,47,192,208,64,127,127,0,,82
14:52:45,3209.529,Fox,400,82,24,6,20,18,10,5,401,377,371,309,156,133,35,47,192,208,64,127,127,0,,82
14:52:46,3211.029,Fox,400,82,24,4,22,18,10,5,401,377,373,309,156,133,35,47,192,208,64,127,127,0,,82
14:52:46,3212.229,Fox,402,83,26,2,23,18,10,5,403,377,375,309,156,133,35,48,193,209,65,127,127,0,,83
14:52:47,3214.029,Fox,402,82,26,2,23,18,10,4,403,377,375,309,156,133,35,47,193,209,65,127,128,0,,82
14:52:48,3216.129,Fox,402,82,24,4,23,18,10,4,403,379,375,309,156,133,35,47,193,209,65,127,128,0,,82
14:52:48,3217.329,Fox,402,80,24,4,23,16,10,4,403,379,375,309,156,133,34,46,193,209,65,129,128,0,,80
14:52:49,3219.429,Fox,402,79,24,4,23,16,10,3,403,379,375,309,156,133,34,45,193,209,65,129,129,0,,79
14:52:50,3221.542,Fox,402,79,24,2,23,18,10,3,403,379,377,311,156,133,34,45,193,209,65,129,129,0,,79
14:52:51,3222.742,Fox,404,80,26,2,22,18,10,3,405,379,377,311,156,133,35,45,195,209,65,130,129,0,,80
14:52:51,3223.942,Fox,404,79,26,2,22,18,10,2,405,379,377,311,156,133,34,45,195,209,65,130,130,0,,79
14:52:52,3225.742,Fox,406,79,26,2,21,17,10,2,405,379,377,311,156,133,34,45,196,210,65,132,130,0,,79
14:52:52,3226.342,Fox,406,78,28,2,20,17,10,2,407,379,377,312,156,133,34,44,196,210,65,133,130,0,,78
14:52:52,3227.242,Fox,406,78,26,4,20,17,8,4,407,381,377,312,156,135,34,44,196,210,65,133,130,0,,78
14:52:53,3228.442,Fox,406,77,26,4,20,16,8,4,407,381,377,312,156,135,34,43,196,210,65,134,130,0,,77
14:52:53,3229.042,Fox,406,77,26,4,19,17,8,4,407,381,377,313,156,135,34,43,196,210,65,134,130,0,,77
14:52:54,3232.042,Fox,408,78,28,4,19,16,8,4,409,381,377,313,156,135,34,44,197,211,65,135,130,0,,78
14:52:55,3234.442,Fox,408,78,28,4,19,16,6,6,409,381,377,313,156,137,34,44,197,211,65,135,130,0,,78
14:52:57,3238.342,Fox,408,78,28,4,15,20,6,6,409,381,377,317,156,137,34,44,197,211,65,135,130,0,,78
14:52:57,3238.942,Fox,408,78,26,6,15,20,6,6,409,383,377,317,156,137,34,44,197,211,65,135,130,0,,78
14:52:58,3240.442,Fox,410,79,28,6,12,22,6,6,411,383,377,319,156,137,33,46,197,213,65,136,130,0,,79
14:52:58,3241.58,Fox,410,79,26,8,12,22,6,6,411,385,377,319,156,137,33,46,197,213,65,136,130,0,,79
14:52:59,3243.217,Fox,410,77,26,8,12,19,7,6,411,385,377,319,157,137,31,46,197,213,65,138,130,0,,77
14:52:59,3244.011,Fox,412,78,28,8,12,18,7,6,413,385,377,319,157,137,31,47,198,214,65,139,130,0,,78
14:52:59,3244.191,Fox,412,78,28,8,12,17,8,6,413,385,377,319,158,137,31,47,198,214,65,139,130,0,,78
14:53:00,3245.391,Fox,414,79,30,8,11,17,8,6,415,385,377,319,158,137,32,47,200,214,65,140,130,0,,79
14:53:01,3247.791,Fox,414,79,30,8,9,19,8,6,415,385,377,321,158,137,32,47,200,214,65,140,130,0,,79
14:53:01,3248.565,Fox,414,79,30,8,9,17,10,6,415,385,377,321,160,137,32,47,200,214,65,140,130,0,,79
14:53:01,3249.896,Fox,416,80,32,8,9,16,10,6,417,385,377,321,160,137,33,47,202,214,66,140,130,0,,80
14:53:02,3250.496,Fox,418,81,34,8,8,16,10,6,419,385,377,321,160,137,33,48,203,215,67,140,130,0,,81
14:53:02,3250.796,Fox,418,79,34,8,8,14,10,6,419,385,377,321,160,137,33,46,203,215,67,142,130,0,,79
14:53:03,3253.496,Fox,418,79,34,8,7,15,10,6,419,385,377,322,160,137,33,46,203,215,67,142,130,0,,79
14:53:03,3254.696,Fox,418,79,32,8,9,15,9,7,419,387,379,322,160,138,33,46,203,215,67,142,130,0,,79
14:53:05,3257.996,Fox,418,79,32,8,9,15,8,8,419,387,379,322,160,139,33,46,203,215,67,142,130,0,,79
14:53:06,3261.595,Fox,418,79,30,10,9,15,8,8,419,389,379,322,160,139,33,46,203,215,67,142,130,0,,79
14:53:07,3263.396,Fox,418,79,28,12,7,17,8,8,419,391,379,324,160,139,33,46,203,215,67,142,130,0,,79
14:53:07,3263.996,Fox,418,79,28,12,7,16,9,8,419,391,379,324,161,139,33,46,203,215,67,142,130,0,,79
14:53:07,3265.492,Fox,418,79,28,10,9,16,9,8,419,391,381,324,161,139,33,46,203,215,67,142,130,0,,79
14:53:08,3266.692,Fox,418,79,26,12,9,15,10,8,419,393,381,324,162,139,33,46,203,215,67,142,130,0,,79
14:53:08,3267.592,Fox,418,78,26,12,8,16,10,7,419,393,381,325,162,139,33,45,203,215,67,142,131,0,,78
14:53:08,3267.879,Fox,418,77,26,12,8,16,10,6,419,393,381,325,162,139,33,44,203,215,67,142,132,0,,77
14:53:10,3271.43,Fox,418,77,26,12,6,18,10,6,419,393,381,327,162,139,33,44,203,215,67,142,132,0,,77
14:53:10,3272.603,Fox,418,77,26,12,4,20,10,6,419,393,381,329,162,139,33,44,203,215,67,142,132,0,,77
14:53:10,3273.571,Fox,418,77,26,12,4,19,11,6,419,393,381,329,163,139,33,44,203,215,67,142,132,0,,77
14:53:11,3275.678,Fox,418,73,24,14,4,15,11,6,419,395,381,329,163,139,33,40,203,215,67,146,132,0,,73
14:53:12,3277.478,Fox,418,72,24,12,6,14,11,6,419,395,383,329,163,139,33,39,203,215,67,147,132,0,,72
14:53:13,3279.999,Fox,418,72,24,10,8,14,11,6,419,395,385,329,163,139,33,39,203,215,67,147,132,0,,72
14:53:14,3282.227,Fox,418,72,24,10,6,16,11,6,419,395,385,331,163,139,33,39,203,215,67,147,132,0,,72
14:53:15,3286.19,Fox,418,72,22,12,6,16,11,6,419,397,385,331,163,139,33,39,203,215,67,147,132,0,,72
14:53:15,3287.39,Fox,418,72,22,12,6,16,10,7,419,397,385,331,163,140,33,39,203,215,67,147,132,0,,72
14:53:16,3288.29,Fox,418,71,20,14,6,16,10,6,419,399,385,331,163,140,33,38,203,215,67,147,133,0,,71
14:53:16,3289.19,Fox,418,71,18,16,6,16,10,6,419,401,385,331,163,140,33,38,203,215,67,147,133,0,,71
14:53:18,3293.125,Fox,418,71,18,14,8,16,10,6,419,401,387,331,163,140,33,38,203,215,67,147,133,0,,71
14:53:18,3294.634,Fox,418,71,16,16,8,16,10,6,419,403,387,331,163,140,33,38,203,215,67,147,133,0,,71
14:53:19,3296.964,Fox,418,70,16,16,8,16,9,6,419,403,387,331,163,140,33,37,203,215,67,148,133,0,,70
14:53:20,3298.936,Fox,418,68,16,16,8,16,9,4,419,403,387,331,163,140,32,36,203,215,67,148,135,0,,68
14:53:20,3300.136,Fox,418,68,16,14,10,16,9,4,419,403,389,331,163,140,32,36,203,215,67,148,135,0,,68
14:53:21,3301.89,Fox,420,69,18,12,12,15,9,4,421,403,391,331,163,140,31,38,203,217,68,148,135,0,,69
14:53:21,3302.49,Fox,420,68,18,12,12,14,9,4,421,403,391,331,163,140,30,38,203,217,68,149,135,0,,68
14:53:22,3303.99,Fox,420,67,18,12,12,14,8,4,421,403,391,331,163,140,30,37,203,217,68,150,135,0,,67
14:53:22,3305.49,Fox,420,67,16,12,14,14,8,4,421,405,393,331,163,140,30,37,203,217,68,150,135,0,,67
14:53:23,3306.39,Fox,420,66,16,12,14,13,8,4,421,405,393,331,163,140,30,36,203,217,68,151,135,0,,66
14:53:23,3308.528,Fox,420,66,14,14,14,13,8,4,421,407,393,331,163,140,30,36,203,217,68,151,135,0,,66
14:53:24,3310.813,Fox,420,65,14,14,14,12,8,4,421,407,393,331,163,140,30,35,203,217,69,151,135,0,,65
14:53:25,3312.37,Fox,420,63,14,14,14,10,8,4,421,407,393,331,163,140,30,33,203,217,70,152,135,0,,63
14:53:26,3314.771,Fox,420,63,12,14,16,9,9,4,421,409,395,331,164,140,30,33,203,217,70,152,135,0,,63
14:53:26,3315.07,Fox,420,63,12,14,14,11,9,4,421,409,395,333,164,140,30,33,203,217,70,152,135,0,,63
14:53:26,3315.597,Fox,420,61,12,14,14,11,9,2,421,409,395,333,164,140,29,32,203,217,70,152,137,0,,61
14:53:27,3317.974,Fox,422,63,14,14,14,11,9,2,423,409,395,333,164,140,30,33,204,218,70,152,137,0,,63
14:53:27,3318.274,Fox,422,63,14,14,14,11,8,3,423,409,395,333,164,141,30,33,204,218,70,152,137,0,,63
14:53:27,3319.474,Fox,424,64,16,14,14,10,8,3,425,409,395,333,164,141,30,34,205,219,70,153,137,0,,64
14:53:28,3319.774,Fox,424,64,16,14,14,9,9,3,425,409,395,333,165,141,30,34,205,219,70,153,137,0,,64
14:53:29,3322.774,Fox,424,63,16,14,14,7,10,3,425,409,395,333,166,141,30,33,205,219,71,153,137,0,,63
14:53:29,3323.074,Fox,424,63,14,16,14,7,10,3,425,411,395,333,166,141,30,33,205,219,71,153,137,0,,63
14:53:29,3324.874,Fox,426,65,14,14,16,7,10,3,425,411,397,333,166,141,30,35,205,221,71,153,137,0,,65
14:53:30,3325.172,Fox,426,65,16,14,16,7,10,3,427,411,397,333,166,141,30,35,205,221,71,153,137,0,,65
14:53:30,3325.96,Fox,426,65,16,14,14,9,10,3,427,411,397,335,166,141,30,35,205,221,71,153,137,0,,65
14:53:30,3326.783,Fox,426,65,14,14,16,9,10,3,427,413,399,335,166,141,30,35,205,221,71,153,137,0,,65
14:53:31,3327.931,Fox,426,65,12,14,18,9,10,3,427,415,401,335,166,141,30,35,205,221,71,153,137,0,,65
14:53:31,3329.702,Fox,428,66,14,14,17,9,10,3,429,415,401,335,166,141,31,35,207,221,71,154,137,0,,66
14:53:32,3333.016,Fox,428,66,10,18,17,9,10,3,429,419,401,335,166,141,31,35,207,221,71,154,137,0,,66
14:53:33,3333.316,Fox,428,66,10,16,19,9,10,3,429,419,403,335,166,141,31,35,207,221,71,154,137,0,,66
14:53:33,3335.716,Fox,428,65,10,16,19,9,10,2,429,419,403,335,166,141,30,35,207,221,71,154,138,0,,65
14:53:34,3337.516,Fox,428,65,10,16,19,9,8,4,429,419,403,335,166,143,30,35,207,221,71,154,138,0,,65
14:53:34,3338.116,Fox,428,65,10,16,17,11,8,4,429,419,403,337,166,143,30,35,207,221,71,154,138,0,,65
14:53:35,3340.761,Fox,428,65,10,16,15,13,8,4,429,419,403,339,166,143,30,35,207,221,71,154,138,0,,65
14:53:36,3341.361,Fox,428,65,10,16,15,12,9,4,429,419,403,339,167,143,30,35,207,221,71,154,138,0,,65
14:53:36,3342.561,Fox,428,64,10,16,15,12,8,4,429,419,403,339,167,143,30,34,207,221,71,155,138,0,,64
14:53:37,3343.761,Fox,428,64,10,14,17,12,8,4,429,419,405,339,167,143,30,34,207,221,71,155,138,0,,64
14:53:37,3344.661,Fox,430,65,12,14,16,12,8,4,431,419,405,339,167,143,30,35,208,222,71,156,138,0,,65
14:53:38,3347.061,Fox,430,65,12,12,18,11,9,4,431,419,407,339,168,143,30,35,208,222,71,156,138,0,,65
14:53:39,3348.561,Fox,432,65,14,12,18,10,9,3,433,419,407,339,168,143,29,36,209,223,71,157,139,0,,65
14:53:40,3352.461,Fox,432,64,14,12,18,9,9,3,433,419,407,339,168,143,29,35,209,223,71,158,139,0,,64
14:53:40,3353.058,Fox,432,64,14,10,20,9,9,3,433,419,409,339,168,143,29,35,209,223,71,158,139,0,,64
14:53:41,3353.65,Fox,432,64,14,10,19,10,9,3,433,419,409,340,168,143,29,35,209,223,71,158,139,0,,64
14:53:42,3356.613,Fox,432,64,14,10,19,9,10,3,433,419,409,340,169,143,29,35,209,223,71,158,139,0,,64
14:53:43,3360.513,Fox,432,64,14,10,17,11,10,3,433,419,409,342,169,143,29,35,209,223,71,158,139,0,,64
14:53:44,3361.713,Fox,432,64,14,8,19,11,10,3,433,419,411,342,169,143,29,35,209,223,71,158,139,0,,64
14:53:44,3362.542,Fox,434,65,16,8,17,12,10,3,435,419,411,344,169,143,29,36,210,224,72,158,139,0,,65
14:53:44,3363.973,Fox,434,64,16,8,17,11,10,3,435,419,411,344,169,143,29,35,210,224,72,159,139,0,,64
14:53:45,3365.158,Fox,434,64,16,6,19,10,11,3,435,419,413,344,170,143,29,35,210,224,72,159,139,0,,64
14:53:45,3365.619,Fox,434,64,16,6,18,11,11,3,435,419,413,345,170,143,29,35,210,224,72,159,139,0,,64
14:53:45,3366.496,Fox,434,64,16,4,20,11,11,3,435,419,415,345,170,143,29,35,210,224,72,159,139,0,,64
14:53:47,3370.993,Fox,436,65,18,4,20,10,11,3,437,419,415,345,170,143,29,36,211,225,73,159,139,0,,65
14:53:47,3371.593,Fox,436,65,18,0,24,10,11,3,437,419,419,345,170,143,29,36,211,225,73,159,139,0,,65
14:53:49,3375.193,Fox,438,67,20,0,22,12,11,3,439,419,419,347,170,143,30,37,212,226,73,159,139,0,,67
14:53:49,3377.456,Fox,440,68,22,0,22,11,11,3,441,419,419,347,170,143,30,38,213,227,73,160,139,0,,68
14:53:50,3378.496,Fox,440,67,22,0,22,10,11,3,441,419,419,347,170,143,30,37,213,227,73,161,139,0,,67
14:53:51,3380.896,Fox,440,67,22,0,22,10,10,4,441,419,419,347,170,144,30,37,213,227,73,161,139,0,,67
14:53:51,3381.796,Fox,440,67,22,0,22,10,9,5,441,419,419,347,170,145,30,37,213,227,73,161,139,0,,67
14:53:52,3384.496,Fox,440,67,20,2,22,10,9,5,441,421,419,347,170,145,30,37,213,227,73,161,139,0,,67
14:53:52,3385.096,Fox,440,67,20,2,20,12,9,5,441,421,419,349,170,145,30,37,213,227,73,161,139,0,,67
14:53:53,3386.296,Fox,442,68,22,2,19,12,8,6,443,421,419,349,170,146,31,37,215,227,73,162,139,0,,68
14:53:53,3386.896,Fox,442,68,22,2,17,14,8,6,443,421,419,351,170,146,31,37,215,227,73,162,139,0,,68
14:53:54,3388.396,Fox,442,67,22,2,15,16,8,5,443,421,419,353,170,146,31,36,215,227,73,162,140,0,,67
14:53:56,3394.066,Fox,442,65,22,2,13,17,8,4,443,421,419,355,170,146,31,34,215,227,73,164,140,0,,65
14:53:58,3399.577,Fox,444,67,24,2,13,17,8,4,445,421,419,355,170,146,32,35,216,228,73,164,140,0,,67
14:53:59,3400.477,Fox,444,66,22,4,13,16,8,4,445,423,419,355,170,146,32,34,216,228,74,164,140,0,,66
14:53:59,3401.656,Fox,444,66,22,4,13,16,7,5,445,423,419,355,170,147,32,34,216,228,74,164,140,0,,66
14:53:59,3402.24,Fox,444,65,20,6,13,15,7,5,445,425,419,355,170,147,32,33,216,228,74,165,140,0,,65
14:54:00,3403.95,Fox,444,64,20,6,13,14,6,6,445,425,419,355,170,148,32,32,216,228,74,166,140,0,,64
14:54:00,3404.236,Fox,444,64,20,6,11,16,6,6,445,425,419,357,170,148,32,32,216,228,74,166,140,0,,64
14:54:00,3405.568,Fox,446,66,22,6,11,16,6,6,447,425,419,357,170,148,34,32,218,228,74,166,140,0,,66
14:54:01,3407.83,Fox,446,64,20,8,10,15,6,6,447,427,419,358,170,148,34,30,218,228,74,168,140,0,,64
14:54:02,3408.931,Fox,448,65,20,8,10,15,6,5,447,427,419,358,170,148,35,30,219,229,74,168,141,0,,65
14:54:02,3409.231,Fox,448,65,22,8,10,15,6,5,449,427,419,358,170,148,35,30,219,229,74,168,141,0,,65
14:54:02,3409.985,Fox,450,66,24,8,10,14,6,5,451,427,419,358,170,148,35,31,220,230,74,169,141,0,,66
14:54:03,3412.205,Fox,450,66,22,10,10,14,6,5,451,429,419,358,170,148,35,31,220,230,74,169,141,0,,66
14:54:04,3413.983,Fox,452,67,24,10,8,15,6,5,453,429,419,360,170,148,35,32,221,231,74,170,141,0,,67
14:54:06,3419.49,Fox,452,66,24,10,8,14,6,5,453,429,419,360,170,148,34,32,221,231,74,171,141,0,,66
14:54:07,3422.19,Fox,452,65,24,10,6,16,6,4,453,429,419,362,170,148,33,32,221,231,74,172,141,0,,65
14:54:07,3423.089,Fox,452,65,24,8,8,16,6,4,453,429,421,362,170,148,33,32,221,231,74,172,141,0,,65
14:54:08,3425.789,Fox,452,65,24,8,6,18,6,4,453,429,421,364,170,148,33,32,221,231,74,172,141,0,,65
14:54:09,3427.266,Fox,452,63,22,10,4,18,6,4,453,431,421,366,170,148,32,31,221,231,74,174,141,0,,63
14:54:09,3429.167,Fox,454,64,24,10,4,17,6,4,455,431,421,366,170,148,33,31,223,231,74,175,141,0,,64
14:54:10,3430.314,Fox,454,63,24,10,4,17,6,3,455,431,421,366,170,148,33,30,223,231,74,175,142,0,,63
14:54:10,3431.059,Fox,454,63,22,12,4,17,6,3,455,433,421,366,170,148,33,30,223,231,74,175,142,0,,63
14:54:10,3431.571,Fox,454,63,22,12,2,18,7,3,455,433,421,368,171,148,33,30,223,231,74,175,142,0,,63
14:54:10,3432.068,Fox,454,62,22,12,0,20,7,2,455,433,421,370,171,148,32,30,223,231,74,175,143,0,,62
14:54:10,3432.544,Fox,454,61,22,12,0,20,7,1,455,433,421,370,171,148,31,30,223,231,74,175,144,0,,61
14:54:11,3434.344,Fox,454,61,22,12,0,19,8,1,455,433,421,370,172,148,31,30,223,231,74,175,144,0,,61
14:54:12,3435.844,Fox,456,63,24,12,0,19,8,1,457,433,421,370,172,148,32,31,224,232,74,175,144,0,,63
14:54:13,3439.144,Fox,456,63,24,10,2,19,8,1,457,433,423,370,172,148,32,31,224,232,74,175,144,0,,63
14:54:13,3439.973,Fox,456,62,24,10,2,18,8,1,457,433,423,370,172,148,32,30,224,232,74,176,144,0,,62
14:54:14,3440.474,Fox,456,62,24,8,4,18,8,1,457,433,425,370,172,148,32,30,224,232,74,176,144,0,,62
14:54:15,3444.044,Fox,456,61,24,8,4,18,8,0,457,433,425,370,172,148,31,30,224,232,74,176,145,0,,61
14:54:15,3445.244,Fox,456,61,22,10,4,18,8,0,457,435,425,370,172,148,31,30,224,232,74,176,145,0,,61
14:54:16,3446.444,Fox,456,61,22,8,6,18,8,0,457,435,427,370,172,148,31,30,224,232,74,176,145,0,,61
14:54:16,3447.944,Fox,456,59,22,8,6,17,7,0,457,435,427,370,172,148,31,28,224,232,74,178,145,0,,59
14:54:17,3449.112,Fox,458,61,24,8,6,17,7,0,459,435,427,370,172,148,32,29,225,233,74,178,145,0,,61
14:54:17,3450.7,Fox,458,61,24,6,8,17,7,0,459,435,429,370,172,148,32,29,225,233,74,178,145,0,,61
14:54:18,3452.2,Fox,458,61,24,6,8,17,6,1,459,435,429,370,172,149,32,29,225,233,74,178,145,0,,61
14:54:18,3453.53,Fox,458,61,22,8,8,17,6,1,459,437,429,370,172,149,32,29,225,233,74,178,145,0,,61
14:54:20,3457.186,Fox,458,58,22,8,8,14,5,2,459,437,429,370,172,150,31,27,225,233,75,180,145,0,,58
14:54:20,3457.731,Fox,458,58,20,10,8,14,5,2,459,439,429,370,172,150,31,27,225,233,75,180,145,0,,58
14:54:20,3458.709,Fox,458,56,20,10,8,12,5,2,459,439,429,370,172,150,29,27,225,233,75,182,145,0,,56
14:54:21,3460.112,Fox,458,56,18,12,8,12,5,2,459,441,429,370,172,150,29,27,225,233,75,182,145,0,,56
14:54:22,3463.412,Fox,458,52,18,12,8,8,5,2,459,441,429,370,172,150,26,26,225,233,75,186,145,0,,52
14:54:23,3465.789,Fox,458,52,18,10,10,8,5,2,459,441,431,370,172,150,26,26,225,233,75,186,145,0,,52
14:54:24,3469.089,Fox,458,52,16,12,10,8,5,2,459,443,431,370,172,150,26,26,225,233,75,186,145,0,,52
14:54:24,3469.689,Fox,458,52,16,10,12,8,5,2,459,443,433,370,172,150,26,26,225,233,75,186,145,0,,52
14:54:27,3477.789,Fox,460,53,18,10,11,8,5,2,461,443,433,370,172,150,26,27,226,234,75,187,145,0,,53
14:54:28,3478.989,Fox,460,53,18,10,11,7,5,3,461,443,433,370,173,151,26,27,226,234,75,187,145,0,,53
14:54:28,3480.489,Fox,460,53,18,10,11,5,7,3,461,443,433,370,175,151,26,27,226,234,75,187,145,0,,53
14:54:29,3481.689,Fox,460,53,18,10,11,3,9,3,461,443,433,370,177,151,26,27,226,234,75,187,145,0,,53
14:54:29,3482.289,Fox,460,53,16,12,11,3,9,3,461,445,433,370,177,151,26,27,226,234,75,187,145,0,,53
14:54:30,3483.789,Fox,460,53,16,10,11,5,9,3,461,445,435,372,177,151,26,27,226,234,75,187,145,0,,53
14:54:31,3488.289,Fox,460,53,14,12,11,5,9,3,461,447,435,372,177,151,26,27,226,234,75,187,145,0,,53
14:54:32,3490.989,Fox,462,55,16,12,11,5,9,3,463,447,435,372,177,151,26,29,226,236,75,187,145,0,,55
14:54:33,3491.551,Fox,462,55,14,14,11,5,9,3,463,449,435,372,177,151,26,29,226,236,75,187,145,0,,55
14:54:33,3491.894,Fox,462,55,14,12,13,5,9,3,463,449,437,372,177,151,26,29,226,236,75,187,145,0,,55
14:54:33,3492.694,Fox,462,55,12,14,13,5,9,3,463,451,437,372,177,151,26,29,226,236,75,187,145,0,,55
14:54:34,3493.894,Fox,462,55,12,14,13,5,8,4,463,451,437,372,177,152,26,29,226,236,75,187,145,0,,55
14:54:35,3496.594,Fox,464,56,12,14,14,5,8,4,465,453,439,372,177,152,26,30,227,237,75,188,145,0,,56
14:54:35,3497.794,Fox,464,55,12,14,14,5,8,3,465,453,439,372,177,152,26,29,227,237,75,188,146,0,,55
14:54:35,3498.694,Fox,464,55,12,12,16,5,8,3,465,453,441,372,177,152,26,29,227,237,75,188,146,0,,55
14:54:36,3499.594,Fox,464,55,12,12,15,6,8,3,465,453,441,373,177,152,26,29,227,237,75,188,146,0,,55
14:54:36,3501.094,Fox,464,55,12,12,14,7,8,3,465,453,441,374,177,152,26,29,227,237,75,188,146,0,,55
14:54:37,3502.594,Fox,464,55,12,12,14,7,7,4,465,453,441,374,177,153,26,29,227,237,75,188,146,0,,55
14:54:38,3506.794,Fox,464,55,12,12,12,9,7,4,465,453,441,376,177,153,26,29,227,237,75,188,146,0,,55
14:54:39,3507.394,Fox,464,55,12,10,14,9,7,4,465,453,443,376,177,153,26,29,227,237,75,188,146,0,,55
14:54:40,3510.112,Fox,466,56,14,10,13,9,7,4,467,453,443,376,177,153,25,31,227,239,75,189,146,0,,56
14:54:40,3511.296,Fox,466,56,14,10,12,10,7,4,467,453,443,377,177,153,25,31,227,239,75,189,146,0,,56
14:54:40,3511.801,Fox,466,56,12,12,12,10,7,4,467,455,443,377,177,153,25,31,227,239,75,189,146,0,,56
14:54:41,3513.812,Fox,466,54,12,12,12,8,7,4,467,455,443,377,177,153,25,29,227,239,77,189,146,0,,54
14:54:42,3515.475,Fox,466,54,12,12,12,7,8,4,467,455,443,377,178,153,25,29,227,239,77,189,146,0,,54
14:54:43,3518.265,Fox,466,54,10,14,12,7,8,4,467,457,443,377,178,153,25,29,227,239,77,189,146,0,,54
14:54:43,3519.514,Fox,468,55,12,14,12,7,8,3,469,457,443,377,178,153,26,29,228,240,77,189,147,0,,55
14:54:44,3520.714,Fox,468,55,12,12,14,7,8,3,469,457,445,377,178,153,26,29,228,240,77,189,147,0,,55
14:54:45,3523.114,Fox,468,54,12,12,14,7,8,2,469,457,445,377,178,153,25,29,228,240,77,189,148,0,,54
14:54:46,3526.714,Fox,469,54,12,10,14,8,8,2,469,457,447,379,178,153,25,29,229,240,77,190,148,0,,54
14:54:46,3527.014,Fox,469,54,14,10,14,8,8,2,471,457,447,379,178,153,25,29,229,240,77,190,148,0,,54
14:54:47,3530.313,Fox,469,54,14,8,14,10,8,2,471,457,449,381,178,153,25,29,229,240,77,190,148,0,,54
14:54:47,3531.092,Fox,469,54,14,6,16,10,8,2,471,457,451,381,178,153,25,29,229,240,77,190,148,0,,54
14:54:48,3531.856,Fox,469,53,12,8,16,9,8,2,471,459,451,381,178,153,25,28,229,240,77,191,148,0,,53
14:54:48,3532.435,Fox,471,54,12,8,16,8,8,2,471,459,451,381,178,153,25,29,229,242,77,192,148,0,,54
14:54:48,3533.022,Fox,473,56,16,8,16,8,8,2,475,459,451,381,178,153,25,31,229,244,77,192,148,0,,56
14:54:49,3534.514,Fox,473,55,16,8,16,8,8,1,475,459,451,381,178,153,25,30,229,244,77,192,149,0,,55
14:54:49,3535.114,Fox,473,55,16,6,18,8,8,1,475,459,453,381,178,153,25,30,229,244,77,192,149,0,,55
14:54:50,3537.119,Fox,473,53,16,6,18,6,8,1,475,459,453,381,178,153,25,28,229,244,77,194,149,0,,53
14:54:50,3538.019,Fox,473,52,16,6,18,5,8,1,475,459,453,381,178,153,24,28,229,244,77,195,149,0,,52
14:54:52,3544.041,Fox,473,52,16,6,16,7,8,1,475,459,453,383,178,153,24,28,229,244,77,195,149,0,,52
14:54:54,3550.215,Fox,473,52,16,4,18,7,8,1,475,459,455,383,178,153,24,28,229,244,77,195,149,0,,52
14:54:55,3552.603,Fox,473,52,16,4,16,9,8,1,475,459,455,385,178,153,24,28,229,244,77,195,149,0,,52
14:54:56,3555.603,Fox,475,54,18,4,16,9,8,1,477,459,455,385,178,153,24,30,229,246,77,195,149,0,,54
14:54:57,3557.103,Fox,477,56,18,2,16,11,8,1,477,459,457,387,178,153,24,32,229,248,77,195,149,0,,56
14:54:57,3557.403,Fox,477,56,20,2,16,11,8,1,479,459,457,387,178,153,24,32,229,248,77,195,149,0,,56
14:54:57,3558.002,Fox,477,55,20,2,16,10,8,1,479,459,457,387,178,153,24,31,229,248,77,196,149,0,,55
14:54:58,3559.202,Fox,477,55,20,2,14,12,8,1,479,459,457,389,178,153,24,31,229,248,77,196,149,0,,55
14:54:58,3560.15,Fox,477,55,18,4,14,12,8,1,479,461,457,389,178,153,24,31,229,248,77,196,149,0,,55
14:55:01,3567.926,Fox,477,55,18,4,12,14,8,1,479,461,457,391,178,153,24,31,229,248,77,196,149,0,,55
14:55:01,3569.426,Fox,477,54,18,4,12,13,7,2,479,461,457,391,178,154,24,30,229,248,77,197,149,0,,54
14:55:02,3570.326,Fox,477,54,18,2,14,13,7,2,479,461,459,391,178,154,24,30,229,248,77,197,149,0,,54
14:55:02,3571.526,Fox,481,56,22,2,12,13,6,3,483,461,459,391,178,155,25,31,232,249,79,197,149,0,,56
14:55:03,3572.928,Fox,483,57,24,2,11,13,6,3,485,461,459,391,178,155,24,33,232,251,79,198,149,0,,57
14:55:03,3573.528,Fox,483,57,22,4,11,13,6,3,485,463,459,391,178,155,24,33,232,251,79,198,149,0,,57
14:55:05,3577.941,Fox,485,58,24,4,10,13,6,3,487,463,459,391,178,155,23,35,232,253,79,199,149,0,,58
14:55:05,3579.356,Fox,485,57,22,6,10,12,6,3,487,465,459,391,178,155,22,35,232,253,79,200,149,0,,57
14:55:06,3581.156,Fox,485,57,22,6,8,14,6,3,487,465,459,393,178,155,22,35,232,253,79,200,149,0,,57
14:55:09,3590.156,Fox,487,59,23,6,8,14,6,3,488,465,459,393,178,155,23,36,233,254,79,200,149,0,,59
14:55:10,3590.756,Fox,487,59,25,6,7,15,6,3,490,465,459,394,178,155,23,36,233,254,79,200,149,0,,59
14:55:10,3591.656,Fox,487,59,25,6,6,16,6,3,490,465,459,395,178,155,23,36,233,254,79,200,149,0,,59
14:55:11,3592.856,Fox,487,59,23,8,6,16,6,3,490,467,459,395,178,155,23,36,233,254,79,200,149,0,,59
14:55:12,3595.556,Fox,487,59,23,8,4,18,6,3,490,467,459,397,178,155,23,36,233,254,79,200,149,0,,59
14:55:13,3599.371,Fox,487,58,23,6,6,17,6,3,490,467,461,397,178,155,23,35,233,254,79,201,149,0,,58
14:55:13,3600.271,Fox,489,59,25,6,6,16,6,3,492,467,461,397,178,155,23,36,234,255,79,202,149,0,,59
14:55:14,3602.071,Fox,489,59,23,8,6,16,6,3,492,469,461,397,178,155,23,36,234,255,79,202,149,0,,59
14:55:15,3604.171,Fox,489,57,23,8,6,15,6,2,492,469,461,397,178,155,22,35,234,255,80,202,150,0,,57
14:55:16,3606.13,Fox,491,58,25,8,5,15,6,2,494,469,461,397,178,155,22,36,235,256,80,203,150,0,,58
14:55:17,3609.73,Fox,491,58,23,10,5,15,6,2,494,471,461,397,178,155,22,36,235,256,80,203,150,0,,58
14:55:18,3610.93,Fox,491,58,23,10,3,17,6,2,494,471,461,399,178,155,22,36,235,256,80,203,150,0,,58
14:55:18,3612.13,Fox,491,58,23,8,5,17,6,2,494,471,463,399,178,155,22,36,235,256,80,203,150,0,,58
14:55:19,3613.901,Fox,493,60,25,8,5,17,6,2,496,471,463,399,178,155,23,37,236,257,80,203,150,0,,60
14:55:19,3615.574,Fox,493,60,21,12,5,17,6,2,496,475,463,399,178,155,23,37,236,257,80,203,150,0,,60
14:55:20,3616.087,Fox,493,60,21,12,5,17,5,3,496,475,463,399,178,156,23,37,236,257,80,203,150,0,,60
14:55:20,3617.74,Fox,493,60,21,10,5,19,5,3,496,475,465,401,178,156,23,37,236,257,80,203,150,0,,60
14:55:20,3618.04,Fox,493,60,21,10,5,19,3,5,496,475,465,401,178,158,23,37,236,257,80,203,150,0,,60
14:55:21,3619.24,Fox,493,60,21,10,5,19,1,7,496,475,465,401,178,160,23,37,236,257,80,203,150,0,,60
14:55:22,3622.84,Fox,493,59,21,10,5,18,1,7,496,475,465,401,178,160,22,37,236,257,80,204,150,0,,59
14:55:24,3628.046,Fox,493,58,21,10,5,18,1,6,496,475,465,401,178,160,22,36,236,257,80,204,151,0,,58
14:55:26,3630.746,Fox,493,58,21,10,4,19,1,6,496,475,465,402,178,160,22,36,236,257,80,204,151,0,,58
14:55:26,3631.346,Fox,493,58,21,8,6,19,1,6,496,475,467,402,178,160,22,36,236,257,80,204,151,0,,58
14:55:28,3637.666,Fox,493,57,21,8,6,17,3,5,496,475,467,402,180,160,21,36,236,257,80,205,151,0,,57
14:55:29,3638.566,Fox,493,55,19,10,6,15,3,5,496,477,467,402,180,160,20,35,236,257,82,205,151,0,,55
14:55:29,3639.466,Fox,493,53,19,10,6,15,3,3,496,477,467,402,180,160,20,33,236,257,82,205,153,0,,53
14:55:29,3640.066,Fox,493,52,17,12,6,14,3,3,496,479,467,402,180,160,20,32,236,257,82,206,153,0,,52
14:55:30,3640.93,Fox,493,51,17,10,8,13,3,3,496,479,469,402,180,160,20,31,236,257,82,207,153,0,,51
14:55:30,3642.56,Fox,493,50,17,10,8,13,3,2,496,479,469,402,180,160,20,30,236,257,82,207,154,0,,50
14:55:30,3643.236,Fox,493,48,17,10,8,11,3,2,496,479,469,402,180,160,19,29,236,257,82,209,154,0,,48
14:55:32,3646.16,Fox,493,48,17,10,8,10,4,2,496,479,469,402,181,160,19,29,236,257,82,209,154,0,,48
14:55:32,3648.26,Fox,493,48,17,8,10,10,4,2,496,479,471,402,181,160,19,29,236,257,82,209,154,0,,48
14:55:33,3650.36,Fox,493,48,17,8,10,9,5,2,496,479,471,402,182,160,19,29,236,257,82,209,154,0,,48
14:55:34,3653.06,Fox,493,48,17,8,10,7,6,3,496,479,471,402,184,161,19,29,236,257,82,209,154,0,,48
14:55:35,3653.66,Fox,495,50,19,8,10,7,6,3,498,479,471,402,184,161,20,30,237,258,82,209,154,0,,50
14:55:35,3654.26,Fox,495,48,15,8,14,5,6,3,498,483,475,402,184,161,18,30,237,258,82,211,154,0,,48
14:55:35,3655.46,Fox,495,48,13,10,14,5,6,3,498,485,475,402,184,161,18,30,237,258,82,211,154,0,,48
14:55:37,3658.951,Fox,497,50,15,10,14,5,6,3,500,485,475,402,184,161,19,31,238,259,82,211,154,0,,50
14:55:37,3659.551,Fox,497,50,15,10,12,7,6,3,500,485,475,404,184,161,19,31,238,259,82,211,154,0,,50
14:55:37,3660.751,Fox,497,49,13,12,12,7,6,2,500,487,475,404,184,161,19,30,238,259,82,211,155,0,,49
14:55:41,3669.549,Fox,497,47,13,12,12,6,5,2,500,487,475,404,184,161,18,29,238,259,82,213,155,0,,47
14:55:42,3672.549,Fox,497,47,12,13,10,8,5,2,500,488,475,406,184,161,18,29,238,259,82,213,155,0,,47
14:55:42,3672.947,Fox,497,47,10,15,10,8,5,2,500,490,475,406,184,161,18,29,238,259,82,213,155,0,,47
14:55:43,3676.775,Fox,497,47,10,13,12,8,5,2,500,490,477,406,184,161,18,29,238,259,82,213,155,0,,47
14:55:44,3677.975,Fox,499,49,12,13,12,8,5,2,502,490,477,406,184,161,20,29,240,259,82,213,155,0,,49
14:55:44,3678.575,Fox,499,49,12,11,12,10,5,2,502,490,479,408,184,161,20,29,240,259,82,213,155,0,,49
14:55:45,3679.775,Fox,501,51,14,11,12,10,5,2,504,490,479,408,184,161,22,29,242,259,82,213,155,0,,51
14:55:46,3682.775,Fox,501,51,12,13,12,10,5,2,504,492,479,408,184,161,22,29,242,259,82,213,155,0,,51
14:55:47,3687.207,Fox,503,53,14,13,12,10,5,2,506,492,479,408,184,161,23,30,243,260,82,213,155,0,,53
14:55:48,3688.707,Fox,503,53,12,15,12,10,5,2,506,494,479,408,184,161,23,30,243,260,82,213,155,0,,53
14:55:49,3691.924,Fox,503,53,12,15,10,12,5,2,506,494,479,410,184,161,23,30,243,260,82,213,155,0,,53
14:55:49,3692.784,Fox,503,53,12,11,14,12,5,2,506,494,483,410,184,161,23,30,243,260,82,213,155,0,,53
14:55:50,3693.775,Fox,503,53,12,9,16,12,5,2,506,494,485,410,184,161,23,30,243,260,82,213,155,0,,53
14:55:51,3696.475,Fox,503,53,10,11,16,12,5,2,506,496,485,410,184,161,23,30,243,260,82,213,155,0,,53
14:55:52,3699.358,Fox,503,53,10,9,18,12,5,2,506,496,487,410,184,161,23,30,243,260,82,213,155,0,,53
14:55:53,3701.158,Fox,503,53,10,9,16,14,5,2,506,496,487,412,184,161,23,30,243,260,82,213,155,0,,53
14:55:55,3708.658,Fox,503,53,10,9,14,16,5,2,506,496,487,414,184,161,23,30,243,260,82,213,155,0,,53
14:55:56,3709.283,Fox,505,55,12,9,14,16,5,2,508,496,487,414,184,161,24,31,244,261,82,213,155,0,,55
14:55:56,3710.926,Fox,505,55,12,8,15,14,7,2,508,496,488,414,186,161,24,31,244,261,82,213,155,0,,55
14:55:56,3711.526,Fox,505,55,12,6,17,14,7,2,508,496,490,414,186,161,24,31,244,261,82,213,155,0,,55
14:55:58,3714.826,Fox,505,55,12,6,13,18,7,2,508,496,490,418,186,161,24,31,244,261,82,213,155,0,,55
14:55:58,3715.426,Fox,505,54,12,6,13,17,7,2,508,496,490,418,186,161,24,30,244,261,82,214,155,0,,54
14:56:00,3721.282,Fox,505,54,12,4,15,17,7,2,508,496,492,418,186,161,24,30,244,261,82,214,155,0,,54
14:56:02,3727.281,Fox,505,54,12,2,17,17,7,2,508,496,494,418,186,161,24,30,244,261,82,214,155,0,,54
14:56:05,3733.854,Fox,505,51,12,2,17,15,7,1,508,496,494,418,186,161,24,27,244,261,83,215,156,0,,51
14:56:05,3735.054,Fox,505,51,12,0,19,15,7,1,508,496,496,418,186,161,24,27,244,261,83,215,156,0,,51
14:56:06,3736.254,Fox,505,51,10,2,19,15,7,1,508,498,496,418,186,161,24,27,244,261,83,215,156,0,,51
14:56:06,3737.114,Fox,505,51,10,2,17,17,7,1,508,498,496,420,186,161,24,27,244,261,83,215,156,0,,51
14:56:07,3739.1,Fox,505,51,10,2,15,19,7,1,508,498,496,422,186,161,24,27,244,261,83,215,156,0,,51
14:56:07,3739.7,Fox,505,50,10,2,15,19,7,0,508,498,496,422,186,161,23,27,244,261,83,215,157,0,,50
14:56:08,3741.5,Fox,505,50,8,4,15,19,7,0,508,500,496,422,186,161,23,27,244,261,83,215,157,0,,50
14:56:10,3746.3,Fox,505,49,8,4,15,18,7,0,508,500,496,422,186,161,22,27,244,261,83,216,157,0,,49
14:56:12,3751.1,Fox,507,51,10,4,15,18,7,0,510,500,496,422,186,161,24,27,246,261,83,216,157,0,,51
14:56:12,3753.211,Fox,507,51,10,4,11,20,9,0,510,500,496,426,188,161,24,27,246,261,83,216,157,0,,51
14:56:13,3754.49,Fox,507,51,10,4,9,22,9,0,510,500,496,428,188,161,24,27,246,261,83,216,157,0,,51
14:56:13,3755.17,Fox,507,50,10,4,9,21,9,0,510,500,496,428,188,161,24,26,246,261,83,217,157,0,,50
14:56:15,3760.003,Fox,509,52,10,4,7,23,9,0,510,500,496,430,188,161,24,28,246,263,83,217,157,0,,52
14:56:15,3760.603,Fox,509,52,10,6,7,23,9,0,512,502,496,430,188,161,24,28,246,263,83,217,157,0,,52
14:56:16,3762.403,Fox,511,54,10,8,7,23,9,0,514,504,496,430,188,161,25,29,247,264,83,217,157,0,,54
14:56:16,3763.003,Fox,513,56,12,8,7,23,9,0,516,504,496,430,188,161,26,30,248,265,83,217,157,0,,56
14:56:18,3766.181,Fox,513,56,12,8,7,22,10,0,516,504,496,430,189,161,26,30,248,265,83,217,157,0,,56
14:56:19,3769.781,Fox,513,56,10,10,7,22,10,0,516,506,496,430,189,161,26,30,248,265,83,217,157,0,,56
14:56:20,3771.881,Fox,513,56,10,10,6,21,12,0,516,506,496,431,191,161,26,30,248,265,83,217,157,0,,56
14:56:20,3772.181,Fox,513,56,10,10,4,23,12,0,516,506,496,433,191,161,26,30,248,265,83,217,157,0,,56
14:56:21,3775.124,Fox,513,56,10,8,6,23,11,1,516,506,498,433,191,162,26,30,248,265,83,217,157,0,,56
14:56:22,3777.224,Fox,515,58,12,8,6,23,11,1,518,506,498,433,191,162,27,31,249,266,83,217,157,0,,58
14:56:24,3780.224,Fox,515,58,12,6,8,23,11,1,518,506,500,433,191,162,27,31,249,266,83,217,157,0,,58
14:56:24,3781.909,Fox,515,58,12,6,6,25,11,1,518,506,500,435,191,162,27,31,249,266,83,217,157,0,,58
14:56:25,3783.709,Fox,517,60,14,6,6,25,10,2,520,506,500,435,191,163,29,31,251,266,83,217,157,0,,60
14:56:26,3785.809,Fox,519,61,16,6,5,25,10,2,522,506,500,435,191,163,30,31,253,266,83,218,157,0,,61
14:56:27,3788.209,Fox,519,60,16,6,4,26,8,3,522,506,500,436,191,164,29,31,253,266,83,219,157,0,,60
14:56:28,3790.309,Fox,519,60,16,6,4,26,6,5,522,506,500,436,191,166,29,31,253,266,83,219,157,0,,60
14:56:28,3791.936,Fox,519,60,14,8,4,26,6,5,522,508,500,436,191,166,29,31,253,266,83,219,157,0,,60
14:56:29,3794.737,Fox,521,61,16,8,3,24,8,5,524,508,500,436,193,166,28,33,253,268,84,219,157,0,,61
14:56:30,3795.637,Fox,521,61,16,8,2,25,8,5,524,508,500,437,193,166,28,33,253,268,84,219,157,0,,61
14:56:31,3797.666,Fox,523,62,18,8,2,24,8,5,526,508,500,437,193,166,28,34,254,269,84,220,157,0,,62
14:56:31,3799.166,Fox,523,62,18,6,4,24,8,5,526,508,502,437,193,166,28,34,254,269,84,220,157,0,,62
14:56:32,3800.966,Fox,523,62,18,4,6,24,8,5,526,508,504,437,193,166,28,34,254,269,84,220,157,0,,62
14:56:33,3802.166,Fox,523,62,18,4,6,23,9,5,526,508,504,437,194,166,28,34,254,269,84,220,157,0,,62
14:56:35,3808.319,Fox,523,62,18,2,8,20,12,5,526,508,506,437,197,166,28,34,254,269,84,220,157,0,,62
14:56:37,3811.019,Fox,525,63,20,2,7,20,12,5,528,508,506,437,197,166,28,35,255,270,84,221,157,0,,63
14:56:39,3815.582,Fox,527,64,22,2,7,20,12,4,530,508,506,437,197,166,30,34,257,270,84,221,158,0,,64
14:56:44,3826.55,Fox,529,66,24,2,7,20,12,4,532,508,506,437,197,166,32,34,259,270,84,221,158,0,,66
14:56:45,3830.642,Fox,529,66,24,0,9,18,14,4,532,508,508,437,199,166,32,34,259,270,84,221,158,0,,66
14:56:46,3832.442,Fox,529,66,24,0,9,16,16,4,532,508,508,437,201,166,32,34,259,270,84,221,158,0,,66
14:56:47,3833.642,Fox,529,66,22,2,9,16,16,4,532,510,508,437,201,166,32,34,259,270,84,221,158,0,,66
14:56:47,3835.442,Fox,529,66,22,2,8,17,16,4,532,510,508,438,201,166,32,34,259,270,84,221,158,0,,66
14:56:49,3838.442,Fox,529,65,22,2,8,16,16,4,532,510,508,438,201,166,32,33,259,270,84,222,158,0,,65
14:56:49,3839.342,Fox,531,67,24,2,8,16,16,4,534,510,508,438,201,166,33,34,260,271,84,222,158,0,,67
14:56:50,3840.542,Fox,531,67,24,2,6,18,16,4,534,510,508,440,201,166,33,34,260,271,84,222,158,0,,67
14:56:51,3842.942,Fox,531,67,22,4,6,18,16,4,534,512,508,440,201,166,33,34,260,271,84,222,158,0,,67
14:56:51,3844.515,Fox,531,66,22,4,6,18,16,3,534,512,508,440,201,166,32,34,260,271,84,222,159,0,,66
14:56:52,3845.105,Fox,531,66,20,6,6,18,16,3,534,514,508,440,201,166,32,34,260,271,84,222,159,0,,66
14:56:52,3845.706,Fox,531,66,18,8,6,18,16,3,534,516,508,440,201,166,32,34,260,271,84,222,159,0,,66
14:56:52,3846.605,Fox,531,66,18,8,6,15,19,3,534,516,508,440,204,166,32,34,260,271,84,222,159,0,,66
14:56:52,3847.206,Fox,531,65,18,8,6,14,19,3,534,516,508,440,204,166,32,33,260,271,85,222,159,0,,65
14:56:53,3848.406,Fox,531,65,18,8,6,12,19,5,534,516,508,440,206,168,32,33,260,271,85,222,159,0,,65
14:56:54,3851.105,Fox,531,63,18,8,6,12,19,3,534,516,508,440,206,168,31,32,260,271,85,222,161,0,,63
14:56:55,3853.206,Fox,531,63,18,8,6,10,21,3,534,516,508,440,208,168,31,32,260,271,85,222,161,0,,63
14:56:58,3859.752,Fox,531,63,16,10,4,12,21,3,534,518,508,442,208,168,31,32,260,271,85,222,161,0,,63
14:56:58,3861.252,Fox,533,64,18,10,4,11,21,3,536,518,508,442,208,168,31,33,261,272,85,223,161,0,,64
14:56:58,3861.552,Fox,533,64,18,10,2,13,21,3,536,518,508,444,208,168,31,33,261,272,85,223,161,0,,64
14:57:00,3865.452,Fox,535,66,18,10,2,12,22,3,536,518,508,444,209,168,33,33,263,272,85,223,161,0,,66
14:57:00,3865.752,Fox,535,66,20,10,2,10,24,3,538,518,508,444,211,168,33,33,263,272,85,223,161,0,,66
14:57:01,3866.352,Fox,535,66,18,12,2,10,24,3,538,520,508,444,211,168,33,33,263,272,85,223,161,0,,66
14:57:02,3868.752,Fox,535,65,16,14,0,12,24,2,538,522,508,446,211,168,33,32,263,272,85,223,162,0,,65
14:57:03,3872.052,Fox,537,67,18,14,0,12,24,2,540,522,508,446,211,168,35,32,265,272,85,223,162,0,,67
14:57:03,3872.352,Fox,537,67,18,12,2,12,24,2,540,522,510,446,211,168,35,32,265,272,85,223,162,0,,67
14:57:05,3875.494,Fox,537,67,18,12,2,10,26,2,540,522,510,446,213,168,35,32,265,272,85,223,162,0,,67
14:57:05,3876.281,Fox,539,69,20,12,2,10,26,2,542,522,510,446,213,168,36,33,266,273,85,223,162,0,,69
14:57:05,3877.333,Fox,539,69,18,14,2,10,26,2,542,524,510,446,213,168,36,33,266,273,85,223,162,0,,69
14:57:06,3878.833,Fox,539,68,18,14,2,9,26,2,542,524,510,446,213,168,36,32,266,273,85,224,162,0,,68
14:57:07,3880.333,Fox,539,68,16,16,2,9,26,2,542,526,510,446,213,168,36,32,266,273,85,224,162,0,,68
14:57:07,3881.396,Fox,541,70,18,14,4,9,26,2,544,526,512,446,213,168,37,33,267,274,85,224,162,0,,70
14:57:08,3883.948,Fox,543,72,18,12,6,9,26,2,544,526,514,446,213,168,38,34,268,275,85,224,162,0,,72
14:57:08,3884.41,Fox,543,71,20,10,8,8,26,2,546,526,516,446,213,168,38,33,268,275,85,225,162,0,,71
14:57:11,3889.21,Fox,543,70,20,10,8,8,26,1,546,526,516,446,213,168,37,33,268,275,85,225,163,0,,70
14:57:11,3890.41,Fox,543,70,20,10,8,8,25,2,546,526,516,446,213,169,37,33,268,275,85,225,163,0,,70
14:57:12,3891.31,Fox,545,71,20,10,6,9,25,2,546,526,516,448,213,169,38,33,270,275,85,226,163,0,,71
14:57:12,3891.61,Fox,545,71,22,10,6,9,25,2,548,526,516,448,213,169,38,33,270,275,85,226,163,0,,71
14:57:13,3893.71,Fox,545,71,20,12,6,9,25,2,548,528,516,448,213,169,38,33,270,275,85,226,163,0,,71
14:57:15,3898.51,Fox,545,71,18,12,8,9,25,2,548,530,518,448,213,169,38,33,270,275,85,226,163,0,,71
14:57:16,3901.81,Fox,547,73,20,12,8,9,25,2,550,530,518,448,213,169,39,34,271,276,85,226,163,0,,73
14:57:17,3903.609,Fox,547,73,20,12,8,9,24,3,550,530,518,448,213,170,39,34,271,276,85,226,163,0,,73
14:57:17,3904.809,Fox,547,73,20,10,10,9,24,3,550,530,520,448,213,170,39,34,271,276,85,226,163,0,,73
14:57:18,3906.874,Fox,547,73,20,8,12,9,24,3,550,530,522,448,213,170,39,34,271,276,85,226,163,0,,73
14:57:19,3909.274,Fox,547,73,18,10,12,9,22,5,550,532,522,448,213,172,39,34,271,276,85,226,163,0,,73
14:57:22,3916.067,Fox,547,73,18,8,14,9,22,5,550,532,524,448,213,172,39,34,271,276,85,226,163,0,,73
14:57:22,3917.567,Fox,549,75,20,8,14,9,22,5,552,532,524,448,213,172,40,35,272,277,85,226,163,0,,75
14:57:23,3918.767,Fox,549,75,20,6,16,9,22,5,552,532,526,448,213,172,40,35,272,277,85,226,163,0,,75
14:57:24,3920.867,Fox,549,74,20,6,16,9,22,4,552,532,526,448,213,172,40,34,272,277,85,226,164,0,,74
14:57:24,3922.067,Fox,549,74,18,8,16,9,22,4,552,534,526,448,213,172,40,34,272,277,85,226,164,0,,74
14:57:25,3925.153,Fox,551,75,20,8,15,9,22,4,554,534,526,448,213,172,40,35,273,278,86,226,164,0,,75
14:57:27,3929.537,Fox,551,73,20,8,15,8,22,3,554,534,526,448,213,172,39,34,273,278,87,226,165,0,,73
14:57:28,3932.237,Fox,551,73,20,6,17,8,20,5,554,534,528,448,213,174,39,34,273,278,87,226,165,0,,73
14:57:29,3932.837,Fox,551,73,20,6,15,10,20,5,554,534,528,450,213,174,39,34,273,278,87,226,165,0,,73
14:57:29,3934.337,Fox,555,77,20,6,15,9,21,5,554,534,528,450,214,174,43,34,277,278,87,226,165,0,,77
14:57:29,3934.637,Fox,555,77,24,6,15,9,21,5,558,534,528,450,214,174,43,34,277,278,87,226,165,0,,77
14:57:30,3936.437,Fox,557,79,26,6,15,9,21,5,560,534,528,450,214,174,45,34,279,278,87,226,165,0,,79
14:57:30,3936.737,Fox,557,79,26,4,17,9,21,5,560,534,530,450,214,174,45,34,279,278,87,226,165,0,,79
14:57:32,3939.437,Fox,559,81,28,4,17,9,21,5,562,534,530,450,214,174,45,36,279,280,87,226,165,0,,81
14:57:32,3939.737,Fox,559,81,28,4,17,9,20,6,562,534,530,450,214,175,45,36,279,280,87,226,165,0,,81
14:57:33,3942.219,Fox,561,83,30,4,15,11,20,6,564,534,530,452,214,175,46,37,280,281,87,226,165,0,,83
14:57:33,3942.519,Fox,561,82,30,4,15,11,20,5,564,534,530,452,214,175,45,37,280,281,87,226,166,0,,82
14:57:33,3943.982,Fox,561,82,28,6,13,13,20,5,564,536,530,454,214,175,45,37,280,281,87,226,166,0,,82
14:57:34,3944.54,Fox,561,82,28,6,12,14,20,5,564,536,530,455,214,175,45,37,280,281,87,226,166,0,,82
14:57:34,3945.646,Fox,561,82,28,6,12,14,17,8,564,536,530,455,214,178,45,37,280,281,87,226,166,0,,82
14:57:34,3946.246,Fox,563,83,30,6,12,13,17,8,566,536,530,455,214,178,45,38,281,282,87,227,166,0,,83
14:57:35,3947.746,Fox,563,83,30,4,14,13,17,8,566,536,532,455,214,178,45,38,281,282,87,227,166,0,,83
14:57:35,3948.346,Fox,563,83,28,6,14,13,17,8,566,538,532,455,214,178,45,38,281,282,87,227,166,0,,83
14:57:38,3953.146,Fox,563,83,28,6,14,12,18,8,566,538,532,455,215,178,45,38,281,282,87,227,166,0,,83
14:57:38,3954.646,Fox,567,85,28,8,13,12,18,7,568,540,532,455,215,178,46,39,283,284,87,228,167,0,,85
14:57:38,3954.946,Fox,567,85,30,8,13,10,20,7,570,540,532,455,217,178,46,39,283,284,87,228,167,0,,85
14:57:39,3955.846,Fox,567,84,30,8,13,10,20,6,570,540,532,455,217,178,46,38,283,284,87,228,168,0,,84
14:57:40,3959.146,Fox,569,86,30,10,11,12,20,6,572,542,532,457,217,178,48,38,285,284,87,228,168,0,,86
14:57:40,3960.346,Fox,569,86,30,8,13,12,20,6,572,542,534,457,217,178,48,38,285,284,87,228,168,0,,86
14:57:41,3962.446,Fox,569,86,30,8,13,10,22,6,572,542,534,457,219,178,48,38,285,284,87,228,168,0,,86
14:57:42,3964.246,Fox,569,86,28,10,13,10,22,6,572,544,534,457,219,178,48,38,285,284,87,228,168,0,,86
14:57:42,3965.446,Fox,569,86,28,10,11,12,22,6,572,544,534,459,219,178,48,38,285,284,87,228,168,0,,86
14:57:43,3966.046,Fox,569,85,28,10,11,12,22,5,572,544,534,459,219,178,48,37,285,284,87,228,169,0,,85
14:57:43,3966.946,Fox,569,85,26,12,11,12,22,5,572,546,534,459,219,178,48,37,285,284,87,228,169,0,,85
14:57:43,3967.542,Fox,569,85,26,12,9,14,22,5,572,546,534,461,219,178,48,37,285,284,87,228,169,0,,85
14:57:43,3968.135,Fox,569,85,26,12,9,14,20,7,572,546,534,461,219,180,48,37,285,284,87,228,169,0,,85
14:57:44,3969.921,Fox,569,85,26,12,9,14,18,9,572,546,534,461,219,182,48,37,285,284,87,228,169,0,,85
14:57:46,3973.221,Fox,569,83,26,12,9,12,18,9,572,546,534,461,219,182,48,35,285,284,89,228,169,0,,83
14:57:46,3974.121,Fox,569,83,24,14,9,12,18,9,572,548,534,461,219,182,48,35,285,284,89,228,169,0,,83
14:57:47,3976.794,Fox,569,80,24,14,7,12,17,9,572,548,534,463,219,182,48,32,285,284,91,229,169,0,,80
14:57:48,3979.194,Fox,569,80,24,14,6,13,17,9,572,548,534,464,219,182,48,32,285,284,91,229,169,0,,80
14:57:49,3980.394,Fox,569,79,24,14,6,13,17,8,572,548,534,464,219,182,48,31,285,284,91,229,170,0,,79
14:57:50,3982.494,Fox,569,79,24,12,8,13,17,8,572,548,536,464,219,182,48,31,285,284,91,229,170,0,,79
14:57:51,3984.594,Fox,569,79,22,14,8,13,14,11,572,550,536,464,219,185,48,31,285,284,91,229,170,0,,79
14:57:51,3985.494,Fox,569,79,22,14,8,13,12,13,572,550,536,464,219,187,48,31,285,284,91,229,170,0,,79
14:57:52,3986.994,Fox,569,79,22,12,10,13,12,13,572,550,538,464,219,187,48,31,285,284,91,229,170,0,,79
14:57:53,3989.994,Fox,573,81,26,12,10,11,12,13,576,550,538,464,219,187,49,32,288,285,91,231,170,0,,81
14:57:53,3990.434,Fox,573,81,26,12,10,11,11,14,576,550,538,464,219,188,49,32,288,285,91,231,170,0,,81
14:57:54,3991.795,Fox,573,79,26,12,10,9,11,14,576,550,538,464,219,188,48,31,288,285,92,232,170,0,,79
14:57:54,3992.695,Fox,573,79,26,12,8,11,11,14,576,550,538,466,219,188,48,31,288,285,92,232,170,0,,79
14:57:54,3993.295,Fox,573,79,26,10,10,11,11,14,576,550,540,466,219,188,48,31,288,285,92,232,170,0,,79
14:57:56,3997.495,Fox,573,79,26,8,10,13,11,14,576,550,542,468,219,188,48,31,288,285,92,232,170,0,,79
14:57:57,3998.695,Fox,573,78,26,8,10,13,11,13,576,550,542,468,219,188,48,30,288,285,92,232,171,0,,78
14:57:57,3999.468,Fox,573,76,26,8,10,11,11,13,576,550,542,468,219,188,46,30,288,285,92,234,171,0,,76
14:57:57,4000.068,Fox,573,76,24,10,10,11,11,13,576,552,542,468,219,188,46,30,288,285,92,234,171,0,,76
14:57:58,4002.768,Fox,573,76,24,8,12,11,10,14,576,552,544,468,219,189,46,30,288,285,92,234,171,0,,76
14:57:59,4003.068,Fox,573,76,24,8,12,11,8,16,576,552,544,468,219,191,46,30,288,285,92,234,171,0,,76
14:57:59,4005.468,Fox,573,76,24,6,14,11,8,16,576,552,546,468,219,191,46,30,288,285,92,234,171,0,,76
14:58:00,4007.268,Fox,573,76,25,6,14,11,8,16,577,552,546,468,219,191,46,30,288,285,92,234,171,0,,76
14:58:01,4008.168,Fox,573,76,23,8,12,13,8,16,577,554,546,470,219,191,46,30,288,285,92,234,171,0,,76
14:58:01,4008.768,Fox,573,75,23,8,12,12,8,16,577,554,546,470,219,191,46,29,288,285,92,235,171,0,,75
14:58:02,4010.772,Fox,573,74,23,8,12,12,8,15,577,554,546,470,219,191,46,28,288,285,92,235,172,0,,74
14:58:02,4012.819,Fox,573,73,23,6,14,11,6,17,577,554,548,470,219,193,46,27,288,285,93,235,172,0,,73
14:58:04,4017.206,Fox,573,73,19,10,14,11,6,17,577,558,548,470,219,193,46,27,288,285,93,235,172,0,,73
14:58:05,4019.278,Fox,575,74,17,12,13,11,6,17,577,560,548,470,219,193,46,28,289,286,94,235,172,0,,74
14:58:05,4019.578,Fox,575,74,19,12,13,11,6,17,579,560,548,470,219,193,46,28,289,286,94,235,172,0,,74
14:58:05,4020.808,Fox,575,73,19,12,11,13,6,16,579,560,548,472,219,193,45,28,289,286,94,235,173,0,,73
14:58:06,4022.415,Fox,577,74,17,14,11,12,6,16,579,562,548,472,219,193,45,29,290,287,94,236,173,0,,74
14:58:06,4023.015,Fox,577,74,19,12,13,12,6,16,581,562,550,472,219,193,45,29,290,287,94,236,173,0,,74
14:58:07,4023.615,Fox,577,72,19,12,13,12,6,14,581,562,550,472,219,193,45,27,290,287,94,236,175,0,,72
14:58:07,4024.814,Fox,577,72,17,14,13,12,6,14,581,564,550,472,219,193,45,27,290,287,94,236,175,0,,72
14:58:08,4026.314,Fox,577,72,17,14,13,10,8,14,581,564,550,472,221,193,45,27,290,287,94,236,175,0,,72
14:58:08,4026.812,Fox,577,71,17,14,13,10,8,13,581,564,550,472,221,193,45,26,290,287,94,236,176,0,,71
14:58:09,4028.911,Fox,577,71,15,16,13,10,8,13,581,566,550,472,221,193,45,26,290,287,94,236,176,0,,71
14:58:10,4030.698,Fox,577,69,15,16,13,10,7,12,581,566,550,472,221,193,44,25,290,287,94,237,177,0,,69
14:58:10,4031.898,Fox,579,71,17,16,13,10,7,12,583,566,550,472,221,193,44,27,290,289,94,237,177,0,,71
14:58:11,4033.098,Fox,581,73,19,16,13,10,7,12,585,566,550,472,221,193,45,28,291,290,94,237,177,0,,73
14:58:12,4036.071,Fox,581,72,19,16,13,10,7,11,585,566,550,472,221,193,45,27,291,290,94,237,178,0,,72
14:58:12,4037.571,Fox,581,72,15,20,13,10,7,11,585,570,550,472,221,193,45,27,291,290,94,237,178,0,,72
14:58:13,4039.071,Fox,583,73,17,18,14,10,7,11,587,570,552,472,221,193,44,29,291,292,95,237,178,0,,73
14:58:13,4039.371,Fox,583,72,17,18,14,10,7,10,587,570,552,472,221,193,44,28,291,292,95,237,179,0,,72
14:58:14,4041.771,Fox,583,72,15,20,14,10,7,10,587,572,552,472,221,193,44,28,291,292,95,237,179,0,,72
14:58:14,4042.935,Fox,585,74,17,20,13,11,7,10,589,572,552,473,221,193,45,29,292,293,95,237,179,0,,74
14:58:14,4043.489,Fox,585,73,17,20,13,11,7,9,589,572,552,473,221,193,44,29,292,293,95,237,180,0,,73
14:58:15,4044.91,Fox,585,72,17,20,13,11,7,8,589,572,552,473,221,193,43,29,292,293,95,237,181,0,,72
14:58:15,4045.81,Fox,587,74,19,20,13,11,7,8,591,572,552,473,221,193,43,31,292,295,95,237,181,0,,74
14:58:16,4046.41,Fox,587,74,19,18,15,11,7,8,591,572,554,473,221,193,43,31,292,295,95,237,181,0,,74
14:58:16,4047.31,Fox,587,74,19,18,13,13,7,8,591,572,554,475,221,193,43,31,292,295,95,237,181,0,,74
14:58:17,4051.138,Fox,587,73,19,18,13,13,7,7,591,572,554,475,221,193,43,30,292,295,95,237,182,0,,73
14:58:19,4053.838,Fox,587,73,19,18,11,15,7,7,591,572,554,477,221,193,43,30,292,295,95,237,182,0,,73
14:58:19,4055.638,Fox,587,73,19,14,15,15,7,7,591,572,558,477,221,193,43,30,292,295,95,237,182,0,,73
14:58:20,4057.3,Fox,587,73,19,12,17,15,7,7,591,572,560,477,221,193,43,30,292,295,95,237,182,0,,73
14:58:20,4058.2,Fox,587,73,19,12,15,17,7,7,591,572,560,479,221,193,43,30,292,295,95,237,182,0,,73
14:58:21,4060.3,Fox,589,75,21,12,15,17,7,7,593,572,560,479,221,193,45,30,294,295,95,237,182,0,,75
14:58:21,4060.6,Fox,589,75,21,10,17,17,7,7,593,572,562,479,221,193,45,30,294,295,95,237,182,0,,75
14:58:22,4063.3,Fox,589,75,21,8,18,18,7,7,593,572,564,480,221,193,45,30,294,295,95,237,182,0,,75
14:58:23,4066.136,Fox,591,77,21,8,16,20,7,7,593,572,564,482,221,193,46,31,295,296,95,237,182,0,,77
14:58:23,4066.421,Fox,591,77,23,8,16,20,7,7,595,572,564,482,221,193,46,31,295,296,95,237,182,0,,77
14:58:24,4067.282,Fox,591,77,23,6,18,20,7,7,595,572,566,482,221,193,46,31,295,296,95,237,182,0,,77
14:58:25,4069.982,Fox,591,77,23,6,18,19,8,7,595,572,566,482,222,193,46,31,295,296,95,237,182,0,,77
14:58:25,4071.482,Fox,591,77,23,6,18,19,7,8,595,572,566,482,222,194,46,31,295,296,95,237,182,0,,77
14:58:26,4072.682,Fox,591,77,19,10,18,19,7,8,595,576,566,482,222,194,46,31,295,296,95,237,182,0,,77
14:58:26,4073.157,Fox,591,77,19,10,16,21,7,8,595,576,566,484,222,194,46,31,295,296,95,237,182,0,,77
14:58:26,4073.892,Fox,595,78,19,10,16,19,7,7,595,576,566,484,222,194,47,31,298,297,97,237,183,0,,78
14:58:27,4074.192,Fox,595,78,23,10,16,19,7,7,599,576,566,484,222,194,47,31,298,297,97,237,183,0,,78
14:58:27,4075.961,Fox,595,78,23,6,20,19,7,7,599,576,570,484,222,194,47,31,298,297,97,237,183,0,,78
14:58:29,4080.428,Fox,595,78,23,4,22,19,7,7,599,576,572,484,222,194,47,31,298,297,97,237,183,0,,78
14:58:29,4081.329,Fox,597,80,25,4,22,19,7,7,601,576,572,484,222,194,48,32,299,298,97,237,183,0,,80
14:58:30,4083.428,Fox,599,81,27,4,20,20,7,7,603,576,572,486,222,194,48,33,300,299,97,238,183,0,,81
14:58:31,4084.928,Fox,599,80,27,4,20,19,7,7,603,576,572,486,222,194,47,33,300,299,97,239,183,0,,80
14:58:31,4086.331,Fox,601,82,27,4,20,17,9,7,603,576,572,486,224,194,48,34,301,300,97,239,183,0,,82
14:58:31,4086.613,Fox,601,81,29,4,20,17,9,6,605,576,572,486,224,194,48,33,301,300,97,239,184,0,,81
14:58:33,4089.905,Fox,601,81,28,5,20,17,9,6,605,577,572,486,224,194,48,33,301,300,97,239,184,0,,81
14:58:33,4090.805,Fox,601,81,28,5,20,15,10,7,605,577,572,486,226,195,48,33,301,300,97,239,184,0,,81
14:58:34,4092.305,Fox,601,81,28,5,20,15,9,8,605,577,572,486,226,196,48,33,301,300,97,239,184,0,,81
14:58:37,4099.205,Fox,601,81,28,5,18,17,9,8,605,577,572,488,226,196,48,33,301,300,97,239,184,0,,81
14:58:37,4099.805,Fox,601,81,28,5,18,17,7,10,605,577,572,488,226,198,48,33,301,300,97,239,184,0,,81
14:58:37,4100.705,Fox,601,80,28,5,18,17,6,10,605,577,572,488,226,198,47,33,301,300,97,240,184,0,,80
14:58:38,4101.905,Fox,601,78,28,5,18,14,8,9,605,577,572,488,228,198,46,32,301,300,97,241,185,0,,78
14:58:38,4102.205,Fox,601,78,26,7,18,14,8,9,605,579,572,488,228,198,46,32,301,300,97,241,185,0,,78
14:58:39,4104.004,Fox,601,77,26,7,18,14,8,8,605,579,572,488,228,198,45,32,301,300,97,241,186,0,,77
14:58:39,4105.805,Fox,601,75,24,9,18,14,8,6,605,581,572,488,228,198,44,31,301,300,97,241,188,0,,75
14:58:40,4106.705,Fox,601,75,24,9,16,16,8,6,605,581,572,490,228,198,44,31,301,300,97,241,188,0,,75
14:58:42,4111.205,Fox,601,75,24,5,20,16,8,6,605,581,576,490,228,198,44,31,301,300,97,241,188,0,,75
14:58:42,4112.705,Fox,601,73,24,5,20,15,8,5,605,581,576,490,228,198,43,30,301,300,97,242,189,0,,73
14:58:43,4114.504,Fox,601,73,22,7,20,14,9,5,605,583,576,490,229,198,43,30,301,300,97,242,189,0,,73
14:58:43,4115.705,Fox,601,73,20,9,20,14,9,5,605,585,576,490,229,198,43,30,301,300,97,242,189,0,,73
14:58:44,4116.604,Fox,603,74,20,9,15,18,9,5,605,585,576,494,229,198,43,31,302,301,98,242,189,0,,74
14:58:44,4116.905,Fox,603,74,22,9,15,18,9,5,607,585,576,494,229,198,43,31,302,301,98,242,189,0,,74
14:58:44,4118.104,Fox,603,74,22,9,13,20,9,5,607,585,576,496,229,198,43,31,302,301,98,242,189,0,,74
14:58:45,4119.004,Fox,605,75,24,9,12,20,9,5,609,585,576,496,229,198,43,32,303,302,99,242,189,0,,75
14:58:46,4121.405,Fox,607,77,24,9,10,22,9,5,609,585,576,498,229,198,44,33,304,303,99,242,189,0,,77
14:58:46,4121.705,Fox,607,77,24,11,10,22,9,5,611,587,576,498,229,198,44,33,304,303,99,242,189,0,,77
14:58:47,4123.805,Fox,607,77,24,11,8,24,9,5,611,587,576,500,229,198,44,33,304,303,99,242,189,0,,77
14:58:48,4125.644,Fox,607,77,22,13,8,24,9,5,611,589,576,500,229,198,44,33,304,303,99,242,189,0,,77
14:58:49,4128.344,Fox,607,77,20,14,7,26,9,5,611,591,577,502,229,198,44,33,304,303,99,242,189,0,,77
14:58:50,4133.051,Fox,607,74,20,14,7,24,9,4,611,591,577,502,229,198,42,32,304,303,99,244,190,0,,74
14:58:52,4136.465,Fox,607,74,20,14,3,27,10,4,611,591,577,506,230,198,42,32,304,303,99,244,190,0,,74
14:58:53,4140.467,Fox,607,74,20,12,5,27,10,4,611,591,579,506,230,198,42,32,304,303,99,244,190,0,,74
14:58:53,4141.391,Fox,607,71,20,12,5,24,10,4,611,591,579,506,230,198,39,32,304,303,99,247,190,0,,71
14:58:54,4143.19,Fox,607,70,18,14,5,23,10,4,611,593,579,506,230,198,38,32,304,303,99,248,190,0,,70
14:58:54,4143.791,Fox,607,70,18,12,7,23,10,4,611,593,581,506,230,198,38,32,304,303,99,248,190,0,,70
14:58:56,4147.062,Fox,609,71,20,12,6,23,10,4,613,593,581,506,230,198,38,33,305,304,99,249,190,0,,71
14:58:56,4148.557,Fox,609,70,20,12,6,22,10,4,613,593,581,506,230,198,37,33,305,304,99,250,190,0,,70
14:58:57,4149.457,Fox,611,71,20,14,5,22,10,4,615,595,581,506,230,198,37,34,306,305,99,251,190,0,,71
14:58:57,4150.657,Fox,611,69,20,14,5,21,10,3,615,595,581,506,230,198,35,34,306,305,100,251,191,0,,69
14:58:57,4151.45,Fox,611,69,20,14,5,19,12,3,615,595,581,506,232,198,35,34,306,305,100,251,191,0,,69
14:58:58,4152.95,Fox,611,69,20,12,7,19,12,3,615,595,583,506,232,198,35,34,306,305,100,251,191,0,,69
14:58:58,4154.15,Fox,611,69,20,10,9,19,12,3,615,595,585,506,232,198,35,34,306,305,100,251,191,0,,69
14:58:59,4156.85,Fox,611,69,16,14,9,19,12,3,615,599,585,506,232,198,35,34,306,305,100,251,191,0,,69
14:59:00,4158.65,Fox,613,71,18,14,9,19,12,3,617,599,585,506,232,198,36,35,307,306,100,251,191,0,,71
14:59:00,4159.25,Fox,613,71,18,14,9,17,14,3,617,599,585,506,234,198,36,35,307,306,100,251,191,0,,71
14:59:01,4160.15,Fox,613,71,18,12,11,17,14,3,617,599,587,506,234,198,36,35,307,306,100,251,191,0,,71
14:59:02,4164.05,Fox,613,71,16,12,13,17,13,4,617,601,589,506,234,199,36,35,307,306,100,251,191,0,,71
14:59:02,4164.542,Fox,615,72,18,12,13,17,13,3,619,601,589,506,234,199,37,35,308,307,100,251,192,0,,72
14:59:03,4165.871,Fox,615,72,16,14,13,17,13,3,619,603,589,506,234,199,37,35,308,307,100,251,192,0,,72
14:59:03,4166.86,Fox,615,72,16,12,15,16,14,3,619,603,591,506,235,199,37,35,308,307,100,251,192,0,,72
14:59:04,4169.26,Fox,615,72,14,14,15,16,14,3,619,605,591,506,235,199,37,35,308,307,100,251,192,0,,72
14:59:05,4171.66,Fox,615,72,14,14,13,18,14,3,619,605,591,508,235,199,37,35,308,307,100,251,192,0,,72
14:59:06,4173.46,Fox,617,74,16,14,13,18,14,3,621,605,591,508,235,199,37,37,308,309,100,251,192,0,,74
14:59:07,4177.1,Fox,617,74,16,14,13,16,16,3,621,605,591,508,237,199,37,37,308,309,100,251,192,0,,74
14:59:09,4181.6,Fox,617,74,16,12,15,16,16,3,621,605,593,508,237,199,37,37,308,309,100,251,192,0,,74
14:59:09,4182.5,Fox,619,75,18,12,14,16,16,3,623,605,593,508,237,199,38,37,310,309,100,252,192,0,,75
14:59:11,4186.323,Fox,621,77,20,12,14,16,16,3,625,605,593,508,237,199,38,39,310,311,100,252,192,0,,77
14:59:11,4187.522,Fox,621,77,20,10,16,16,16,3,625,605,595,508,237,199,38,39,310,311,100,252,192,0,,77
14:59:12,4189.022,Fox,621,77,20,10,15,17,16,3,625,605,595,509,237,199,38,39,310,311,100,252,192,0,,77
14:59:13,4192.623,Fox,621,77,20,10,15,15,18,3,625,605,595,509,239,199,38,39,310,311,100,252,192,0,,77
14:59:14,4195.104,Fox,621,77,20,6,19,15,18,3,625,605,599,509,239,199,38,39,310,311,100,252,192,0,,77
14:59:16,4199.613,Fox,621,77,18,8,19,15,18,3,625,607,599,509,239,199,38,39,310,311,100,252,192,0,,77
14:59:16,4200.45,Fox,623,78,20,8,18,15,18,3,627,607,599,509,239,199,38,40,311,312,100,253,192,0,,78
14:59:17,4201.649,Fox,623,78,18,10,17,16,18,3,627,609,599,510,239,199,38,40,311,312,100,253,192,0,,78
14:59:17,4202.55,Fox,623,77,18,8,19,16,18,2,627,609,601,510,239,199,37,40,311,312,100,253,193,0,,77
14:59:17,4203.45,Fox,625,78,20,8,18,16,18,2,629,609,601,510,239,199,38,40,313,312,100,254,193,0,,78
14:59:18,4204.649,Fox,627,80,20,8,19,17,18,2,631,611,603,511,239,199,39,41,314,313,100,254,193,0,,80
14:59:19,4207.649,Fox,627,78,20,6,21,15,17,3,631,611,605,511,239,200,38,40,314,313,101,255,193,0,,78
14:59:19,4208.25,Fox,629,80,22,6,21,15,17,3,633,611,605,511,239,200,39,41,315,314,101,255,193,0,,80
14:59:20,4209.75,Fox,629,80,22,6,21,14,18,3,633,611,605,511,240,200,39,41,315,314,101,255,193,0,,80
14:59:21,4211.55,Fox,629,80,22,6,21,13,19,3,633,611,605,511,241,200,39,41,315,314,101,255,193,0,,80
14:59:21,4213.649,Fox,629,80,22,6,19,15,19,3,633,611,605,513,241,200,39,41,315,314,101,255,193,0,,80
14:59:22,4214.85,Fox,629,80,22,6,17,15,21,3,633,611,605,515,243,200,39,41,315,314,101,255,193,0,,80
14:59:23,4217.22,Fox,629,80,22,6,17,14,22,3,633,611,605,515,244,200,39,41,315,314,101,255,193,0,,80
14:59:24,4220.793,Fox,629,80,22,6,15,16,22,3,633,611,605,517,244,200,39,41,315,314,101,255,193,0,,80
14:59:24,4221.312,Fox,629,80,22,6,15,15,23,3,633,611,605,517,245,200,39,41,315,314,101,255,193,0,,80
14:59:25,4223.505,Fox,629,80,22,6,15,15,21,5,633,611,605,517,245,202,39,41,315,314,101,255,193,0,,80
14:59:26,4224.705,Fox,631,81,24,6,13,16,21,5,635,611,605,518,245,202,38,43,315,316,101,256,193,0,,81
14:59:26,4225.905,Fox,633,83,26,6,13,16,21,5,637,611,605,518,245,202,40,43,317,316,101,256,193,0,,83
14:59:27,4227.405,Fox,633,83,26,6,11,18,21,5,637,611,605,520,245,202,40,43,317,316,101,256,193,0,,83
14:59:27,4228.305,Fox,633,83,26,6,11,18,19,7,637,611,605,520,245,204,40,43,317,316,101,256,193,0,,83
14:59:27,4230.045,Fox,633,83,24,8,11,14,23,7,637,613,605,520,249,204,40,43,317,316,101,256,193,0,,83
14:59:28,4231.957,Fox,633,83,22,10,11,14,23,7,637,615,605,520,249,204,40,43,317,316,101,256,193,0,,83
14:59:29,4234.456,Fox,635,84,24,10,11,14,23,6,639,615,605,520,249,204,41,43,319,316,101,256,194,0,,84
14:59:30,4236.849,Fox,637,86,26,10,11,14,23,6,641,615,605,520,249,204,41,45,319,318,101,256,194,0,,86
14:59:30,4238.049,Fox,637,85,26,8,13,14,23,5,641,615,607,520,249,204,41,44,319,318,101,256,195,0,,85
14:59:31,4239.249,Fox,637,85,26,8,13,14,21,7,641,615,607,520,249,206,41,44,319,318,101,256,195,0,,85
14:59:31,4240.054,Fox,637,85,26,6,15,14,21,7,641,615,609,520,249,206,41,44,319,318,101,256,195,0,,85
14:59:31,4240.894,Fox,639,86,28,6,14,14,21,7,643,615,609,520,249,206,41,45,320,319,102,256,195,0,,86
14:59:32,4241.193,Fox,639,86,26,8,14,14,21,7,643,617,609,520,249,206,41,45,320,319,102,256,195,0,,86
14:59:32,4242.093,Fox,639,85,26,8,12,16,21,6,643,617,609,522,249,206,41,44,320,319,102,256,196,0,,85
14:59:32,4242.994,Fox,639,85,26,6,14,16,21,6,643,617,611,522,249,206,41,44,320,319,102,256,196,0,,85
14:59:33,4246.311,Fox,639,84,26,6,14,15,21,6,643,617,611,522,249,206,41,43,320,319,102,257,196,0,,84
14:59:34,4247.51,Fox,641,84,24,8,13,14,21,6,643,619,611,522,249,206,41,43,321,320,102,259,196,0,,84
14:59:34,4248.11,Fox,641,84,26,8,12,15,21,6,645,619,611,523,249,206,41,43,321,320,102,259,196,0,,84
14:59:35,4251.002,Fox,643,84,26,8,11,14,21,6,645,619,611,523,249,206,41,43,322,321,104,259,196,0,,84
14:59:35,4251.302,Fox,643,84,28,8,11,14,21,6,647,619,611,523,249,206,41,43,322,321,104,259,196,0,,84
14:59:35,4251.902,Fox,643,84,28,8,11,14,20,7,647,619,611,523,249,207,41,43,322,321,104,259,196,0,,84
14:59:36,4253.702,Fox,647,86,30,8,9,14,20,7,649,619,611,523,249,207,41,45,324,323,104,261,196,0,,86
14:59:36,4254.002,Fox,647,86,32,8,9,14,20,7,651,619,611,523,249,207,41,45,324,323,104,261,196,0,,86
14:59:37,4256.103,Fox,647,85,30,10,8,14,20,7,651,621,611,524,249,207,41,44,324,323,105,261,196,0,,85
14:59:40,4263.061,Fox,647,85,30,10,6,16,20,7,651,621,611,526,249,207,41,44,324,323,105,261,196,0,,85
14:59:40,4263.961,Fox,647,84,30,10,6,16,20,6,651,621,611,526,249,207,41,43,324,323,105,261,197,0,,84
14:59:40,4265.093,Fox,647,84,28,12,5,17,20,6,651,623,611,527,249,207,41,43,324,323,105,261,197,0,,84
14:59:41,4268.394,Fox,647,84,28,10,6,18,20,6,651,623,613,528,249,207,41,43,324,323,105,261,197,0,,84
14:59:42,4268.866,Fox,647,83,26,12,6,18,20,5,651,625,613,528,249,207,40,43,324,323,105,261,198,0,,83
14:59:42,4269.679,Fox,647,82,26,12,6,18,20,4,651,625,613,528,249,207,39,43,324,323,105,261,199,0,,82
14:59:42,4270.427,Fox,647,82,26,10,8,18,20,4,651,625,615,528,249,207,39,43,324,323,105,261,199,0,,82
14:59:44,4274.327,Fox,649,83,28,10,8,17,19,5,653,625,615,528,249,208,38,45,324,325,106,261,199,0,,83
14:59:44,4274.627,Fox,649,82,28,10,8,16,19,5,653,625,615,528,249,208,37,45,324,325,106,262,199,0,,82
14:59:46,4279.972,Fox,651,84,28,8,10,16,19,5,653,625,617,528,249,208,38,46,325,326,106,262,199,0,,84
14:59:46,4280.245,Fox,651,84,30,8,10,16,19,5,655,625,617,528,249,208,38,46,325,326,106,262,199,0,,84
14:59:46,4281.048,Fox,653,86,32,8,10,16,19,5,657,625,617,528,249,208,38,48,325,328,106,262,199,0,,86
14:59:46,4281.247,Fox,653,85,32,8,10,15,19,5,657,625,617,528,249,208,38,47,325,328,106,263,199,0,,85
14:59:47,4282.23,Fox,653,85,32,8,10,14,20,5,657,625,617,528,250,208,38,47,325,328,106,263,199,0,,85
14:59:47,4282.936,Fox,653,85,30,10,10,14,20,5,657,627,617,528,250,208,38,47,325,328,106,263,199,0,,85
14:59:47,4284.278,Fox,653,84,30,10,10,14,20,4,657,627,617,528,250,208,37,47,325,328,106,263,200,0,,84
14:59:48,4285.94,Fox,653,84,28,10,12,14,20,4,657,629,619,528,250,208,37,47,325,328,106,263,200,0,,84
14:59:48,4287.163,Fox,653,84,26,12,12,14,20,4,657,631,619,528,250,208,37,47,325,328,106,263,200,0,,84
14:59:49,4289.263,Fox,653,83,26,12,12,13,18,6,657,631,619,528,250,210,37,46,325,328,106,264,200,0,,83
14:59:50,4290.763,Fox,653,83,24,14,12,13,18,6,657,633,619,528,250,210,37,46,325,328,106,264,200,0,,83
14:59:50,4291.66,Fox,655,84,26,14,11,13,18,6,659,633,619,528,250,210,38,46,327,328,106,265,200,0,,84
14:59:51,4294.863,Fox,655,84,26,12,13,12,19,6,659,633,621,528,251,210,38,46,327,328,106,265,200,0,,84
14:59:52,4295.163,Fox,655,83,26,12,13,11,19,6,659,633,621,528,251,210,38,45,327,328,107,265,200,0,,83
14:59:52,4297.263,Fox,657,84,26,12,13,10,17,8,659,633,621,528,251,212,38,46,327,330,108,265,200,0,,84
14:59:53,4297.863,Fox,657,84,28,12,13,9,18,8,661,633,621,528,252,212,38,46,327,330,108,265,200,0,,84
14:59:53,4298.463,Fox,657,83,28,12,12,9,18,8,661,633,621,529,252,212,38,45,327,330,109,265,200,0,,83
14:59:54,4299.963,Fox,657,82,28,12,12,9,18,7,661,633,621,529,252,212,37,45,327,330,109,265,201,0,,82
14:59:54,4300.563,Fox,657,82,28,12,10,11,18,7,661,633,621,531,252,212,37,45,327,330,109,265,201,0,,82
14:59:55,4303.563,Fox,657,82,28,10,10,13,18,7,661,633,623,533,252,212,37,45,327,330,109,265,201,0,,82
14:59:55,4304.163,Fox,657,82,28,10,10,13,17,8,661,633,623,533,252,213,37,45,327,330,109,265,201,0,,82
14:59:56,4307.196,Fox,657,81,26,12,10,12,18,7,661,635,623,533,253,213,37,44,327,330,109,265,202,0,,81
14:59:56,4307.795,Fox,657,81,27,10,12,12,18,7,662,635,625,533,253,213,37,44,327,330,109,265,202,0,,81
14:59:57,4308.628,Fox,659,83,27,12,12,11,19,7,664,637,625,533,254,213,38,45,328,331,109,265,202,0,,83
14:59:57,4309.257,Fox,659,82,27,12,12,11,19,6,664,637,625,533,254,213,37,45,328,331,109,265,203,0,,82
14:59:59,4314.356,Fox,659,82,27,12,12,10,18,8,664,637,625,533,255,215,37,45,328,331,109,265,203,0,,82
15:00:00,4316.457,Fox,661,84,29,12,12,10,18,8,666,637,625,533,255,215,38,46,329,332,109,265,203,0,,84
15:00:00,4317.057,Fox,661,84,27,14,12,10,18,8,666,639,625,533,255,215,38,46,329,332,109,265,203,0,,84
15:00:01,4319.423,Fox,661,83,25,16,12,10,18,7,666,641,625,533,255,215,37,46,329,332,109,265,204,0,,83
15:00:01,4320.923,Fox,661,83,25,16,12,8,20,7,666,641,625,533,257,215,37,46,329,332,109,265,204,0,,83
15:00:02,4321.523,Fox,661,83,25,14,14,8,20,7,666,641,627,533,257,215,37,46,329,332,109,265,204,0,,83
15:00:02,4322.724,Fox,661,82,25,14,14,8,20,6,666,641,627,533,257,215,37,45,329,332,109,265,205,0,,82
15:00:02,4323.624,Fox,661,82,23,16,14,8,20,6,666,643,627,533,257,215,37,45,329,332,109,265,205,0,,82
15:00:03,4324.523,Fox,661,81,23,14,16,8,20,5,666,643,629,533,257,215,36,45,329,332,109,265,206,0,,81
15:00:03,4326.023,Fox,663,82,25,12,17,8,20,5,668,643,631,533,257,215,35,47,329,334,110,265,206,0,,82
15:00:04,4327.523,Fox,665,83,27,12,17,7,20,5,670,643,631,533,257,215,34,49,329,336,110,266,206,0,,83
15:00:04,4328.581,Fox,665,83,27,12,15,9,20,5,670,643,631,535,257,215,34,49,329,336,110,266,206,0,,83
15:00:05,4329.481,Fox,665,83,27,10,17,9,20,5,670,643,633,535,257,215,34,49,329,336,110,266,206,0,,83
15:00:05,4330.381,Fox,665,83,25,12,17,9,18,7,670,645,633,535,257,217,34,49,329,336,110,266,206,0,,83
15:00:05,4330.981,Fox,665,83,25,12,16,10,18,7,670,645,633,536,257,217,34,49,329,336,110,266,206,0,,95
15:00:05,4331.881,Fox,665,82,25,12,16,9,18,7,670,645,633,536,257,217,34,48,329,336,110,267,206,0,,94
15:00:06,4333.979,Fox,665,81,23,14,16,8,18,7,670,647,633,536,257,217,34,47,329,336,110,268,206,0,,93
15:00:07,4335.479,Fox,665,81,23,14,16,7,19,7,670,647,633,536,258,217,34,47,329,336,110,268,206,0,,93
15:00:07,4336.679,Fox,665,81,19,18,16,7,19,7,670,651,633,536,258,217,34,47,329,336,110,268,206,0,,93
15:00:09,4340.345,Fox,665,81,19,18,14,9,19,7,670,651,633,538,258,217,34,47,329,336,110,268,206,0,,93
15:00:10,4343.945,Fox,667,83,21,18,14,9,19,7,672,651,633,538,258,217,34,49,329,338,110,268,206,0,,95
15:00:11,4344.845,Fox,667,82,21,18,14,9,19,6,672,651,633,538,258,217,34,48,329,338,110,268,207,0,,94
15:00:11,4345.746,Fox,667,82,21,16,16,9,19,6,672,651,635,538,258,217,34,48,329,338,110,268,207,0,,94
15:00:11,4346.345,Fox,667,82,21,16,14,11,19,6,672,651,635,540,258,217,34,48,329,338,110,268,207,0,,94
15:00:11,4347.125,Fox,667,82,21,14,16,11,18,7,672,651,637,540,258,218,34,48,329,338,110,268,207,0,,94
15:00:12,4347.725,Fox,671,86,25,14,16,11,18,7,676,651,637,540,258,218,38,48,333,338,110,268,207,0,,98
15:00:12,4349.441,Fox,673,88,25,14,16,11,17,8,676,651,637,540,258,219,38,50,333,340,110,268,207,0,,100
15:00:12,4349.716,Fox,673,88,27,14,16,11,17,8,678,651,637,540,258,219,38,50,333,340,110,268,207,0,,100
15:00:13,4352.068,Fox,673,88,27,14,16,11,15,10,678,651,637,540,258,221,38,50,333,340,110,268,207,0,,100
15:00:14,4355.029,Fox,673,88,27,14,14,13,14,11,678,651,637,542,258,222,38,50,333,340,110,268,207,0,,100
15:00:15,4355.629,Fox,673,88,27,12,16,13,14,11,678,651,639,542,258,222,38,50,333,340,110,268,207,0,,100
15:00:15,4356.829,Fox,673,88,25,14,16,13,14,11,678,653,639,542,258,222,38,50,333,340,110,268,207,0,,100
15:00:15,4358.029,Fox,677,91,29,12,18,13,14,10,682,653,641,542,258,222,38,53,334,343,110,268,208,0,,103
15:00:16,4358.929,Fox,677,91,29,12,18,13,13,11,682,653,641,542,258,223,38,53,334,343,110,268,208,0,,103
15:00:16,4360.088,Fox,677,90,29,12,18,13,13,10,682,653,641,542,258,223,38,52,334,343,110,268,209,0,,102
15:00:16,4360.688,Fox,677,89,29,12,18,13,13,9,682,653,641,542,258,223,38,51,334,343,110,268,210,0,,101
15:00:17,4361.767,Fox,677,89,29,10,20,13,13,9,682,653,643,542,258,223,38,51,334,343,110,268,210,0,,101
15:00:17,4362.639,Fox,677,89,27,12,20,13,13,9,682,655,643,542,258,223,38,51,334,343,110,268,210,0,,101
15:00:18,4364.131,Fox,677,89,25,14,18,15,13,9,682,657,643,544,258,223,38,51,334,343,110,268,210,0,,101
15:00:18,4364.731,Fox,679,91,27,14,18,15,13,9,684,657,643,544,258,223,38,53,334,345,110,268,210,0,,103
15:00:18,4366.82,Fox,679,90,27,14,18,14,13,9,684,657,643,544,258,223,37,53,334,345,110,269,210,0,,102
15:00:19,4367.721,Fox,679,90,27,14,18,14,9,13,684,657,643,544,258,227,37,53,334,345,110,269,210,0,,102
15:00:19,4368.021,Fox,679,90,27,14,16,16,9,13,684,657,643,546,258,227,37,53,334,345,110,269,210,0,,102
15:00:19,4368.92,Fox,679,89,27,12,18,15,9,13,684,657,645,546,258,227,37,52,334,345,110,270,210,0,,101
15:00:20,4370.795,Fox,679,88,27,12,18,15,9,12,684,657,645,546,258,227,36,52,334,345,110,270,211,0,,100
15:00:20,4371.87,Fox,681,90,29,12,18,15,9,12,686,657,645,546,258,227,36,54,334,347,110,270,211,0,,102
15:00:21,4372.47,Fox,681,90,29,10,20,15,9,12,686,657,647,546,258,227,36,54,334,347,110,270,211,0,,102
15:00:21,4374.57,Fox,683,91,29,12,19,15,9,12,688,659,647,546,258,227,36,55,335,348,110,271,211,0,,103
15:00:22,4375.17,Fox,683,90,29,8,23,15,9,11,688,659,651,546,258,227,35,55,335,348,110,271,212,0,,102
15:00:22,4375.771,Fox,683,89,29,8,23,15,9,10,688,659,651,546,258,227,35,54,335,348,110,271,213,0,,101
15:00:23,4379.07,Fox,685,91,31,8,23,15,9,10,690,659,651,546,258,227,37,54,337,348,110,271,213,0,,103
15:00:24,4380.271,Fox,685,91,29,10,23,15,9,10,690,661,651,546,258,227,37,54,337,348,110,271,213,0,,103
15:00:24,4381.771,Fox,687,92,31,10,23,14,9,10,692,661,651,546,258,227,37,55,338,349,110,272,213,0,,104
15:00:24,4382.07,Fox,687,92,31,10,21,16,9,10,692,661,651,548,258,227,37,55,338,349,110,272,213,0,,104
15:00:25,4385.011,Fox,687,92,31,10,19,18,9,10,692,661,651,550,258,227,37,55,338,349,110,272,213,0,,104
15:00:26,4386.211,Fox,687,92,31,10,18,19,9,10,692,661,651,551,258,227,37,55,338,349,110,272,213,0,,104
15:00:27,4387.711,Fox,687,91,31,10,18,19,9,9,692,661,651,551,258,227,36,55,338,349,110,272,214,0,,103
15:00:27,4389.786,Fox,687,90,31,10,16,21,9,8,692,661,651,553,258,227,36,54,338,349,110,272,215,0,,102
15:00:28,4390.386,Fox,687,90,30,11,16,21,9,8,692,662,651,553,258,227,36,54,338,349,110,272,215,0,,102
15:00:28,4391.28,Fox,687,90,28,13,16,21,9,8,692,664,651,553,258,227,36,54,338,349,110,272,215,0,,102
15:00:29,4395.461,Fox,687,90,28,11,18,21,9,8,692,664,653,553,258,227,36,54,338,349,110,272,215,0,,102
15:00:30,4396.961,Fox,687,90,28,11,18,19,11,8,692,664,653,553,260,227,36,54,338,349,110,272,215,0,,102
15:00:31,4399.062,Fox,687,90,26,13,18,19,11,8,692,666,653,553,260,227,36,54,338,349,110,272,215,0,,102
15:00:32,4401.461,Fox,687,90,26,11,20,19,11,8,692,666,655,553,260,227,36,54,338,349,110,272,215,0,,102
15:00:32,4402.623,Fox,687,89,26,9,22,19,11,7,692,666,657,553,260,227,36,53,338,349,110,272,216,0,,101
15:00:34,4406.432,Fox,687,89,26,9,20,21,11,7,692,666,657,555,260,227,36,53,338,349,110,272,216,0,,101
15:00:34,4407.932,Fox,687,88,26,9,18,23,11,6,692,666,657,557,260,227,35,53,338,349,110,272,217,0,,100
15:00:34,4408.368,Fox,687,88,24,11,18,23,11,6,692,668,657,557,260,227,35,53,338,349,110,272,217,0,,100
15:00:35,4410.598,Fox,687,87,22,13,18,22,11,6,692,670,657,557,260,227,35,52,338,349,111,272,217,0,,99
15:00:36,4411.198,Fox,689,88,24,13,17,22,11,6,694,670,657,557,260,227,36,52,340,349,111,273,217,0,,100
15:00:36,4412.698,Fox,689,88,24,11,19,22,11,6,694,670,659,557,260,227,36,52,340,349,111,273,217,0,,100
15:00:37,4413.897,Fox,691,90,26,11,19,22,11,6,696,670,659,557,260,227,37,53,341,350,111,273,217,0,,102
15:00:38,4415.397,Fox,691,89,26,11,19,22,11,5,696,670,659,557,260,227,37,52,341,350,111,273,218,0,,101
15:00:38,4415.998,Fox,691,89,26,11,17,24,11,5,696,670,659,559,260,227,37,52,341,350,111,273,218,0,,101
15:00:39,4418.698,Fox,691,87,26,9,17,26,11,3,696,670,661,561,260,227,37,50,341,350,111,273,220,0,,99
15:00:40,4419.897,Fox,691,87,26,9,17,26,10,4,696,670,661,561,260,228,37,50,341,350,111,273,220,0,,99
15:00:41,4421.899,Fox,693,88,28,9,17,25,10,4,698,670,661,561,260,228,38,50,343,350,111,274,220,0,,100
15:00:41,4422.499,Fox,693,88,28,9,15,26,11,4,698,670,661,563,261,228,38,50,343,350,111,274,220,0,,100
15:00:42,4426.684,Fox,693,88,26,11,15,26,11,4,698,672,661,563,261,228,38,50,343,350,111,274,220,0,,100
15:00:43,4428.391,Fox,695,89,26,11,15,26,11,3,698,672,661,563,261,228,37,52,343,352,111,274,221,0,,101
15:00:43,4428.943,Fox,695,89,28,10,16,26,11,3,700,672,662,563,261,228,37,52,343,352,111,274,221,0,,101
15:00:44,4429.711,Fox,695,89,28,8,16,28,11,3,700,672,664,565,261,228,37,52,343,352,111,274,221,0,,101
15:00:44,4430.493,Fox,697,90,24,12,16,27,11,3,700,676,664,565,261,228,37,53,344,353,111,275,221,0,,102
15:00:44,4430.704,Fox,697,90,26,12,16,27,11,3,702,676,664,565,261,228,37,53,344,353,111,275,221,0,,102
15:00:44,4431.242,Fox,697,88,26,12,16,25,11,3,702,676,664,565,261,228,35,53,344,353,112,276,221,0,,100
15:00:44,4432.322,Fox,697,88,24,14,16,25,10,4,702,678,664,565,261,229,35,53,344,353,112,276,221,0,,100
15:00:45,4432.922,Fox,697,88,24,14,14,27,10,4,702,678,664,567,261,229,35,53,344,353,112,276,221,0,,100
15:00:45,4433.822,Fox,697,88,24,14,14,25,12,4,702,678,664,567,263,229,35,53,344,353,112,276,221,0,,100
15:00:46,4435.622,Fox,697,88,24,14,11,28,11,5,702,678,664,570,263,230,35,53,344,353,112,276,221,0,,100
15:00:47,4437.606,Fox,697,88,24,12,13,28,11,5,702,678,666,570,263,230,35,53,344,353,112,276,221,0,,100
15:00:48,4440.006,Fox,697,87,24,12,13,26,12,5,702,678,666,570,264,230,35,52,344,353,112,277,221,0,,99
15:00:48,4440.606,Fox,697,87,20,16,13,26,12,5,702,682,666,570,264,230,35,52,344,353,112,277,221,0,,99
15:00:49,4443.002,Fox,697,86,20,16,13,26,12,4,702,682,666,570,264,230,35,51,344,353,112,277,222,0,,98
15:00:49,4444.348,Fox,697,86,20,16,13,26,11,5,702,682,666,570,264,231,35,51,344,353,112,277,222,0,,98
15:00:50,4445.884,Fox,697,86,20,16,13,26,10,6,702,682,666,570,264,232,35,51,344,353,112,277,222,0,,98
15:00:51,4447.375,Fox,697,86,18,16,15,26,10,6,702,684,668,570,264,232,35,51,344,353,112,277,222,0,,98
15:00:51,4448.539,Fox,697,86,18,14,17,24,12,6,702,684,670,570,266,232,35,51,344,353,112,277,222,0,,98
15:00:52,4450.901,Fox,699,87,20,14,17,24,12,5,704,684,670,570,266,232,35,52,345,354,112,277,223,0,,99
15:00:52,4451.801,Fox,699,87,20,14,17,24,11,6,704,684,670,570,266,233,35,52,345,354,112,277,223,0,,99
15:00:53,4453,Fox,699,86,20,14,17,23,11,6,704,684,670,570,266,233,35,51,345,354,112,278,223,0,,98
15:00:53,4453.901,Fox,699,85,20,14,17,22,11,6,704,684,670,570,266,233,34,51,345,354,112,279,223,0,,97
15:00:53,4454.5,Fox,699,85,18,16,17,22,11,6,704,686,670,570,266,233,34,51,345,354,112,279,223,0,,97
15:00:54,4456,Fox,699,85,18,16,15,24,11,6,704,686,670,572,266,233,34,51,345,354,112,279,223,0,,97
15:00:55,4457.5,Fox,701,87,16,18,15,22,13,6,704,688,670,572,268,233,34,53,345,356,112,279,223,0,,99
15:00:55,4457.801,Fox,701,87,18,18,15,22,13,6,706,688,670,572,268,233,34,53,345,356,112,279,223,0,,99
15:00:55,4458.401,Fox,701,87,18,18,15,22,11,8,706,688,670,572,268,235,34,53,345,356,112,279,223,0,,99
15:00:55,4459.895,Fox,701,86,18,18,15,21,11,8,706,688,670,572,268,235,33,53,345,356,112,280,223,0,,98
15:00:56,4461.672,Fox,701,86,16,20,15,20,12,8,706,690,670,572,269,235,33,53,345,356,112,280,223,0,,98
15:00:56,4461.87,Fox,701,86,16,20,13,22,12,8,706,690,670,574,269,235,33,53,345,356,112,280,223,0,,98
15:00:57,4462.612,Fox,701,86,16,20,11,24,12,8,706,690,670,576,269,235,33,53,345,356,112,280,223,0,,98
15:00:57,4464.529,Fox,701,86,14,22,11,24,12,8,706,692,670,576,269,235,33,53,345,356,112,280,223,0,,98
15:00:58,4465.128,Fox,701,86,14,20,13,24,12,8,706,692,672,576,269,235,33,53,345,356,112,280,223,0,,98
15:00:58,4465.729,Fox,701,85,14,20,13,24,12,7,706,692,672,576,269,235,33,52,345,356,112,280,224,0,,97
15:00:59,4468.884,Fox,701,85,14,16,17,24,12,7,706,692,676,576,269,235,33,52,345,356,112,280,224,0,,97
15:01:00,4470.933,Fox,701,85,14,14,19,24,12,7,706,692,678,576,269,235,33,52,345,356,112,280,224,0,,97
15:01:01,4473.333,Fox,701,85,14,14,17,26,11,8,706,692,678,578,269,236,33,52,345,356,112,280,224,0,,97
15:01:01,4473.933,Fox,701,83,14,14,17,24,11,8,706,692,678,578,269,236,32,51,345,356,112,282,224,0,,95
15:01:02,4475.733,Fox,701,83,14,14,17,22,13,8,706,692,678,578,271,236,32,51,345,356,112,282,224,0,,95
15:01:02,4476.633,Fox,703,85,16,14,17,22,13,8,708,692,678,578,271,236,33,52,346,357,112,282,224,0,,97
15:01:03,4479.333,Fox,705,87,18,10,19,24,13,8,710,692,682,580,271,236,34,53,347,358,112,282,224,0,,99
15:01:03,4479.932,Fox,705,87,18,10,19,23,14,8,710,692,682,580,272,236,34,53,347,358,112,282,224,0,,99
15:01:04,4482.333,Fox,707,88,20,10,19,22,14,8,712,692,682,580,272,236,34,54,348,359,112,283,224,0,,100
15:01:06,4485.902,Fox,707,88,20,8,21,22,14,8,712,692,684,580,272,236,34,54,348,359,112,283,224,0,,100
15:01:07,4489.36,Fox,707,88,20,8,20,23,14,8,712,692,684,581,272,236,34,54,348,359,112,283,224,0,,100
15:01:08,4490.26,Fox,707,88,20,8,18,25,14,8,712,692,684,583,272,236,34,54,348,359,112,283,224,0,,100
15:01:09,4493.26,Fox,707,87,20,6,20,25,14,7,712,692,686,583,272,236,34,53,348,359,112,283,225,0,,99
15:01:09,4493.86,Fox,707,87,18,8,20,25,14,7,712,694,686,583,272,236,34,53,348,359,112,283,225,0,,99
15:01:10,4495.66,Fox,707,87,18,6,22,25,14,7,712,694,688,583,272,236,34,53,348,359,112,283,225,0,,99
15:01:11,4496.56,Fox,707,87,16,8,22,25,14,7,712,696,688,583,272,236,34,53,348,359,112,283,225,0,,99
15:01:11,4498.06,Fox,707,87,16,8,20,27,14,7,712,696,688,585,272,236,34,53,348,359,112,283,225,0,,99
15:01:12,4500.16,Fox,707,87,16,6,22,26,15,7,712,696,690,585,273,236,34,53,348,359,112,283,225,0,,99
15:01:12,4501.06,Fox,707,86,16,6,22,25,15,7,712,696,690,585,273,236,34,52,348,359,112,284,225,0,,98
15:01:13,4502.82,Fox,707,86,16,4,24,25,15,7,712,696,692,585,273,236,34,52,348,359,112,284,225,0,,98
15:01:14,4504.92,Fox,707,85,14,6,24,25,15,6,712,698,692,585,273,236,34,51,348,359,112,284,226,0,,97
15:01:14,4505.82,Fox,709,87,16,6,24,25,15,6,714,698,692,585,273,236,34,53,348,361,112,284,226,0,,99
15:01:15,4507.02,Fox,709,86,16,6,24,24,15,6,714,698,692,585,273,236,33,53,348,361,112,285,226,0,,98
15:01:15,4507.62,Fox,709,86,16,6,22,26,15,6,714,698,692,587,273,236,33,53,348,361,112,285,226,0,,98
15:01:16,4509.12,Fox,709,86,16,6,20,28,15,6,714,698,692,589,273,236,33,53,348,361,112,285,226,0,,98
15:01:16,4510.02,Fox,711,87,16,6,20,26,16,6,714,698,692,589,274,236,33,54,349,362,112,286,226,0,,99
15:01:16,4510.32,Fox,711,87,18,6,20,26,16,6,716,698,692,589,274,236,33,54,349,362,112,286,226,0,,99
15:01:16,4511.172,Fox,711,87,16,8,20,26,16,6,716,700,692,589,274,236,33,54,349,362,112,286,226,0,,99
15:01:17,4511.825,Fox,711,87,16,8,20,24,18,6,716,700,692,589,276,236,33,54,349,362,112,286,226,0,,99
15:01:17,4513.325,Fox,711,87,14,10,20,24,18,6,716,702,692,589,276,236,33,54,349,362,112,286,226,0,,99
15:01:18,4516.025,Fox,711,87,14,10,20,22,20,6,716,702,692,589,278,236,33,54,349,362,112,286,226,0,,99
15:01:19,4516.925,Fox,713,88,16,10,20,22,20,5,718,702,692,589,278,236,32,56,349,364,112,286,227,0,,100
15:01:20,4518.725,Fox,715,89,18,10,19,22,20,5,720,702,692,589,278,236,32,57,350,365,112,287,227,0,,101
15:01:20,4519.325,Fox,715,87,18,10,19,22,20,3,720,702,692,589,278,236,32,55,350,365,112,287,229,0,,99
15:01:21,4521.125,Fox,717,89,20,10,19,22,20,3,722,702,692,589,278,236,32,57,350,367,112,287,229,0,,101
15:01:21,4522.877,Fox,717,89,20,10,19,20,22,3,722,702,692,589,280,236,32,57,350,367,112,287,229,0,,101
15:01:22,4524.399,Fox,717,87,20,10,19,18,22,3,722,702,692,589,280,236,31,56,350,367,114,287,229,0,,99
15:01:22,4525.599,Fox,717,87,20,10,17,20,22,3,722,702,692,591,280,236,31,56,350,367,114,287,229,0,,99
15:01:23,4526.499,Fox,717,87,20,10,17,18,24,3,722,702,692,591,282,236,31,56,350,367,114,287,229,0,,99
15:01:24,4528.735,Fox,717,87,20,10,17,17,25,3,722,702,692,591,283,236,31,56,350,367,114,287,229,0,,99
15:01:24,4529.335,Fox,717,87,20,10,13,21,25,3,722,702,692,595,283,236,31,56,350,367,114,287,229,0,,99
15:01:25,4531.435,Fox,717,87,20,10,11,23,25,3,722,702,692,597,283,236,31,56,350,367,114,287,229,0,,99
15:01:25,4532.335,Fox,717,87,20,8,13,23,25,3,722,702,694,597,283,236,31,56,350,367,114,287,229,0,,99
15:01:25,4532.935,Fox,717,86,20,8,13,23,25,2,722,702,694,597,283,236,31,55,350,367,114,287,230,0,,98
15:01:26,4533.535,Fox,717,86,18,10,13,23,25,2,722,704,694,597,283,236,31,55,350,367,114,287,230,0,,98
15:01:26,4534.735,Fox,719,88,18,10,13,23,23,4,722,704,694,597,283,238,32,56,351,368,114,287,230,0,,100
15:01:26,4535.035,Fox,719,88,20,8,15,23,23,4,724,704,696,597,283,238,32,56,351,368,114,287,230,0,,100
15:01:27,4537.135,Fox,721,89,22,8,15,22,23,4,726,704,696,597,283,238,31,58,351,370,115,287,230,0,,101
15:01:28,4538.335,Fox,723,91,24,8,15,22,23,4,728,704,696,597,283,238,32,59,352,371,115,287,230,0,,103
15:01:28,4539.535,Fox,723,91,24,8,12,25,23,4,728,704,696,600,283,238,32,59,352,371,115,287,230,0,,103
15:01:28,4540.348,Fox,723,91,22,10,12,25,23,4,728,706,696,600,283,238,32,59,352,371,115,287,230,0,,103
15:01:29,4541.541,Fox,723,90,22,10,12,25,23,3,728,706,696,600,283,238,31,59,352,371,115,287,231,0,,102
15:01:30,4543.041,Fox,723,90,22,8,14,25,23,3,728,706,698,600,283,238,31,59,352,371,115,287,231,0,,102
15:01:31,4545.441,Fox,725,89,22,8,13,23,23,3,728,706,698,600,283,238,32,57,354,371,116,289,231,0,,101
15:01:31,4545.741,Fox,725,89,24,8,13,23,23,3,730,706,698,600,283,238,32,57,354,371,116,289,231,0,,101
15:01:31,4546.641,Fox,727,91,24,8,11,25,23,3,730,706,698,602,283,238,34,57,356,371,116,289,231,0,,103
15:01:31,4546.941,Fox,727,91,26,8,11,25,23,3,732,706,698,602,283,238,34,57,356,371,116,289,231,0,,103
15:01:32,4549.341,Fox,727,90,26,8,11,22,25,3,732,706,698,602,285,238,34,56,356,371,116,290,231,0,,102
15:01:33,4549.941,Fox,727,90,26,6,13,22,25,3,732,706,700,602,285,238,34,56,356,371,116,290,231,0,,102
15:01:33,4552.041,Fox,727,90,26,4,15,22,25,3,732,706,702,602,285,238,34,56,356,371,116,290,231,0,,102
15:01:34,4553.841,Fox,731,94,30,4,13,24,25,3,736,706,702,604,285,238,37,57,359,372,116,290,231,0,,106
15:01:35,4555.175,Fox,733,96,32,4,13,24,25,3,738,706,702,604,285,238,39,57,361,372,116,290,231,0,,108
15:01:35,4556.375,Fox,735,97,32,4,11,23,27,3,738,706,702,605,287,238,38,59,361,374,116,291,231,0,,109
15:01:35,4556.675,Fox,735,97,34,4,11,23,27,3,740,706,702,605,287,238,38,59,361,374,116,291,231,0,,109
15:01:36,4559.209,Fox,735,97,32,6,11,23,27,3,740,708,702,605,287,238,38,59,361,374,116,291,231,0,,109
15:01:36,4559.655,Fox,735,97,32,6,11,23,26,4,740,708,702,605,287,239,38,59,361,374,116,291,231,0,,109
15:01:37,4560.608,Fox,735,97,32,6,10,24,26,4,740,708,702,606,287,239,38,59,361,374,116,291,231,0,,109
15:01:37,4562.092,Fox,735,97,30,8,10,24,26,4,740,710,702,606,287,239,38,59,361,374,116,291,231,0,,109
15:01:38,4563.292,Fox,735,97,30,8,8,26,26,4,740,710,702,608,287,239,38,59,361,374,116,291,231,0,,109
15:01:38,4564.192,Fox,735,96,30,8,8,26,26,3,740,710,702,608,287,239,37,59,361,374,116,291,232,0,,108
15:01:39,4565.092,Fox,735,96,28,10,8,26,26,3,740,712,702,608,287,239,37,59,361,374,116,291,232,0,,108
15:01:39,4566.854,Fox,735,91,28,10,8,20,27,3,740,712,702,608,288,239,34,57,361,374,119,293,232,0,,103
15:01:40,4569.918,Fox,737,92,30,10,7,20,27,3,742,712,702,608,288,239,33,59,361,376,119,294,232,0,,104
15:01:41,4571.154,Fox,737,92,30,10,7,20,25,5,742,712,702,608,288,241,33,59,361,376,119,294,232,0,,104
15:01:41,4571.998,Fox,737,92,30,8,9,20,25,5,742,712,704,608,288,241,33,59,361,376,119,294,232,0,,104
15:01:41,4572.769,Fox,737,92,30,8,9,18,27,5,742,712,704,608,290,241,33,59,361,376,119,294,232,0,,104
15:01:42,4574.098,Fox,737,91,30,8,9,17,27,5,742,712,704,608,290,241,33,58,361,376,119,295,232,0,,103
15:01:43,4577.098,Fox,737,91,30,8,9,17,26,6,742,712,704,608,290,242,33,58,361,376,119,295,232,0,,103
15:01:44,4578.898,Fox,737,91,30,6,11,17,26,6,742,712,706,608,290,242,33,58,361,376,119,295,232,0,,103
15:01:46,4582.798,Fox,737,91,30,6,11,16,27,6,742,712,706,608,291,242,33,58,361,376,119,295,232,0,,103
15:01:46,4584.898,Fox,739,92,32,6,10,16,27,6,744,712,706,608,291,242,33,59,362,377,119,296,232,0,,104
15:01:47,4585.18,Fox,739,89,32,6,10,14,27,5,744,712,706,608,291,242,33,56,362,377,120,297,233,0,,101
15:01:47,4585.971,Fox,739,89,32,6,10,14,25,7,744,712,706,608,291,244,33,56,362,377,120,297,233,0,,101
15:01:48,4588.371,Fox,739,88,30,8,10,13,25,7,744,714,706,608,291,244,33,55,362,377,121,297,233,0,,100
15:01:48,4588.971,Fox,743,90,34,8,8,13,25,7,748,714,706,608,291,244,34,56,365,378,121,299,233,0,,102
15:01:49,4590.171,Fox,745,92,36,8,8,13,25,7,750,714,706,608,291,244,35,57,366,379,121,299,233,0,,104
15:01:49,4590.771,Fox,747,94,38,8,8,13,25,7,752,714,706,608,291,244,37,57,368,379,121,299,233,0,,106
15:01:49,4591.671,Fox,747,94,38,8,8,12,26,7,752,714,706,608,292,244,37,57,368,379,121,299,233,0,,106
15:01:50,4592.871,Fox,747,94,36,10,8,12,26,7,752,716,706,608,292,244,37,57,368,379,121,299,233,0,,106
15:01:51,4595.271,Fox,747,93,36,10,8,11,24,9,752,716,706,608,292,246,36,57,368,379,122,299,233,0,,105
15:01:51,4595.571,Fox,747,93,36,10,7,12,24,9,752,716,706,609,292,246,36,57,368,379,122,299,233,0,,105
15:01:52,4597.671,Fox,747,93,36,8,9,12,24,9,752,716,708,609,292,246,36,57,368,379,122,299,233,0,,105
15:01:52,4598.871,Fox,747,93,36,8,9,12,23,10,752,716,708,609,292,247,36,57,368,379,122,299,233,0,,105
15:01:53,4599.471,Fox,747,93,34,10,9,12,23,10,752,718,708,609,292,247,36,57,368,379,122,299,233,0,,105
15:01:53,4600.371,Fox,747,93,34,8,11,12,23,10,752,718,710,609,292,247,36,57,368,379,122,299,233,0,,105
15:01:54,4601.571,Fox,747,92,32,10,11,12,23,9,752,720,710,609,292,247,36,56,368,379,122,299,234,0,,104
15:01:54,4602.771,Fox,747,92,32,10,11,11,24,9,752,720,710,609,293,247,36,56,368,379,122,299,234,0,,104
15:01:55,4603.671,Fox,747,92,30,10,12,12,24,9,752,722,712,610,293,247,36,56,368,379,122,299,234,0,,104
15:01:55,4605.471,Fox,747,91,30,10,12,12,24,8,752,722,712,610,293,247,35,56,368,379,122,299,235,0,,103
15:01:57,4608.771,Fox,749,92,32,10,12,11,24,8,754,722,712,610,293,247,34,58,368,381,122,300,235,0,,104
15:01:58,4610.571,Fox,751,93,34,10,9,13,24,8,756,722,712,612,293,247,35,58,370,381,122,301,235,0,,105
15:01:58,4612.371,Fox,751,93,34,10,7,15,24,8,756,722,712,614,293,247,35,58,370,381,122,301,235,0,,105
15:01:59,4612.971,Fox,751,93,34,10,7,15,22,10,756,722,712,614,293,249,35,58,370,381,122,301,235,0,,105
15:02:00,4617.213,Fox,751,93,34,10,7,15,21,11,756,722,712,614,293,250,35,58,370,381,122,301,235,0,,105
15:02:01,4617.768,Fox,751,93,32,12,7,15,21,11,756,724,712,614,293,250,35,58,370,381,122,301,235,0,,105
15:02:01,4618.968,Fox,751,93,32,12,7,13,23,11,756,724,712,614,295,250,35,58,370,381,122,301,235,0,,105
15:02:02,4619.868,Fox,751,93,30,14,7,13,23,11,756,726,712,614,295,250,35,58,370,381,122,301,235,0,,105
15:02:02,4621.067,Fox,751,93,28,16,7,13,23,11,756,728,712,614,295,250,35,58,370,381,122,301,235,0,,105
15:02:04,4625.789,Fox,751,92,28,16,7,13,23,10,756,728,712,614,295,250,34,58,370,381,122,301,236,0,,104
15:02:05,4626.758,Fox,751,92,28,14,9,13,23,10,756,728,714,614,295,250,34,58,370,381,122,301,236,0,,104
15:02:05,4628.459,Fox,751,92,26,16,9,13,23,10,756,730,714,614,295,250,34,58,370,381,122,301,236,0,,104
15:02:06,4629.659,Fox,751,92,24,18,9,13,23,10,756,732,714,614,295,250,34,58,370,381,122,301,236,0,,104
15:02:07,4631.459,Fox,751,92,24,16,11,13,23,10,756,732,716,614,295,250,34,58,370,381,122,301,236,0,,104
15:02:07,4632.659,Fox,751,92,24,16,10,14,23,10,756,732,716,615,295,250,34,58,370,381,122,301,236,0,,104
15:02:07,4633.259,Fox,751,92,24,16,10,12,25,10,756,732,716,615,297,250,34,58,370,381,122,301,236,0,,104
15:02:09,4635.959,Fox,751,91,24,16,10,12,25,9,756,732,716,615,297,250,33,58,370,381,122,301,237,0,,103
15:02:09,4636.859,Fox,751,90,20,20,10,12,25,8,756,736,716,615,297,250,33,57,370,381,122,301,238,0,,102
15:02:09,4637.459,Fox,751,89,20,20,10,11,24,9,756,736,716,615,297,251,33,56,370,381,122,302,238,0,,101
15:02:10,4638.059,Fox,751,89,18,20,12,11,24,9,756,738,718,615,297,251,33,56,370,381,122,302,238,0,,101
15:02:10,4639.559,Fox,751,88,16,22,10,13,24,8,756,740,718,617,297,251,33,55,370,381,122,302,239,0,,100
15:02:10,4639.75,Fox,751,88,16,20,12,11,26,8,756,740,720,617,299,251,33,55,370,381,122,302,239,0,,100
15:02:11,4640.65,Fox,751,87,16,20,12,11,26,7,756,740,720,617,299,251,33,54,370,381,122,302,240,0,,99
15:02:11,4642.15,Fox,751,87,16,18,14,11,26,7,756,740,722,617,299,251,33,54,370,381,122,302,240,0,,99
15:02:13,4647.25,Fox,751,87,16,18,14,11,25,8,756,740,722,617,299,252,33,54,370,381,122,302,240,0,,99
15:02:14,4648.151,Fox,751,86,16,18,14,11,25,7,756,740,722,617,299,252,33,53,370,381,122,302,241,0,,98
15:02:14,4649.351,Fox,751,86,16,18,14,11,23,9,756,740,722,617,299,254,33,53,370,381,122,302,241,0,,98
15:02:16,4652.951,Fox,751,84,14,20,14,9,23,9,756,742,722,617,299,254,33,51,370,381,122,304,241,0,,96
15:02:16,4653.551,Fox,751,83,14,20,14,8,21,11,756,742,722,617,299,256,33,50,370,381,122,305,241,0,,95
15:02:17,4655.677,Fox,753,85,16,20,14,8,21,11,758,742,722,617,299,256,34,51,371,382,122,305,241,0,,97
15:02:17,4656.199,Fox,753,85,16,18,16,8,21,11,758,742,724,617,299,256,34,51,371,382,122,305,241,0,,97
15:02:17,4656.772,Fox,753,85,16,18,16,6,23,11,758,742,724,617,301,256,34,51,371,382,122,305,241,0,,97
15:02:18,4658.272,Fox,753,85,16,16,16,8,23,11,758,742,726,619,301,256,34,51,371,382,122,305,241,0,,97
15:02:18,4659.472,Fox,753,85,16,14,18,8,23,11,758,742,728,619,301,256,34,51,371,382,122,305,241,0,,97
15:02:19,4660.626,Fox,755,86,18,14,17,8,21,13,760,742,728,619,301,258,34,52,372,383,122,306,241,0,,98
15:02:19,4660.926,Fox,755,86,18,14,16,9,21,13,760,742,728,620,301,258,34,52,372,383,122,306,241,0,,98
15:02:20,4662.426,Fox,755,85,18,14,16,9,21,12,760,742,728,620,301,258,33,52,372,383,122,306,242,0,,97
15:02:20,4663.857,Fox,755,84,18,14,14,11,19,13,760,742,728,622,301,260,33,51,372,383,122,306,243,0,,96
15:02:22,4666.558,Fox,757,86,20,14,14,11,18,14,762,742,728,622,301,261,33,53,372,385,122,306,243,0,,98
15:02:22,4667.158,Fox,757,85,20,12,16,11,18,13,762,742,730,622,301,261,33,52,372,385,122,306,244,0,,97
15:02:22,4667.458,Fox,757,85,18,14,16,11,18,13,762,744,730,622,301,261,33,52,372,385,122,306,244,0,,97
15:02:22,4667.939,Fox,757,85,18,12,18,11,18,13,762,744,732,622,301,261,33,52,372,385,122,306,244,0,,97
15:02:24,4671.565,Fox,757,85,14,16,18,11,18,13,762,748,732,622,301,261,33,52,372,385,122,306,244,0,,97
15:02:24,4672.465,Fox,759,87,16,16,18,11,18,13,764,748,732,622,301,261,35,52,374,385,122,306,244,0,,99
15:02:24,4672.765,Fox,759,87,14,18,18,11,18,13,764,750,732,622,301,261,35,52,374,385,122,306,244,0,,99
15:02:24,4673.265,Fox,759,87,12,20,18,11,18,13,764,752,732,622,301,261,35,52,374,385,122,306,244,0,,99
15:02:25,4674.297,Fox,761,88,14,20,17,11,18,13,766,752,732,622,301,261,35,53,375,386,122,307,244,0,,100
15:02:25,4674.897,Fox,761,88,14,16,21,11,18,13,766,752,736,622,301,261,35,53,375,386,122,307,244,0,,100
15:02:25,4675.497,Fox,761,86,14,16,21,9,18,13,766,752,736,622,301,261,35,51,375,386,122,309,244,0,,98
15:02:26,4676.397,Fox,761,86,14,14,23,9,18,13,766,752,738,622,301,261,35,51,375,386,122,309,244,0,,98
15:02:26,4677.297,Fox,763,87,16,14,22,9,18,13,768,752,738,622,301,261,35,52,376,387,122,310,244,0,,99
15:02:26,4677.897,Fox,765,89,18,12,24,9,18,13,770,752,740,622,301,261,36,53,377,388,122,310,244,0,,101
15:02:28,4682.02,Fox,767,90,20,12,24,8,18,13,772,752,740,622,301,261,37,53,379,388,122,311,244,0,,102
15:02:29,4683.819,Fox,767,89,20,12,24,8,18,12,772,752,740,622,301,261,36,53,379,388,122,311,245,0,,101
15:02:30,4687.419,Fox,767,89,20,12,22,10,16,14,772,752,740,624,301,263,36,53,379,388,122,311,245,0,,101
15:02:31,4689.52,Fox,767,88,20,12,22,9,16,14,772,752,740,624,301,263,36,52,379,388,122,312,245,0,,100
15:02:31,4690.719,Fox,769,90,22,12,22,9,16,14,774,752,740,624,301,263,37,53,380,389,122,312,245,0,,102
15:02:32,4691.319,Fox,769,89,20,12,24,8,16,14,774,754,742,624,301,263,37,52,380,389,122,313,245,0,,101
15:02:32,4691.919,Fox,771,91,22,12,23,9,16,14,776,754,742,625,301,263,38,53,381,390,122,313,245,0,,103
15:02:32,4693.12,Fox,771,90,20,14,23,8,16,14,776,756,742,625,301,263,38,52,381,390,123,313,245,0,,102
15:02:33,4693.719,Fox,771,90,20,14,23,8,14,16,776,756,742,625,301,265,38,52,381,390,123,313,245,0,,102
15:02:34,4696.419,Fox,773,91,22,14,22,8,14,16,778,756,742,625,301,265,38,53,382,391,124,313,245,0,,103
15:02:35,4698.52,Fox,773,90,22,14,20,10,14,15,778,756,742,627,301,265,38,52,382,391,124,313,246,0,,102
15:02:35,4700.121,Fox,773,90,22,14,19,11,14,15,778,756,742,628,301,265,38,52,382,391,124,313,246,0,,102
15:02:36,4700.794,Fox,773,89,22,14,19,11,14,14,778,756,742,628,301,265,37,52,382,391,124,313,247,0,,101
15:02:36,4702.655,Fox,773,89,22,14,17,13,14,14,778,756,742,630,301,265,37,52,382,391,124,313,247,0,,101
15:02:37,4704.755,Fox,775,89,24,14,16,13,13,14,780,756,742,630,301,266,37,52,384,391,125,313,248,0,,101
15:02:38,4705.955,Fox,775,89,24,12,18,12,14,14,780,756,744,630,302,266,37,52,384,391,125,313,248,0,,101
15:02:39,4708.055,Fox,775,88,24,12,18,12,14,13,780,756,744,630,302,266,36,52,384,391,125,313,249,0,,100
15:02:39,4710.155,Fox,775,87,24,8,22,12,12,14,780,756,748,630,302,268,36,51,384,391,125,313,250,0,,99
15:02:40,4711.355,Fox,775,87,24,6,24,12,12,14,780,756,750,630,302,268,36,51,384,391,125,313,250,0,,99
15:02:40,4711.955,Fox,775,87,24,4,26,12,12,14,780,756,752,630,302,268,36,51,384,391,125,313,250,0,,99
15:02:41,4713.455,Fox,777,88,26,4,25,12,12,14,782,756,752,630,302,268,35,53,384,393,125,314,250,0,,100
15:02:42,4716.755,Fox,777,88,26,4,24,13,12,14,782,756,752,631,302,268,35,53,384,393,125,314,250,0,,100
15:02:43,4718.855,Fox,777,88,26,4,22,15,12,14,782,756,752,633,302,268,35,53,384,393,125,314,250,0,,100
15:02:44,4720.355,Fox,777,88,26,4,21,16,11,15,782,756,752,634,302,269,35,53,384,393,125,314,250,0,,100
15:02:44,4721.855,Fox,779,89,28,4,20,16,11,15,784,756,752,634,302,269,35,54,385,394,125,315,250,0,,101
15:02:45,4724.395,Fox,779,85,28,4,20,14,11,13,784,756,752,634,302,269,34,51,385,394,127,315,252,0,,97
15:02:46,4724.995,Fox,779,83,28,4,20,14,10,12,784,756,752,634,302,269,33,50,385,394,127,316,253,0,,95
15:02:46,4726.194,Fox,779,83,28,4,20,13,11,12,784,756,752,634,303,269,33,50,385,394,127,316,253,0,,95
15:02:47,4727.395,Fox,779,82,28,4,19,14,11,11,784,756,752,635,303,269,33,49,385,394,127,316,254,0,,94
15:02:47,4728.304,Fox,779,82,28,4,17,16,11,11,784,756,752,637,303,269,33,49,385,394,127,316,254,0,,94
15:02:47,4729.173,Fox,779,82,28,4,17,16,10,12,784,756,752,637,303,270,33,49,385,394,127,316,254,0,,94
15:02:48,4729.773,Fox,779,82,28,2,19,16,10,12,784,756,754,637,303,270,33,49,385,394,127,316,254,0,,94
15:02:48,4730.374,Fox,779,81,28,2,19,16,10,11,784,756,754,637,303,270,33,48,385,394,127,317,254,0,,93
15:02:48,4731.574,Fox,779,80,28,0,21,16,10,10,784,756,756,637,303,270,33,47,385,394,127,317,255,0,,92
15:02:48,4732.173,Fox,779,79,28,0,21,15,10,10,784,756,756,637,303,270,33,46,385,394,127,318,255,0,,91
15:02:50,4735.474,Fox,781,81,30,0,18,18,10,10,786,756,756,640,303,270,35,46,387,394,127,318,255,0,,93
15:02:51,4736.673,Fox,783,83,32,0,18,18,10,10,788,756,756,640,303,270,35,48,387,396,127,318,255,0,,95
15:02:51,4736.974,Fox,783,83,32,0,16,20,10,10,788,756,756,642,303,270,35,48,387,396,127,318,255,0,,95
15:02:51,4737.874,Fox,783,80,32,0,16,18,10,9,788,756,756,642,303,270,35,45,387,396,129,318,256,0,,92
15:02:51,4738.472,Fox,783,80,30,2,14,20,10,9,788,758,756,644,303,270,35,45,387,396,129,318,256,0,,92
15:02:52,4740.271,Fox,783,79,30,2,14,19,9,10,788,758,756,644,303,271,35,44,387,396,129,319,256,0,,91
15:02:54,4743.571,Fox,783,78,28,4,14,18,9,10,788,760,756,644,303,271,35,43,387,396,129,320,256,0,,90
15:02:56,4749.245,Fox,783,77,26,6,14,18,9,9,788,762,756,644,303,271,35,42,387,396,129,320,257,0,,89
15:02:57,4751.824,Fox,783,77,26,6,12,19,10,9,788,762,756,646,304,271,35,42,387,396,129,320,257,0,,89
15:02:57,4752.424,Fox,785,79,28,6,12,19,10,9,790,762,756,646,304,271,36,43,388,397,129,320,257,0,,91
15:02:58,4754.225,Fox,785,78,28,6,12,18,10,9,790,762,756,646,304,271,36,42,388,397,129,321,257,0,,90
15:02:58,4755.424,Fox,787,79,26,8,12,17,10,9,790,764,756,646,304,271,36,43,389,398,129,322,257,0,,91
15:02:59,4755.725,Fox,787,79,28,8,12,17,10,9,792,764,756,646,304,271,36,43,389,398,129,322,257,0,,91
15:02:59,4756.625,Fox,787,77,28,8,12,15,8,11,792,764,756,646,304,273,36,41,389,398,131,322,257,0,,89
15:02:59,4756.924,Fox,787,77,26,10,12,15,8,11,792,766,756,646,304,273,36,41,389,398,131,322,257,0,,89
15:03:00,4759.024,Fox,789,79,28,10,12,15,8,11,794,766,756,646,304,273,36,43,389,400,131,322,257,0,,91
15:03:00,4759.625,Fox,793,81,32,10,10,15,8,11,798,766,756,646,304,273,35,46,390,403,131,324,257,0,,93
15:03:00,4759.868,Fox,793,81,30,12,10,15,8,11,798,768,756,646,304,273,35,46,390,403,131,324,257,0,,93
15:03:01,4760.406,Fox,793,81,28,14,10,15,8,11,798,770,756,646,304,273,35,46,390,403,131,324,257,0,,93
15:03:02,4764.606,Fox,793,81,26,16,10,15,8,11,798,772,756,646,304,273,35,46,390,403,131,324,257,0,,93
15:03:03,4766.706,Fox,795,83,28,16,9,16,8,11,800,772,756,647,304,273,36,47,391,404,131,324,257,0,,95
15:03:04,4767.306,Fox,797,83,30,16,8,15,8,11,802,772,756,647,304,273,35,48,392,405,132,325,257,0,,95
15:03:04,4768.335,Fox,797,82,30,16,8,15,8,10,802,772,756,647,304,273,35,47,392,405,132,325,258,0,,94
15:03:05,4770.735,Fox,797,81,30,16,5,18,6,11,802,772,756,650,304,275,35,46,392,405,132,325,259,0,,93
15:03:05,4771.936,Fox,797,81,30,16,3,20,6,11,802,772,756,652,304,275,35,46,392,405,132,325,259,0,,93
15:03:06,4772.835,Fox,799,83,32,16,1,22,6,11,804,772,756,654,304,275,35,48,392,407,132,325,259,0,,95
15:03:06,4773.436,Fox,799,82,30,18,1,21,6,11,804,774,756,654,304,275,35,47,392,407,132,326,259,0,,94
15:03:07,4774.936,Fox,801,81,30,20,0,19,6,11,806,776,756,654,304,275,33,48,393,408,133,328,259,0,,93
15:03:08,4776.735,Fox,801,81,30,18,2,19,6,11,806,776,758,654,304,275,33,48,393,408,133,328,259,0,,93
15:03:08,4777.335,Fox,801,81,30,18,2,19,4,13,806,776,758,654,304,277,33,48,393,408,133,328,259,0,,93
15:03:09,4779.135,Fox,803,83,30,20,2,19,4,13,808,778,758,654,304,277,33,50,393,410,133,328,259,0,,95
15:03:09,4780.936,Fox,803,82,30,20,2,19,4,12,808,778,758,654,304,277,33,49,393,410,133,328,260,0,,94
15:03:10,4781.718,Fox,803,82,30,18,4,19,4,12,808,778,760,654,304,277,33,49,393,410,133,328,260,0,,94
15:03:11,4783.779,Fox,803,80,30,18,4,17,4,12,808,778,760,654,304,277,33,47,393,410,133,330,260,0,,92
15:03:12,4787.599,Fox,803,80,28,18,6,17,4,12,808,780,762,654,304,277,33,47,393,410,133,330,260,0,,92
15:03:13,4790.291,Fox,803,80,28,18,4,19,4,12,808,780,762,656,304,277,33,47,393,410,133,330,260,0,,92
15:03:15,4793.761,Fox,803,80,28,16,6,19,4,12,808,780,764,656,304,277,33,47,393,410,133,330,260,0,,92
15:03:15,4794.331,Fox,803,79,28,16,6,18,3,13,808,780,764,656,304,278,33,46,393,410,133,331,260,0,,91
15:03:15,4795.288,Fox,803,78,28,14,8,18,3,12,808,780,766,656,304,278,32,46,393,410,133,331,261,0,,90
15:03:16,4796.188,Fox,803,78,26,16,8,17,4,12,808,782,766,656,305,278,32,46,393,410,133,331,261,0,,90
15:03:17,4798.588,Fox,803,77,26,14,10,16,4,12,808,782,768,656,305,278,32,45,393,410,134,331,261,0,,89
15:03:17,4799.488,Fox,803,75,26,12,12,14,4,12,808,782,770,656,305,278,31,44,393,410,136,331,261,0,,87
15:03:17,4800.088,Fox,803,74,26,12,12,13,4,12,808,782,770,656,305,278,30,44,393,410,136,332,261,0,,86
15:03:17,4801.243,Fox,803,73,26,12,12,13,4,11,808,782,770,656,305,278,30,43,393,410,136,332,262,0,,85
15:03:18,4803.312,Fox,803,73,26,10,14,13,4,11,808,782,772,656,305,278,30,43,393,410,136,332,262,0,,85
15:03:19,4804.511,Fox,803,73,24,12,14,13,4,11,808,784,772,656,305,278,30,43,393,410,136,332,262,0,,85
15:03:20,4807.132,Fox,803,72,24,12,14,13,4,10,808,784,772,656,305,278,30,42,393,410,136,332,263,0,,84
15:03:22,4811.931,Fox,803,72,24,10,16,13,4,10,808,784,774,656,305,278,30,42,393,410,136,332,263,0,,84
15:03:22,4813.431,Fox,803,72,24,8,18,12,5,10,808,784,776,656,306,278,30,42,393,410,136,332,263,0,,84
15:03:23,4815.231,Fox,803,71,24,8,18,12,5,9,808,784,776,656,306,278,30,41,393,410,136,332,264,0,,83
15:03:24,4817.581,Fox,803,71,24,6,20,12,5,9,808,784,778,656,306,278,30,41,393,410,136,332,264,0,,83
15:03:24,4818.181,Fox,803,71,22,8,20,12,5,9,808,786,778,656,306,278,30,41,393,410,136,332,264,0,,83
15:03:24,4819.381,Fox,803,71,20,10,20,12,5,9,808,788,778,656,306,278,30,41,393,410,136,332,264,0,,83
15:03:25,4820.881,Fox,803,70,20,10,20,10,6,9,808,788,778,656,307,278,30,40,393,410,137,332,264,0,,82
15:03:25,4822.081,Fox,803,70,20,10,20,9,7,9,808,788,778,656,308,278,30,40,393,410,137,332,264,0,,82
15:03:27,4825.381,Fox,803,69,20,10,20,9,7,8,808,788,778,656,308,278,30,39,393,410,137,332,265,0,,81
15:03:27,4825.981,Fox,803,69,20,8,22,9,7,8,808,788,780,656,308,278,30,39,393,410,137,332,265,0,,81
15:03:28,4828.981,Fox,803,69,20,8,22,8,8,8,808,788,780,656,309,278,30,39,393,410,137,332,265,0,,81
15:03:29,4831.681,Fox,803,67,20,8,22,6,10,6,808,788,780,656,311,278,30,37,393,410,137,332,267,0,,79
15:03:30,4834.537,Fox,803,67,20,6,24,6,10,6,808,788,782,656,311,278,30,37,393,410,137,332,267,0,,79
15:03:30,4835.046,Fox,803,67,18,8,24,6,10,6,808,790,782,656,311,278,30,37,393,410,137,332,267,0,,79
15:03:31,4837.181,Fox,803,67,18,8,22,8,10,6,808,790,782,658,311,278,30,37,393,410,137,332,267,0,,79
15:03:31,4838.191,Fox,803,65,16,10,22,8,10,4,808,792,782,658,311,278,30,35,393,410,137,332,269,0,,77
15:03:32,4841.802,Fox,805,66,16,12,22,8,10,3,810,794,782,658,311,278,31,35,394,411,137,332,270,0,,78
15:03:33,4842.367,Fox,805,66,12,16,20,10,10,3,810,798,782,660,311,278,31,35,394,411,137,332,270,0,,78
15:03:33,4842.967,Fox,805,66,12,14,22,10,10,3,810,798,784,660,311,278,31,35,394,411,137,332,270,0,,78
15:03:33,4843.567,Fox,805,66,12,14,22,10,9,4,810,798,784,660,311,279,31,35,394,411,137,332,270,0,,78
15:03:35,4847.732,Fox,805,65,12,14,22,10,9,3,810,798,784,660,311,279,31,34,394,411,137,332,271,0,,77
15:03:35,4848.302,Fox,805,65,12,14,20,12,9,3,810,798,784,662,311,279,31,34,394,411,137,332,271,0,,77
15:03:35,4849.497,Fox,805,65,10,16,20,12,9,3,810,800,784,662,311,279,31,34,394,411,137,332,271,0,,77
15:03:35,4850.083,Fox,805,65,8,18,20,12,9,3,810,802,784,662,311,279,31,34,394,411,137,332,271,0,,77
15:03:36,4852.638,Fox,807,67,10,18,20,12,9,3,812,802,784,662,311,279,32,35,395,412,137,332,271,0,,79
15:03:37,4854.138,Fox,807,67,10,18,18,14,9,3,812,802,784,664,311,279,32,35,395,412,137,332,271,0,,79
15:03:37,4855.338,Fox,807,67,8,20,18,14,9,3,812,804,784,664,311,279,32,35,395,412,137,332,271,0,,79
15:03:37,4855.938,Fox,807,67,8,20,16,16,9,3,812,804,784,666,311,279,32,35,395,412,137,332,271,0,,79
15:03:38,4856.538,Fox,807,67,8,18,18,16,9,3,812,804,786,666,311,279,32,35,395,412,137,332,271,0,,79
15:03:38,4857.738,Fox,807,67,6,18,20,16,9,3,812,806,788,666,311,279,32,35,395,412,137,332,271,0,,79
15:03:39,4858.938,Fox,807,67,6,18,18,18,9,3,812,806,788,668,311,279,32,35,395,412,137,332,271,0,,79
15:03:39,4859.538,Fox,807,67,6,18,16,20,9,3,812,806,788,670,311,279,32,35,395,412,137,332,271,0,,79
15:03:39,4860.738,Fox,809,69,8,18,16,20,9,3,814,806,788,670,311,279,34,35,397,412,137,332,271,0,,81
15:03:39,4861.338,Fox,811,70,10,18,15,20,9,3,816,806,788,670,311,279,34,36,398,413,137,333,271,0,,82
15:03:40,4861.638,Fox,811,69,8,20,15,19,9,3,816,808,788,670,311,279,33,36,398,413,137,334,271,0,,81
15:03:40,4862.538,Fox,813,70,10,20,14,19,9,3,818,808,788,670,311,279,32,38,398,415,137,335,271,0,,82
15:03:40,4863.138,Fox,815,71,12,20,14,18,9,3,820,808,788,670,311,279,33,38,400,415,138,335,271,0,,83
15:03:40,4863.738,Fox,815,71,12,20,12,20,8,4,820,808,788,672,311,280,33,38,400,415,138,335,271,0,,83
15:03:40,4864.038,Fox,815,71,12,20,12,18,10,4,820,808,788,672,313,280,33,38,400,415,138,335,271,0,,83
15:03:41,4866.138,Fox,817,71,12,20,12,16,10,4,820,808,788,672,313,280,32,39,400,417,138,337,271,0,,83
15:03:41,4866.438,Fox,817,71,14,20,12,16,10,4,822,808,788,672,313,280,32,39,400,417,138,337,271,0,,83
15:03:42,4867.638,Fox,819,72,16,20,12,15,10,4,824,808,788,672,313,280,33,39,402,417,138,338,271,0,,84
15:03:42,4869.112,Fox,821,74,18,20,12,15,10,4,826,808,788,672,313,280,34,40,403,418,138,338,271,0,,86
15:03:43,4872.39,Fox,821,73,18,20,10,17,10,3,826,808,788,674,313,280,34,39,403,418,138,338,272,0,,85
15:03:44,4873.59,Fox,821,73,18,18,11,18,10,3,826,808,790,675,313,280,34,39,403,418,138,338,272,0,,85
15:03:45,4875.39,Fox,825,77,22,18,11,18,10,3,830,808,790,675,313,280,35,42,404,421,138,338,272,0,,89
15:03:45,4875.69,Fox,825,76,22,18,11,18,10,2,830,808,790,675,313,280,35,41,404,421,138,338,273,0,,88
15:03:45,4876.89,Fox,825,76,22,16,13,18,10,2,830,808,792,675,313,280,35,41,404,421,138,338,273,0,,88
15:03:46,4878.09,Fox,825,76,22,16,12,19,10,2,830,808,792,676,313,280,35,41,404,421,138,338,273,0,,88
15:03:47,4880.19,Fox,825,76,22,14,14,19,10,2,830,808,794,676,313,280,35,41,404,421,138,338,273,0,,88
15:03:47,4880.79,Fox,825,76,22,10,18,19,10,2,830,808,798,676,313,280,35,41,404,421,138,338,273,0,,88
15:03:48,4883.79,Fox,825,76,22,10,18,18,11,2,830,808,798,676,314,280,35,41,404,421,138,338,273,0,,88
15:03:48,4884.33,Fox,825,75,22,10,18,18,11,1,830,808,798,676,314,280,34,41,404,421,138,338,274,0,,87
15:03:49,4886.255,Fox,825,75,22,10,16,20,11,1,830,808,798,678,314,280,34,41,404,421,138,338,274,0,,87
15:03:49,4886.855,Fox,825,74,22,10,16,19,11,1,830,808,798,678,314,280,33,41,404,421,138,339,274,0,,86
15:03:49,4887.755,Fox,825,73,22,8,18,18,11,1,830,808,800,678,314,280,33,40,404,421,138,340,274,0,,85
15:03:49,4888.355,Fox,825,73,22,6,20,18,11,1,830,808,802,678,314,280,33,40,404,421,138,340,274,0,,85
15:03:50,4889.255,Fox,825,73,22,6,20,18,10,2,830,808,802,678,314,281,33,40,404,421,138,340,274,0,,85
15:03:50,4890.755,Fox,825,71,22,6,20,16,10,2,830,808,802,678,314,281,32,39,404,421,140,340,274,0,,83
15:03:51,4893.852,Fox,825,71,22,4,22,16,10,2,830,808,804,678,314,281,32,39,404,421,140,340,274,0,,83
15:03:52,4894.345,Fox,825,69,22,4,22,14,10,2,830,808,804,678,314,281,30,39,404,421,140,342,274,0,,81
15:03:52,4894.851,Fox,825,69,22,4,20,16,10,2,830,808,804,680,314,281,30,39,404,421,140,342,274,0,,81
15:03:52,4896.051,Fox,825,69,22,2,22,16,10,2,830,808,806,680,314,281,30,39,404,421,140,342,274,0,,81
15:03:54,4900.251,Fox,825,69,22,0,24,16,10,2,830,808,808,680,314,281,30,39,404,421,140,342,274,0,,81
15:03:54,4901.751,Fox,825,68,22,0,24,15,10,2,830,808,808,680,314,281,30,38,404,421,140,343,274,0,,80
15:03:55,4903.551,Fox,827,70,24,0,22,17,10,2,832,808,808,682,314,281,30,40,404,423,140,343,274,0,,82
15:03:56,4905.351,Fox,829,72,26,0,22,17,10,2,834,808,808,682,314,281,31,41,405,424,140,343,274,0,,84
15:03:56,4906.251,Fox,831,73,28,0,21,17,10,2,836,808,808,682,314,281,32,41,407,424,140,344,274,0,,85
15:03:58,4911.507,Fox,833,74,30,0,20,17,10,2,838,808,808,682,314,281,33,41,409,424,140,345,274,0,,86
15:04:00,4918.431,Fox,833,74,30,0,18,19,10,2,838,808,808,684,314,281,33,41,409,424,140,345,274,0,,86
15:04:02,4923.65,Fox,835,75,32,0,17,19,10,2,840,808,808,684,314,281,33,42,410,425,140,346,274,0,,87
15:04:02,4924.549,Fox,835,75,30,2,17,19,10,2,840,810,808,684,314,281,33,42,410,425,140,346,274,0,,87
15:04:03,4926.048,Fox,837,77,32,2,17,19,10,2,842,810,808,684,314,281,33,44,410,427,140,346,274,0,,89
15:04:03,4927.541,Fox,839,78,34,2,16,19,10,2,844,810,808,684,314,281,33,45,411,428,140,347,274,0,,90
15:04:04,4928.44,Fox,839,77,34,2,16,18,10,2,844,810,808,684,314,281,32,45,411,428,140,348,274,0,,89
15:04:05,4932.564,Fox,839,75,34,2,16,16,10,2,844,810,808,684,314,281,32,43,411,428,141,349,274,0,,87
15:04:06,4934.037,Fox,839,75,34,2,14,18,9,3,844,810,808,686,314,282,32,43,411,428,141,349,274,0,,87
15:04:06,4935.103,Fox,839,75,32,4,14,18,9,3,844,812,808,686,314,282,32,43,411,428,141,349,274,0,,87
15:04:06,4935.563,Fox,839,75,32,4,14,16,11,3,844,812,808,686,316,282,32,43,411,428,141,349,274,0,,87
15:04:07,4937.394,Fox,839,75,32,4,12,18,11,3,844,812,808,688,316,282,32,43,411,428,141,349,274,0,,87
15:04:07,4937.994,Fox,839,74,32,4,12,17,11,3,844,812,808,688,316,282,32,42,411,428,141,350,274,0,,86
15:04:08,4940.693,Fox,839,73,32,4,10,18,11,3,844,812,808,690,316,282,32,41,411,428,141,351,274,0,,85
15:04:08,4941.222,Fox,839,73,32,4,7,21,11,3,844,812,808,693,316,282,32,41,411,428,141,351,274,0,,85
15:04:08,4941.758,Fox,839,73,32,4,7,19,13,3,844,812,808,693,318,282,32,41,411,428,141,351,274,0,,85
15:04:09,4943.558,Fox,841,75,30,6,7,19,13,3,844,814,808,693,318,282,34,41,413,428,141,351,274,0,,87
15:04:09,4943.719,Fox,841,75,30,8,7,19,13,3,846,816,808,693,318,282,34,41,413,428,141,351,274,0,,87
15:04:10,4944.742,Fox,843,76,32,8,7,19,12,3,848,816,808,693,318,282,34,42,414,429,141,352,274,0,,88
15:04:10,4945.042,Fox,843,76,30,10,7,19,12,3,848,818,808,693,318,282,34,42,414,429,141,352,274,0,,88
15:04:10,4945.642,Fox,843,76,28,12,7,19,12,3,848,820,808,693,318,282,34,42,414,429,141,352,274,0,,88
15:04:11,4947.436,Fox,845,78,30,12,7,19,12,3,850,820,808,693,318,282,34,44,414,431,141,352,274,0,,90
15:04:11,4948.336,Fox,845,78,30,12,6,20,12,3,850,820,808,694,318,282,34,44,414,431,141,352,274,0,,90
15:04:11,4949.228,Fox,845,78,28,14,4,22,12,3,850,822,808,696,318,282,34,44,414,431,141,352,274,0,,90
15:04:11,4949.528,Fox,845,78,28,14,4,21,13,3,850,822,808,696,319,282,34,44,414,431,141,352,274,0,,90
15:04:12,4950.428,Fox,845,78,26,16,4,21,13,3,850,824,808,696,319,282,34,44,414,431,141,352,274,0,,90
15:04:12,4951.028,Fox,845,78,26,16,4,21,12,4,850,824,808,696,319,283,34,44,414,431,141,352,274,0,,90
15:04:12,4951.928,Fox,845,78,24,18,4,21,12,4,850,826,808,696,319,283,34,44,414,431,141,352,274,0,,90
15:04:13,4953.128,Fox,845,78,24,18,4,20,13,4,850,826,808,696,320,283,34,44,414,431,141,352,274,0,,90
15:04:13,4954.028,Fox,845,77,24,18,4,19,13,4,850,826,808,696,320,283,34,43,414,431,142,352,274,0,,89
15:04:13,4954.627,Fox,845,76,25,18,2,21,13,3,851,826,808,698,320,283,34,42,414,431,142,352,275,0,,88
15:04:14,4956.592,Fox,845,76,25,18,0,23,13,3,851,826,808,700,320,283,34,42,414,431,142,352,275,0,,88
15:04:14,4957.938,Fox,847,78,23,22,0,23,13,3,853,830,808,700,320,283,35,43,415,432,142,352,275,0,,90
15:04:15,4958.539,Fox,847,78,23,22,0,23,12,4,853,830,808,700,320,284,35,43,415,432,142,352,275,0,,90
15:04:15,4960.639,Fox,849,80,25,22,-2,25,12,4,855,830,808,702,320,284,35,45,415,434,142,352,275,0,,92
15:04:16,4963.039,Fox,849,80,25,20,0,25,12,4,855,830,810,702,320,284,35,45,415,434,142,352,275,0,,92
15:04:18,4966.931,Fox,849,80,25,20,0,24,12,5,855,830,810,702,321,285,35,45,415,434,142,352,275,0,,92
15:04:18,4969.331,Fox,849,80,25,20,0,24,10,7,855,830,810,702,321,287,35,45,415,434,142,352,275,0,,92
15:04:20,4973.462,Fox,849,80,25,18,2,24,10,7,855,830,812,702,321,287,35,45,415,434,142,352,275,0,,92
15:04:22,4979.772,Fox,849,80,25,18,2,22,12,7,855,830,812,702,323,287,35,45,415,434,142,352,275,0,,92
15:04:23,4981.861,Fox,849,78,25,16,4,20,12,7,855,830,814,702,323,287,35,43,415,434,144,352,275,0,,90
15:04:23,4982.461,Fox,849,78,25,14,6,20,12,7,855,830,816,702,323,287,35,43,415,434,144,352,275,0,,90
15:04:24,4983.642,Fox,849,76,25,12,8,18,12,7,855,830,818,702,323,287,35,41,415,434,144,354,275,0,,88
15:04:24,4984.242,Fox,849,76,25,10,10,18,12,7,855,830,820,702,323,287,35,41,415,434,144,354,275,0,,88
15:04:25,4986.287,Fox,849,76,23,12,10,18,12,7,855,832,820,702,323,287,35,41,415,434,144,354,275,0,,88
15:04:25,4987.188,Fox,851,77,25,12,10,17,12,7,857,832,820,702,323,287,35,42,416,435,144,355,275,0,,89
15:04:25,4987.487,Fox,851,77,25,10,12,17,12,7,857,832,822,702,323,287,35,42,416,435,144,355,275,0,,89
15:04:25,4988.087,Fox,851,77,23,12,12,17,12,7,857,834,822,702,323,287,35,42,416,435,144,355,275,0,,89
15:04:25,4988.914,Fox,851,77,21,12,14,17,12,7,857,836,824,702,323,287,35,42,416,435,144,355,275,0,,89
15:04:26,4990.398,Fox,851,76,21,10,16,16,12,7,857,836,826,702,323,287,35,41,416,435,144,356,275,0,,88
15:04:28,4994.598,Fox,851,75,19,12,16,16,12,6,857,838,826,702,323,287,35,40,416,435,144,356,276,0,,87
15:04:28,4995.798,Fox,853,77,21,12,16,16,12,6,859,838,826,702,323,287,36,41,417,436,144,356,276,0,,89
15:04:28,4996.398,Fox,853,75,21,8,20,14,12,6,859,838,830,702,323,287,36,39,417,436,144,358,276,0,,87
15:04:28,4996.998,Fox,853,75,21,8,20,13,13,6,859,838,830,702,324,287,36,39,417,436,144,358,276,0,,87
15:04:29,4997.898,Fox,853,74,21,8,20,12,13,6,859,838,830,702,324,287,36,38,417,436,144,359,276,0,,86
15:04:30,5000.598,Fox,853,73,21,8,20,12,13,5,859,838,830,702,324,287,35,38,417,436,144,359,277,0,,85
15:04:30,5001.798,Fox,855,75,21,8,20,12,11,7,859,838,830,702,324,289,36,39,418,437,144,359,277,0,,87
15:04:30,5001.966,Fox,855,75,23,8,20,12,11,7,861,838,830,702,324,289,36,39,418,437,144,359,277,0,,87
15:04:30,5002.654,Fox,857,77,25,8,20,12,11,7,863,838,830,702,324,289,38,39,420,437,144,359,277,0,,89
15:04:31,5003.641,Fox,857,75,25,8,20,10,11,7,863,838,830,702,324,289,38,37,420,437,144,361,277,0,,87
15:04:32,5006.373,Fox,857,75,23,10,20,10,11,7,863,840,830,702,324,289,38,37,420,437,144,361,277,0,,87
15:04:33,5008.772,Fox,857,75,21,12,20,10,11,7,863,842,830,702,324,289,38,37,420,437,144,361,277,0,,87
15:04:33,5010.272,Fox,857,75,19,14,20,10,11,7,863,844,830,702,324,289,38,37,420,437,144,361,277,0,,87
15:04:34,5011.772,Fox,857,75,19,14,20,9,12,7,863,844,830,702,325,289,38,37,420,437,144,361,277,0,,87
15:04:35,5014.772,Fox,859,76,21,14,19,9,12,7,865,844,830,702,325,289,39,37,422,437,144,362,277,0,,88
15:04:36,5017.475,Fox,859,75,21,14,19,9,12,6,865,844,830,702,325,289,38,37,422,437,144,362,278,0,,87
15:04:36,5018.375,Fox,861,77,23,14,19,9,12,6,867,844,830,702,325,289,39,38,423,438,144,362,278,0,,89
15:04:37,5020.175,Fox,863,77,25,14,18,9,12,5,869,844,830,702,325,289,38,39,423,440,145,362,279,0,,89
15:04:37,5021.375,Fox,863,77,25,14,18,9,11,6,869,844,830,702,325,290,38,39,423,440,145,362,279,0,,89
15:04:37,5021.974,Fox,863,76,25,14,18,9,11,5,869,844,830,702,325,290,37,39,423,440,145,362,280,0,,88
15:04:38,5023.474,Fox,863,76,25,14,17,10,11,5,869,844,830,703,325,290,37,39,423,440,145,362,280,0,,88
15:04:38,5024.674,Fox,863,76,25,12,19,10,11,5,869,844,832,703,325,290,37,39,423,440,145,362,280,0,,88
15:04:39,5026.44,Fox,863,76,23,12,21,10,11,5,869,846,834,703,325,290,37,39,423,440,145,362,280,0,,88
15:04:39,5027.472,Fox,863,76,21,12,23,8,13,5,869,848,836,703,327,290,37,39,423,440,145,362,280,0,,88
15:04:40,5030.085,Fox,863,75,19,14,23,8,13,4,869,850,836,703,327,290,36,39,423,440,145,362,281,0,,87
15:04:41,5031.285,Fox,865,76,21,14,22,6,15,4,871,850,836,703,329,290,37,39,425,440,145,363,281,0,,88
15:04:41,5032.785,Fox,865,76,21,12,24,6,15,4,871,850,838,703,329,290,37,39,425,440,145,363,281,0,,88
15:04:42,5034.268,Fox,865,76,21,12,23,7,15,4,871,850,838,704,329,290,37,39,425,440,145,363,281,0,,88
15:04:42,5034.864,Fox,865,76,21,12,23,6,16,4,871,850,838,704,330,290,37,39,425,440,145,363,281,0,,88
15:04:43,5037.225,Fox,865,76,20,13,23,6,16,4,871,851,838,704,330,290,37,39,425,440,145,363,281,0,,88
15:04:44,5039.625,Fox,867,77,22,13,22,6,16,4,873,851,838,704,330,290,37,40,426,441,145,364,281,0,,89
15:04:44,5040.524,Fox,867,77,20,15,22,6,16,4,873,853,838,704,330,290,37,40,426,441,145,364,281,0,,89
15:04:45,5042.325,Fox,867,76,20,15,20,6,18,3,873,853,838,706,332,290,36,40,426,441,145,364,282,0,,88
15:04:45,5043.225,Fox,867,76,18,17,19,7,18,3,873,855,838,707,332,290,36,40,426,441,145,364,282,0,,88
15:04:45,5044.125,Fox,867,76,18,17,17,9,18,3,873,855,838,709,332,290,36,40,426,441,145,364,282,0,,88
15:04:46,5045.032,Fox,867,75,18,15,17,11,17,3,873,855,840,711,332,290,35,40,426,441,146,364,282,0,,87
15:04:46,5047.132,Fox,867,75,18,13,19,11,17,3,873,855,842,711,332,290,35,40,426,441,146,364,282,0,,87
15:04:47,5048.03,Fox,867,75,18,13,17,13,17,3,873,855,842,713,332,290,35,40,426,441,146,364,282,0,,87
15:04:47,5048.63,Fox,867,75,18,11,19,13,17,3,873,855,844,713,332,290,35,40,426,441,146,364,282,0,,87
15:04:47,5049.229,Fox,867,75,18,11,18,14,17,3,873,855,844,714,332,290,35,40,426,441,146,364,282,0,,87
15:04:48,5050.729,Fox,867,74,18,11,16,16,17,2,873,855,844,716,332,290,35,39,426,441,146,364,283,0,,86
15:04:49,5054.329,Fox,867,73,18,11,16,15,17,2,873,855,844,716,332,290,35,38,426,441,146,365,283,0,,85
15:04:50,5057.027,Fox,867,73,18,11,12,19,17,2,873,855,844,720,332,290,35,38,426,441,146,365,283,0,,85
15:04:50,5057.768,Fox,869,74,20,11,12,18,17,2,875,855,844,720,332,290,35,39,427,442,146,366,283,0,,86
15:04:52,5063.744,Fox,869,73,20,11,12,17,17,2,875,855,844,720,332,290,35,38,427,442,146,367,283,0,,85
15:04:53,5064.944,Fox,869,73,20,9,14,17,17,2,875,855,846,720,332,290,35,38,427,442,146,367,283,0,,85
15:04:53,5065.844,Fox,869,73,20,7,16,17,17,2,875,855,848,720,332,290,35,38,427,442,146,367,283,0,,85
15:04:54,5068.544,Fox,869,73,20,5,18,17,17,2,875,855,850,720,332,290,35,38,427,442,146,367,283,0,,85
15:04:54,5069.723,Fox,869,73,18,7,18,17,17,2,875,857,850,720,332,290,35,38,427,442,146,367,283,0,,85
15:04:55,5071.748,Fox,869,72,18,7,18,16,17,2,875,857,850,720,332,290,34,38,427,442,146,368,283,0,,84
15:04:56,5073.143,Fox,869,72,18,7,18,16,15,4,875,857,850,720,332,292,34,38,427,442,146,368,283,0,,84
15:04:56,5073.779,Fox,871,71,20,7,17,14,15,4,877,857,850,720,332,292,34,37,428,443,147,370,283,0,,83
15:04:56,5074.079,Fox,871,69,20,7,17,12,15,4,877,857,850,720,332,292,32,37,428,443,148,371,283,0,,81
15:04:57,5075.878,Fox,871,69,20,6,18,12,15,4,877,857,851,720,332,292,32,37,428,443,148,371,283,0,,81
15:04:57,5077.979,Fox,873,71,22,6,18,12,15,4,879,857,851,720,332,292,33,38,429,444,148,371,283,0,,83
15:04:58,5078.579,Fox,873,71,20,8,18,12,15,4,879,859,851,720,332,292,33,38,429,444,148,371,283,0,,83
15:04:58,5079.178,Fox,873,71,20,6,20,12,13,6,879,859,853,720,332,294,33,38,429,444,148,371,283,0,,83
15:04:58,5080.079,Fox,873,70,20,6,20,11,13,6,879,859,853,720,332,294,33,37,429,444,148,372,283,0,,82
15:04:59,5081.878,Fox,873,70,20,4,22,11,13,6,879,859,855,720,332,294,33,37,429,444,148,372,283,0,,82
15:04:59,5083.071,Fox,873,69,20,4,22,11,13,5,879,859,855,720,332,294,33,36,429,444,148,372,284,0,,81
15:05:00,5085.171,Fox,873,69,18,6,20,13,13,5,879,861,855,722,332,294,33,36,429,444,148,372,284,0,,81
15:05:00,5085.471,Fox,873,69,16,8,20,13,13,5,879,863,855,722,332,294,33,36,429,444,148,372,284,0,,81
15:05:01,5086.825,Fox,873,69,16,8,19,14,12,6,879,863,855,723,332,295,33,36,429,444,148,372,284,0,,81
15:05:01,5087.425,Fox,873,68,16,8,19,13,12,6,879,863,855,723,332,295,33,35,429,444,148,373,284,0,,80
15:05:01,5088.025,Fox,873,68,16,8,17,15,12,6,879,863,855,725,332,295,33,35,429,444,148,373,284,0,,80
15:05:01,5089.225,Fox,873,67,16,8,17,15,12,5,879,863,855,725,332,295,33,34,429,444,148,373,285,0,,79
15:05:02,5090.694,Fox,875,69,18,8,17,15,11,6,881,863,855,725,332,296,34,35,430,445,148,373,285,0,,81
15:05:02,5092.194,Fox,875,68,18,8,17,15,11,5,881,863,855,725,332,296,34,34,430,445,148,373,286,0,,80
15:05:03,5093.055,Fox,877,69,20,8,15,16,11,5,883,863,855,727,332,296,34,35,431,446,148,374,286,0,,81
15:05:03,5095.086,Fox,879,70,22,8,14,16,11,5,885,863,855,727,332,296,34,36,432,447,148,375,286,0,,82
15:05:04,5095.986,Fox,881,71,24,8,14,15,11,5,887,863,855,727,332,296,34,37,433,448,148,376,286,0,,83
15:05:04,5097.483,Fox,881,71,22,10,14,15,11,5,887,865,855,727,332,296,34,37,433,448,148,376,286,0,,83
15:05:05,5099.583,Fox,883,73,24,10,14,15,11,5,889,865,855,727,332,296,34,39,433,450,148,376,286,0,,85
15:05:06,5101.083,Fox,883,73,22,12,14,15,11,5,889,867,855,727,332,296,34,39,433,450,148,376,286,0,,85
15:05:06,5103.154,Fox,885,74,20,14,13,15,11,5,889,869,855,727,332,296,34,40,434,451,149,376,286,0,,86
15:05:07,5103.454,Fox,885,74,22,14,13,15,11,5,891,869,855,727,332,296,34,40,434,451,149,376,286,0,,86
15:05:07,5104.294,Fox,887,75,24,14,12,15,11,5,893,869,855,727,332,296,33,42,434,453,150,376,286,0,,87
15:05:07,5104.477,Fox,887,75,24,14,12,15,10,6,893,869,855,727,332,297,33,42,434,453,150,376,286,0,,87
15:05:07,5105.188,Fox,887,75,24,14,11,16,10,6,893,869,855,728,332,297,33,42,434,453,150,376,286,0,,87
15:05:08,5107.018,Fox,889,77,26,14,11,16,10,6,895,869,855,728,332,297,33,44,434,455,150,376,286,0,,89
15:05:08,5107.618,Fox,889,77,26,14,9,18,10,6,895,869,855,730,332,297,33,44,434,455,150,376,286,0,,89
15:05:08,5108.09,Fox,889,77,26,12,11,18,10,6,895,869,857,730,332,297,33,44,434,455,150,376,286,0,,89
15:05:09,5109.306,Fox,889,77,26,12,9,20,10,6,895,869,857,732,332,297,33,44,434,455,150,376,286,0,,89
15:05:10,5113.806,Fox,889,75,24,14,9,18,10,6,895,871,857,732,332,297,33,42,434,455,152,376,286,0,,87
15:05:11,5115.605,Fox,889,74,24,14,9,17,10,6,895,871,857,732,332,297,33,41,434,455,152,377,286,0,,86
15:05:12,5116.505,Fox,891,74,26,14,8,16,10,6,897,871,857,732,332,297,32,42,435,456,153,378,286,0,,86
15:05:12,5116.806,Fox,891,74,26,12,10,16,10,6,897,871,859,732,332,297,32,42,435,456,153,378,286,0,,86
15:05:12,5117.406,Fox,891,74,26,12,10,16,8,8,897,871,859,732,332,299,32,42,435,456,153,378,286,0,,86
15:05:13,5121.005,Fox,891,73,26,12,10,16,8,7,897,871,859,732,332,299,32,41,435,456,153,378,287,0,,85
15:05:14,5122.206,Fox,891,73,24,14,10,16,8,7,897,873,859,732,332,299,32,41,435,456,153,378,287,0,,85
15:05:14,5123.105,Fox,891,73,24,12,12,16,8,7,897,873,861,732,332,299,32,41,435,456,153,378,287,0,,85
15:05:14,5124.005,Fox,891,72,24,10,14,16,8,6,897,873,863,732,332,299,31,41,435,456,153,378,288,0,,84
15:05:15,5125.206,Fox,891,71,24,10,14,15,8,6,897,873,863,732,332,299,30,41,435,456,153,379,288,0,,83
15:05:15,5126.686,Fox,891,70,24,10,13,15,8,6,897,873,863,733,332,299,30,40,435,456,153,380,288,0,,82
15:05:16,5127.286,Fox,891,69,24,10,13,15,8,5,897,873,863,733,332,299,29,40,435,456,153,380,289,0,,81
15:05:16,5129.085,Fox,891,69,24,10,11,17,8,5,897,873,863,735,332,299,29,40,435,456,153,380,289,0,,81
15:05:18,5134.485,Fox,891,69,24,10,11,17,7,6,897,873,863,735,332,300,29,40,435,456,153,380,289,0,,81
15:05:18,5135.085,Fox,891,68,24,10,11,17,7,5,897,873,863,735,332,300,29,39,435,456,153,380,290,0,,80
15:05:19,5135.803,Fox,891,68,24,8,13,16,8,5,897,873,865,735,333,300,29,39,435,456,153,380,290,0,,80
15:05:19,5136.359,Fox,891,68,24,8,12,16,9,5,897,873,865,736,334,300,29,39,435,456,153,380,290,0,,80
15:05:19,5136.532,Fox,891,67,24,8,12,15,9,5,897,873,865,736,334,300,29,38,435,456,153,381,290,0,,79
15:05:20,5138.861,Fox,891,65,24,8,12,13,9,5,897,873,865,736,334,300,29,36,435,456,153,383,290,0,,77
15:05:20,5139.761,Fox,891,64,24,6,12,15,9,4,897,873,867,738,334,300,29,35,435,456,153,383,291,0,,76
15:05:20,5140.32,Fox,891,64,22,8,12,15,9,4,897,875,867,738,334,300,29,35,435,456,153,383,291,0,,76
15:05:21,5141.384,Fox,891,64,22,6,14,14,10,4,897,875,869,738,335,300,29,35,435,456,153,383,291,0,,76
15:05:21,5142.209,Fox,891,64,22,6,12,16,10,4,897,875,869,740,335,300,29,35,435,456,153,383,291,0,,76
15:05:21,5142.768,Fox,891,62,22,6,12,13,11,4,897,875,869,740,336,300,28,34,435,456,155,383,291,0,,74
15:05:23,5147.77,Fox,891,61,22,6,12,13,11,3,897,875,869,740,336,300,27,34,435,456,155,383,292,0,,73
15:05:24,5149.27,Fox,891,61,22,6,12,13,10,4,897,875,869,740,336,301,27,34,435,456,155,383,292,0,,73
15:05:24,5150.47,Fox,891,61,22,6,12,10,13,4,897,875,869,740,339,301,27,34,435,456,155,383,292,0,,73
15:05:25,5152.57,Fox,891,61,22,4,14,10,13,4,897,875,871,740,339,301,27,34,435,456,155,383,292,0,,73
15:05:25,5154.353,Fox,891,60,22,4,14,10,13,3,897,875,871,740,339,301,27,33,435,456,155,383,293,0,,72
15:05:26,5154.953,Fox,891,59,22,4,14,9,13,3,897,875,871,740,339,301,27,32,435,456,155,384,293,0,,71
15:05:26,5156.453,Fox,891,59,20,6,14,9,13,3,897,877,871,740,339,301,27,32,435,456,155,384,293,0,,71
15:05:27,5157.653,Fox,891,58,20,6,14,8,13,3,897,877,871,740,339,301,27,31,435,456,155,385,293,0,,70
15:05:28,5160.653,Fox,891,58,18,6,16,8,13,3,897,879,873,740,339,301,27,31,435,456,155,385,293,0,,70
15:05:29,5165.023,Fox,891,58,18,6,16,8,11,5,897,879,873,740,339,303,27,31,435,456,155,385,293,0,,70
15:05:30,5167.467,Fox,891,57,18,6,16,7,11,5,897,879,873,740,339,303,27,30,435,456,155,386,293,0,,69
15:05:30,5168.299,Fox,891,57,18,6,16,7,10,6,897,879,873,740,339,304,27,30,435,456,155,386,293,0,,69
15:05:30,5168.725,Fox,891,57,18,6,14,9,10,6,897,879,873,742,339,304,27,30,435,456,155,386,293,0,,69
15:05:32,5172.193,Fox,891,57,18,6,14,9,9,7,897,879,873,742,339,305,27,30,435,456,155,386,293,0,,69
15:05:32,5173.364,Fox,891,57,16,8,14,9,9,7,897,881,873,742,339,305,27,30,435,456,155,386,293,0,,69
15:05:33,5174.864,Fox,893,58,18,8,13,9,9,7,899,881,873,742,339,305,27,31,436,457,155,387,293,0,,70
15:05:33,5175.164,Fox,893,57,18,8,13,9,9,6,899,881,873,742,339,305,26,31,436,457,155,387,294,0,,69
15:05:33,5175.764,Fox,893,57,16,10,13,9,9,6,899,883,873,742,339,305,26,31,436,457,155,387,294,0,,69
15:05:34,5177.859,Fox,893,57,14,12,11,11,9,6,899,885,873,744,339,305,26,31,436,457,155,387,294,0,,69
15:05:34,5179.059,Fox,893,57,12,12,13,11,9,6,899,887,875,744,339,305,26,31,436,457,155,387,294,0,,69
15:05:35,5179.959,Fox,893,57,12,12,13,11,7,8,899,887,875,744,339,307,26,31,436,457,155,387,294,0,,69
15:05:35,5181.159,Fox,895,58,14,12,13,10,7,8,901,887,875,744,339,307,26,32,437,458,155,388,294,0,,70
15:05:35,5182.359,Fox,895,58,12,14,13,10,7,8,901,889,875,744,339,307,26,32,437,458,155,388,294,0,,70
15:05:36,5183.859,Fox,895,58,12,14,11,12,7,8,901,889,875,746,339,307,26,32,437,458,155,388,294,0,,70
15:05:36,5184.737,Fox,897,60,14,14,9,14,7,8,903,889,875,748,339,307,27,33,438,459,155,388,294,0,,72
15:05:37,5186.237,Fox,897,59,12,16,9,13,7,8,903,891,875,748,339,307,27,32,438,459,155,389,294,0,,71
15:05:37,5187.137,Fox,897,59,10,18,9,13,7,8,903,893,875,748,339,307,27,32,438,459,155,389,294,0,,71
15:05:37,5188.037,Fox,899,61,12,18,9,13,7,8,905,893,875,748,339,307,28,33,439,460,155,389,294,0,,73
15:05:38,5188.337,Fox,899,60,12,18,9,13,7,7,905,893,875,748,339,307,27,33,439,460,155,389,295,0,,72
15:05:38,5189.837,Fox,901,62,12,20,9,13,7,7,907,895,875,748,339,307,28,34,440,461,155,389,295,0,,74
15:05:40,5194.937,Fox,901,62,12,18,11,13,7,7,907,895,877,748,339,307,28,34,440,461,155,389,295,0,,74
15:05:41,5196.421,Fox,901,62,12,18,10,14,7,7,907,895,877,749,339,307,28,34,440,461,155,389,295,0,,74
15:05:41,5197.921,Fox,903,64,14,18,10,14,7,7,909,895,877,749,339,307,30,34,442,461,155,389,295,0,,76
15:05:42,5198.848,Fox,903,63,12,18,12,14,7,6,909,897,879,749,339,307,30,33,442,461,155,389,296,0,,75
15:05:42,5200.025,Fox,903,62,12,18,10,16,7,5,909,897,879,751,339,307,30,32,442,461,155,389,297,0,,74
15:05:43,5201.825,Fox,903,61,12,18,8,17,7,5,909,897,879,753,339,307,30,31,442,461,155,390,297,0,,73
15:05:45,5208.729,Fox,905,63,14,18,8,17,7,5,911,897,879,753,339,307,30,33,442,463,155,390,297,0,,75
15:05:46,5210.362,Fox,905,62,14,18,8,17,7,4,911,897,879,753,339,307,29,33,442,463,155,390,298,0,,74
15:05:46,5211.851,Fox,905,62,14,16,10,17,7,4,911,897,881,753,339,307,29,33,442,463,155,390,298,0,,74
15:05:47,5213.023,Fox,905,61,14,16,8,19,7,3,911,897,881,755,339,307,29,32,442,463,155,390,299,0,,73
15:05:47,5214.223,Fox,905,61,14,14,10,19,7,3,911,897,883,755,339,307,29,32,442,463,155,390,299,0,,73
15:05:48,5216.321,Fox,905,61,14,12,12,19,7,3,911,897,885,755,339,307,29,32,442,463,155,390,299,0,,73
15:05:48,5217.221,Fox,905,61,14,10,14,19,7,3,911,897,887,755,339,307,29,32,442,463,155,390,299,0,,73
15:05:49,5220.82,Fox,905,61,14,8,16,19,7,3,911,897,889,755,339,307,29,32,442,463,155,390,299,0,,73
15:05:50,5221.4,Fox,905,61,14,8,14,21,7,3,911,897,889,757,339,307,29,32,442,463,155,390,299,0,,73
15:05:50,5222.596,Fox,905,61,14,8,14,20,8,3,911,897,889,757,340,307,29,32,442,463,155,390,299,0,,73
15:05:51,5224.677,Fox,905,61,14,6,16,20,8,3,911,897,891,757,340,307,29,32,442,463,155,390,299,0,,73
15:05:51,5225.555,Fox,905,61,14,4,18,20,8,3,911,897,893,757,340,307,29,32,442,463,155,390,299,0,,73
15:05:52,5228.088,Fox,905,61,14,2,20,20,8,3,911,897,895,757,340,307,29,32,442,463,155,390,299,0,,73
15:05:52,5229.288,Fox,905,59,14,2,20,18,8,3,911,897,895,757,340,307,29,30,442,463,155,392,299,0,,71
15:05:53,5229.832,Fox,905,59,14,2,20,17,9,3,911,897,895,757,341,307,29,30,442,463,155,392,299,0,,71
15:05:53,5231.277,Fox,907,61,16,2,20,17,9,3,913,897,895,757,341,307,29,32,442,465,155,392,299,0,,73
15:05:54,5232.878,Fox,907,61,16,2,20,16,10,3,913,897,895,757,342,307,29,32,442,465,155,392,299,0,,73
15:05:54,5235.629,Fox,907,61,16,2,20,15,11,3,913,897,895,757,343,307,29,32,442,465,155,392,299,0,,73
15:05:55,5237.958,Fox,909,62,18,0,21,15,11,3,915,897,897,757,343,307,29,33,443,466,155,393,299,0,,74
15:05:56,5239.758,Fox,909,61,18,0,19,16,11,3,915,897,897,759,343,307,28,33,443,466,155,394,299,0,,73
15:05:56,5240.934,Fox,909,60,18,0,19,16,11,2,915,897,897,759,343,307,28,32,443,466,155,394,300,0,,72
15:05:57,5242.734,Fox,911,61,20,0,19,15,11,2,917,897,897,759,343,307,29,32,445,466,155,395,300,0,,73
15:06:01,5255.074,Fox,913,62,22,0,18,15,11,2,919,897,897,759,343,307,29,33,446,467,155,396,300,0,,74
15:06:01,5255.375,Fox,913,62,22,0,16,17,11,2,919,897,897,761,343,307,29,33,446,467,155,396,300,0,,74
15:06:02,5256.574,Fox,913,61,22,0,16,17,11,1,919,897,897,761,343,307,29,32,446,467,155,396,301,0,,73
15:06:02,5257.473,Fox,913,61,20,2,16,17,11,1,919,899,897,761,343,307,29,32,446,467,155,396,301,0,,73
15:06:03,5259.573,Fox,913,61,20,2,15,18,11,1,919,899,897,762,343,307,29,32,446,467,155,396,301,0,,73
15:06:05,5263.772,Fox,913,61,18,4,15,18,11,1,919,901,897,762,343,307,29,32,446,467,155,396,301,0,,73
15:06:06,5267.673,Fox,913,60,16,6,15,17,11,1,919,903,897,762,343,307,29,31,446,467,155,397,301,0,,72
15:06:06,5268.272,Fox,915,61,18,6,14,17,11,1,921,903,897,762,343,307,29,32,447,468,156,397,301,0,,73
15:06:07,5269.173,Fox,917,63,20,6,14,17,11,1,923,903,897,762,343,307,31,32,449,468,156,397,301,0,,75
15:06:07,5270.849,Fox,917,63,18,8,14,15,13,1,923,905,897,762,345,307,31,32,449,468,156,397,301,0,,75
15:06:08,5272.538,Fox,917,63,16,10,12,17,13,1,923,907,897,764,345,307,31,32,449,468,156,397,301,0,,75
15:06:08,5273.438,Fox,917,63,16,10,12,17,12,2,923,907,897,764,345,308,31,32,449,468,156,397,301,0,,75
15:06:08,5274.038,Fox,917,63,16,10,12,17,11,3,923,907,897,764,345,309,31,32,449,468,156,397,301,0,,75
15:06:08,5274.638,Fox,917,63,16,10,10,19,11,3,923,907,897,766,345,309,31,32,449,468,156,397,301,0,,75
15:06:09,5275.538,Fox,919,65,18,10,10,19,11,3,925,907,897,766,345,309,32,33,450,469,156,397,301,0,,77
15:06:09,5276.484,Fox,921,67,20,10,8,21,11,3,927,907,897,768,345,309,33,34,451,470,156,397,301,0,,79
15:06:09,5277.118,Fox,921,67,20,10,8,19,13,3,927,907,897,768,347,309,33,34,451,470,156,397,301,0,,79
15:06:09,5277.405,Fox,921,67,20,10,7,20,13,3,927,907,897,769,347,309,33,34,451,470,156,397,301,0,,79
15:06:10,5277.701,Fox,921,67,20,10,7,18,15,3,927,907,897,769,349,309,33,34,451,470,156,397,301,0,,79
15:06:10,5279.201,Fox,921,67,20,10,7,18,14,4,927,907,897,769,349,310,33,34,451,470,156,397,301,0,,79
15:06:11,5280.701,Fox,921,67,18,12,7,18,13,5,927,909,897,769,349,311,33,34,451,470,156,397,301,0,,79
15:06:11,5281.301,Fox,921,67,18,12,5,20,13,5,927,909,897,771,349,311,33,34,451,470,156,397,301,0,,79
15:06:12,5283.699,Fox,921,66,18,12,5,19,13,5,927,909,897,771,349,311,33,33,451,470,156,398,301,0,,78
15:06:12,5284.964,Fox,921,66,18,12,4,20,13,5,927,909,897,772,349,311,33,33,451,470,156,398,301,0,,78
15:06:13,5286.055,Fox,921,66,18,12,2,22,13,5,927,909,897,774,349,311,33,33,451,470,156,398,301,0,,78
15:06:13,5286.955,Fox,921,65,18,12,2,22,13,4,927,909,897,774,349,311,32,33,451,470,156,398,302,0,,77
15:06:13,5288.066,Fox,921,65,18,12,2,22,10,7,927,909,897,774,349,314,32,33,451,470,156,398,302,0,,77
15:06:13,5288.613,Fox,921,64,18,12,0,23,10,7,927,909,897,776,349,314,32,32,451,470,156,399,302,0,,76
15:06:14,5289.946,Fox,921,64,18,12,0,22,11,7,927,909,897,776,350,314,32,32,451,470,156,399,302,0,,76
15:06:14,5291.407,Fox,921,64,16,14,0,22,11,7,927,911,897,776,350,314,32,32,451,470,156,399,302,0,,76
15:06:15,5292.254,Fox,923,66,18,14,0,22,11,7,929,911,897,776,350,314,33,33,452,471,156,399,302,0,,78
15:06:15,5293.454,Fox,923,66,18,14,0,20,13,7,929,911,897,776,352,314,33,33,452,471,156,399,302,0,,78
15:06:16,5296.154,Fox,923,66,18,12,2,20,13,7,929,911,899,776,352,314,33,33,452,471,156,399,302,0,,78
15:06:17,5298.186,Fox,923,66,18,12,0,22,13,7,929,911,899,778,352,314,33,33,452,471,156,399,302,0,,78
15:06:18,5301.786,Fox,923,64,18,12,0,20,13,7,929,911,899,778,352,314,32,32,452,471,157,400,302,0,,76
15:06:19,5302.386,Fox,923,64,18,10,2,20,13,7,929,911,901,778,352,314,32,32,452,471,157,400,302,0,,76
15:06:20,5305.686,Fox,923,64,18,8,4,20,13,7,929,911,903,778,352,314,32,32,452,471,157,400,302,0,,76
15:06:20,5306.285,Fox,923,64,18,8,4,19,14,7,929,911,903,778,353,314,32,32,452,471,157,400,302,0,,76
15:06:21,5309.285,Fox,923,64,18,6,6,19,14,7,929,911,905,778,353,314,32,32,452,471,157,400,302,0,,76
15:06:21,5309.898,Fox,925,66,20,6,6,19,14,7,931,911,905,778,353,314,32,34,452,473,157,400,302,0,,78
15:06:22,5310.959,Fox,925,66,20,4,8,19,14,7,931,911,907,778,353,314,32,34,452,473,157,400,302,0,,78
15:06:22,5312.707,Fox,925,64,20,4,8,17,14,7,931,911,907,778,353,314,32,32,452,473,159,400,302,0,,76
15:06:23,5314.089,Fox,925,64,18,6,8,17,14,7,931,913,907,778,353,314,32,32,452,473,159,400,302,0,,76
15:06:23,5314.661,Fox,925,64,18,6,8,16,15,7,931,913,907,778,354,314,32,32,452,473,159,400,302,0,,76
15:06:25,5318.561,Fox,927,65,20,6,8,15,15,7,933,913,907,778,354,314,32,33,452,475,160,400,302,0,,77
15:06:25,5319.161,Fox,927,65,20,4,10,15,15,7,933,913,909,778,354,314,32,33,452,475,160,400,302,0,,77
15:06:25,5319.761,Fox,927,64,20,4,10,15,15,6,933,913,909,778,354,314,32,32,452,475,160,400,303,0,,76
15:06:25,5320.492,Fox,927,64,18,6,10,15,15,6,933,915,909,778,354,314,32,32,452,475,160,400,303,0,,76
15:06:27,5323.434,Fox,929,65,20,6,10,14,15,6,935,915,909,778,354,314,32,33,453,476,161,400,303,0,,77
15:06:27,5325.534,Fox,931,67,20,8,10,14,15,6,937,917,909,778,354,314,32,35,453,478,161,400,303,0,,79
15:06:29,5328.834,Fox,931,66,20,8,10,14,15,5,937,917,909,778,354,314,32,34,453,478,161,400,304,0,,78
15:06:29,5329.881,Fox,931,66,20,6,12,14,15,5,937,917,911,778,354,314,32,34,453,478,161,400,304,0,,78
15:06:30,5331.381,Fox,931,65,20,6,12,13,15,5,937,917,911,778,354,314,32,33,453,478,162,400,304,0,,77
15:06:30,5332.848,Fox,931,65,20,6,12,12,16,5,937,917,911,778,355,314,32,33,453,478,162,400,304,0,,77
15:06:32,5337.648,Fox,931,65,18,8,12,12,16,5,937,919,911,778,355,314,32,33,453,478,162,400,304,0,,77
15:06:32,5338.848,Fox,931,64,18,8,12,12,16,4,937,919,911,778,355,314,31,33,453,478,162,400,305,0,,76
15:06:33,5340.048,Fox,933,65,20,8,11,12,16,4,939,919,911,778,355,314,32,33,455,478,162,401,305,0,,77
15:06:36,5349.015,Fox,933,65,20,8,11,11,17,4,939,919,911,778,356,314,32,33,455,478,162,401,305,0,,77
15:06:37,5351.115,Fox,935,67,20,10,11,11,17,4,941,921,911,778,356,314,33,34,456,479,162,401,305,0,,79
15:06:38,5351.715,Fox,935,67,18,12,11,11,17,4,941,923,911,778,356,314,33,34,456,479,162,401,305,0,,79
15:06:38,5352.615,Fox,939,70,20,10,12,11,17,4,943,923,913,778,356,314,35,35,459,480,162,402,305,0,,82
15:06:38,5352.915,Fox,939,70,22,10,12,11,17,4,945,923,913,778,356,314,35,35,459,480,162,402,305,0,,82
15:06:39,5354.715,Fox,943,73,26,10,11,11,17,4,949,923,913,778,356,314,38,35,463,480,162,403,305,0,,85
15:06:40,5356.515,Fox,943,73,26,10,10,12,17,4,949,923,913,779,356,314,38,35,463,480,162,403,305,0,,85
15:06:40,5358.315,Fox,943,73,24,12,10,12,17,4,949,925,913,779,356,314,38,35,463,480,162,403,305,0,,85
15:06:41,5359.515,Fox,945,75,24,12,12,12,17,4,951,927,915,779,356,314,39,36,464,481,162,403,305,0,,87
15:06:41,5360.115,Fox,945,75,24,12,12,12,16,5,951,927,915,779,356,315,39,36,464,481,162,403,305,0,,87
15:06:42,5362.815,Fox,947,77,26,12,11,13,16,5,953,927,915,780,356,315,39,38,464,483,162,403,305,0,,89
15:06:43,5363.963,Fox,949,79,28,10,13,13,16,5,955,927,917,780,356,315,40,39,465,484,162,403,305,0,,91
15:06:43,5364.864,Fox,949,78,28,10,13,13,16,4,955,927,917,780,356,315,39,39,465,484,162,403,306,0,,90
15:06:43,5365.764,Fox,951,79,30,10,13,13,16,3,957,927,917,780,356,315,40,39,466,485,162,403,307,0,,91
15:06:43,5366.364,Fox,951,79,30,10,12,14,16,3,957,927,917,781,356,315,40,39,466,485,162,403,307,0,,91
15:06:44,5367.264,Fox,951,79,30,10,12,14,15,4,957,927,917,781,356,316,40,39,466,485,162,403,307,0,,91
15:06:44,5368.163,Fox,951,79,30,10,12,12,17,4,957,927,917,781,358,316,40,39,466,485,162,403,307,0,,91
15:06:44,5369.446,Fox,951,79,30,10,10,14,17,4,957,927,917,783,358,316,40,39,466,485,162,403,307,0,,91
15:06:45,5370.531,Fox,951,79,30,10,10,12,18,5,957,927,917,783,360,317,40,39,466,485,162,403,307,0,,91
15:06:45,5371.41,Fox,951,78,30,10,8,13,19,4,957,927,917,785,361,317,39,39,466,485,162,403,308,0,,90
15:06:46,5373.21,Fox,951,78,30,10,8,13,18,5,957,927,917,785,361,318,39,39,466,485,162,403,308,0,,90
15:06:47,5375.213,Fox,953,79,28,12,7,13,18,5,957,929,917,785,361,318,39,40,467,486,162,404,308,0,,91
15:06:47,5375.513,Fox,953,79,30,12,7,13,18,5,959,929,917,785,361,318,39,40,467,486,162,404,308,0,,91
15:06:47,5376.109,Fox,953,79,30,10,9,13,18,5,959,929,919,785,361,318,39,40,467,486,162,404,308,0,,91
15:06:48,5379.704,Fox,953,79,30,10,8,12,20,5,959,929,919,786,363,318,39,40,467,486,162,404,308,0,,91
15:06:49,5382.104,Fox,953,79,30,10,8,10,22,5,959,929,919,786,365,318,39,40,467,486,162,404,308,0,,91
15:06:51,5387.504,Fox,953,78,30,10,8,9,22,5,959,929,919,786,365,318,39,39,467,486,162,405,308,0,,90
15:06:52,5389.304,Fox,953,78,30,8,10,9,22,5,959,929,921,786,365,318,39,39,467,486,162,405,308,0,,90
15:06:52,5390.204,Fox,955,80,32,6,12,9,22,5,961,929,923,786,365,318,39,41,467,488,162,405,308,0,,92
15:06:53,5390.804,Fox,955,79,32,6,10,10,22,5,961,929,923,788,365,318,39,40,467,488,162,406,308,0,,91
15:06:53,5392.604,Fox,955,79,30,8,10,10,22,5,961,931,923,788,365,318,39,40,467,488,162,406,308,0,,91
15:06:54,5394.007,Fox,955,78,30,8,10,9,22,5,961,931,923,788,365,318,39,39,467,488,162,407,308,0,,90
15:06:55,5396.655,Fox,955,78,30,6,12,9,22,5,961,931,925,788,365,318,39,39,467,488,162,407,308,0,,90
15:06:55,5397.855,Fox,955,77,30,4,14,9,22,4,961,931,927,788,365,318,39,38,467,488,162,407,309,0,,89
15:06:56,5401.012,Fox,955,77,28,6,14,9,22,4,961,933,927,788,365,318,39,38,467,488,162,407,309,0,,89
15:06:59,5406.112,Fox,957,79,28,8,14,9,22,4,963,935,927,788,365,318,39,40,467,490,162,407,309,0,,91
15:06:59,5406.668,Fox,959,80,30,8,13,9,22,4,965,935,927,788,365,318,39,41,468,491,162,408,309,0,,92
15:06:59,5408.373,Fox,959,80,28,10,13,9,20,6,965,937,927,788,365,320,39,41,468,491,162,408,309,0,,92
15:07:00,5410.339,Fox,961,82,30,10,13,9,20,6,967,937,927,788,365,320,40,42,469,492,162,408,309,0,,94
15:07:01,5412.742,Fox,961,82,30,10,11,11,20,6,967,937,927,790,365,320,40,42,469,492,162,408,309,0,,94
15:07:01,5413.187,Fox,961,82,30,8,13,11,20,6,967,937,929,790,365,320,40,42,469,492,162,408,309,0,,94
15:07:02,5414.592,Fox,961,82,30,8,13,11,18,8,967,937,929,790,365,322,40,42,469,492,162,408,309,0,,94
15:07:02,5415.492,Fox,961,82,30,8,13,11,16,10,967,937,929,790,365,324,40,42,469,492,162,408,309,0,,94
15:07:04,5419.992,Fox,961,81,30,8,12,12,16,9,967,937,929,791,365,324,40,41,469,492,162,408,310,0,,93
15:07:05,5422.992,Fox,961,80,28,10,12,11,16,9,967,939,929,791,365,324,40,40,469,492,162,409,310,0,,92
15:07:06,5424.792,Fox,963,82,28,10,10,13,16,9,967,939,929,793,365,324,42,40,471,492,162,409,310,0,,94
15:07:06,5425.092,Fox,963,82,30,10,10,13,16,9,969,939,929,793,365,324,42,40,471,492,162,409,310,0,,94
15:07:07,5427.492,Fox,963,82,30,10,10,13,15,10,969,939,929,793,365,325,42,40,471,492,162,409,310,0,,94
15:07:07,5428.692,Fox,965,84,32,10,10,13,15,10,971,939,929,793,365,325,42,42,471,494,162,409,310,0,,96
15:07:08,5430.492,Fox,967,85,34,10,10,12,15,10,973,939,929,793,365,325,42,43,472,495,163,409,310,0,,97
15:07:08,5431.092,Fox,967,85,34,8,12,12,13,12,973,939,931,793,365,327,42,43,472,495,163,409,310,0,,97
15:07:09,5433.192,Fox,969,86,36,8,11,12,13,12,975,939,931,793,365,327,42,44,473,496,164,409,310,0,,98
15:07:09,5433.792,Fox,969,86,34,10,11,12,13,12,975,941,931,793,365,327,42,44,473,496,164,409,310,0,,98
15:07:10,5435.592,Fox,969,86,30,14,11,12,13,12,975,945,931,793,365,327,42,44,473,496,164,409,310,0,,98
15:07:10,5436.792,Fox,969,86,30,14,9,14,13,12,975,945,931,795,365,327,42,44,473,496,164,409,310,0,,98
15:07:10,5437.392,Fox,969,86,26,18,9,14,13,12,975,949,931,795,365,327,42,44,473,496,164,409,310,0,,98
15:07:11,5439.567,Fox,969,86,26,16,11,14,13,12,975,949,933,795,365,327,42,44,473,496,164,409,310,0,,98
15:07:12,5441.367,Fox,969,85,26,16,11,14,13,11,975,949,933,795,365,327,42,43,473,496,164,409,311,0,,97
15:07:12,5442.267,Fox,969,85,24,18,11,14,13,11,975,951,933,795,365,327,42,43,473,496,164,409,311,0,,97
15:07:13,5444.367,Fox,969,84,24,18,11,14,12,11,975,951,933,795,365,328,42,42,473,496,164,409,312,0,,96
15:07:13,5444.667,Fox,969,84,24,16,13,14,12,11,975,951,935,795,365,328,42,42,473,496,164,409,312,0,,96
15:07:13,5445.567,Fox,969,83,22,18,13,14,12,10,975,953,935,795,365,328,41,42,473,496,164,409,313,0,,95
15:07:14,5446.767,Fox,969,83,20,18,15,14,12,10,975,955,937,795,365,328,41,42,473,496,164,409,313,0,,95
15:07:15,5448.267,Fox,969,83,18,20,15,14,12,10,975,957,937,795,365,328,41,42,473,496,164,409,313,0,,95
15:07:15,5450.067,Fox,969,83,18,20,13,16,12,10,975,957,937,797,365,328,41,42,473,496,164,409,313,0,,95
15:07:16,5451.267,Fox,969,82,18,20,11,17,12,10,975,957,937,799,365,328,40,42,473,496,165,409,313,0,,94
15:07:16,5451.716,Fox,971,83,20,20,10,17,12,10,977,957,937,799,365,328,40,43,474,497,166,409,313,0,,95
15:07:16,5452.15,Fox,971,83,20,20,10,17,11,11,977,957,937,799,365,329,40,43,474,497,166,409,313,0,,95
15:07:16,5453.35,Fox,973,85,22,20,10,17,11,11,979,957,937,799,365,329,40,45,474,499,166,409,313,0,,97
15:07:17,5454.25,Fox,975,87,24,20,10,17,11,11,981,957,937,799,365,329,41,46,475,500,166,409,313,0,,99
15:07:18,5457.25,Fox,975,87,24,20,8,19,11,11,981,957,937,801,365,329,41,46,475,500,166,409,313,0,,99
15:07:18,5458.15,Fox,975,87,22,22,7,20,11,11,981,959,937,802,365,329,41,46,475,500,166,409,313,0,,99
15:07:19,5459.35,Fox,975,86,22,22,7,20,11,10,981,959,937,802,365,329,41,45,475,500,166,409,314,0,,98
15:07:19,5460.55,Fox,975,85,22,22,7,19,11,10,981,959,937,802,365,329,41,44,475,500,166,410,314,0,,97
15:07:20,5461.15,Fox,975,85,22,20,9,19,11,10,981,959,939,802,365,329,41,44,475,500,166,410,314,0,,97
15:07:20,5461.978,Fox,977,87,24,20,9,19,11,10,983,959,939,802,365,329,43,44,477,500,166,410,314,0,,99
15:07:20,5462.962,Fox,977,87,24,20,9,17,13,10,983,959,939,802,367,329,43,44,477,500,166,410,314,0,,99
15:07:21,5464.946,Fox,977,87,24,20,9,15,15,10,983,959,939,802,369,329,43,44,477,500,166,410,314,0,,99
15:07:22,5468.246,Fox,977,86,24,20,9,15,15,9,983,959,939,802,369,329,42,44,477,500,166,410,315,0,,98
15:07:23,5470.436,Fox,977,86,24,20,9,15,14,10,983,959,939,802,369,330,42,44,477,500,166,410,315,0,,98
15:07:24,5472.215,Fox,977,86,24,18,11,15,14,10,983,959,941,802,369,330,42,44,477,500,166,410,315,0,,98
15:07:24,5473.115,Fox,977,86,22,20,11,14,15,10,983,961,941,802,370,330,42,44,477,500,166,410,315,0,,98
15:07:24,5474.015,Fox,977,86,22,16,14,15,15,10,983,961,945,803,370,330,42,44,477,500,166,410,315,0,,98
15:07:25,5475.815,Fox,977,86,22,12,18,15,15,10,983,961,949,803,370,330,42,44,477,500,166,410,315,0,,98
15:07:25,5476.715,Fox,977,85,22,12,18,15,15,9,983,961,949,803,370,330,41,44,477,500,166,410,316,0,,97
15:07:25,5477.315,Fox,977,83,22,12,18,13,15,9,983,961,949,803,370,330,40,43,477,500,168,410,316,0,,95
15:07:27,5480.615,Fox,977,83,22,10,20,13,15,9,983,961,951,803,370,330,40,43,477,500,168,410,316,0,,95
15:07:27,5482.115,Fox,977,82,22,10,20,13,15,8,983,961,951,803,370,330,39,43,477,500,168,410,317,0,,94
15:07:28,5483.865,Fox,977,82,22,8,22,12,16,8,983,961,953,803,371,330,39,43,477,500,168,410,317,0,,94
15:07:29,5485.365,Fox,977,79,22,6,24,9,16,8,983,961,955,803,371,330,38,41,477,500,169,412,317,0,,91
15:07:29,5486.865,Fox,977,79,22,4,26,9,15,9,983,961,957,803,371,331,38,41,477,500,169,412,317,0,,91
15:07:30,5488.666,Fox,977,79,20,6,26,9,15,9,983,963,957,803,371,331,38,41,477,500,169,412,317,0,,91
15:07:30,5489.266,Fox,977,79,18,8,26,9,15,9,983,965,957,803,371,331,38,41,477,500,169,412,317,0,,91
15:07:30,5489.865,Fox,977,78,18,8,26,9,15,8,983,965,957,803,371,331,37,41,477,500,169,412,318,0,,90
15:07:31,5491.666,Fox,977,78,18,8,24,11,15,8,983,965,957,805,371,331,37,41,477,500,169,412,318,0,,90
15:07:31,5492.865,Fox,977,78,16,10,24,11,15,8,983,967,957,805,371,331,37,41,477,500,169,412,318,0,,90
15:07:33,5497.065,Fox,977,77,16,8,26,11,15,7,983,967,959,805,371,331,36,41,477,500,169,412,319,0,,89
15:07:34,5498.565,Fox,979,79,18,8,26,11,15,7,985,967,959,805,371,331,38,41,479,500,169,412,319,0,,91
15:07:34,5500.065,Fox,981,81,20,8,24,13,15,7,987,967,959,807,371,331,39,42,480,501,169,412,319,0,,93
15:07:35,5502.465,Fox,981,80,20,8,24,13,15,6,987,967,959,807,371,331,39,41,480,501,169,412,320,0,,92
15:07:36,5505.022,Fox,985,84,22,8,22,15,15,6,989,967,959,809,371,331,41,43,482,503,169,412,320,0,,96
15:07:36,5505.622,Fox,985,84,24,8,22,15,13,8,991,967,959,809,371,333,41,43,482,503,169,412,320,0,,96
15:07:37,5506.522,Fox,985,84,24,8,22,13,15,8,991,967,959,809,373,333,41,43,482,503,169,412,320,0,,96
15:07:37,5507.122,Fox,985,84,24,8,20,15,15,8,991,967,959,811,373,333,41,43,482,503,169,412,320,0,,96
15:07:37,5507.722,Fox,985,84,22,10,20,15,13,10,991,969,959,811,373,335,41,43,482,503,169,412,320,0,,96
15:07:38,5508.622,Fox,985,84,22,10,20,15,12,11,991,969,959,811,373,336,41,43,482,503,169,412,320,0,,96
15:07:38,5509.822,Fox,987,86,24,10,20,15,12,11,993,969,959,811,373,336,42,44,483,504,169,412,320,0,,98
15:07:38,5510.717,Fox,989,87,26,10,20,14,12,11,995,969,959,811,373,336,42,45,484,505,169,413,320,0,,99
15:07:39,5511.316,Fox,989,87,24,10,22,14,12,11,995,971,961,811,373,336,42,45,484,505,169,413,320,0,,99
15:07:39,5513.115,Fox,989,87,22,12,22,14,12,11,995,973,961,811,373,336,42,45,484,505,169,413,320,0,,99
15:07:40,5515.814,Fox,989,87,20,14,22,14,12,11,995,975,961,811,373,336,42,45,484,505,169,413,320,0,,99
15:07:41,5517.015,Fox,989,87,20,14,22,14,10,13,995,975,961,811,373,338,42,45,484,505,169,413,320,0,,99
15:07:42,5519.715,Fox,989,87,20,14,22,14,8,15,995,975,961,811,373,340,42,45,484,505,169,413,320,0,,99
15:07:43,5521.814,Fox,989,87,20,14,20,16,8,15,995,975,961,813,373,340,42,45,484,505,169,413,320,0,,99
15:07:43,5523.314,Fox,991,88,22,14,19,16,8,15,997,975,961,813,373,340,41,47,484,507,170,413,320,0,,100
15:07:44,5525.317,Fox,991,87,22,14,19,16,8,14,997,975,961,813,373,340,40,47,484,507,170,413,321,0,,99
15:07:45,5527.117,Fox,991,87,22,12,21,16,8,14,997,975,963,813,373,340,40,47,484,507,170,413,321,0,,99
15:07:45,5527.717,Fox,991,85,22,10,23,14,8,14,997,975,965,813,373,340,40,45,484,507,170,415,321,0,,97
15:07:46,5530.117,Fox,991,85,22,10,23,12,10,14,997,975,965,813,375,340,40,45,484,507,170,415,321,0,,97
15:07:47,5531.425,Fox,991,85,22,8,25,12,10,14,997,975,967,813,375,340,40,45,484,507,170,415,321,0,,97
15:07:47,5532.885,Fox,991,83,22,8,23,13,10,13,997,975,967,815,375,340,39,44,484,507,170,416,322,0,,95
15:07:48,5534.679,Fox,991,82,20,10,19,16,10,13,997,977,967,819,375,340,39,43,484,507,170,417,322,0,,94
15:07:48,5535.279,Fox,993,83,22,10,18,16,10,13,999,977,967,819,375,340,38,45,484,509,171,417,322,0,,95
15:07:48,5535.879,Fox,993,83,20,12,18,16,10,13,999,979,967,819,375,340,38,45,484,509,171,417,322,0,,95
15:07:49,5536.779,Fox,993,82,18,14,14,20,10,12,999,981,967,823,375,340,38,44,484,509,171,417,323,0,,94
15:07:49,5537.379,Fox,993,81,18,14,14,20,10,11,999,981,967,823,375,340,37,44,484,509,171,417,324,0,,93
15:07:49,5538.279,Fox,993,80,18,14,14,20,10,10,999,981,967,823,375,340,37,43,484,509,171,417,325,0,,92
15:07:50,5541.268,Fox,993,80,18,14,12,22,10,10,999,981,967,825,375,340,37,43,484,509,171,417,325,0,,92
15:07:51,5543.05,Fox,995,82,20,14,12,22,10,10,1001,981,967,825,375,340,39,43,486,509,171,417,325,0,,94
15:07:52,5544.55,Fox,997,84,22,14,10,22,12,10,1003,981,967,827,377,340,41,43,488,509,171,417,325,0,,96
15:07:52,5544.85,Fox,997,84,20,16,10,22,12,10,1003,983,967,827,377,340,41,43,488,509,171,417,325,0,,96
15:07:52,5545.75,Fox,997,84,20,16,9,23,12,10,1003,983,967,828,377,340,41,43,488,509,171,417,325,0,,96
15:07:52,5546.35,Fox,997,84,20,14,11,23,12,10,1003,983,969,828,377,340,41,43,488,509,171,417,325,0,,96
15:07:53,5547.55,Fox,997,84,20,14,10,24,12,10,1003,983,969,829,377,340,41,43,488,509,171,417,325,0,,96
15:07:54,5549.95,Fox,997,84,20,12,12,24,12,10,1003,983,971,829,377,340,41,43,488,509,171,417,325,0,,96
15:07:54,5551.75,Fox,997,84,20,10,14,24,12,10,1003,983,973,829,377,340,41,43,488,509,171,417,325,0,,96
15:07:56,5554.45,Fox,997,84,20,8,16,24,12,10,1003,983,975,829,377,340,41,43,488,509,171,417,325,0,,96
15:07:56,5556.452,Fox,997,83,20,8,16,24,12,9,1003,983,975,829,377,340,40,43,488,509,171,417,326,0,,95
15:07:57,5557.052,Fox,997,83,20,8,14,26,12,9,1003,983,975,831,377,340,40,43,488,509,171,417,326,0,,95
15:07:58,5560.267,Fox,997,82,20,8,14,26,12,8,1003,983,975,831,377,340,40,42,488,509,171,417,327,0,,94
15:08:00,5567.022,Fox,999,83,22,8,14,25,12,8,1005,983,975,831,377,340,39,44,488,511,171,418,327,0,,95
15:08:00,5567.311,Fox,999,83,22,8,14,24,13,8,1005,983,975,831,378,340,39,44,488,511,171,418,327,0,,95
15:08:01,5568.811,Fox,999,81,22,8,14,23,13,7,1005,983,975,831,378,340,37,44,488,511,171,419,328,0,,93
15:08:02,5571.811,Fox,999,80,22,8,12,25,13,6,1005,983,975,833,378,340,36,44,488,511,171,419,329,0,,92
15:08:02,5572.71,Fox,1001,82,24,8,12,25,13,6,1007,983,975,833,378,340,36,46,488,513,171,419,329,0,,94
15:08:02,5573.011,Fox,1001,82,24,6,14,25,13,6,1007,983,977,833,378,340,36,46,488,513,171,419,329,0,,94
15:08:03,5574.511,Fox,1001,82,24,4,16,25,13,6,1007,983,979,833,378,340,36,46,488,513,171,419,329,0,,94
15:08:03,5575.71,Fox,1003,84,24,2,18,25,13,6,1007,983,981,833,378,340,37,47,489,514,171,419,329,0,,96
15:08:03,5576.011,Fox,1003,84,26,2,18,25,13,6,1009,983,981,833,378,340,37,47,489,514,171,419,329,0,,96
15:08:04,5577.132,Fox,1003,83,26,2,18,24,13,6,1009,983,981,833,378,340,37,46,489,514,172,419,329,0,,95
15:08:05,5580.432,Fox,1005,84,28,2,18,23,13,6,1011,983,981,833,378,340,38,46,491,514,172,420,329,0,,96
15:08:05,5581.333,Fox,1005,84,26,4,18,23,13,6,1011,985,981,833,378,340,38,46,491,514,172,420,329,0,,96
15:08:06,5582.833,Fox,1007,86,26,6,18,23,13,6,1013,987,981,833,378,340,38,48,491,516,172,420,329,0,,98
15:08:06,5583.132,Fox,1007,86,26,4,20,23,13,6,1013,987,983,833,378,340,38,48,491,516,172,420,329,0,,98
15:08:07,5584.333,Fox,1007,84,26,4,20,22,13,5,1013,987,983,833,378,340,38,46,491,516,172,421,330,0,,96
15:08:07,5585.232,Fox,1007,84,26,4,20,20,15,5,1013,987,983,833,380,340,38,46,491,516,172,421,330,0,,96
15:08:08,5587.932,Fox,1009,85,24,8,17,22,15,5,1015,991,983,835,380,340,38,47,492,517,172,422,330,0,,97
15:08:08,5588.232,Fox,1009,85,24,8,15,24,15,5,1015,991,983,837,380,340,38,47,492,517,172,422,330,0,,97
15:08:09,5589.902,Fox,1009,84,24,8,15,24,15,4,1015,991,983,837,380,340,38,46,492,517,172,422,331,0,,96
15:08:10,5592.002,Fox,1009,84,24,8,13,26,15,4,1015,991,983,839,380,340,38,46,492,517,172,422,331,0,,96
15:08:10,5592.602,Fox,1009,84,22,10,13,26,15,4,1015,993,983,839,380,340,38,46,492,517,172,422,331,0,,96
15:08:11,5593.802,Fox,1011,86,22,12,13,26,15,4,1017,995,983,839,380,340,38,48,492,519,172,422,331,0,,98
15:08:12,5596.802,Fox,1011,85,22,12,13,26,15,3,1017,995,983,839,380,340,38,47,492,519,172,422,332,0,,97
15:08:12,5598.215,Fox,1013,87,24,12,13,26,15,3,1019,995,983,839,380,340,38,49,492,521,172,422,332,0,,99
15:08:13,5599.115,Fox,1015,89,26,12,13,26,15,3,1021,995,983,839,380,340,38,51,492,523,172,422,332,0,,101
15:08:13,5600.615,Fox,1015,86,26,12,13,23,14,4,1021,995,983,839,381,342,38,48,492,523,174,422,333,0,,98
15:08:14,5602.22,Fox,1015,86,26,12,13,23,12,6,1021,995,983,839,381,344,38,48,492,523,174,422,333,0,,98
15:08:16,5605.815,Fox,1015,86,24,14,13,23,12,6,1021,997,983,839,381,344,38,48,492,523,174,422,333,0,,98
15:08:16,5606.715,Fox,1015,86,24,14,12,24,12,6,1021,997,983,840,381,344,38,48,492,523,174,422,333,0,,98
15:08:17,5608.515,Fox,1017,88,26,14,12,24,12,6,1023,997,983,840,381,344,39,49,493,524,174,422,333,0,,100
15:08:17,5608.815,Fox,1017,87,26,14,12,24,12,5,1023,997,983,840,381,344,39,48,493,524,174,422,334,0,,99
15:08:18,5610.615,Fox,1017,87,26,14,10,26,11,6,1023,997,983,842,381,345,39,48,493,524,174,422,334,0,,99
15:08:18,5612.115,Fox,1017,87,26,14,8,28,11,6,1023,997,983,844,381,345,39,48,493,524,174,422,334,0,,99
15:08:20,5615.115,Fox,1017,87,26,14,6,28,13,6,1023,997,983,846,383,345,39,48,493,524,174,422,334,0,,99
15:08:20,5616.315,Fox,1017,86,26,14,6,27,13,6,1023,997,983,846,383,345,38,48,493,524,174,423,334,0,,98
15:08:21,5618.115,Fox,1019,88,24,16,6,27,13,6,1023,999,983,846,383,345,38,50,493,526,174,423,334,0,,100
15:08:21,5618.415,Fox,1019,88,26,16,6,27,13,6,1025,999,983,846,383,345,38,50,493,526,174,423,334,0,,100
15:08:21,5619.315,Fox,1021,89,28,16,5,27,13,6,1027,999,983,846,383,345,39,50,495,526,174,424,334,0,,101
15:08:22,5619.615,Fox,1021,89,28,14,7,27,13,6,1027,999,985,846,383,345,39,50,495,526,174,424,334,0,,101
15:08:22,5621.415,Fox,1021,89,28,12,9,27,12,7,1027,999,987,846,383,346,39,50,495,526,174,424,334,0,,101
15:08:24,5625.615,Fox,1021,89,26,14,9,27,12,7,1027,1001,987,846,383,346,39,50,495,526,174,424,334,0,,101
15:08:24,5626.515,Fox,1023,91,28,10,13,25,14,7,1029,1001,991,846,385,346,41,50,497,526,174,424,334,0,,103
15:08:25,5627.115,Fox,1023,91,26,12,13,25,14,7,1029,1003,991,846,385,346,41,50,497,526,174,424,334,0,,103
15:08:25,5628.015,Fox,1023,91,26,12,13,22,17,7,1029,1003,991,846,388,346,41,50,497,526,174,424,334,0,,103
15:08:26,5629.815,Fox,1023,90,26,12,13,18,20,7,1029,1003,991,846,391,346,41,49,497,526,174,425,334,0,,102
15:08:26,5630.715,Fox,1025,91,28,12,13,17,20,7,1031,1003,991,846,391,346,41,50,498,527,175,425,334,0,,103
15:08:26,5631.315,Fox,1025,90,28,10,15,17,20,6,1031,1003,993,846,391,346,40,50,498,527,175,425,335,0,,102
15:08:27,5631.915,Fox,1025,90,28,8,17,17,20,6,1031,1003,995,846,391,346,40,50,498,527,175,425,335,0,,102
15:08:27,5633.415,Fox,1025,90,28,8,15,19,20,6,1031,1003,995,848,391,346,40,50,498,527,175,425,335,0,,102
15:08:28,5634.615,Fox,1027,90,30,8,15,15,22,6,1033,1003,995,848,393,346,41,49,499,528,177,425,335,0,,102
15:08:28,5635.215,Fox,1029,92,32,8,13,17,22,6,1035,1003,995,850,393,346,42,50,500,529,177,425,335,0,,104
15:08:28,5636.115,Fox,1029,91,32,8,12,17,22,6,1035,1003,995,851,393,346,42,49,500,529,177,426,335,0,,103
15:08:29,5637.915,Fox,1029,91,32,8,12,15,24,6,1035,1003,995,851,395,346,42,49,500,529,177,426,335,0,,103
15:08:29,5638.815,Fox,1029,90,32,8,12,14,24,6,1035,1003,995,851,395,346,41,49,500,529,177,427,335,0,,102
15:08:30,5640.915,Fox,1029,90,32,8,12,13,25,6,1035,1003,995,851,396,346,41,49,500,529,177,427,335,0,,102
15:08:30,5641.37,Fox,1029,89,32,8,12,13,25,5,1035,1003,995,851,396,346,41,48,500,529,177,427,336,0,,101
15:08:31,5643.974,Fox,1029,89,32,8,10,15,23,7,1035,1003,995,853,396,348,41,48,500,529,177,427,336,0,,101
15:08:32,5644.552,Fox,1029,89,32,6,12,15,23,7,1035,1003,997,853,396,348,41,48,500,529,177,427,336,0,,101
15:08:34,5649.913,Fox,1029,89,30,8,12,15,23,7,1035,1005,997,853,396,348,41,48,500,529,177,427,336,0,,101
15:08:35,5651.861,Fox,1031,91,32,8,12,15,23,7,1037,1005,997,853,396,348,42,49,501,530,177,427,336,0,,103
15:08:36,5655.347,Fox,1031,91,30,10,12,15,23,7,1037,1007,997,853,396,348,42,49,501,530,177,427,336,0,,103
15:08:36,5656.547,Fox,1031,91,30,8,14,15,23,7,1037,1007,999,853,396,348,42,49,501,530,177,427,336,0,,103
15:08:37,5658.647,Fox,1031,91,28,10,14,15,23,7,1037,1009,999,853,396,348,42,49,501,530,177,427,336,0,,103
15:08:39,5661.647,Fox,1033,93,30,10,14,15,23,7,1039,1009,999,853,396,348,44,49,503,530,177,427,336,0,,105
15:08:39,5662.847,Fox,1037,97,34,10,14,15,23,7,1043,1009,999,853,396,348,45,52,504,533,177,427,336,0,,109
15:08:39,5663.447,Fox,1037,96,32,12,14,15,23,6,1043,1011,999,853,396,348,44,52,504,533,177,427,337,0,,108
15:08:40,5664.347,Fox,1039,97,34,10,16,14,23,6,1045,1011,1001,853,396,348,45,52,505,534,178,427,337,0,,109
15:08:40,5665.847,Fox,1039,97,32,10,18,14,23,6,1045,1013,1003,853,396,348,45,52,505,534,178,427,337,0,,109
15:08:41,5667.647,Fox,1039,97,32,10,18,14,21,8,1045,1013,1003,853,396,350,45,52,505,534,178,427,337,0,,109
15:08:41,5668.547,Fox,1041,98,34,10,17,14,21,8,1047,1013,1003,853,396,350,44,54,505,536,178,428,337,0,,110
15:08:42,5670.047,Fox,1041,97,34,10,17,14,21,7,1047,1013,1003,853,396,350,44,53,505,536,178,428,338,0,,109
15:08:42,5670.647,Fox,1041,97,32,12,17,14,21,7,1047,1015,1003,853,396,350,44,53,505,536,178,428,338,0,,109
15:08:43,5671.547,Fox,1041,96,32,12,17,14,21,6,1047,1015,1003,853,396,350,43,53,505,536,178,428,339,0,,108
15:08:45,5676.316,Fox,1041,96,30,14,17,14,21,6,1047,1017,1003,853,396,350,43,53,505,536,178,428,339,0,,108
15:08:45,5677.947,Fox,1043,98,32,14,17,14,21,6,1049,1017,1003,853,396,350,44,54,506,537,178,428,339,0,,110
15:08:45,5678.247,Fox,1043,97,32,14,17,13,21,6,1049,1017,1003,853,396,350,43,54,506,537,179,428,339,0,,109
15:08:47,5680.646,Fox,1047,100,34,14,14,15,21,6,1051,1017,1003,855,396,350,44,56,508,539,180,428,339,0,,112
15:08:47,5681.247,Fox,1047,100,34,16,14,14,22,6,1053,1019,1003,855,397,350,44,56,508,539,180,428,339,0,,112
15:08:47,5681.847,Fox,1047,100,32,18,12,15,21,8,1053,1021,1003,857,398,352,44,56,508,539,180,428,339,0,,112
15:08:48,5684.547,Fox,1049,102,34,18,12,15,21,8,1055,1021,1003,857,398,352,45,57,509,540,180,428,339,0,,114
15:08:48,5685.447,Fox,1049,102,34,18,12,13,23,8,1055,1021,1003,857,400,352,45,57,509,540,180,428,339,0,,114
15:08:49,5686.947,Fox,1049,102,34,18,9,16,23,8,1055,1021,1003,860,400,352,45,57,509,540,180,428,339,0,,114
15:08:50,5688.146,Fox,1049,102,34,16,11,16,23,8,1055,1021,1005,860,400,352,45,57,509,540,180,428,339,0,,114
15:08:51,5691.447,Fox,1051,104,32,18,9,18,23,8,1055,1023,1005,862,400,352,47,57,511,540,180,428,339,0,,116
15:08:51,5691.747,Fox,1051,104,34,18,9,18,23,8,1057,1023,1005,862,400,352,47,57,511,540,180,428,339,0,,116
15:08:52,5692.347,Fox,1051,104,34,18,8,19,23,8,1057,1023,1005,863,400,352,47,57,511,540,180,428,339,0,,116
15:08:52,5693.847,Fox,1051,104,34,16,10,19,23,8,1057,1023,1007,863,400,352,47,57,511,540,180,428,339,0,,116
15:08:54,5697.243,Fox,1053,106,36,14,12,19,23,8,1059,1023,1009,863,400,352,49,57,513,540,180,428,339,0,,118
15:08:54,5698.255,Fox,1053,105,36,14,12,19,23,7,1059,1023,1009,863,400,352,48,57,513,540,180,428,340,0,,117
15:08:55,5700.955,Fox,1053,105,34,16,12,19,23,7,1059,1025,1009,863,400,352,48,57,513,540,180,428,340,0,,117
15:08:56,5701.855,Fox,1055,106,32,16,13,19,23,7,1059,1027,1011,863,400,352,49,57,515,540,180,429,340,0,,118
15:08:56,5702.155,Fox,1055,106,34,16,13,19,23,7,1061,1027,1011,863,400,352,49,57,515,540,180,429,340,0,,118
15:08:56,5702.755,Fox,1055,105,34,16,13,19,23,6,1061,1027,1011,863,400,352,49,56,515,540,180,429,341,0,,117
15:08:56,5703.558,Fox,1057,107,36,16,13,19,23,6,1063,1027,1011,863,400,352,50,57,516,541,180,429,341,0,,119
15:08:57,5703.858,Fox,1057,107,36,14,15,19,23,6,1063,1027,1013,863,400,352,50,57,516,541,180,429,341,0,,119
15:08:57,5705.058,Fox,1057,106,36,14,13,21,22,6,1063,1027,1013,865,400,353,50,56,516,541,180,429,342,0,,118
15:08:57,5705.658,Fox,1057,106,36,14,13,20,23,6,1063,1027,1013,865,401,353,50,56,516,541,180,429,342,0,,118
15:08:59,5708.358,Fox,1057,106,36,14,13,19,24,6,1063,1027,1013,865,402,353,50,56,516,541,180,429,342,0,,118
15:08:59,5709.258,Fox,1057,106,34,14,15,19,24,6,1063,1029,1015,865,402,353,50,56,516,541,180,429,342,0,,118
15:09:01,5713.758,Fox,1059,108,32,16,15,19,24,6,1063,1031,1015,865,402,353,50,58,516,543,180,429,342,0,,120
15:09:01,5714.358,Fox,1061,109,34,16,14,19,24,6,1065,1031,1015,865,402,353,50,59,517,544,180,430,342,0,,121
15:09:01,5714.958,Fox,1061,109,36,14,16,19,24,6,1067,1031,1017,865,402,353,50,59,517,544,180,430,342,0,,121
15:09:02,5717.302,Fox,1061,109,34,16,14,21,24,6,1067,1033,1017,867,402,353,50,59,517,544,180,430,342,0,,121
15:09:03,5717.901,Fox,1061,109,32,18,14,21,24,6,1067,1035,1017,867,402,353,50,59,517,544,180,430,342,0,,121
15:09:03,5719.401,Fox,1061,109,32,16,16,21,24,6,1067,1035,1019,867,402,353,50,59,517,544,180,430,342,0,,121
15:09:04,5720.602,Fox,1063,111,34,14,18,21,24,6,1069,1035,1021,867,402,353,50,61,517,546,180,430,342,0,,123
15:09:05,5722.702,Fox,1063,109,34,14,18,20,22,7,1069,1035,1021,867,402,355,49,60,517,546,180,431,343,0,,121
15:09:06,5724.802,Fox,1063,109,34,14,17,21,22,7,1069,1035,1021,868,402,355,49,60,517,546,180,431,343,0,,121
15:09:06,5726.237,Fox,1063,109,34,14,16,22,22,7,1069,1035,1021,869,402,355,49,60,517,546,180,431,343,0,,121
15:09:07,5726.984,Fox,1063,108,34,14,16,19,24,7,1069,1035,1021,869,404,355,49,59,517,546,180,432,343,0,,120
15:09:07,5728.671,Fox,1063,107,34,14,16,18,25,6,1069,1035,1021,869,405,355,49,58,517,546,180,432,344,0,,119
15:09:08,5729.572,Fox,1065,109,36,12,18,17,26,6,1071,1035,1023,869,406,355,51,58,519,546,180,432,344,0,,121
15:09:09,5733.331,Fox,1067,110,38,12,18,16,26,6,1073,1035,1023,869,406,355,51,59,520,547,180,433,344,0,,122
15:09:10,5734.53,Fox,1067,109,36,14,18,16,26,5,1073,1037,1023,869,406,355,51,58,520,547,180,433,345,0,,121
15:09:10,5735.13,Fox,1067,108,36,14,18,16,26,4,1073,1037,1023,869,406,355,51,57,520,547,180,433,346,0,,120
15:09:11,5737.23,Fox,1067,108,36,14,18,15,27,4,1073,1037,1023,869,407,355,51,57,520,547,180,433,346,0,,120
15:09:12,5738.431,Fox,1069,109,36,14,17,15,26,5,1073,1037,1023,869,407,356,51,58,521,548,180,434,346,0,,121
15:09:12,5738.73,Fox,1069,109,38,14,17,15,26,5,1075,1037,1023,869,407,356,51,58,521,548,180,434,346,0,,121
15:09:12,5739.63,Fox,1069,108,38,12,19,14,26,5,1075,1037,1025,869,407,356,51,57,521,548,180,435,346,0,,120
15:09:13,5740.53,Fox,1069,108,38,10,21,14,26,5,1075,1037,1027,869,407,356,51,57,521,548,180,435,346,0,,120
15:09:14,5742.483,Fox,1069,107,38,10,21,14,26,4,1075,1037,1027,869,407,356,50,57,521,548,180,435,347,0,,119
15:09:15,5744.372,Fox,1069,107,36,12,21,14,26,4,1075,1039,1027,869,407,356,50,57,521,548,180,435,347,0,,119
15:09:15,5745.572,Fox,1069,107,32,16,21,14,26,4,1075,1043,1027,869,407,356,50,57,521,548,180,435,347,0,,119
15:09:16,5747.072,Fox,1069,107,30,18,21,14,26,4,1075,1045,1027,869,407,356,50,57,521,548,180,435,347,0,,119
15:09:16,5747.672,Fox,1069,107,30,16,23,14,26,4,1075,1045,1029,869,407,356,50,57,521,548,180,435,347,0,,119
15:09:16,5748.272,Fox,1069,107,31,16,23,14,26,4,1076,1045,1029,869,407,356,50,57,521,548,180,435,347,0,,119
15:09:17,5748.872,Fox,1069,107,31,16,21,16,26,4,1076,1045,1029,871,407,356,50,57,521,548,180,435,347,0,,119
15:09:17,5749.772,Fox,1069,105,31,16,21,14,26,4,1076,1045,1029,871,407,356,50,55,521,548,182,435,347,0,,117
15:09:18,5751.272,Fox,1069,105,29,18,21,14,26,4,1076,1047,1029,871,407,356,50,55,521,548,182,435,347,0,,117
15:09:18,5751.872,Fox,1069,105,29,16,23,14,26,4,1076,1047,1031,871,407,356,50,55,521,548,182,435,347,0,,117
15:09:19,5752.772,Fox,1069,105,29,16,23,14,24,6,1076,1047,1031,871,407,358,50,55,521,548,182,435,347,0,,117
15:09:20,5754.272,Fox,1069,105,29,16,21,16,24,6,1076,1047,1031,873,407,358,50,55,521,548,182,435,347,0,,117
15:09:21,5755.772,Fox,1069,105,29,14,23,16,24,6,1076,1047,1033,873,407,358,50,55,521,548,182,435,347,0,,117
15:09:21,5756.672,Fox,1071,107,29,12,25,16,24,6,1076,1047,1035,873,407,358,52,55,523,548,182,435,347,0,,119
15:09:21,5756.972,Fox,1071,107,31,12,25,16,24,6,1078,1047,1035,873,407,358,52,55,523,548,182,435,347,0,,119
15:09:22,5757.572,Fox,1071,107,31,12,24,17,24,6,1078,1047,1035,874,407,358,52,55,523,548,182,435,347,0,,119
15:09:23,5760.497,Fox,1071,107,29,14,24,17,24,6,1078,1049,1035,874,407,358,52,55,523,548,182,435,347,0,,119
15:09:24,5761.913,Fox,1073,109,31,14,24,17,24,6,1080,1049,1035,874,407,358,52,57,523,550,182,435,347,0,,121
15:09:24,5762.212,Fox,1073,109,31,14,22,19,24,6,1080,1049,1035,876,407,358,52,57,523,550,182,435,347,0,,121
15:09:25,5763.712,Fox,1077,112,29,18,22,18,22,8,1082,1053,1035,876,407,360,53,59,525,552,182,436,347,0,,124
15:09:25,5764.012,Fox,1077,112,31,18,22,18,22,8,1084,1053,1035,876,407,360,53,59,525,552,182,436,347,0,,124
15:09:26,5764.612,Fox,1077,112,31,18,20,20,22,8,1084,1053,1035,878,407,360,53,59,525,552,182,436,347,0,,124
15:09:26,5765.512,Fox,1077,112,31,18,20,20,19,11,1084,1053,1035,878,407,363,53,59,525,552,182,436,347,0,,124
15:09:26,5766.112,Fox,1079,114,33,18,20,20,19,11,1086,1053,1035,878,407,363,55,59,527,552,182,436,347,0,,126
15:09:27,5767.313,Fox,1079,114,31,20,20,20,16,14,1086,1055,1035,878,407,366,55,59,527,552,182,436,347,0,,126
15:09:27,5768.512,Fox,1079,113,31,20,20,20,16,13,1086,1055,1035,878,407,366,55,58,527,552,182,436,348,0,,125
15:09:28,5769.712,Fox,1079,113,31,20,18,22,16,13,1086,1055,1035,880,407,366,55,58,527,552,182,436,348,0,,125
15:09:29,5772.112,Fox,1081,114,33,20,17,22,14,15,1088,1055,1035,880,407,368,55,59,528,553,182,437,348,0,,126
15:09:30,5773.012,Fox,1081,114,33,18,19,22,14,15,1088,1055,1037,880,407,368,55,59,528,553,182,437,348,0,,126
15:09:30,5773.612,Fox,1081,114,33,18,19,20,16,15,1088,1055,1037,880,409,368,55,59,528,553,182,437,348,0,,126
15:09:31,5774.813,Fox,1083,115,33,20,19,19,16,15,1090,1057,1037,880,409,368,55,60,529,554,182,438,348,0,,127
15:09:31,5775.413,Fox,1085,117,33,20,17,19,16,17,1090,1057,1037,882,411,370,55,62,529,556,182,438,348,0,,129
15:09:31,5775.712,Fox,1085,116,35,20,17,19,16,16,1092,1057,1037,882,411,370,55,61,529,556,182,438,349,0,,128
15:09:32,5776.913,Fox,1085,114,35,20,17,17,16,16,1092,1057,1037,882,411,370,55,59,529,556,182,440,349,0,,126
15:09:32,5777.512,Fox,1085,113,35,20,17,17,16,15,1092,1057,1037,882,411,370,54,59,529,556,182,440,350,0,,125
15:09:33,5778.712,Fox,1087,115,35,20,17,17,15,16,1092,1057,1037,882,411,371,56,59,531,556,182,440,350,0,,127
15:09:33,5779.012,Fox,1087,115,37,20,17,17,15,16,1094,1057,1037,882,411,371,56,59,531,556,182,440,350,0,,127
15:09:33,5780.212,Fox,1089,117,37,22,15,17,17,16,1096,1059,1037,884,413,371,57,60,532,557,182,440,350,0,,129
15:09:34,5780.813,Fox,1089,117,37,22,13,19,17,16,1096,1059,1037,886,413,371,57,60,532,557,182,440,350,0,,129
15:09:34,5781.413,Fox,1089,115,37,22,13,17,17,16,1096,1059,1037,886,413,371,57,58,532,557,183,441,350,0,,127
15:09:35,5782.913,Fox,1089,115,37,20,15,17,17,16,1096,1059,1039,886,413,371,57,58,532,557,183,441,350,0,,127
15:09:35,5783.512,Fox,1089,113,37,20,15,17,17,14,1096,1059,1039,886,413,371,57,56,532,557,183,441,352,0,,125
15:09:35,5784.413,Fox,1089,111,37,16,19,16,17,13,1096,1059,1043,886,413,371,57,54,532,557,184,441,353,0,,123
15:09:36,5785.012,Fox,1089,111,35,18,19,15,18,13,1096,1061,1043,886,414,371,57,54,532,557,184,441,353,0,,123
15:09:36,5785.913,Fox,1089,111,35,16,21,14,19,13,1096,1061,1045,886,415,371,57,54,532,557,184,441,353,0,,123
15:09:36,5786.212,Fox,1089,111,33,18,21,14,19,13,1096,1063,1045,886,415,371,57,54,532,557,184,441,353,0,,123
15:09:38,5789.293,Fox,1091,113,35,18,21,14,19,13,1098,1063,1045,886,415,371,59,54,534,557,184,441,353,0,,125
15:09:38,5789.593,Fox,1091,113,35,16,23,14,19,13,1098,1063,1047,886,415,371,59,54,534,557,184,441,353,0,,125
15:09:38,5790.193,Fox,1091,113,35,16,22,15,19,13,1098,1063,1047,887,415,371,59,54,534,557,184,441,353,0,,125
15:09:39,5791.093,Fox,1093,114,37,16,21,15,19,13,1100,1063,1047,887,415,371,59,55,535,558,184,442,353,0,,126
15:09:40,5794.393,Fox,1093,113,37,16,21,15,19,12,1100,1063,1047,887,415,371,58,55,535,558,184,442,354,0,,125
15:09:41,5795.293,Fox,1095,115,39,16,21,15,19,12,1102,1063,1047,887,415,371,59,56,536,559,184,442,354,0,,127
15:09:41,5796.793,Fox,1095,115,37,18,21,15,19,12,1102,1065,1047,887,415,371,59,56,536,559,184,442,354,0,,127
15:09:42,5797.393,Fox,1095,115,35,20,21,15,19,12,1102,1067,1047,887,415,371,59,56,536,559,184,442,354,0,,127
15:09:42,5797.993,Fox,1095,114,35,20,21,15,19,11,1102,1067,1047,887,415,371,58,56,536,559,184,442,355,0,,126
15:09:42,5798.593,Fox,1095,114,35,20,21,14,20,11,1102,1067,1047,887,416,371,58,56,536,559,184,442,355,0,,126
15:09:43,5799.193,Fox,1095,114,35,18,23,14,20,11,1102,1067,1049,887,416,371,58,56,536,559,184,442,355,0,,126
15:09:43,5800.093,Fox,1095,114,35,18,21,16,20,11,1102,1067,1049,889,416,371,58,56,536,559,184,442,355,0,,126
15:09:44,5800.993,Fox,1095,114,35,18,19,18,20,11,1102,1067,1049,891,416,371,58,56,536,559,184,442,355,0,,126
15:09:44,5802.193,Fox,1097,115,37,14,22,18,20,11,1104,1067,1053,891,416,371,57,58,536,561,184,443,355,0,,127
15:09:44,5802.665,Fox,1097,113,37,14,22,18,20,9,1104,1067,1053,891,416,371,56,57,536,561,184,443,357,0,,125
15:09:45,5802.986,Fox,1097,113,35,16,22,18,20,9,1104,1069,1053,891,416,371,56,57,536,561,184,443,357,0,,125
15:09:46,5805.546,Fox,1097,113,35,14,24,18,20,9,1104,1069,1055,891,416,371,56,57,536,561,184,443,357,0,,125
15:09:46,5806.604,Fox,1099,114,35,14,24,18,20,8,1104,1069,1055,891,416,371,55,59,536,563,184,443,358,0,,126
15:09:46,5806.905,Fox,1099,114,37,14,24,18,20,8,1106,1069,1055,891,416,371,55,59,536,563,184,443,358,0,,126
15:09:47,5808.405,Fox,1099,112,37,14,24,16,20,8,1106,1069,1055,891,416,371,55,57,536,563,186,443,358,0,,124
15:09:49,5811.405,Fox,1101,114,39,14,24,16,20,8,1108,1069,1055,891,416,371,57,57,538,563,186,443,358,0,,126
15:09:49,5812.224,Fox,1101,114,37,16,22,18,20,8,1108,1071,1055,893,416,371,57,57,538,563,186,443,358,0,,126
15:09:50,5812.966,Fox,1101,114,37,14,24,18,20,8,1108,1071,1057,893,416,371,57,57,538,563,186,443,358,0,,126
15:09:50,5813.794,Fox,1101,113,37,14,24,18,20,7,1108,1071,1057,893,416,371,56,57,538,563,186,443,359,0,,125
15:09:51,5816.194,Fox,1101,113,35,16,22,20,20,7,1108,1073,1057,895,416,371,56,57,538,563,186,443,359,0,,125
15:09:52,5816.794,Fox,1101,113,35,16,20,22,20,7,1108,1073,1057,897,416,371,56,57,538,563,186,443,359,0,,125
15:09:52,5817.994,Fox,1103,115,37,16,20,22,20,7,1110,1073,1057,897,416,371,57,58,539,564,186,443,359,0,,127
15:09:52,5818.294,Fox,1103,115,37,14,22,22,20,7,1110,1073,1059,897,416,371,57,58,539,564,186,443,359,0,,127
15:09:52,5818.894,Fox,1103,115,37,14,22,22,19,8,1110,1073,1059,897,416,372,57,58,539,564,186,443,359,0,,127
15:09:53,5819.627,Fox,1105,117,39,14,22,21,19,9,1112,1073,1059,897,417,373,58,59,540,565,186,443,359,0,,129
15:09:53,5820.827,Fox,1107,118,39,14,22,20,19,9,1112,1073,1059,897,417,373,59,59,541,566,186,444,359,0,,130
15:09:54,5821.427,Fox,1107,118,39,16,22,20,19,9,1114,1075,1059,897,417,373,59,59,541,566,186,444,359,0,,130
15:09:54,5822.927,Fox,1109,120,41,16,22,20,17,11,1116,1075,1059,897,417,375,60,60,542,567,186,444,359,0,,132
15:09:55,5823.227,Fox,1109,120,41,14,24,20,17,11,1116,1075,1061,897,417,375,60,60,542,567,186,444,359,0,,132
15:09:55,5824.427,Fox,1111,122,43,14,24,20,17,11,1118,1075,1061,897,417,375,60,62,542,569,186,444,359,0,,134
15:09:55,5824.727,Fox,1111,122,43,12,26,20,17,11,1118,1075,1063,897,417,375,60,62,542,569,186,444,359,0,,134
15:09:56,5826.227,Fox,1111,121,43,12,26,20,17,10,1118,1075,1063,897,417,375,60,61,542,569,186,444,360,0,,133
15:09:57,5828.027,Fox,1113,123,45,12,26,20,17,10,1120,1075,1063,897,417,375,61,62,543,570,186,444,360,0,,135
15:09:57,5828.327,Fox,1113,122,45,12,26,20,17,9,1120,1075,1063,897,417,375,60,62,543,570,186,444,361,0,,134
15:09:58,5828.927,Fox,1113,121,45,12,26,20,17,8,1120,1075,1063,897,417,375,60,61,543,570,186,444,362,0,,133
15:09:59,5831.027,Fox,1113,121,44,13,26,20,17,8,1120,1076,1063,897,417,375,60,61,543,570,186,444,362,0,,133
15:10:00,5833.427,Fox,1113,121,44,13,24,22,17,8,1120,1076,1063,899,417,375,60,61,543,570,186,444,362,0,,133
15:10:01,5835.227,Fox,1113,121,44,11,26,22,17,8,1120,1076,1065,899,417,375,60,61,543,570,186,444,362,0,,133
15:10:01,5835.827,Fox,1113,121,44,9,28,22,17,8,1120,1076,1067,899,417,375,60,61,543,570,186,444,362,0,,133
15:10:02,5836.727,Fox,1115,123,46,9,28,22,17,8,1122,1076,1067,899,417,375,61,62,544,571,186,444,362,0,,135
15:10:03,5839.427,Fox,1117,123,46,9,27,22,17,7,1122,1076,1067,899,417,375,61,62,545,572,187,444,363,0,,135
15:10:03,5839.727,Fox,1117,123,46,11,27,22,17,7,1124,1078,1067,899,417,375,61,62,545,572,187,444,363,0,,135
15:10:04,5841.527,Fox,1119,125,48,11,27,22,17,7,1126,1078,1067,899,417,375,63,62,547,572,187,444,363,0,,137
15:10:04,5841.827,Fox,1119,125,48,9,29,22,17,7,1126,1078,1069,899,417,375,63,62,547,572,187,444,363,0,,137
15:10:05,5843.027,Fox,1121,126,50,9,28,22,16,8,1128,1078,1069,899,417,376,63,63,548,573,188,444,363,0,,138
15:10:05,5843.327,Fox,1121,126,50,9,26,24,16,8,1128,1078,1069,901,417,376,63,63,548,573,188,444,363,0,,138
15:10:06,5844.527,Fox,1121,125,48,11,22,27,16,8,1128,1080,1069,905,417,376,62,63,548,573,189,444,363,0,,137
15:10:06,5846.027,Fox,1121,125,48,11,20,29,15,9,1128,1080,1069,907,417,377,62,63,548,573,189,444,363,0,,137
15:10:07,5846.627,Fox,1121,124,44,15,20,29,15,8,1128,1084,1069,907,417,377,62,62,548,573,189,444,364,0,,136
15:10:08,5849.027,Fox,1121,123,42,17,19,29,15,8,1128,1086,1069,907,417,377,61,62,548,573,189,445,364,0,,135
15:10:09,5850.227,Fox,1121,122,42,17,17,31,15,7,1128,1086,1069,909,417,377,61,61,548,573,189,445,365,0,,134
15:10:09,5850.827,Fox,1123,123,44,15,18,31,15,7,1130,1086,1071,909,417,377,62,61,550,573,189,446,365,0,,135
15:10:11,5854.727,Fox,1123,123,42,15,20,31,15,7,1130,1088,1073,909,417,377,62,61,550,573,189,446,365,0,,135
15:10:12,5857.127,Fox,1129,128,46,15,19,31,15,7,1134,1088,1073,909,417,377,64,64,553,576,189,447,365,0,,140
15:10:12,5857.427,Fox,1129,128,46,17,19,31,15,7,1136,1090,1073,909,417,377,64,64,553,576,189,447,365,0,,140
15:10:13,5858.327,Fox,1129,128,44,19,19,29,17,7,1136,1092,1073,909,419,377,64,64,553,576,189,447,365,0,,140
15:10:13,5858.927,Fox,1131,129,44,19,19,28,17,7,1136,1092,1073,909,419,377,65,64,554,577,189,448,365,0,,141
15:10:13,5859.527,Fox,1133,131,46,19,18,29,17,7,1138,1092,1073,910,419,377,67,64,556,577,189,448,365,0,,143
15:10:13,5859.827,Fox,1133,131,48,17,20,29,17,7,1140,1092,1075,910,419,377,67,64,556,577,189,448,365,0,,143
15:10:14,5861.627,Fox,1133,131,46,19,20,29,17,7,1140,1094,1075,910,419,377,67,64,556,577,189,448,365,0,,143
15:10:15,5862.527,Fox,1133,131,46,19,17,32,17,7,1140,1094,1075,913,419,377,67,64,556,577,189,448,365,0,,143
15:10:15,5863.127,Fox,1133,131,44,21,17,30,19,7,1140,1096,1075,913,421,377,67,64,556,577,189,448,365,0,,143
15:10:16,5864.627,Fox,1133,130,44,21,17,30,17,8,1140,1096,1075,913,421,379,66,64,556,577,189,448,366,0,,142
15:10:17,5866.427,Fox,1135,132,44,21,16,31,16,9,1140,1096,1075,914,421,380,68,64,558,577,189,448,366,0,,144
15:10:18,5867.027,Fox,1135,130,46,21,16,31,15,8,1142,1096,1075,914,421,381,67,63,558,577,189,448,368,0,,142
15:10:18,5868.227,Fox,1135,128,46,21,16,29,15,8,1142,1096,1075,914,421,381,67,61,558,577,191,448,368,0,,140
15:10:19,5869.127,Fox,1137,130,46,21,16,27,17,8,1142,1096,1075,914,423,381,68,62,559,578,191,448,368,0,,142
15:10:19,5869.427,Fox,1137,130,48,20,17,27,17,8,1144,1096,1076,914,423,381,68,62,559,578,191,448,368,0,,142
15:10:20,5871.946,Fox,1137,130,46,22,17,27,17,8,1144,1098,1076,914,423,381,68,62,559,578,191,448,368,0,,142
15:10:21,5872.846,Fox,1139,132,48,22,17,27,17,8,1146,1098,1076,914,423,381,68,64,559,580,191,448,368,0,,144
15:10:21,5873.446,Fox,1141,134,50,22,17,27,17,8,1148,1098,1076,914,423,381,69,65,560,581,191,448,368,0,,146
15:10:21,5873.746,Fox,1141,133,48,24,17,27,17,7,1148,1100,1076,914,423,381,68,65,560,581,191,448,369,0,,145
15:10:22,5874.646,Fox,1141,133,48,24,17,25,18,8,1148,1100,1076,914,425,382,68,65,560,581,191,448,369,0,,145
15:10:24,5878.246,Fox,1141,133,46,24,19,25,18,8,1148,1102,1078,914,425,382,68,65,560,581,191,448,369,0,,145
15:10:24,5879.146,Fox,1143,134,48,24,16,27,18,8,1150,1102,1078,916,425,382,68,66,561,582,192,448,369,0,,146
15:10:26,5882.146,Fox,1147,138,52,24,16,27,18,8,1154,1102,1078,916,425,382,72,66,565,582,192,448,369,0,,150
15:10:26,5883.046,Fox,1147,137,52,22,18,26,18,8,1154,1102,1080,916,425,382,72,65,565,582,193,448,369,0,,149
15:10:27,5883.946,Fox,1149,138,54,22,16,28,18,7,1156,1102,1080,918,425,382,74,64,567,582,193,448,370,0,,150
15:10:27,5885.146,Fox,1149,138,52,20,19,29,18,7,1156,1104,1084,919,425,382,74,64,567,582,193,448,370,0,,150
15:10:28,5885.746,Fox,1149,137,52,20,19,28,18,7,1156,1104,1084,919,425,382,74,63,567,582,194,448,370,0,,149
15:10:29,5887.546,Fox,1151,139,52,18,21,28,18,7,1156,1104,1086,919,425,382,75,64,568,583,194,448,370,0,,151
15:10:29,5887.846,Fox,1151,139,54,18,21,28,18,7,1158,1104,1086,919,425,382,75,64,568,583,194,448,370,0,,151
15:10:30,5889.646,Fox,1151,138,52,20,21,27,18,7,1158,1106,1086,919,425,382,75,63,568,583,195,448,370,0,,150
15:10:32,5893.055,Fox,1153,139,54,20,20,27,18,7,1160,1106,1086,919,425,382,75,64,569,584,196,448,370,0,,151
15:10:32,5893.655,Fox,1153,139,54,18,22,25,20,7,1160,1106,1088,919,427,382,75,64,569,584,196,448,370,0,,151
15:10:32,5893.956,Fox,1153,139,52,20,22,25,20,7,1160,1108,1088,919,427,382,75,64,569,584,196,448,370,0,,151
15:10:32,5894.555,Fox,1153,139,52,20,22,23,22,7,1160,1108,1088,919,429,382,75,64,569,584,196,448,370,0,,151
15:10:33,5895.61,Fox,1155,141,54,20,20,25,22,7,1162,1108,1088,921,429,382,75,66,569,586,196,448,370,0,,153
15:10:33,5896.209,Fox,1155,141,54,18,20,27,22,7,1162,1108,1090,923,429,382,75,66,569,586,196,448,370,0,,153
15:10:34,5896.81,Fox,1155,140,54,16,22,27,22,6,1162,1108,1092,923,429,382,75,65,569,586,196,448,371,0,,152
15:10:34,5897.41,Fox,1155,139,54,16,22,27,22,5,1162,1108,1092,923,429,382,75,64,569,586,196,448,372,0,,151
15:10:35,5898.91,Fox,1157,141,56,16,22,27,22,5,1164,1108,1092,923,429,382,76,65,570,587,196,448,372,0,,153
15:10:35,5900.08,Fox,1157,141,56,14,24,27,22,5,1164,1108,1094,923,429,382,76,65,570,587,196,448,372,0,,153
15:10:36,5900.655,Fox,1157,141,54,16,24,27,22,5,1164,1110,1094,923,429,382,76,65,570,587,196,448,372,0,,153
15:10:36,5901.255,Fox,1157,141,54,14,26,27,22,5,1164,1110,1096,923,429,382,76,65,570,587,196,448,372,0,,153
15:10:36,5902.155,Fox,1159,143,56,14,24,29,22,5,1166,1110,1096,925,429,382,76,67,570,589,196,448,372,0,,155
15:10:37,5902.455,Fox,1159,143,54,16,24,29,22,5,1166,1112,1096,925,429,382,76,67,570,589,196,448,372,0,,155
15:10:37,5903.655,Fox,1159,143,52,18,24,29,22,5,1166,1114,1096,925,429,382,76,67,570,589,196,448,372,0,,155
15:10:38,5905.755,Fox,1159,143,50,20,24,27,24,5,1166,1116,1096,925,431,382,76,67,570,589,196,448,372,0,,155
15:10:39,5906.355,Fox,1161,145,52,20,24,27,24,5,1168,1116,1096,925,431,382,77,68,571,590,196,448,372,0,,157
15:10:39,5906.955,Fox,1161,145,50,22,24,27,24,5,1168,1118,1096,925,431,382,77,68,571,590,196,448,372,0,,157
15:10:40,5909.055,Fox,1163,147,52,22,24,27,24,5,1170,1118,1096,925,431,382,79,68,573,590,196,448,372,0,,159
15:10:41,5909.955,Fox,1165,149,52,22,24,26,25,5,1170,1118,1096,925,432,382,80,69,574,591,196,448,372,0,,161
15:10:41,5910.555,Fox,1165,149,52,22,26,24,27,5,1172,1120,1098,925,434,382,80,69,574,591,196,448,372,0,,161
15:10:41,5911.155,Fox,1165,149,52,22,25,25,25,7,1172,1120,1098,926,434,384,80,69,574,591,196,448,372,0,,161
15:10:42,5912.253,Fox,1167,151,54,20,27,25,25,7,1174,1120,1100,926,434,384,81,70,575,592,196,448,372,0,,163
15:10:42,5913.052,Fox,1169,153,56,20,27,25,23,9,1176,1120,1100,926,434,386,82,71,576,593,196,448,372,0,,165
15:10:42,5914.048,Fox,1169,152,56,20,27,25,23,8,1176,1120,1100,926,434,386,81,71,576,593,196,448,373,0,,164
15:10:43,5914.948,Fox,1169,152,56,20,25,27,23,8,1176,1120,1100,928,434,386,81,71,576,593,196,448,373,0,,164
15:10:44,5916.448,Fox,1169,152,56,18,27,27,23,8,1176,1120,1102,928,434,386,81,71,576,593,196,448,373,0,,164
15:10:45,5917.948,Fox,1171,154,58,18,27,27,21,10,1178,1120,1102,928,434,388,82,72,577,594,196,448,373,0,,166
15:10:46,5919.448,Fox,1175,158,58,20,27,27,21,10,1180,1122,1102,928,434,388,83,75,578,597,196,448,373,0,,170
15:10:46,5919.748,Fox,1175,158,60,20,27,27,21,10,1182,1122,1102,928,434,388,83,75,578,597,196,448,373,0,,170
15:10:46,5920.348,Fox,1175,158,60,20,25,29,21,10,1182,1122,1102,930,434,388,83,75,578,597,196,448,373,0,,170
15:10:47,5922.448,Fox,1175,158,58,22,25,29,20,11,1182,1124,1102,930,434,389,83,75,578,597,196,448,373,0,,170
15:10:48,5923.348,Fox,1175,158,58,20,27,29,19,12,1182,1124,1104,930,434,390,83,75,578,597,196,448,373,0,,170
15:10:48,5924.248,Fox,1175,158,56,22,27,29,19,12,1182,1126,1104,930,434,390,83,75,578,597,196,448,373,0,,170
15:10:49,5926.048,Fox,1177,158,54,24,26,28,19,12,1182,1128,1104,930,434,390,84,74,580,597,196,450,373,0,,170
15:10:50,5926.648,Fox,1179,159,58,24,26,28,18,12,1186,1128,1104,930,434,390,84,75,581,598,196,451,373,0,,171
15:10:50,5926.948,Fox,1179,158,58,24,26,27,19,11,1186,1128,1104,930,435,390,84,74,581,598,196,451,374,0,,170
15:10:50,5928.148,Fox,1179,158,58,22,28,27,19,11,1186,1128,1106,930,435,390,84,74,581,598,196,451,374,0,,170
15:10:51,5929.948,Fox,1179,158,58,22,27,28,19,11,1186,1128,1106,931,435,390,84,74,581,598,196,451,374,0,,170
15:10:52,5930.848,Fox,1181,160,60,22,27,28,19,11,1188,1128,1106,931,435,390,85,75,582,599,196,451,374,0,,172
15:10:53,5932.948,Fox,1183,161,60,20,28,28,19,11,1188,1128,1108,931,435,390,84,77,582,601,197,451,374,0,,173
15:10:53,5933.548,Fox,1183,161,60,22,28,28,19,11,1190,1130,1108,931,435,390,84,77,582,601,197,451,374,0,,173
15:10:54,5934.148,Fox,1185,163,62,22,28,28,19,11,1192,1130,1108,931,435,390,85,78,583,602,197,451,374,0,,175
15:10:55,5935.948,Fox,1185,163,62,22,28,28,18,12,1192,1130,1108,931,435,391,85,78,583,602,197,451,374,0,,175
15:10:55,5937.148,Fox,1187,164,62,22,27,26,20,12,1192,1130,1108,931,437,391,85,79,584,603,197,452,374,0,,176
15:10:56,5937.748,Fox,1189,166,66,22,27,26,20,12,1196,1130,1108,931,437,391,85,81,584,605,197,452,374,0,,178
15:10:56,5938.048,Fox,1189,166,66,22,27,24,22,12,1196,1130,1108,931,439,391,85,81,584,605,197,452,374,0,,178
15:10:56,5938.648,Fox,1189,166,66,22,25,26,22,12,1196,1130,1108,933,439,391,85,81,584,605,197,452,374,0,,178
15:10:57,5939.548,Fox,1191,168,66,20,27,24,24,12,1196,1130,1110,933,441,391,85,83,584,607,197,452,374,0,,180
15:10:57,5940.148,Fox,1191,168,62,26,27,24,24,12,1198,1136,1110,933,441,391,85,83,584,607,197,452,374,0,,180
15:10:57,5940.748,Fox,1191,168,62,24,29,24,24,12,1198,1136,1112,933,441,391,85,83,584,607,197,452,374,0,,180
15:10:58,5942.248,Fox,1191,168,60,24,31,24,24,12,1198,1138,1114,933,441,391,85,83,584,607,197,452,374,0,,180
15:10:58,5942.516,Fox,1191,168,58,26,31,24,24,12,1198,1140,1114,933,441,391,85,83,584,607,197,452,374,0,,180
15:10:59,5943.416,Fox,1193,169,60,26,29,25,24,12,1200,1140,1114,935,441,391,86,83,586,607,198,452,374,0,,181
15:10:59,5944.016,Fox,1193,169,60,24,31,23,26,12,1200,1140,1116,935,443,391,86,83,586,607,198,452,374,0,,181
15:11:00,5945.516,Fox,1193,169,60,22,29,27,26,12,1200,1140,1118,939,443,391,86,83,586,607,198,452,374,0,,181
15:11:01,5946.116,Fox,1193,166,60,22,29,27,26,9,1200,1140,1118,939,443,391,85,81,586,607,198,452,377,0,,178
15:11:02,5948.216,Fox,1193,165,60,22,29,27,26,8,1200,1140,1118,939,443,391,84,81,586,607,198,452,378,0,,177
15:11:02,5949.416,Fox,1195,166,60,22,30,27,26,8,1202,1142,1120,939,443,391,83,83,586,609,198,453,378,0,,178
15:11:03,5950.616,Fox,1197,167,62,22,29,27,26,8,1204,1142,1120,939,443,391,83,84,587,610,198,454,378,0,,179
15:11:04,5952.116,Fox,1197,167,60,24,29,27,26,8,1204,1144,1120,939,443,391,83,84,587,610,198,454,378,0,,179
15:11:04,5953.016,Fox,1197,166,60,24,29,27,26,7,1204,1144,1120,939,443,391,82,84,587,610,198,454,379,0,,178
15:11:05,5953.916,Fox,1199,168,60,24,27,29,26,7,1204,1144,1120,941,443,391,83,85,588,611,198,454,379,0,,180
15:11:05,5954.134,Fox,1199,168,62,24,27,29,26,7,1206,1144,1120,941,443,391,83,85,588,611,198,454,379,0,,180
15:11:05,5954.699,Fox,1201,169,64,24,26,29,26,7,1208,1144,1120,941,443,391,82,87,588,613,198,455,379,0,,181
15:11:06,5955.794,Fox,1203,171,62,26,26,27,28,7,1208,1146,1120,941,445,391,83,88,589,614,198,455,379,0,,183
15:11:06,5956.395,Fox,1203,171,62,28,25,28,28,7,1210,1148,1120,942,445,391,83,88,589,614,198,455,379,0,,183
15:11:07,5957.294,Fox,1203,171,62,28,23,30,27,8,1210,1148,1120,944,445,392,83,88,589,614,198,455,379,0,,183
15:11:07,5957.895,Fox,1203,171,62,26,25,30,27,8,1210,1148,1122,944,445,392,83,88,589,614,198,455,379,0,,183
15:11:09,5960.595,Fox,1205,173,64,26,23,32,27,8,1212,1148,1122,946,445,392,85,88,591,614,198,455,379,0,,185
15:11:09,5960.895,Fox,1205,173,64,24,25,32,27,8,1212,1148,1124,946,445,392,85,88,591,614,198,455,379,0,,185
15:11:09,5961.794,Fox,1205,173,62,26,23,34,27,8,1212,1150,1124,948,445,392,85,88,591,614,198,455,379,0,,185
15:11:10,5962.694,Fox,1205,173,62,24,25,34,27,8,1212,1150,1126,948,445,392,85,88,591,614,198,455,379,0,,185
15:11:11,5964.194,Fox,1205,172,62,22,27,34,27,7,1212,1150,1128,948,445,392,85,87,591,614,198,455,380,0,,184
15:11:11,5964.739,Fox,1205,172,58,26,27,34,27,7,1212,1154,1128,948,445,392,85,87,591,614,198,455,380,0,,184
15:11:12,5966.539,Fox,1207,173,56,28,27,34,27,6,1212,1156,1128,948,445,392,86,87,593,614,198,455,381,0,,185
15:11:12,5966.839,Fox,1207,173,58,28,27,34,27,6,1214,1156,1128,948,445,392,86,87,593,614,198,455,381,0,,185
15:11:14,5970.439,Fox,1207,173,56,30,27,34,27,6,1214,1158,1128,948,445,392,86,87,593,614,198,455,381,0,,185
15:11:15,5972.239,Fox,1207,170,56,28,29,33,27,4,1214,1158,1130,948,445,392,84,86,593,614,198,456,383,0,,182
15:11:16,5972.839,Fox,1207,170,56,28,28,32,29,4,1214,1158,1130,949,447,392,84,86,593,614,198,456,383,0,,182
15:11:16,5973.139,Fox,1207,168,56,28,28,30,29,4,1214,1158,1130,949,447,392,83,85,593,614,200,456,383,0,,180
15:11:16,5975.576,Fox,1209,170,56,30,28,30,29,4,1216,1160,1130,949,447,392,84,86,594,615,200,456,383,0,,182
15:11:17,5976.77,Fox,1209,170,56,30,26,32,29,4,1216,1160,1130,951,447,392,84,86,594,615,200,456,383,0,,182
15:11:17,5977.269,Fox,1209,170,56,30,26,30,31,4,1216,1160,1130,951,449,392,84,86,594,615,200,456,383,0,,182
15:11:18,5978.469,Fox,1211,171,54,26,32,30,30,4,1216,1162,1136,951,449,392,83,88,594,617,200,457,383,0,,183
15:11:18,5979.069,Fox,1213,173,58,26,32,29,31,4,1220,1162,1136,951,450,392,84,89,595,618,200,457,383,0,,185
15:11:19,5979.669,Fox,1213,172,58,26,32,28,31,4,1220,1162,1136,951,450,392,84,88,595,618,200,458,383,0,,184
15:11:19,5980.569,Fox,1215,173,58,24,33,28,31,4,1220,1162,1138,951,450,392,84,89,596,619,200,459,383,0,,185
15:11:19,5980.869,Fox,1215,173,60,22,35,28,31,4,1222,1162,1140,951,450,392,84,89,596,619,200,459,383,0,,185
15:11:20,5981.769,Fox,1217,174,60,24,34,28,31,4,1224,1164,1140,951,450,392,84,90,597,620,201,459,383,0,,186
15:11:20,5982.354,Fox,1217,173,60,24,34,27,31,4,1224,1164,1140,951,450,392,84,89,597,620,201,460,383,0,,185
15:11:21,5983.217,Fox,1217,172,60,24,34,26,31,4,1224,1164,1140,951,450,392,84,88,597,620,201,461,383,0,,184
15:11:21,5983.817,Fox,1217,172,60,24,32,28,31,4,1224,1164,1140,953,450,392,84,88,597,620,201,461,383,0,,184
15:11:22,5984.717,Fox,1217,172,58,26,32,28,31,4,1224,1166,1140,953,450,392,84,88,597,620,201,461,383,0,,184
15:11:22,5985.617,Fox,1219,174,60,26,32,28,31,4,1226,1166,1140,953,450,392,85,89,598,621,201,461,383,0,,186
15:11:24,5988.317,Fox,1223,177,60,24,34,27,31,4,1226,1166,1142,953,450,392,89,88,602,621,202,461,383,0,,189
15:11:24,5988.917,Fox,1225,179,64,26,32,29,31,4,1232,1168,1142,955,450,392,89,90,602,623,202,461,383,0,,191
15:11:25,5989.217,Fox,1225,179,64,26,32,28,32,4,1232,1168,1142,955,451,392,89,90,602,623,202,461,383,0,,191
15:11:25,5989.817,Fox,1225,179,64,26,32,26,34,4,1232,1168,1142,955,453,392,89,90,602,623,202,461,383,0,,191
15:11:25,5990.717,Fox,1225,179,64,24,34,26,34,4,1232,1168,1144,955,453,392,89,90,602,623,202,461,383,0,,191
15:11:26,5991.617,Fox,1225,179,62,26,34,26,34,4,1232,1170,1144,955,453,392,89,90,602,623,202,461,383,0,,191
15:11:27,5993.117,Fox,1227,181,62,28,33,27,34,4,1234,1172,1144,956,453,392,91,90,604,623,202,461,383,0,,193
15:11:28,5994.017,Fox,1227,181,62,26,35,27,34,4,1234,1172,1146,956,453,392,91,90,604,623,202,461,383,0,,193
15:11:28,5994.917,Fox,1227,181,60,26,37,27,34,4,1234,1174,1148,956,453,392,91,90,604,623,202,461,383,0,,193
15:11:29,5995.817,Fox,1227,181,58,28,37,25,34,6,1234,1176,1148,956,455,394,91,90,604,623,202,461,383,0,,193
15:11:29,5997.017,Fox,1231,185,60,28,37,25,34,6,1236,1176,1148,956,455,394,91,94,604,627,202,461,383,0,,197
15:11:30,5997.317,Fox,1231,185,62,28,37,25,34,6,1238,1176,1148,956,455,394,91,94,604,627,202,461,383,0,,197
15:11:31,5999.117,Fox,1231,184,62,28,37,25,34,5,1238,1176,1148,956,455,394,91,93,604,627,202,461,384,0,,196
15:11:31,5999.717,Fox,1231,184,62,28,35,27,34,5,1238,1176,1148,958,455,394,91,93,604,627,202,461,384,0,,196
15:11:32,6000.617,Fox,1231,184,60,28,37,27,32,7,1238,1178,1150,958,455,396,91,93,604,627,202,461,384,0,,196
15:11:32,6001.217,Fox,1231,184,60,28,35,29,32,7,1238,1178,1150,960,455,396,91,93,604,627,202,461,384,0,,196
15:11:33,6002.417,Fox,1231,184,56,32,35,29,32,7,1238,1182,1150,960,455,396,91,93,604,627,202,461,384,0,,196
15:11:33,6002.717,Fox,1231,184,56,32,33,31,32,7,1238,1182,1150,962,455,396,91,93,604,627,202,461,384,0,,196
15:11:33,6003.192,Fox,1231,184,56,28,37,31,32,7,1238,1182,1154,962,455,396,91,93,604,627,202,461,384,0,,196
15:11:34,6004.564,Fox,1233,185,58,28,36,32,32,6,1240,1182,1154,963,455,396,91,94,604,629,202,461,385,0,,197
15:11:34,6005.149,Fox,1233,185,58,26,38,31,33,6,1240,1182,1156,963,456,396,91,94,604,629,202,461,385,0,,197
15:11:34,6006.005,Fox,1235,187,60,26,36,33,33,6,1242,1182,1156,965,456,396,92,95,605,630,202,461,385,0,,199
15:11:34,6006.292,Fox,1235,186,60,26,36,33,31,7,1242,1182,1156,965,456,398,92,94,605,630,202,461,386,0,,198
15:11:35,6007.473,Fox,1237,187,62,26,35,33,31,7,1244,1182,1156,965,456,398,92,95,606,631,203,461,386,0,,199
15:11:35,6008.672,Fox,1239,188,62,26,34,31,33,7,1244,1182,1156,965,458,398,93,95,608,631,204,461,386,0,,200
15:11:35,6009.116,Fox,1239,188,60,28,36,31,33,7,1246,1186,1158,965,458,398,93,95,608,631,204,461,386,0,,200
15:11:36,6009.917,Fox,1241,189,62,28,33,33,33,7,1248,1186,1158,967,458,398,94,95,610,631,205,461,386,0,,201
15:11:36,6010.517,Fox,1243,191,64,28,33,33,33,7,1250,1186,1158,967,458,398,96,95,612,631,205,461,386,0,,203
15:11:37,6011.717,Fox,1245,192,66,28,32,33,31,9,1252,1186,1158,967,458,400,96,96,613,632,206,461,386,0,,204
15:11:38,6013.517,Fox,1245,190,64,30,32,31,31,9,1252,1188,1158,967,458,400,96,94,613,632,206,463,386,0,,202
15:11:39,6014.117,Fox,1247,191,66,28,33,30,32,9,1254,1188,1160,967,459,400,96,95,614,633,207,463,386,0,,203
15:11:39,6014.717,Fox,1247,190,66,28,33,30,32,8,1254,1188,1160,967,459,400,95,95,614,633,207,463,387,0,,202
15:11:39,6015.917,Fox,1247,190,64,30,33,30,32,8,1254,1190,1160,967,459,400,95,95,614,633,207,463,387,0,,202
15:11:40,6016.817,Fox,1247,190,62,30,35,30,32,8,1254,1192,1162,967,459,400,95,95,614,633,207,463,387,0,,202
15:11:41,6018.317,Fox,1249,192,64,30,34,31,32,8,1256,1192,1162,968,459,400,96,96,615,634,207,463,387,0,,204
15:11:42,6020.417,Fox,1249,192,60,32,36,31,32,8,1256,1196,1164,968,459,400,96,96,615,634,207,463,387,0,,204
15:11:42,6021.317,Fox,1249,191,60,32,35,32,32,7,1256,1196,1164,969,459,400,96,95,615,634,207,463,388,0,,203
15:11:43,6022.817,Fox,1251,192,60,34,34,32,32,7,1258,1198,1164,969,459,400,96,96,616,635,208,463,388,0,,204
15:11:43,6023.345,Fox,1251,192,60,32,34,33,33,7,1258,1198,1166,971,460,400,96,96,616,635,208,463,388,0,,204
15:11:44,6024.545,Fox,1251,192,60,32,33,34,33,7,1258,1198,1166,972,460,400,96,96,616,635,208,463,388,0,,204
15:11:45,6026.045,Fox,1251,192,58,34,33,34,33,7,1258,1200,1166,972,460,400,96,96,616,635,208,463,388,0,,204
15:11:45,6026.538,Fox,1251,191,58,34,33,34,33,6,1258,1200,1166,972,460,400,96,95,616,635,208,463,389,0,,203
15:11:45,6027.241,Fox,1251,191,58,32,35,34,33,6,1258,1200,1168,972,460,400,96,95,616,635,208,463,389,0,,203
15:11:46,6029.361,Fox,1253,193,60,32,35,34,33,6,1260,1200,1168,972,460,400,97,96,617,636,208,463,389,0,,205
15:11:47,6030.195,Fox,1253,193,60,30,37,34,33,6,1260,1200,1170,972,460,400,97,96,617,636,208,463,389,0,,205
15:11:47,6031.497,Fox,1255,194,60,28,39,34,31,7,1260,1200,1172,972,460,402,97,97,618,637,208,463,390,0,,206
15:11:48,6032.097,Fox,1255,194,60,30,39,32,32,8,1262,1202,1172,972,462,403,97,97,618,637,208,463,390,0,,206
15:11:48,6032.397,Fox,1255,194,60,30,38,33,32,8,1262,1202,1172,973,462,403,97,97,618,637,208,463,390,0,,206
15:11:49,6033.597,Fox,1259,196,60,30,38,33,32,8,1264,1204,1174,973,462,403,97,99,620,639,209,464,390,0,,208
15:11:49,6034.197,Fox,1259,194,62,28,40,31,32,8,1266,1204,1176,973,462,403,97,97,620,639,209,466,390,0,,206
15:11:49,6034.797,Fox,1261,195,64,28,39,31,32,8,1268,1204,1176,973,462,403,97,98,621,640,210,466,390,0,,207
15:11:50,6036.338,Fox,1261,194,64,28,39,31,32,7,1268,1204,1176,973,462,403,97,97,621,640,210,466,391,0,,206
15:11:51,6036.938,Fox,1261,194,62,30,39,30,33,7,1268,1206,1176,973,463,403,97,97,621,640,210,466,391,0,,206
15:11:51,6037.538,Fox,1261,194,60,32,39,30,33,7,1268,1208,1176,973,463,403,97,97,621,640,210,466,391,0,,206
15:11:52,6038.738,Fox,1261,192,58,34,37,30,33,7,1268,1210,1176,975,463,403,96,96,621,640,210,468,391,0,,204
15:11:52,6039.038,Fox,1261,192,58,32,38,29,35,7,1268,1210,1178,976,465,403,96,96,621,640,210,468,391,0,,204
15:11:53,6040.771,Fox,1261,192,58,28,41,30,35,7,1268,1210,1182,977,465,403,96,96,621,640,210,468,391,0,,204
15:11:53,6041.372,Fox,1261,192,58,28,40,31,35,7,1268,1210,1182,978,465,403,96,96,621,640,210,468,391,0,,204
15:11:53,6042.257,Fox,1265,195,62,28,39,31,35,7,1272,1210,1182,978,465,403,98,97,624,641,210,469,391,0,,207
15:11:54,6043.157,Fox,1267,197,62,30,39,31,35,7,1274,1212,1182,978,465,403,99,98,625,642,210,469,391,0,,209
15:11:54,6043.457,Fox,1267,197,62,30,39,31,33,9,1274,1212,1182,978,465,405,99,98,625,642,210,469,391,0,,209
15:11:55,6045.557,Fox,1269,199,64,30,39,31,33,9,1276,1212,1182,978,465,405,99,100,625,644,210,469,391,0,,211
15:11:56,6047.657,Fox,1269,199,64,26,43,30,33,10,1276,1212,1186,978,466,406,99,100,625,644,210,469,391,0,,211
15:11:57,6048.257,Fox,1273,203,66,26,41,32,31,12,1278,1212,1186,980,466,408,101,102,627,646,210,469,391,0,,215
15:11:57,6048.557,Fox,1273,203,68,26,41,32,31,12,1280,1212,1186,980,466,408,101,102,627,646,210,469,391,0,,215
15:11:58,6049.457,Fox,1273,203,66,28,41,32,31,12,1280,1214,1186,980,466,408,101,102,627,646,210,469,391,0,,215
15:11:59,6051.257,Fox,1275,204,68,28,39,32,32,12,1282,1214,1186,982,467,408,102,102,629,646,210,470,391,0,,216
15:11:59,6051.857,Fox,1275,204,68,26,41,32,32,12,1282,1214,1188,982,467,408,102,102,629,646,210,470,391,0,,216
15:12:00,6053.357,Fox,1277,206,70,26,41,32,32,12,1284,1214,1188,982,467,408,103,103,630,647,210,470,391,0,,218
15:12:01,6054.257,Fox,1279,207,72,24,42,31,33,12,1286,1214,1190,982,468,408,103,104,631,648,211,470,391,0,,219
15:12:01,6054.557,Fox,1279,207,72,24,40,33,33,12,1286,1214,1190,984,468,408,103,104,631,648,211,470,391,0,,219
15:12:01,6055.457,Fox,1279,207,72,22,40,34,34,12,1286,1214,1192,986,469,408,103,104,631,648,211,470,391,0,,219
15:12:02,6056.957,Fox,1283,211,74,22,40,34,34,12,1288,1214,1192,986,469,408,106,105,634,649,211,470,391,0,,223
15:12:02,6057.257,Fox,1283,211,76,22,40,34,34,12,1290,1214,1192,986,469,408,106,105,634,649,211,470,391,0,,223
15:12:03,6058.757,Fox,1285,213,76,20,44,34,34,12,1292,1216,1196,986,469,408,106,107,634,651,211,470,391,0,,225
15:12:04,6059.357,Fox,1287,213,76,20,43,34,34,11,1292,1216,1196,986,469,408,105,108,635,652,212,470,392,0,,225
15:12:04,6059.957,Fox,1289,215,78,20,43,34,34,11,1294,1216,1196,986,469,408,106,109,636,653,212,470,392,0,,227
15:12:04,6060.257,Fox,1289,215,80,20,43,34,34,11,1296,1216,1196,986,469,408,106,109,636,653,212,470,392,0,,227
15:12:04,6060.857,Fox,1289,215,80,18,43,36,34,11,1296,1216,1198,988,469,408,106,109,636,653,212,470,392,0,,227
15:12:05,6061.757,Fox,1289,215,76,22,43,36,34,11,1296,1220,1198,988,469,408,106,109,636,653,212,470,392,0,,227
15:12:05,6062.657,Fox,1289,214,76,22,43,36,34,10,1296,1220,1198,988,469,408,106,108,636,653,212,470,393,0,,226
15:12:06,6063.857,Fox,1289,214,74,24,42,37,34,10,1296,1222,1198,989,469,408,106,108,636,653,212,470,393,0,,226
15:12:06,6064.457,Fox,1289,214,72,24,44,37,34,10,1296,1224,1200,989,469,408,106,108,636,653,212,470,393,0,,226
15:12:07,6065.657,Fox,1291,215,74,24,41,39,34,10,1298,1224,1200,991,469,408,107,108,638,653,213,470,393,0,,227
15:12:07,6066.118,Fox,1291,215,74,24,41,38,35,10,1298,1224,1200,991,470,408,107,108,638,653,213,470,393,0,,227
15:12:08,6067.019,Fox,1293,217,76,24,41,38,35,10,1300,1224,1200,991,470,408,108,109,639,654,213,470,393,0,,229
15:12:09,6068.218,Fox,1293,217,74,26,41,38,35,10,1300,1226,1200,991,470,408,108,109,639,654,213,470,393,0,,229
15:12:10,6069.718,Fox,1295,219,76,26,40,39,35,10,1302,1226,1200,992,470,408,109,110,640,655,213,470,393,0,,231
15:12:10,6070.618,Fox,1295,219,76,24,42,37,37,10,1302,1226,1202,992,472,408,109,110,640,655,213,470,393,0,,231
15:12:11,6071.519,Fox,1295,217,70,30,42,35,37,10,1302,1232,1202,992,472,408,109,108,640,655,215,470,393,0,,229
15:12:11,6071.818,Fox,1295,216,70,28,44,35,37,9,1302,1232,1204,992,472,408,109,107,640,655,215,470,394,0,,228
15:12:12,6073.618,Fox,1295,215,70,28,44,34,37,9,1302,1232,1204,992,472,408,109,106,640,655,215,471,394,0,,227
15:12:12,6074.218,Fox,1295,214,70,28,44,33,35,11,1302,1232,1204,992,472,410,108,106,640,655,216,471,394,0,,226
15:12:13,6074.818,Fox,1295,214,70,28,42,35,35,11,1302,1232,1204,994,472,410,108,106,640,655,216,471,394,0,,226
15:12:13,6075.718,Fox,1295,214,68,28,44,35,33,13,1302,1234,1206,994,472,412,108,106,640,655,216,471,394,0,,226
15:12:13,6076.019,Fox,1295,214,68,26,46,35,33,13,1302,1234,1208,994,472,412,108,106,640,655,216,471,394,0,,226
15:12:14,6077.218,Fox,1299,218,70,24,46,37,31,15,1304,1234,1210,996,472,414,110,108,642,657,216,471,394,0,,230
15:12:15,6077.818,Fox,1301,220,74,24,46,37,31,15,1308,1234,1210,996,472,414,111,109,643,658,216,471,394,0,,232
15:12:16,6079.318,Fox,1303,222,76,24,46,37,31,15,1310,1234,1210,996,472,414,112,110,644,659,216,471,394,0,,234
15:12:16,6079.918,Fox,1303,222,72,28,46,37,31,15,1310,1238,1210,996,472,414,112,110,644,659,216,471,394,0,,234
15:12:16,6080.519,Fox,1303,222,72,28,44,39,31,15,1310,1238,1210,998,472,414,112,110,644,659,216,471,394,0,,234
15:12:17,6081.118,Fox,1303,222,72,28,44,39,29,17,1310,1238,1210,998,472,416,112,110,644,659,216,471,394,0,,234
15:12:17,6082.019,Fox,1307,224,76,26,45,36,31,17,1314,1238,1212,998,474,416,111,113,645,662,218,471,394,0,,236
15:12:18,6083.218,Fox,1309,225,78,26,45,36,31,16,1316,1238,1212,998,474,416,112,113,647,662,218,471,395,0,,237
15:12:19,6084.118,Fox,1311,227,80,26,43,38,31,16,1318,1238,1212,1000,474,416,113,114,648,663,218,471,395,0,,239
15:12:19,6085.019,Fox,1313,229,82,26,43,38,31,16,1320,1238,1212,1000,474,416,113,116,648,665,218,471,395,0,,241
15:12:20,6085.618,Fox,1315,230,84,26,42,38,31,16,1322,1238,1212,1000,474,416,113,117,649,666,219,471,395,0,,242
15:12:20,6086.369,Fox,1315,228,84,26,42,35,32,16,1322,1238,1212,1000,475,416,113,115,649,666,221,471,395,0,,240
15:12:21,6087.269,Fox,1315,227,82,28,42,34,32,16,1322,1240,1212,1000,475,416,113,114,649,666,222,471,395,0,,239
15:12:21,6087.869,Fox,1317,229,84,26,42,36,32,16,1324,1240,1214,1002,475,416,114,115,650,667,222,471,395,0,,241
15:12:21,6088.699,Fox,1319,230,82,28,42,36,32,15,1324,1242,1214,1002,475,416,113,117,650,669,222,471,396,0,,242
15:12:21,6088.958,Fox,1319,230,84,28,42,36,32,15,1326,1242,1214,1002,475,416,113,117,650,669,222,471,396,0,,242
15:12:22,6089.858,Fox,1323,233,88,28,42,36,31,15,1330,1242,1214,1002,475,416,114,119,652,671,222,472,396,0,,245
15:12:22,6090.158,Fox,1323,233,86,30,42,36,31,15,1330,1244,1214,1002,475,416,114,119,652,671,222,472,396,0,,245
15:12:22,6090.758,Fox,1323,233,86,30,40,38,31,15,1330,1244,1214,1004,475,416,114,119,652,671,222,472,396,0,,245
15:12:23,6091.958,Fox,1323,233,84,32,38,40,31,15,1330,1246,1214,1006,475,416,114,119,652,671,222,472,396,0,,245
15:12:23,6092.558,Fox,1323,233,82,34,38,40,31,15,1330,1248,1214,1006,475,416,114,119,652,671,222,472,396,0,,245
15:12:24,6093.458,Fox,1329,239,86,36,38,38,31,17,1336,1250,1214,1006,477,418,118,121,656,673,222,472,396,0,,251
15:12:25,6094.358,Fox,1331,241,84,38,36,40,31,17,1336,1252,1214,1008,477,418,119,122,657,674,222,472,396,0,,253
15:12:25,6094.958,Fox,1331,241,86,38,34,40,33,17,1338,1252,1214,1010,479,418,119,122,657,674,222,472,396,0,,253
15:12:26,6096.158,Fox,1333,242,88,38,34,37,35,17,1340,1252,1214,1010,481,418,119,123,658,675,222,473,396,0,,254
15:12:26,6097.058,Fox,1333,241,86,38,36,37,35,16,1340,1254,1216,1010,481,418,119,122,658,675,222,473,397,0,,253
15:12:27,6098.258,Fox,1335,242,88,38,35,36,36,16,1342,1254,1216,1010,482,418,118,124,658,677,223,473,397,0,,254
15:12:27,6098.858,Fox,1337,243,88,38,35,36,36,15,1342,1254,1216,1010,482,418,119,124,659,678,223,473,398,0,,255
15:12:28,6099.458,Fox,1337,242,90,38,34,36,36,15,1344,1254,1216,1011,482,418,118,124,659,678,224,473,398,0,,254
15:12:28,6100.358,Fox,1337,242,90,34,38,36,36,15,1344,1254,1220,1011,482,418,118,124,659,678,224,473,398,0,,254
15:12:29,6101.258,Fox,1337,242,88,36,34,40,36,15,1344,1256,1220,1015,482,418,118,124,659,678,224,473,398,0,,254
15:12:29,6102.383,Fox,1337,241,88,34,36,40,36,14,1344,1256,1222,1015,482,418,118,123,659,678,224,473,399,0,,253
15:12:29,6102.788,Fox,1337,241,88,32,38,40,36,14,1344,1256,1224,1015,482,418,118,123,659,678,224,473,399,0,,253
15:12:31,6104.954,Fox,1339,243,90,32,38,40,36,14,1346,1256,1224,1015,482,418,119,124,660,679,224,473,399,0,,255
15:12:31,6105.553,Fox,1339,243,88,34,38,40,36,14,1346,1258,1224,1015,482,418,119,124,660,679,224,473,399,0,,255
15:12:32,6106.454,Fox,1341,244,90,34,37,40,36,14,1348,1258,1224,1015,482,418,119,125,661,680,224,474,399,0,,256
15:12:32,6106.753,Fox,1341,244,90,32,39,40,36,14,1348,1258,1226,1015,482,418,119,125,661,680,224,474,399,0,,256
15:12:33,6108.095,Fox,1343,245,90,32,37,41,36,14,1348,1258,1226,1016,482,418,119,126,662,681,225,474,399,0,,257
15:12:33,6108.395,Fox,1343,245,92,32,36,42,36,14,1350,1258,1226,1017,482,418,119,126,662,681,225,474,399,0,,257
15:12:34,6109.895,Fox,1345,246,92,28,40,41,34,16,1350,1258,1230,1017,482,420,120,126,664,681,225,475,399,0,,258
15:12:34,6110.495,Fox,1347,247,96,26,41,41,34,16,1354,1258,1232,1017,482,420,121,126,666,681,226,475,399,0,,259
15:12:34,6111.095,Fox,1347,245,96,26,41,39,34,16,1354,1258,1232,1017,482,420,121,124,666,681,226,477,399,0,,257
15:12:35,6111.995,Fox,1349,247,96,28,41,38,35,16,1356,1260,1232,1017,483,420,121,126,666,683,226,477,399,0,,259
15:12:35,6112.595,Fox,1349,247,96,28,39,40,35,16,1356,1260,1232,1019,483,420,121,126,666,683,226,477,399,0,,259
15:12:36,6113.495,Fox,1349,246,96,28,39,40,35,15,1356,1260,1232,1019,483,420,121,125,666,683,226,477,400,0,,258
15:12:36,6114.57,Fox,1349,246,94,28,41,40,35,15,1356,1262,1234,1019,483,420,121,125,666,683,226,477,400,0,,258
15:12:37,6115.17,Fox,1349,243,94,28,39,40,34,15,1356,1262,1234,1021,484,422,120,123,666,683,226,478,402,0,,255
15:12:37,6116.07,Fox,1351,245,96,28,37,42,34,15,1358,1262,1234,1023,484,422,121,124,667,684,226,478,402,0,,257
15:12:38,6116.67,Fox,1351,244,92,32,37,40,35,15,1358,1266,1234,1023,486,423,120,124,667,684,226,478,403,0,,256
15:12:39,6117.87,Fox,1353,243,90,34,37,38,35,14,1358,1268,1234,1023,486,423,120,123,668,685,228,478,404,0,,255
15:12:39,6118.47,Fox,1353,242,92,30,41,37,36,13,1360,1268,1238,1023,487,423,120,122,668,685,228,478,405,0,,254
15:12:40,6119.37,Fox,1353,242,92,30,38,40,36,13,1360,1268,1238,1026,487,423,120,122,668,685,228,478,405,0,,254
15:12:40,6119.97,Fox,1355,244,94,30,38,40,36,13,1362,1268,1238,1026,487,423,121,123,669,686,228,478,405,0,,256
15:12:41,6121.679,Fox,1357,245,96,30,35,42,36,13,1364,1268,1238,1028,487,423,120,125,669,688,228,479,405,0,,257
15:12:42,6124.077,Fox,1359,247,98,30,35,42,36,13,1366,1268,1238,1028,487,423,120,127,669,690,228,479,405,0,,259
15:12:43,6125.277,Fox,1361,248,94,34,35,42,36,12,1366,1272,1238,1028,487,423,120,128,670,691,228,479,406,0,,260
15:12:43,6125.877,Fox,1361,245,94,34,37,39,37,11,1368,1274,1240,1028,488,423,118,127,670,691,228,482,406,0,,257
15:12:44,6126.777,Fox,1361,244,94,34,37,39,36,11,1368,1274,1240,1028,488,424,118,126,670,691,228,482,407,0,,256
15:12:44,6127.377,Fox,1361,244,94,32,39,39,34,13,1368,1274,1242,1028,488,426,118,126,670,691,228,482,407,0,,256
15:12:45,6127.978,Fox,1363,246,96,32,39,39,34,13,1370,1274,1242,1028,488,426,119,127,671,692,228,482,407,0,,258
15:12:45,6128.577,Fox,1363,246,94,32,41,39,34,13,1370,1276,1244,1028,488,426,119,127,671,692,228,482,407,0,,258
15:12:46,6130.077,Fox,1365,247,96,30,42,39,34,13,1372,1276,1246,1028,488,426,119,128,672,693,228,483,407,0,,259
15:12:46,6130.677,Fox,1367,249,98,30,42,39,34,13,1374,1276,1246,1028,488,426,120,129,673,694,228,483,407,0,,261
15:12:47,6131.277,Fox,1367,249,94,32,42,41,34,13,1374,1280,1248,1030,488,426,120,129,673,694,228,483,407,0,,261
15:12:47,6131.577,Fox,1367,249,94,30,44,41,34,13,1374,1280,1250,1030,488,426,120,129,673,694,228,483,407,0,,261
15:12:48,6132.478,Fox,1369,251,96,30,42,42,35,13,1376,1280,1250,1032,489,426,121,130,674,695,228,483,407,0,,263
15:12:48,6132.777,Fox,1369,251,96,28,44,42,35,13,1376,1280,1252,1032,489,426,121,130,674,695,228,483,407,0,,263
15:12:48,6133.377,Fox,1369,251,96,28,44,42,33,15,1376,1280,1252,1032,489,428,121,130,674,695,228,483,407,0,,263
15:12:48,6133.978,Fox,1369,251,94,30,44,42,33,15,1376,1282,1252,1032,489,428,121,130,674,695,228,483,407,0,,263
15:12:49,6135.478,Fox,1369,250,94,28,46,41,33,15,1376,1282,1254,1032,489,428,121,129,674,695,228,484,407,0,,262
15:12:49,6136.077,Fox,1369,249,92,30,45,41,33,15,1376,1284,1254,1033,489,428,121,128,674,695,228,485,407,0,,261
15:12:49,6136.377,Fox,1369,249,92,30,43,43,33,15,1376,1284,1254,1035,489,428,121,128,674,695,228,485,407,0,,261
15:12:50,6137.245,Fox,1373,252,92,32,42,43,33,15,1378,1286,1254,1035,489,428,123,129,677,696,229,485,407,0,,264
15:12:50,6137.845,Fox,1373,251,94,32,40,45,33,14,1380,1286,1254,1037,489,428,123,128,677,696,229,485,408,0,,263
15:12:51,6139.345,Fox,1375,252,96,30,41,45,33,14,1382,1286,1256,1037,489,428,123,129,678,697,229,486,408,0,,264
15:12:51,6139.945,Fox,1375,252,92,34,41,45,33,14,1382,1290,1256,1037,489,428,123,129,678,697,229,486,408,0,,264
15:12:52,6141.745,Fox,1375,251,90,36,41,42,35,14,1382,1292,1256,1037,491,428,123,128,678,697,230,486,408,0,,263
15:12:53,6142.345,Fox,1375,251,88,38,39,44,34,15,1382,1294,1256,1039,491,429,123,128,678,697,230,486,408,0,,263
15:12:53,6142.945,Fox,1375,251,86,40,39,44,34,15,1382,1296,1256,1039,491,429,123,128,678,697,230,486,408,0,,263
15:12:54,6143.845,Fox,1375,251,86,38,41,44,34,15,1382,1296,1258,1039,491,429,123,128,678,697,230,486,408,0,,263
15:12:54,6144.445,Fox,1375,251,86,38,41,42,36,15,1382,1296,1258,1039,493,429,123,128,678,697,230,486,408,0,,263
15:12:55,6145.86,Fox,1375,251,86,38,41,42,34,17,1382,1296,1258,1039,493,431,123,128,678,697,230,486,408,0,,263
15:12:57,6148.56,Fox,1377,250,86,40,39,40,35,17,1384,1298,1258,1040,494,431,122,128,678,699,230,489,408,0,,262
15:12:57,6148.86,Fox,1377,249,86,40,39,40,35,16,1384,1298,1258,1040,494,431,122,127,678,699,230,490,408,0,,261
15:12:57,6149.76,Fox,1377,249,84,42,39,40,35,16,1384,1300,1258,1040,494,431,122,127,678,699,230,490,408,0,,261
15:12:58,6150.66,Fox,1377,249,84,40,41,40,35,16,1384,1300,1260,1040,494,431,122,127,678,699,230,490,408,0,,261
15:12:58,6151.26,Fox,1377,249,84,40,41,40,34,17,1384,1300,1260,1040,494,432,122,127,678,699,230,490,408,0,,261
15:12:59,6152.76,Fox,1377,246,82,42,41,37,34,17,1384,1302,1260,1040,494,432,122,124,678,699,231,492,408,0,,258
15:12:59,6153.06,Fox,1377,246,82,40,43,37,34,17,1384,1302,1262,1040,494,432,122,124,678,699,231,492,408,0,,258
15:13:00,6154.26,Fox,1381,249,84,40,43,35,36,16,1386,1302,1262,1040,496,432,122,127,679,702,231,492,409,0,,261
15:13:00,6154.86,Fox,1381,249,86,38,45,35,36,16,1388,1302,1264,1040,496,432,122,127,679,702,231,492,409,0,,261
15:13:00,6155.16,Fox,1381,249,86,36,47,35,36,16,1388,1302,1266,1040,496,432,122,127,679,702,231,492,409,0,,261
15:13:01,6156.021,Fox,1381,249,86,34,49,35,36,16,1388,1302,1268,1040,496,432,122,127,679,702,231,492,409,0,,261
15:13:02,6157.521,Fox,1383,251,86,34,47,37,36,16,1388,1302,1268,1042,496,432,123,128,680,703,231,492,409,0,,263
15:13:02,6157.821,Fox,1383,251,88,34,47,37,36,16,1390,1302,1268,1042,496,432,123,128,680,703,231,492,409,0,,263
15:13:03,6159.321,Fox,1385,252,90,34,46,36,37,16,1392,1302,1268,1042,497,432,122,130,680,705,231,493,409,0,,264
15:13:03,6160.221,Fox,1387,253,86,38,46,35,37,16,1392,1306,1268,1042,497,432,122,131,681,706,231,494,409,0,,265
15:13:04,6160.821,Fox,1387,251,86,40,43,38,36,15,1394,1308,1268,1045,497,433,120,131,681,706,231,494,411,0,,263
15:13:05,6162.021,Fox,1389,252,86,42,42,38,36,15,1396,1310,1268,1045,497,433,119,133,681,708,231,495,411,0,,264
15:13:05,6162.921,Fox,1391,254,86,42,41,38,37,15,1396,1310,1268,1046,498,433,120,134,682,709,231,495,411,0,,266
15:13:06,6163.521,Fox,1391,254,88,38,43,40,37,15,1398,1310,1272,1048,498,433,120,134,682,709,231,495,411,0,,266
15:13:06,6164.721,Fox,1391,254,84,40,45,40,37,15,1398,1314,1274,1048,498,433,120,134,682,709,231,495,411,0,,266
15:13:07,6165.921,Fox,1397,256,86,42,44,38,37,14,1402,1316,1274,1048,498,433,119,137,685,712,232,497,412,0,,268
15:13:08,6166.521,Fox,1399,258,88,42,44,38,37,14,1404,1316,1274,1048,498,433,120,138,686,713,232,497,412,0,,270
15:13:08,6167.122,Fox,1401,259,88,42,45,39,37,13,1406,1318,1276,1049,498,433,121,138,687,714,232,497,413,0,,271
15:13:08,6167.721,Fox,1401,258,88,44,45,39,37,12,1408,1320,1276,1049,498,433,121,137,687,714,232,497,414,0,,270
15:13:09,6168.622,Fox,1403,259,86,46,45,37,38,12,1408,1322,1276,1049,499,433,121,138,688,715,232,498,414,0,,271
15:13:09,6168.921,Fox,1403,259,88,46,45,37,38,12,1410,1322,1276,1049,499,433,121,138,688,715,232,498,414,0,,271
15:13:10,6169.821,Fox,1403,259,88,42,49,37,36,14,1410,1322,1280,1049,499,435,121,138,688,715,232,498,414,0,,271
15:13:10,6170.421,Fox,1407,262,88,44,43,42,36,14,1412,1324,1280,1054,499,435,122,140,690,717,233,498,414,0,,274
15:13:11,6171.021,Fox,1413,267,92,44,42,42,36,14,1416,1324,1280,1054,499,435,124,143,693,720,234,498,414,0,,279
15:13:11,6171.622,Fox,1413,266,94,46,42,41,36,14,1420,1326,1280,1054,499,435,123,143,693,720,234,499,414,0,,278
15:13:12,6172.821,Fox,1419,271,90,48,43,41,36,14,1420,1330,1282,1054,499,435,125,146,696,723,234,500,414,0,,283
15:13:12,6173.122,Fox,1419,271,96,48,43,41,36,14,1426,1330,1282,1054,499,435,125,146,696,723,234,500,414,0,,283
15:13:13,6174.321,Fox,1423,272,100,48,42,40,36,13,1430,1330,1282,1054,499,435,125,147,698,725,235,501,415,0,,284
15:13:13,6174.921,Fox,1425,273,102,46,43,40,35,14,1432,1330,1284,1055,499,436,126,147,699,726,235,502,415,0,,285
15:13:14,6175.8,Fox,1425,272,102,44,45,40,35,13,1432,1330,1286,1055,499,436,125,147,699,726,235,502,416,0,,284
15:13:14,6176.028,Fox,1425,272,96,50,45,40,35,13,1432,1336,1286,1055,499,436,125,147,699,726,235,502,416,0,,284
15:13:14,6176.573,Fox,1425,272,96,50,45,40,33,15,1432,1336,1286,1055,499,438,125,147,699,726,235,502,416,0,,284
15:13:15,6177.173,Fox,1425,272,94,52,45,40,33,15,1432,1338,1286,1055,499,438,125,147,699,726,235,502,416,0,,284
15:13:15,6178.374,Fox,1425,272,94,48,49,40,33,15,1432,1338,1290,1055,499,438,125,147,699,726,235,502,416,0,,284
15:13:16,6178.973,Fox,1425,272,92,50,45,44,33,15,1432,1340,1290,1059,499,438,125,147,699,726,235,502,416,0,,284
15:13:17,6179.874,Fox,1425,272,92,48,47,44,33,15,1432,1340,1292,1059,499,438,125,147,699,726,235,502,416,0,,284
15:13:17,6180.773,Fox,1427,274,92,48,49,44,33,15,1434,1342,1294,1059,499,438,127,147,701,726,235,502,416,0,,286
15:13:18,6181.374,Fox,1427,273,92,46,51,42,35,14,1434,1342,1296,1059,501,438,126,147,701,726,235,502,417,0,,285
15:13:18,6181.673,Fox,1427,273,90,48,51,42,35,14,1434,1344,1296,1059,501,438,126,147,701,726,235,502,417,0,,285
15:13:19,6182.874,Fox,1429,274,92,48,50,42,35,14,1436,1344,1296,1059,501,438,126,148,702,727,236,502,417,0,,286
15:13:19,6184.073,Fox,1429,274,92,48,50,40,37,14,1436,1344,1296,1059,503,438,126,148,702,727,236,502,417,0,,286
15:13:19,6184.808,Fox,1429,273,92,48,50,40,36,14,1436,1344,1296,1059,503,439,126,147,702,727,236,502,418,0,,285
15:13:20,6186.308,Fox,1429,273,92,48,48,42,36,14,1436,1344,1296,1061,503,439,126,147,702,727,236,502,418,0,,285
15:13:21,6187.208,Fox,1431,275,94,46,50,42,36,14,1438,1344,1298,1061,503,439,128,147,704,727,236,502,418,0,,287
15:13:21,6187.808,Fox,1435,278,96,48,49,40,38,14,1442,1346,1298,1062,505,439,128,150,705,730,236,503,418,0,,290
15:13:22,6188.408,Fox,1435,276,96,46,51,37,39,14,1442,1346,1300,1062,507,440,126,150,705,730,236,504,419,0,,288
15:13:22,6189.008,Fox,1435,276,94,48,50,38,39,14,1442,1348,1300,1063,507,440,126,150,705,730,236,504,419,0,,288
15:13:24,6190.808,Fox,1439,279,98,46,50,39,39,14,1446,1348,1302,1064,507,440,128,151,708,731,236,505,419,0,,291
15:13:24,6191.105,Fox,1439,279,96,48,50,39,39,14,1446,1350,1302,1064,507,440,128,151,708,731,236,505,419,0,,291
15:13:24,6191.683,Fox,1439,279,96,48,49,40,38,15,1446,1350,1302,1065,507,441,128,151,708,731,236,505,419,0,,291
15:13:25,6192.583,Fox,1441,280,98,48,48,40,38,15,1448,1350,1302,1066,507,441,128,152,709,732,236,506,419,0,,292
15:13:25,6193.183,Fox,1445,284,96,52,48,39,38,16,1450,1354,1302,1066,508,442,130,154,711,734,236,506,419,0,,296
15:13:25,6193.649,Fox,1447,286,98,52,46,41,38,16,1452,1354,1302,1068,508,442,130,156,711,736,236,506,419,0,,298
15:13:25,6193.889,Fox,1447,286,100,52,46,41,38,16,1454,1354,1302,1068,508,442,130,156,711,736,236,506,419,0,,298
15:13:25,6194.792,Fox,1447,286,98,54,46,39,40,16,1454,1356,1302,1068,510,442,130,156,711,736,236,506,419,0,,298
15:13:25,6195.011,Fox,1447,285,98,54,46,39,40,15,1454,1356,1302,1068,510,442,130,155,711,736,236,506,420,0,,297
15:13:26,6195.91,Fox,1447,285,98,54,44,41,40,15,1454,1356,1302,1070,510,442,130,155,711,736,236,506,420,0,,297
15:13:26,6197.318,Fox,1449,286,100,54,43,41,40,15,1456,1356,1302,1070,510,442,130,156,712,737,236,507,420,0,,298
15:13:27,6198.772,Fox,1449,286,98,52,47,41,40,15,1456,1358,1306,1070,510,442,130,156,712,737,236,507,420,0,,298
15:13:28,6199.373,Fox,1449,285,98,50,49,40,40,15,1456,1358,1308,1070,510,442,130,155,712,737,236,508,420,0,,297
15:13:28,6199.973,Fox,1449,285,98,50,47,42,40,15,1456,1358,1308,1072,510,442,130,155,712,737,236,508,420,0,,297
15:13:29,6200.873,Fox,1451,287,96,50,49,42,40,15,1456,1360,1310,1072,510,442,132,155,714,737,236,508,420,0,,299
15:13:29,6201.473,Fox,1451,285,98,50,49,39,41,15,1458,1360,1310,1072,511,442,132,153,714,737,238,508,420,0,,297
15:13:30,6202.973,Fox,1451,282,96,52,49,39,41,12,1458,1362,1310,1072,511,442,130,152,714,737,238,508,423,0,,294
15:13:30,6203.573,Fox,1451,281,96,48,53,38,41,12,1458,1362,1314,1072,511,442,130,151,714,737,239,508,423,0,,293
15:13:31,6204.173,Fox,1453,283,98,48,53,38,40,13,1460,1362,1314,1072,511,443,131,152,715,738,239,508,423,0,,295
15:13:31,6204.473,Fox,1453,283,96,48,54,39,40,13,1460,1364,1316,1073,511,443,131,152,715,738,239,508,423,0,,295
15:13:32,6205.373,Fox,1453,283,96,46,56,39,40,13,1460,1364,1318,1073,511,443,131,152,715,738,239,508,423,0,,295
15:13:32,6206.272,Fox,1453,283,96,44,58,37,42,13,1460,1364,1320,1073,513,443,131,152,715,738,239,508,423,0,,295
15:13:33,6206.873,Fox,1453,282,94,44,60,36,42,13,1460,1366,1322,1073,513,443,131,151,715,738,239,509,423,0,,294
15:13:34,6208.373,Fox,1453,282,92,46,60,36,40,15,1460,1368,1322,1073,513,445,131,151,715,738,239,509,423,0,,294
15:13:34,6209.189,Fox,1453,282,92,44,62,34,42,15,1460,1368,1324,1073,515,445,131,151,715,738,239,509,423,0,,294
15:13:34,6210.028,Fox,1453,282,92,42,64,34,42,15,1460,1368,1326,1073,515,445,131,151,715,738,239,509,423,0,,294
15:13:35,6210.928,Fox,1455,283,90,40,65,36,42,15,1460,1370,1330,1075,515,445,131,152,716,739,240,509,423,0,,295
15:13:35,6211.528,Fox,1459,284,96,40,64,34,42,15,1466,1370,1330,1075,515,445,130,154,717,742,241,511,423,0,,296
15:13:35,6211.782,Fox,1459,283,96,40,64,34,42,14,1466,1370,1330,1075,515,445,130,153,717,742,241,511,424,0,,295
15:13:36,6212.625,Fox,1459,283,94,42,64,34,42,14,1466,1372,1330,1075,515,445,130,153,717,742,241,511,424,0,,295
15:13:37,6213.525,Fox,1461,283,92,44,62,35,42,13,1466,1374,1330,1076,515,445,130,153,718,743,242,511,425,0,,295
15:13:37,6213.826,Fox,1461,283,94,44,62,35,42,13,1468,1374,1330,1076,515,445,130,153,718,743,242,511,425,0,,295
15:13:38,6215.025,Fox,1463,285,94,40,68,33,44,13,1470,1376,1336,1076,517,445,130,155,718,745,242,511,425,0,,297
15:13:38,6215.625,Fox,1463,285,94,40,64,37,44,13,1470,1376,1336,1080,517,445,130,155,718,745,242,511,425,0,,297
15:13:38,6215.925,Fox,1463,285,94,38,66,37,44,13,1470,1376,1338,1080,517,445,130,155,718,745,242,511,425,0,,297
15:13:39,6216.826,Fox,1463,283,94,38,65,38,44,11,1470,1376,1338,1081,517,445,129,154,718,745,242,511,427,0,,295
15:13:39,6217.425,Fox,1463,283,94,36,67,38,44,11,1470,1376,1340,1081,517,445,129,154,718,745,242,511,427,0,,295
15:13:40,6218.326,Fox,1465,284,96,36,66,38,44,11,1472,1376,1340,1081,517,445,129,155,719,746,243,511,427,0,,296
15:13:41,6219.798,Fox,1467,285,94,36,67,38,42,13,1472,1378,1342,1081,517,447,128,157,719,748,244,511,427,0,,297
15:13:41,6220.398,Fox,1467,284,94,36,69,37,42,13,1474,1380,1344,1081,517,447,127,157,719,748,244,512,427,0,,296
15:13:41,6220.698,Fox,1467,283,94,36,69,36,42,13,1474,1380,1344,1081,517,447,127,156,719,748,244,513,427,0,,295
15:13:42,6221.898,Fox,1467,283,92,38,69,36,42,13,1474,1382,1344,1081,517,447,127,156,719,748,244,513,427,0,,295
15:13:44,6224.298,Fox,1467,282,92,38,68,37,42,12,1474,1382,1344,1082,517,447,127,155,719,748,244,513,428,0,,294
15:13:44,6224.898,Fox,1467,281,92,38,66,36,44,12,1474,1382,1344,1084,519,447,126,155,719,748,244,514,428,0,,293
15:13:45,6226.098,Fox,1469,282,92,36,67,35,45,12,1474,1382,1346,1084,520,447,125,157,719,750,244,515,428,0,,294
15:13:45,6226.698,Fox,1471,284,94,36,67,35,45,12,1476,1382,1346,1084,520,447,127,157,721,750,244,515,428,0,,296
15:13:45,6227.131,Fox,1471,283,96,36,65,37,45,11,1478,1382,1346,1086,520,447,126,157,721,750,244,515,429,0,,295
15:13:45,6227.731,Fox,1471,283,96,34,67,37,45,11,1478,1382,1348,1086,520,447,126,157,721,750,244,515,429,0,,295
15:13:46,6228.724,Fox,1471,282,96,34,67,37,45,10,1478,1382,1348,1086,520,447,126,156,721,750,244,515,430,0,,294
15:13:46,6229.561,Fox,1473,282,98,32,69,35,45,10,1480,1382,1350,1086,520,447,127,155,722,751,245,516,430,0,,294
15:13:46,6230.116,Fox,1473,282,98,32,65,37,47,10,1480,1382,1350,1090,522,447,127,155,722,751,245,516,430,0,,294
15:13:46,6230.716,Fox,1473,282,98,32,65,37,45,12,1480,1382,1350,1090,522,449,127,155,722,751,245,516,430,0,,294
15:13:47,6231.616,Fox,1473,282,96,30,69,35,47,12,1480,1384,1354,1090,524,449,127,155,722,751,245,516,430,0,,294
15:13:47,6232.516,Fox,1475,283,98,30,68,35,45,14,1482,1384,1354,1090,524,451,127,156,723,752,245,517,430,0,,295
15:13:48,6233.116,Fox,1479,287,98,28,68,37,45,14,1482,1384,1356,1092,524,451,128,159,724,755,245,517,430,0,,299
15:13:48,6233.716,Fox,1481,289,102,28,68,37,43,16,1486,1384,1356,1092,524,453,129,160,725,756,245,517,430,0,,301
15:13:48,6234.016,Fox,1481,289,104,28,68,37,43,16,1488,1384,1356,1092,524,453,129,160,725,756,245,517,430,0,,301
15:13:49,6234.916,Fox,1481,289,104,28,66,39,43,16,1488,1384,1356,1094,524,453,129,160,725,756,245,517,430,0,,301
15:13:50,6235.816,Fox,1481,289,104,28,64,41,42,17,1488,1384,1356,1096,524,454,129,160,725,756,245,517,430,0,,301
15:13:50,6237.316,Fox,1481,289,100,30,66,41,42,17,1488,1388,1358,1096,524,454,129,160,725,756,245,517,430,0,,301
15:13:51,6238.71,Fox,1483,290,100,30,64,42,42,17,1488,1388,1358,1097,524,454,129,161,726,757,246,517,430,0,,302
15:13:51,6239.31,Fox,1491,296,106,28,64,42,42,17,1494,1388,1360,1099,524,454,132,164,731,760,248,517,430,0,,308
15:13:51,6239.61,Fox,1491,295,110,28,64,42,42,16,1498,1388,1360,1099,524,454,132,163,731,760,248,517,431,0,,307
15:13:52,6240.51,Fox,1491,295,108,30,62,44,42,16,1498,1390,1360,1101,524,454,132,163,731,760,248,517,431,0,,307
15:13:53,6241.41,Fox,1491,293,108,28,63,43,42,16,1498,1390,1362,1102,524,454,132,161,731,760,248,519,431,0,,305
15:13:53,6242.01,Fox,1491,293,106,30,62,44,42,16,1498,1392,1362,1103,524,454,132,161,731,760,248,519,431,0,,305
15:13:54,6243.172,Fox,1491,293,104,30,64,44,42,16,1498,1394,1364,1103,524,454,132,161,731,760,248,519,431,0,,305
15:13:54,6244.072,Fox,1497,298,106,30,64,43,42,16,1500,1394,1364,1103,524,454,132,166,732,765,248,520,431,0,,310
15:13:55,6244.672,Fox,1497,297,108,32,64,42,42,16,1504,1396,1364,1103,524,454,132,165,732,765,249,520,431,0,,309
15:13:55,6245.272,Fox,1499,298,110,30,66,42,42,15,1506,1396,1366,1103,524,454,132,166,733,766,249,520,432,0,,310
15:13:55,6245.872,Fox,1499,298,108,32,66,42,42,15,1506,1398,1366,1103,524,454,132,166,733,766,249,520,432,0,,310
15:13:56,6246.772,Fox,1499,297,108,30,68,41,42,15,1506,1398,1368,1103,524,454,132,165,733,766,250,520,432,0,,309
15:13:56,6247.372,Fox,1499,297,108,30,66,43,42,15,1506,1398,1368,1105,524,454,132,165,733,766,250,520,432,0,,309
15:13:57,6248.272,Fox,1501,297,110,30,66,41,42,15,1508,1398,1368,1105,524,454,130,167,733,768,252,520,432,0,,309
15:13:57,6248.872,Fox,1501,297,104,36,65,42,42,15,1508,1404,1368,1106,524,454,130,167,733,768,252,520,432,0,,309
15:13:57,6249.472,Fox,1501,297,102,36,67,42,41,16,1508,1406,1370,1106,524,455,130,167,733,768,252,520,432,0,,309
15:13:58,6250.372,Fox,1505,300,102,38,66,42,41,16,1510,1408,1370,1106,524,455,131,169,735,770,252,521,432,0,,312
15:13:58,6250.672,Fox,1505,300,104,38,66,42,41,16,1512,1408,1370,1106,524,455,131,169,735,770,252,521,432,0,,312
15:13:59,6251.572,Fox,1507,301,104,38,65,44,41,16,1514,1410,1372,1108,524,455,131,170,736,771,252,522,432,0,,313
15:13:59,6251.872,Fox,1507,301,104,36,67,44,41,16,1514,1410,1374,1108,524,455,131,170,736,771,252,522,432,0,,313
15:13:59,6252.472,Fox,1507,301,104,36,67,44,40,17,1514,1410,1374,1108,524,456,131,170,736,771,252,522,432,0,,313
15:14:00,6253.372,Fox,1511,304,102,40,66,44,40,17,1516,1414,1374,1108,524,456,134,170,740,771,252,523,432,0,,316
15:14:00,6253.934,Fox,1511,304,98,44,68,44,40,17,1518,1420,1376,1108,524,456,134,170,740,771,252,523,432,0,,316
15:14:00,6254.419,Fox,1517,309,100,44,67,44,38,19,1520,1420,1376,1108,524,458,136,173,743,774,253,523,432,0,,321
15:14:00,6254.683,Fox,1517,309,104,44,67,44,38,19,1524,1420,1376,1108,524,458,136,173,743,774,253,523,432,0,,321
15:14:01,6255.473,Fox,1519,310,106,44,66,44,38,19,1526,1420,1376,1108,524,458,136,174,744,775,253,524,432,0,,322
15:14:01,6255.717,Fox,1519,310,100,50,66,44,37,20,1526,1426,1376,1108,524,459,136,174,744,775,253,524,432,0,,322
15:14:01,6257.097,Fox,1519,309,96,54,66,43,37,20,1526,1430,1376,1108,524,459,136,173,744,775,253,525,432,0,,321
15:14:02,6257.697,Fox,1521,311,96,56,66,43,37,20,1528,1432,1376,1108,524,459,137,174,745,776,253,525,432,0,,323
15:14:02,6258.296,Fox,1523,313,98,54,68,43,37,20,1530,1432,1378,1108,524,459,138,175,746,777,253,525,432,0,,325
15:14:03,6258.896,Fox,1523,312,98,52,68,44,37,20,1530,1432,1380,1110,524,459,138,174,746,777,253,526,432,0,,324
15:14:03,6259.497,Fox,1523,312,98,52,65,47,37,20,1530,1432,1380,1113,524,459,138,174,746,777,253,526,432,0,,324
15:14:03,6260.091,Fox,1525,312,98,52,64,46,37,20,1530,1432,1380,1113,524,459,137,175,746,779,253,528,432,0,,324
15:14:03,6260.668,Fox,1525,312,100,50,66,45,38,20,1532,1432,1382,1113,525,459,137,175,746,779,253,528,432,0,,324
15:14:04,6261.208,Fox,1525,311,100,50,65,46,38,19,1532,1432,1382,1114,525,459,137,174,746,779,253,528,433,0,,323
15:14:05,6263.607,Fox,1525,311,98,52,62,49,37,20,1532,1434,1382,1117,525,460,137,174,746,779,253,528,433,0,,323
15:14:06,6264.508,Fox,1527,313,100,52,62,48,38,20,1534,1434,1382,1117,526,460,137,176,746,781,253,528,433,0,,325
15:14:06,6265.107,Fox,1531,316,100,52,60,49,38,20,1534,1434,1382,1118,526,460,138,178,748,783,253,529,433,0,,328
15:14:06,6265.708,Fox,1539,322,106,54,58,49,38,20,1542,1436,1382,1119,526,460,140,182,752,787,253,531,433,0,,334
15:14:07,6266.008,Fox,1539,322,110,54,58,49,38,20,1546,1436,1382,1119,526,460,140,182,752,787,253,531,433,0,,334
15:14:07,6266.569,Fox,1539,322,110,54,56,51,38,20,1546,1436,1382,1121,526,460,140,182,752,787,253,531,433,0,,334
15:14:07,6267.359,Fox,1539,322,110,54,55,52,38,20,1546,1436,1382,1122,526,460,140,182,752,787,253,531,433,0,,334
15:14:09,6269.159,Fox,1541,323,112,54,54,52,38,20,1548,1436,1382,1122,526,460,140,183,753,788,253,532,433,0,,335
15:14:09,6269.759,Fox,1541,323,110,54,54,54,38,20,1548,1438,1384,1124,526,460,140,183,753,788,253,532,433,0,,335
15:14:09,6270.359,Fox,1541,321,106,58,54,54,37,19,1548,1442,1384,1124,526,461,138,183,753,788,253,532,435,0,,333
15:14:09,6270.959,Fox,1541,318,106,58,52,53,37,19,1548,1442,1384,1126,526,461,137,181,753,788,254,534,435,0,,330
15:14:10,6271.559,Fox,1541,318,106,58,48,57,37,19,1548,1442,1384,1130,526,461,137,181,753,788,254,534,435,0,,330
15:14:11,6272.459,Fox,1545,320,108,58,47,54,39,19,1550,1442,1384,1130,528,461,135,185,753,792,255,535,435,0,,332
15:14:11,6273.059,Fox,1545,318,110,58,47,52,39,19,1552,1442,1384,1130,528,461,135,183,753,792,255,537,435,0,,330
15:14:11,6273.659,Fox,1549,322,106,62,47,52,39,19,1552,1446,1384,1130,528,461,135,187,753,796,255,537,435,0,,334
15:14:12,6274.236,Fox,1553,323,114,62,46,51,39,18,1560,1446,1384,1130,528,461,135,188,755,798,255,539,436,0,,335
15:14:12,6275.136,Fox,1555,324,114,64,41,55,39,18,1562,1448,1384,1134,528,461,136,188,757,798,255,540,436,0,,336
15:14:13,6275.736,Fox,1555,324,112,62,45,55,39,18,1562,1450,1388,1134,528,461,136,188,757,798,255,540,436,0,,336
15:14:13,6276.336,Fox,1557,324,110,64,44,54,39,18,1562,1452,1388,1135,528,461,138,186,759,798,255,542,436,0,,336
15:14:13,6276.636,Fox,1557,324,110,66,44,54,39,18,1564,1454,1388,1135,528,461,138,186,759,798,255,542,436,0,,336
15:14:14,6277.536,Fox,1559,325,112,66,43,54,39,18,1566,1454,1388,1135,528,461,138,187,760,799,255,543,436,0,,337
15:14:14,6277.836,Fox,1559,325,112,66,41,56,39,18,1566,1454,1388,1137,528,461,138,187,760,799,255,543,436,0,,337
15:14:15,6279.036,Fox,1559,324,112,64,43,55,39,18,1566,1454,1390,1137,528,461,137,187,760,799,255,544,436,0,,336
15:14:15,6279.636,Fox,1563,326,116,64,43,55,37,18,1570,1454,1390,1137,528,463,138,188,761,802,255,544,438,0,,338
15:14:16,6280.236,Fox,1565,326,116,66,41,56,37,17,1572,1456,1390,1139,528,463,137,189,761,804,256,544,439,0,,338
15:14:16,6280.836,Fox,1565,326,116,64,41,58,37,17,1572,1456,1392,1141,528,463,137,189,761,804,256,544,439,0,,338
15:14:17,6281.436,Fox,1567,326,118,64,41,55,38,17,1574,1456,1392,1141,529,463,138,188,763,804,257,545,439,0,,338
15:14:17,6282.036,Fox,1567,326,118,62,43,55,36,19,1574,1456,1394,1141,529,465,138,188,763,804,257,545,439,0,,338
15:14:17,6282.873,Fox,1569,327,118,62,43,54,37,18,1574,1456,1394,1141,530,465,139,188,765,804,257,545,440,0,,339
15:14:18,6283.1,Fox,1569,327,120,60,45,54,37,18,1576,1456,1396,1141,530,465,139,188,765,804,257,545,440,0,,339
15:14:18,6284,Fox,1571,329,120,62,45,53,38,18,1578,1458,1396,1141,531,465,140,189,766,805,257,545,440,0,,341
15:14:19,6284.3,Fox,1571,328,120,60,47,53,38,17,1578,1458,1398,1141,531,465,139,189,766,805,257,545,441,0,,340
15:14:19,6285.2,Fox,1573,329,122,60,46,53,38,17,1580,1458,1398,1141,531,465,140,189,768,805,258,545,441,0,,341
15:14:20,6285.8,Fox,1575,330,124,60,45,52,39,17,1582,1458,1398,1141,532,465,139,191,768,807,258,546,441,0,,342
15:14:20,6286.1,Fox,1575,330,124,60,45,52,38,18,1582,1458,1398,1141,532,466,139,191,768,807,258,546,441,0,,342
15:14:20,6287,Fox,1575,328,122,58,48,50,39,18,1582,1460,1402,1142,533,466,139,189,768,807,258,548,441,0,,340
15:14:21,6287.6,Fox,1577,329,122,56,49,50,39,18,1582,1460,1404,1142,533,466,138,191,768,809,258,549,441,0,,341
15:14:21,6288.2,Fox,1577,327,124,54,50,50,39,17,1584,1460,1406,1143,533,466,138,189,768,809,259,549,442,0,,339
15:14:21,6288.5,Fox,1577,326,124,52,52,49,39,17,1584,1460,1408,1143,533,466,138,188,768,809,260,549,442,0,,338
15:14:22,6289.4,Fox,1581,329,126,52,51,48,40,17,1586,1460,1408,1143,534,466,139,190,770,811,260,550,442,0,,341
15:14:22,6290,Fox,1581,329,128,50,52,49,40,17,1588,1460,1410,1144,534,466,139,190,770,811,260,550,442,0,,341
15:14:23,6291.8,Fox,1581,329,128,46,55,50,38,19,1588,1460,1414,1145,534,468,139,190,770,811,260,550,442,0,,341
15:14:24,6292.4,Fox,1581,329,128,40,59,52,38,19,1588,1460,1420,1147,534,468,139,190,770,811,260,550,442,0,,341
15:14:24,6293,Fox,1581,327,128,40,59,52,38,17,1588,1460,1420,1147,534,468,138,189,770,811,260,550,444,0,,339
15:14:25,6293.9,Fox,1581,327,126,42,57,53,39,17,1588,1462,1420,1149,535,468,138,189,770,811,260,550,444,0,,339
15:14:25,6294.2,Fox,1581,327,122,40,63,53,39,17,1588,1466,1426,1149,535,468,138,189,770,811,260,550,444,0,,339
15:14:26,6295.39,Fox,1581,326,122,36,67,52,39,17,1588,1466,1430,1149,535,468,138,188,770,811,260,551,444,0,,338
15:14:26,6295.987,Fox,1581,326,122,34,69,52,39,17,1588,1466,1432,1149,535,468,138,188,770,811,260,551,444,0,,338
15:14:27,6296.887,Fox,1583,328,120,36,69,52,38,18,1588,1468,1432,1149,535,469,139,189,771,812,260,551,444,0,,340
15:14:27,6297.487,Fox,1585,329,122,36,68,52,38,18,1590,1468,1432,1149,535,469,140,189,773,812,260,552,444,0,,341
15:14:27,6298.087,Fox,1587,330,124,38,66,52,39,18,1594,1470,1432,1150,536,469,141,189,775,812,260,553,444,0,,342
15:14:28,6300.047,Fox,1589,331,126,38,65,52,39,18,1596,1470,1432,1151,536,469,140,191,775,814,260,554,444,0,,343
15:14:29,6300.647,Fox,1591,332,126,38,65,52,38,18,1596,1470,1432,1151,536,470,140,192,775,816,260,554,445,0,,344
15:14:29,6301.247,Fox,1593,333,128,40,64,52,38,18,1600,1472,1432,1151,536,470,140,193,776,817,260,555,445,0,,345
15:14:30,6301.847,Fox,1593,333,128,38,64,54,38,18,1600,1472,1434,1153,536,470,140,193,776,817,260,555,445,0,,345
15:14:30,6302.747,Fox,1593,333,126,40,64,54,38,18,1600,1474,1434,1153,536,470,140,193,776,817,260,555,445,0,,345
15:14:31,6303.347,Fox,1593,333,126,40,62,56,38,18,1600,1474,1434,1155,536,470,140,193,776,817,260,555,445,0,,345
15:14:31,6303.947,Fox,1593,333,126,38,64,56,38,18,1600,1474,1436,1155,536,470,140,193,776,817,260,555,445,0,,345
15:14:32,6305.747,Fox,1593,332,126,38,62,57,37,19,1600,1474,1436,1157,536,471,140,192,776,817,261,555,445,0,,344
15:14:33,6306.347,Fox,1593,331,126,38,62,57,37,18,1600,1474,1436,1157,536,471,140,191,776,817,261,555,446,0,,343
15:14:33,6307.247,Fox,1593,330,126,38,61,57,37,18,1600,1474,1436,1158,536,471,140,190,776,817,261,556,446,0,,342
15:14:34,6308.747,Fox,1593,330,126,36,63,55,39,18,1600,1474,1438,1158,538,471,140,190,776,817,261,556,446,0,,342
15:14:35,6309.047,Fox,1593,330,124,34,67,54,40,18,1600,1476,1442,1158,539,471,140,190,776,817,261,556,446,0,,342
15:14:35,6309.947,Fox,1597,333,122,36,64,56,40,18,1600,1478,1442,1160,539,471,141,192,778,819,261,557,446,0,,345
15:14:36,6310.547,Fox,1601,334,126,36,62,56,40,17,1604,1478,1442,1160,539,471,141,193,780,821,261,559,447,0,,346
15:14:36,6310.847,Fox,1601,334,130,36,62,56,40,17,1608,1478,1442,1160,539,471,141,193,780,821,261,559,447,0,,346
15:14:37,6312.047,Fox,1601,334,130,32,65,57,40,17,1608,1478,1446,1161,539,471,141,193,780,821,261,559,447,0,,346
15:14:37,6312.347,Fox,1601,334,128,34,64,58,40,17,1608,1480,1446,1162,539,471,141,193,780,821,261,559,447,0,,346
15:14:37,6312.947,Fox,1601,332,128,34,64,56,40,17,1608,1480,1446,1162,539,471,141,191,780,821,261,561,447,0,,344
15:14:38,6314.147,Fox,1601,332,128,32,65,57,40,17,1608,1480,1448,1163,539,471,141,191,780,821,261,561,447,0,,344
15:14:39,6314.747,Fox,1601,331,128,28,69,57,40,16,1608,1480,1452,1163,539,471,140,191,780,821,261,561,448,0,,343
15:14:39,6315.347,Fox,1603,332,128,28,71,56,40,16,1610,1482,1454,1163,539,471,140,192,781,822,261,562,448,0,,344
15:14:39,6315.947,Fox,1603,328,124,32,71,52,40,16,1610,1486,1454,1163,539,471,140,188,781,822,262,565,448,0,,340
15:14:40,6316.547,Fox,1605,327,124,34,71,50,40,15,1612,1488,1454,1163,539,471,140,187,781,824,262,567,449,0,,339
15:14:40,6316.847,Fox,1605,326,124,34,71,49,40,15,1612,1488,1454,1163,539,471,140,186,781,824,263,567,449,0,,338
15:14:41,6317.747,Fox,1609,330,128,34,71,49,40,15,1616,1488,1454,1163,539,471,142,188,783,826,263,567,449,0,,342
15:14:41,6318.347,Fox,1609,330,128,32,73,49,40,15,1616,1488,1456,1163,539,471,142,188,783,826,263,567,449,0,,342
15:14:42,6319.247,Fox,1611,332,130,32,72,50,38,17,1618,1488,1456,1164,539,473,143,189,784,827,263,567,449,0,,344
15:14:43,6321.269,Fox,1613,334,130,32,71,51,38,17,1618,1488,1456,1165,539,473,144,190,785,828,263,567,449,0,,346
15:14:44,6321.869,Fox,1615,333,128,38,70,50,35,19,1622,1494,1456,1165,539,475,142,191,786,829,263,570,449,0,,345
15:14:44,6322.434,Fox,1615,333,124,40,72,50,35,19,1622,1498,1458,1165,539,475,142,191,786,829,263,570,449,0,,345
15:14:44,6323.034,Fox,1617,334,126,40,72,49,35,19,1624,1498,1458,1165,539,475,143,191,787,830,264,570,449,0,,346
15:14:45,6323.934,Fox,1621,337,130,40,71,49,35,19,1628,1498,1458,1165,539,475,145,192,790,831,264,571,449,0,,349
15:14:45,6324.833,Fox,1623,338,132,40,71,48,33,21,1630,1498,1458,1165,539,477,146,192,791,832,264,572,449,0,,350
15:14:46,6325.434,Fox,1625,340,134,38,73,48,33,21,1632,1498,1460,1165,539,477,146,194,791,834,264,572,449,0,,352
15:14:46,6325.734,Fox,1625,340,134,38,73,48,31,23,1632,1498,1460,1165,539,479,146,194,791,834,264,572,449,0,,352
15:14:47,6326.934,Fox,1625,339,128,44,73,48,31,22,1632,1504,1460,1165,539,479,145,194,791,834,264,572,450,0,,351
15:14:47,6327.234,Fox,1625,337,128,44,73,46,31,22,1632,1504,1460,1165,539,479,145,192,791,834,264,574,450,0,,349
15:14:47,6327.833,Fox,1625,337,126,46,73,46,31,22,1632,1506,1460,1165,539,479,145,192,791,834,264,574,450,0,,349
15:14:48,6328.434,Fox,1625,337,126,46,73,45,32,22,1632,1506,1460,1165,540,479,145,192,791,834,264,574,450,0,,349
15:14:48,6329.333,Fox,1625,337,126,46,73,43,34,22,1632,1506,1460,1165,542,479,145,192,791,834,264,574,450,0,,349
15:14:49,6330.234,Fox,1635,343,136,46,67,45,34,22,1642,1506,1460,1167,542,479,147,196,797,838,265,577,450,0,,355
15:14:49,6330.833,Fox,1637,343,134,48,66,45,33,22,1642,1508,1460,1167,542,480,148,195,799,838,265,578,451,0,,355
15:14:50,6331.134,Fox,1637,343,136,48,66,45,33,22,1644,1508,1460,1167,542,480,148,195,799,838,265,578,451,0,,355
15:14:50,6332.333,Fox,1637,342,136,46,68,44,32,23,1644,1508,1462,1167,543,482,147,195,799,838,265,578,452,0,,354
15:14:51,6332.934,Fox,1639,344,136,44,72,44,32,23,1646,1510,1466,1167,543,482,148,196,800,839,265,578,452,0,,356
15:14:51,6333.234,Fox,1639,344,134,46,72,44,32,23,1646,1512,1466,1167,543,482,148,196,800,839,265,578,452,0,,356
15:14:51,6333.763,Fox,1639,343,134,46,72,43,32,23,1646,1512,1466,1167,543,482,148,195,800,839,265,579,452,0,,355
15:14:52,6334.363,Fox,1639,343,132,48,72,43,32,23,1646,1514,1466,1167,543,482,148,195,800,839,265,579,452,0,,355
15:14:52,6335.263,Fox,1641,345,132,46,74,43,32,23,1646,1514,1468,1167,543,482,149,196,801,840,265,579,452,0,,357
15:14:53,6335.863,Fox,1641,344,134,46,72,44,32,23,1648,1514,1468,1169,543,482,149,195,801,840,266,579,452,0,,356
15:14:53,6336.437,Fox,1641,343,130,48,72,46,32,22,1648,1518,1470,1171,543,482,149,194,801,840,266,579,453,0,,355
15:14:54,6337.037,Fox,1641,342,128,50,72,46,32,21,1648,1520,1470,1171,543,482,148,194,801,840,266,579,454,0,,354
15:14:54,6337.637,Fox,1643,344,124,54,72,46,32,21,1648,1524,1470,1171,543,482,149,195,802,841,266,579,454,0,,356
15:14:55,6338.237,Fox,1645,346,124,56,72,46,32,21,1650,1526,1470,1171,543,482,149,197,802,843,266,579,454,0,,358
15:14:55,6338.537,Fox,1645,346,126,56,72,46,32,21,1652,1526,1470,1171,543,482,149,197,802,843,266,579,454,0,,358
15:14:56,6339.437,Fox,1649,349,126,54,71,48,31,22,1652,1526,1472,1173,543,483,150,199,804,845,266,580,454,0,,361
15:14:56,6339.737,Fox,1649,349,130,54,71,48,31,22,1656,1526,1472,1173,543,483,150,199,804,845,266,580,454,0,,361
15:14:56,6340.337,Fox,1649,349,128,56,71,48,31,22,1656,1528,1472,1173,543,483,150,199,804,845,266,580,454,0,,361
15:14:57,6341.237,Fox,1651,351,128,56,71,49,32,22,1658,1530,1474,1175,544,483,152,199,806,845,266,580,454,0,,363
15:14:57,6342.137,Fox,1651,350,128,56,69,50,33,21,1658,1530,1474,1177,545,483,151,199,806,845,266,580,455,0,,362
15:14:58,6343.003,Fox,1653,350,126,58,68,50,33,20,1658,1532,1474,1177,545,483,150,200,807,846,266,581,456,0,,362
15:14:58,6343.604,Fox,1655,350,130,58,65,51,31,22,1662,1532,1474,1179,545,485,150,200,808,847,267,582,456,0,,362
15:14:59,6344.804,Fox,1657,350,130,58,63,50,33,21,1662,1532,1474,1180,547,485,149,201,809,848,267,583,457,0,,362
15:14:59,6345.074,Fox,1657,350,132,58,63,50,33,21,1664,1532,1474,1180,547,485,149,201,809,848,267,583,457,0,,362
15:14:59,6346.128,Fox,1659,352,134,58,63,50,33,21,1666,1532,1474,1180,547,485,150,202,810,849,267,583,457,0,,364
15:15:00,6346.618,Fox,1663,354,136,58,61,50,31,23,1668,1532,1474,1180,547,487,149,205,811,852,267,585,457,0,,366
15:15:00,6347.096,Fox,1663,354,136,60,61,50,31,23,1670,1534,1474,1180,547,487,149,205,811,852,267,585,457,0,,366
15:15:00,6347.937,Fox,1663,354,132,62,58,55,31,23,1670,1538,1476,1185,547,487,149,205,811,852,267,585,457,0,,366
15:15:01,6348.536,Fox,1665,355,126,68,59,55,31,23,1672,1546,1478,1186,547,487,150,205,813,852,267,586,457,0,,367
15:15:01,6349.437,Fox,1667,357,126,68,57,57,31,23,1672,1546,1478,1188,547,487,150,207,813,854,267,586,457,0,,369
15:15:02,6350.036,Fox,1669,358,128,68,57,56,31,23,1674,1546,1478,1188,547,487,149,209,813,856,268,586,457,0,,370
15:15:02,6350.636,Fox,1669,356,130,66,58,57,31,21,1676,1546,1480,1189,547,487,147,209,813,856,268,586,459,0,,368
15:15:03,6351.536,Fox,1671,356,130,66,57,56,31,21,1676,1546,1480,1189,547,487,147,209,814,857,268,588,459,0,,368
15:15:03,6352.136,Fox,1673,357,132,68,55,57,31,21,1680,1548,1480,1190,547,487,147,210,815,858,268,589,459,0,,369
15:15:04,6352.736,Fox,1675,358,134,68,52,58,31,22,1682,1548,1480,1193,549,489,147,211,816,859,268,589,460,0,,370
15:15:04,6353.036,Fox,1675,357,134,68,50,60,31,21,1682,1548,1480,1195,549,489,147,210,816,859,268,589,461,0,,369
15:15:04,6353.937,Fox,1675,355,134,66,52,58,31,21,1682,1548,1482,1195,549,489,147,208,816,859,268,591,461,0,,367
15:15:05,6354.699,Fox,1675,355,134,62,53,60,32,21,1682,1548,1486,1198,550,489,147,208,816,859,268,591,461,0,,367
15:15:05,6355.244,Fox,1675,354,130,64,55,60,32,20,1682,1552,1488,1198,550,489,146,208,816,859,268,591,462,0,,366
15:15:05,6356.035,Fox,1675,354,130,64,53,62,32,20,1682,1552,1488,1200,550,489,146,208,816,859,268,591,462,0,,366
15:15:06,6356.889,Fox,1677,355,122,72,51,63,32,20,1682,1560,1488,1202,550,489,146,209,817,860,268,592,462,0,,367
15:15:06,6357.189,Fox,1677,355,124,72,51,62,33,20,1684,1560,1488,1202,551,489,146,209,817,860,268,592,462,0,,367
15:15:06,6357.79,Fox,1677,355,122,74,51,62,33,20,1684,1562,1488,1202,551,489,146,209,817,860,268,592,462,0,,367
15:15:07,6359.29,Fox,1679,357,122,76,51,61,34,20,1686,1564,1488,1202,552,489,147,210,818,861,268,592,462,0,,369
15:15:08,6359.589,Fox,1679,354,122,76,51,59,34,19,1686,1564,1488,1202,552,489,146,208,818,861,268,594,463,0,,366
15:15:08,6360.489,Fox,1679,354,120,72,57,59,34,19,1686,1566,1494,1202,552,489,146,208,818,861,268,594,463,0,,366
15:15:08,6360.79,Fox,1679,354,120,68,61,59,34,19,1686,1566,1498,1202,552,489,146,208,818,861,268,594,463,0,,366
15:15:09,6362.29,Fox,1679,354,116,72,60,60,32,21,1686,1570,1498,1203,552,491,146,208,818,861,268,594,463,0,,366
15:15:10,6363.189,Fox,1683,357,116,74,60,58,32,22,1688,1572,1498,1203,553,492,148,209,821,862,268,595,463,0,,369
15:15:10,6363.79,Fox,1685,358,120,74,59,58,32,22,1692,1572,1498,1203,553,492,149,209,823,862,269,595,463,0,,370
15:15:11,6364.389,Fox,1685,358,118,76,57,60,32,22,1692,1574,1498,1205,553,492,149,209,823,862,269,595,463,0,,370
15:15:12,6365.29,Fox,1689,359,122,74,58,57,34,21,1696,1574,1500,1205,555,492,147,212,824,865,269,597,464,0,,371
15:15:12,6365.889,Fox,1689,359,120,72,62,57,34,21,1696,1576,1504,1205,555,492,147,212,824,865,269,597,464,0,,371
15:15:12,6366.489,Fox,1691,359,120,70,63,56,34,21,1696,1576,1506,1205,555,492,148,211,826,865,271,597,464,0,,371
15:15:13,6366.79,Fox,1691,359,120,72,63,56,34,21,1698,1578,1506,1205,555,492,148,211,826,865,271,597,464,0,,371
15:15:13,6367.389,Fox,1691,359,120,72,63,56,32,23,1698,1578,1506,1205,555,494,148,211,826,865,271,597,464,0,,371
15:15:14,6367.989,Fox,1691,359,118,74,63,56,32,23,1698,1580,1506,1205,555,494,148,211,826,865,271,597,464,0,,371
15:15:14,6368.855,Fox,1691,359,116,76,61,56,32,25,1698,1582,1506,1207,557,496,148,211,826,865,271,597,464,0,,371
15:15:14,6369.268,Fox,1691,359,116,74,60,59,32,25,1698,1582,1508,1210,557,496,148,211,826,865,271,597,464,0,,371
15:15:15,6370.435,Fox,1693,359,114,76,59,58,32,25,1698,1584,1508,1210,557,496,148,211,827,866,271,599,464,0,,371
15:15:15,6370.729,Fox,1693,358,116,76,59,58,32,24,1700,1584,1508,1210,557,496,147,211,827,866,271,599,465,0,,370
15:15:16,6371.929,Fox,1697,360,114,74,61,58,32,24,1700,1586,1512,1210,557,496,149,211,831,866,273,599,465,0,,372
15:15:16,6372.529,Fox,1697,360,116,76,59,60,32,24,1704,1588,1512,1212,557,496,149,211,831,866,273,599,465,0,,372
15:15:16,6372.727,Fox,1697,360,116,74,61,60,32,24,1704,1588,1514,1212,557,496,149,211,831,866,273,599,465,0,,372
15:15:17,6374.254,Fox,1699,360,116,74,58,60,34,23,1704,1588,1514,1214,559,496,149,211,832,867,274,599,466,0,,372
15:15:17,6374.854,Fox,1699,360,118,70,62,60,34,23,1706,1588,1518,1214,559,496,149,211,832,867,274,599,466,0,,372
15:15:18,6375.455,Fox,1701,362,118,70,58,64,34,23,1706,1588,1518,1218,559,496,150,212,833,868,274,599,466,0,,374
15:15:18,6376.054,Fox,1703,364,122,64,64,64,34,23,1710,1588,1524,1218,559,496,151,213,834,869,274,599,466,0,,376
15:15:19,6376.654,Fox,1703,364,122,62,66,64,34,23,1710,1588,1526,1218,559,496,151,213,834,869,274,599,466,0,,376
15:15:19,6377.254,Fox,1703,363,122,62,66,64,34,22,1710,1588,1526,1218,559,496,151,212,834,869,274,599,467,0,,375
15:15:20,6378.455,Fox,1705,363,122,62,66,62,34,22,1710,1588,1526,1218,559,496,151,212,835,870,274,601,467,0,,375
15:15:20,6379.054,Fox,1705,363,124,60,66,64,34,22,1712,1588,1528,1220,559,496,151,212,835,870,274,601,467,0,,375
15:15:21,6379.654,Fox,1705,362,124,58,68,63,34,22,1712,1588,1530,1220,559,496,151,211,835,870,274,602,467,0,,374
15:15:21,6379.955,Fox,1705,360,122,60,68,63,32,22,1712,1590,1530,1220,559,496,151,209,835,870,274,604,467,0,,372
15:15:22,6380.854,Fox,1705,360,118,64,68,63,32,22,1712,1594,1530,1220,559,496,151,209,835,870,274,604,467,0,,372
15:15:22,6381.455,Fox,1709,364,122,62,70,62,33,22,1716,1594,1532,1220,560,496,155,209,839,870,274,604,467,0,,376
15:15:23,6382.955,Fox,1711,365,122,64,69,63,33,21,1718,1596,1532,1221,560,496,156,209,840,871,274,604,468,0,,377
15:15:24,6383.854,Fox,1711,365,118,68,69,63,33,21,1718,1600,1532,1221,560,496,156,209,840,871,274,604,468,0,,377
15:15:24,6384.154,Fox,1711,364,118,68,69,63,33,20,1718,1600,1532,1221,560,496,155,209,840,871,274,604,469,0,,376
15:15:25,6385.955,Fox,1711,364,118,66,70,62,35,20,1718,1600,1534,1222,562,496,155,209,840,871,274,604,469,0,,376
15:15:25,6386.434,Fox,1713,365,120,62,73,62,35,20,1720,1600,1538,1222,562,496,155,210,841,872,275,604,469,0,,377
15:15:26,6387.012,Fox,1713,364,120,54,81,60,37,19,1720,1600,1546,1222,564,496,155,209,841,872,275,604,470,0,,376
15:15:27,6389.412,Fox,1715,365,122,54,81,59,37,19,1722,1600,1546,1222,564,496,155,210,842,873,275,605,470,0,,377
15:15:28,6390.312,Fox,1715,365,122,52,83,59,37,19,1722,1600,1548,1222,564,496,155,210,842,873,275,605,470,0,,377
15:15:29,6391.812,Fox,1715,363,122,52,83,57,37,19,1722,1600,1548,1222,564,496,155,208,842,873,275,607,470,0,,375
15:15:30,6393.289,Fox,1715,363,118,56,77,63,37,19,1722,1604,1548,1228,564,496,155,208,842,873,275,607,470,0,,375
15:15:30,6393.889,Fox,1715,363,114,56,81,63,37,19,1722,1608,1552,1228,564,496,155,208,842,873,275,607,470,0,,375
15:15:31,6394.489,Fox,1719,366,116,56,80,63,37,19,1724,1608,1552,1228,564,496,156,210,844,875,275,608,470,0,,378
15:15:31,6395.089,Fox,1719,366,118,52,84,61,39,19,1726,1608,1556,1228,566,496,156,210,844,875,275,608,470,0,,378
15:15:31,6395.389,Fox,1719,366,118,48,87,62,39,19,1726,1608,1560,1229,566,496,156,210,844,875,275,608,470,0,,378
15:15:32,6396.589,Fox,1719,366,118,46,87,64,39,19,1726,1608,1562,1231,566,496,156,210,844,875,275,608,470,0,,378
15:15:32,6396.889,Fox,1719,365,118,46,87,63,39,19,1726,1608,1562,1231,566,496,156,209,844,875,275,609,470,0,,377
15:15:33,6397.789,Fox,1721,366,120,44,88,63,39,19,1728,1608,1564,1231,566,496,156,210,845,876,275,610,470,0,,378
15:15:33,6398.389,Fox,1723,367,120,46,88,62,38,20,1730,1610,1564,1231,566,497,157,210,846,877,275,611,470,0,,379
15:15:34,6398.689,Fox,1723,367,120,44,90,62,38,20,1730,1610,1566,1231,566,497,157,210,846,877,275,611,470,0,,379
15:15:34,6399.589,Fox,1725,368,118,46,90,61,38,20,1730,1612,1566,1231,566,497,158,210,848,877,275,612,470,0,,380
15:15:34,6399.889,Fox,1725,368,120,46,88,63,38,20,1732,1612,1566,1233,566,497,158,210,848,877,275,612,470,0,,380
15:15:35,6400.789,Fox,1725,367,116,46,92,61,39,20,1732,1616,1570,1233,567,497,158,209,848,877,275,613,470,0,,379
15:15:36,6401.689,Fox,1725,367,116,44,92,63,38,21,1732,1616,1572,1235,567,498,158,209,848,877,275,613,470,0,,379
15:15:36,6401.989,Fox,1725,367,114,46,92,63,38,21,1732,1618,1572,1235,567,498,158,209,848,877,275,613,470,0,,379
15:15:36,6402.889,Fox,1725,365,114,44,94,63,38,19,1732,1618,1574,1235,567,498,157,208,848,877,275,613,472,0,,377
15:15:36,6403.489,Fox,1727,363,116,44,94,58,40,18,1734,1618,1574,1235,569,498,156,207,849,878,275,616,473,0,,375
15:15:37,6404.066,Fox,1731,364,116,46,94,55,40,18,1736,1620,1574,1235,569,498,158,206,852,879,275,619,473,0,,376
15:15:37,6404.63,Fox,1733,365,118,46,95,55,40,18,1740,1622,1576,1235,569,498,158,207,853,880,275,620,473,0,,377
15:15:37,6405.417,Fox,1735,366,118,44,97,54,40,18,1740,1622,1578,1235,569,498,159,207,854,881,276,620,473,0,,378
15:15:37,6405.693,Fox,1735,366,118,46,97,53,41,18,1742,1624,1578,1235,570,498,159,207,854,881,276,620,473,0,,378
15:15:38,6406.594,Fox,1735,366,114,48,99,53,41,18,1742,1628,1580,1235,570,498,159,207,854,881,276,620,473,0,,378
15:15:38,6407.193,Fox,1735,365,114,46,101,52,41,18,1742,1628,1582,1235,570,498,159,206,854,881,276,621,473,0,,377
15:15:38,6407.494,Fox,1735,365,112,48,101,52,41,18,1742,1630,1582,1235,570,498,159,206,854,881,276,621,473,0,,377
15:15:39,6408.094,Fox,1735,365,110,50,99,54,41,18,1742,1632,1582,1237,570,498,159,206,854,881,276,621,473,0,,377
15:15:39,6408.994,Fox,1735,364,110,48,99,55,41,18,1742,1632,1584,1239,570,498,159,205,854,881,276,622,473,0,,376
15:15:40,6409.594,Fox,1735,360,110,48,99,52,39,19,1742,1632,1584,1239,570,500,158,202,854,881,277,624,474,0,,372
15:15:41,6410.793,Fox,1735,360,110,44,103,52,39,19,1742,1632,1588,1239,570,500,158,202,854,881,277,624,474,0,,372
15:15:41,6411.394,Fox,1737,362,112,44,102,53,39,19,1744,1632,1588,1240,570,500,158,204,854,883,277,624,474,0,,374
15:15:42,6412.293,Fox,1739,364,114,44,102,53,39,19,1746,1632,1588,1240,570,500,160,204,856,883,277,624,474,0,,376
15:15:42,6413.193,Fox,1739,361,104,54,102,51,39,18,1746,1642,1588,1240,570,500,159,202,856,883,278,625,475,0,,373
15:15:43,6414.094,Fox,1741,360,102,56,99,51,39,18,1746,1644,1588,1242,570,500,159,201,857,884,279,627,475,0,,372
15:15:43,6414.693,Fox,1743,362,104,56,99,51,39,18,1748,1644,1588,1242,570,500,159,203,857,886,279,627,475,0,,374
15:15:44,6415.293,Fox,1747,366,108,56,96,54,39,18,1752,1644,1588,1245,570,500,161,205,859,888,279,627,475,0,,378
15:15:44,6415.894,Fox,1749,367,108,58,93,56,39,18,1754,1646,1588,1247,570,500,161,206,860,889,279,628,475,0,,379
15:15:44,6416.193,Fox,1749,367,110,58,93,56,39,18,1756,1646,1588,1247,570,500,161,206,860,889,279,628,475,0,,379
15:15:46,6418.275,Fox,1751,368,110,58,95,55,39,18,1758,1648,1590,1247,570,500,162,206,862,889,279,629,475,0,,380
15:15:46,6418.875,Fox,1751,368,110,56,97,55,38,19,1758,1648,1592,1247,570,501,162,206,862,889,279,629,475,0,,380
15:15:46,6419.475,Fox,1753,369,110,54,99,55,38,18,1758,1648,1594,1247,570,501,163,206,863,890,279,629,476,0,,381
15:15:47,6420.075,Fox,1753,366,112,54,99,54,37,17,1760,1648,1594,1247,570,502,162,204,863,890,279,630,478,0,,378
15:15:48,6420.975,Fox,1753,366,110,56,94,59,37,17,1760,1650,1594,1252,570,502,162,204,863,890,279,630,478,0,,378
15:15:48,6421.575,Fox,1753,366,108,56,94,61,36,18,1760,1652,1596,1254,570,503,162,204,863,890,279,630,478,0,,378
15:15:48,6422.175,Fox,1757,370,112,54,96,61,36,18,1764,1652,1598,1254,570,503,164,206,865,892,279,630,478,0,,382
15:15:49,6422.775,Fox,1761,373,112,56,97,61,36,18,1768,1656,1600,1254,570,503,165,208,867,894,280,630,478,0,,385
15:15:49,6423.375,Fox,1763,374,114,56,96,61,35,19,1770,1656,1600,1254,570,504,166,208,869,894,280,631,478,0,,386
15:15:49,6424.214,Fox,1765,376,112,58,96,61,35,19,1770,1658,1600,1254,570,504,167,209,870,895,280,631,478,0,,388
15:15:50,6424.792,Fox,1767,377,116,58,95,61,34,20,1774,1658,1600,1254,570,505,168,209,872,895,280,632,478,0,,389
15:15:50,6425.593,Fox,1769,378,118,58,92,63,34,20,1776,1658,1600,1256,570,505,168,210,873,896,280,633,478,0,,390
15:15:50,6426.106,Fox,1769,378,114,62,89,66,34,20,1776,1662,1600,1259,570,505,168,210,873,896,280,633,478,0,,390
15:15:51,6426.95,Fox,1769,378,114,62,87,68,33,21,1776,1662,1600,1261,570,506,168,210,873,896,280,633,478,0,,390
15:15:51,6428.15,Fox,1769,375,112,64,87,66,33,20,1776,1664,1600,1261,570,506,167,208,873,896,280,635,479,0,,387
15:15:52,6428.75,Fox,1769,375,110,66,87,66,33,20,1776,1666,1600,1261,570,506,167,208,873,896,280,635,479,0,,387
15:15:52,6429.65,Fox,1769,375,106,70,87,63,36,20,1776,1670,1600,1261,573,506,167,208,873,896,280,635,479,0,,387
15:15:53,6429.95,Fox,1769,375,106,70,85,65,36,20,1776,1670,1600,1263,573,506,167,208,873,896,280,635,479,0,,387
15:15:53,6431.15,Fox,1769,375,104,72,85,65,35,21,1776,1672,1600,1263,573,507,167,208,873,896,280,635,479,0,,387
15:15:54,6431.75,Fox,1769,373,104,68,89,63,35,21,1776,1672,1604,1263,573,507,167,206,873,896,281,636,479,0,,385
15:15:54,6432.35,Fox,1771,373,104,66,89,66,34,21,1778,1674,1608,1266,573,507,167,206,874,897,282,637,479,0,,385
15:15:55,6433.25,Fox,1773,374,102,68,87,65,36,21,1778,1676,1608,1267,575,507,166,208,874,899,282,638,479,0,,386
15:15:55,6433.55,Fox,1773,374,104,68,87,65,36,21,1780,1676,1608,1267,575,507,166,208,874,899,282,638,479,0,,386
15:15:56,6434.75,Fox,1773,374,100,72,87,64,37,21,1780,1680,1608,1267,576,507,166,208,874,899,282,638,479,0,,386
15:15:56,6435.35,Fox,1775,375,100,74,82,68,36,22,1782,1682,1608,1271,576,508,166,209,875,900,282,639,479,0,,387
15:15:57,6435.95,Fox,1779,377,102,74,82,65,37,22,1784,1682,1608,1271,577,508,169,208,878,901,282,641,479,0,,389
15:15:57,6436.55,Fox,1779,376,104,72,79,69,37,22,1786,1682,1610,1276,577,508,169,207,878,901,282,642,479,0,,388
15:15:58,6437.45,Fox,1781,378,106,72,77,69,39,22,1788,1682,1610,1278,579,508,169,209,878,903,282,642,479,0,,390
15:15:58,6437.75,Fox,1781,378,106,70,79,69,39,22,1788,1682,1612,1278,579,508,169,209,878,903,282,642,479,0,,390
15:15:59,6439.25,Fox,1785,380,106,66,81,69,39,22,1788,1682,1616,1280,579,508,170,210,881,904,282,644,479,0,,392
15:15:59,6439.85,Fox,1785,379,108,68,79,70,39,22,1792,1684,1616,1282,579,508,169,210,881,904,283,644,479,0,,391
15:16:00,6440.75,Fox,1789,381,110,66,81,68,39,22,1794,1684,1618,1282,579,508,170,211,884,905,284,645,479,0,,393
15:16:00,6441.255,Fox,1791,383,112,66,81,68,39,22,1796,1684,1618,1282,579,508,172,211,886,905,284,645,479,0,,395
15:16:00,6441.806,Fox,1791,383,112,68,81,68,39,22,1798,1686,1618,1282,579,508,172,211,886,905,284,645,479,0,,395
15:16:01,6442.106,Fox,1791,382,112,68,79,69,40,21,1798,1686,1618,1284,580,508,172,210,886,905,284,645,480,0,,394
15:16:01,6443.006,Fox,1791,382,112,64,83,69,40,21,1798,1686,1622,1284,580,508,172,210,886,905,284,645,480,0,,394
15:16:02,6443.606,Fox,1793,383,114,64,82,69,40,21,1800,1686,1622,1284,580,508,172,211,887,906,284,646,480,0,,395
15:16:02,6444.506,Fox,1795,384,116,62,84,68,40,21,1802,1686,1624,1284,580,508,173,211,888,907,285,646,480,0,,396
15:16:03,6445.397,Fox,1795,383,116,58,88,68,40,20,1802,1686,1628,1284,580,508,173,210,888,907,285,646,481,0,,395
15:16:03,6445.935,Fox,1795,383,112,60,90,66,42,20,1802,1690,1630,1284,582,508,173,210,888,907,285,646,481,0,,395
15:16:03,6446.535,Fox,1795,383,110,60,90,68,40,22,1802,1692,1632,1286,582,510,173,210,888,907,285,646,481,0,,417
15:16:04,6447.435,Fox,1795,383,110,60,84,74,40,22,1802,1692,1632,1292,582,510,173,210,888,907,285,646,481,0,,417
15:16:04,6448.035,Fox,1795,383,106,64,80,78,40,22,1802,1696,1632,1296,582,510,173,210,888,907,285,646,481,0,,417
15:16:05,6448.335,Fox,1795,383,106,64,80,77,41,22,1802,1696,1632,1296,583,510,173,210,888,907,285,646,481,0,,417
15:16:05,6449.535,Fox,1799,385,108,66,79,76,41,22,1806,1698,1632,1296,583,510,174,211,891,908,286,647,481,0,,419
15:16:06,6450.435,Fox,1803,385,110,66,79,71,42,22,1808,1698,1632,1296,584,510,178,207,895,908,287,650,481,0,,419
15:16:06,6450.735,Fox,1803,385,112,66,77,73,42,22,1810,1698,1632,1298,584,510,178,207,895,908,287,650,481,0,,419
15:16:06,6451.335,Fox,1803,385,112,56,87,73,42,22,1810,1698,1642,1298,584,510,178,207,895,908,287,650,481,0,,419
15:16:07,6452.235,Fox,1805,385,114,54,88,72,42,22,1812,1698,1644,1298,584,510,178,207,896,909,288,651,481,0,,419
15:16:08,6453.392,Fox,1805,383,112,56,88,70,42,22,1812,1700,1644,1298,584,510,178,205,896,909,288,653,481,0,,417
15:16:08,6454.292,Fox,1805,383,112,54,86,74,42,22,1812,1700,1646,1302,584,510,178,205,896,909,288,653,481,0,,417
15:16:09,6454.892,Fox,1807,383,110,58,85,74,42,21,1814,1704,1646,1302,584,510,178,205,897,910,288,654,482,0,,417
15:16:09,6455.792,Fox,1807,383,110,58,78,81,42,21,1814,1704,1646,1309,584,510,178,205,897,910,288,654,482,0,,417
15:16:10,6456.692,Fox,1809,382,110,56,78,81,42,20,1814,1704,1648,1310,584,510,179,203,899,910,289,655,483,0,,416
15:16:10,6457.292,Fox,1809,382,110,58,78,81,42,20,1816,1706,1648,1310,584,510,179,203,899,910,289,655,483,0,,416
15:16:11,6458.15,Fox,1809,380,110,58,76,81,42,20,1816,1706,1648,1312,584,510,179,201,899,910,291,655,483,0,,414
15:16:11,6458.647,Fox,1809,380,106,62,76,81,42,20,1816,1710,1648,1312,584,510,179,201,899,910,291,655,483,0,,414
15:16:11,6459.202,Fox,1811,381,106,60,76,82,42,20,1816,1710,1650,1313,584,510,180,201,901,910,292,655,483,0,,415
15:16:11,6459.801,Fox,1811,380,108,58,78,82,42,19,1818,1710,1652,1313,584,510,180,200,901,910,292,655,484,0,,414
15:16:12,6460.662,Fox,1815,381,112,58,77,82,42,17,1822,1710,1652,1313,584,510,181,200,903,912,292,656,486,0,,415
15:16:12,6461.216,Fox,1815,380,112,54,78,85,42,16,1822,1710,1656,1316,584,510,181,199,903,912,292,656,487,0,,414
15:16:12,6461.79,Fox,1815,380,110,56,76,87,42,16,1822,1712,1656,1318,584,510,181,199,903,912,292,656,487,0,,414
15:16:12,6462.315,Fox,1815,379,110,54,78,85,44,15,1822,1712,1658,1318,586,510,180,199,903,912,292,656,488,0,,413
15:16:13,6463.185,Fox,1815,378,110,54,77,84,45,15,1822,1712,1658,1319,587,510,180,198,903,912,292,657,488,0,,412
15:16:13,6463.785,Fox,1817,378,112,54,77,82,45,15,1824,1712,1658,1319,587,510,180,198,904,913,293,658,488,0,,412
15:16:14,6464.385,Fox,1817,378,108,56,79,82,45,15,1824,1716,1660,1319,587,510,180,198,904,913,293,658,488,0,,412
15:16:14,6464.685,Fox,1817,378,108,54,79,84,45,15,1824,1716,1662,1321,587,510,180,198,904,913,293,658,488,0,,412
15:16:14,6465.8,Fox,1817,375,106,56,77,83,45,15,1824,1718,1662,1323,587,510,180,195,904,913,293,661,488,0,,409
15:16:14,6466.4,Fox,1817,374,106,54,79,82,44,16,1824,1718,1664,1323,587,511,180,194,904,913,294,661,488,0,,408
15:16:15,6467.3,Fox,1817,374,106,52,77,86,42,18,1824,1718,1666,1327,587,513,180,194,904,913,294,661,488,0,,408
15:16:16,6468.2,Fox,1817,374,106,48,81,86,42,18,1824,1718,1670,1327,587,513,180,194,904,913,294,661,488,0,,408
15:16:16,6468.5,Fox,1817,374,106,48,81,84,44,18,1824,1718,1670,1327,589,513,180,194,904,913,294,661,488,0,,408
15:16:16,6469.4,Fox,1819,369,104,50,79,79,44,18,1824,1720,1670,1329,589,513,178,191,905,914,295,667,488,0,,403
15:16:17,6469.7,Fox,1819,369,106,48,81,79,43,19,1826,1720,1672,1329,589,514,178,191,905,914,295,667,488,0,,403
15:16:18,6471.2,Fox,1823,372,108,46,82,79,43,19,1828,1720,1674,1330,589,514,179,193,907,916,295,668,488,0,,406
15:16:18,6471.8,Fox,1827,374,110,44,81,80,43,19,1830,1720,1676,1332,589,514,178,196,908,919,295,670,488,0,,408
15:16:18,6472.4,Fox,1835,380,116,46,81,78,43,19,1838,1722,1676,1332,589,514,180,200,912,923,295,672,488,0,,414
15:16:19,6473,Fox,1839,382,124,44,83,76,43,19,1846,1722,1678,1332,589,514,179,203,913,926,295,674,488,0,,416
15:16:19,6473.6,Fox,1841,384,126,42,85,76,43,19,1848,1722,1680,1332,589,514,181,203,915,926,295,674,488,0,,418
15:16:19,6473.9,Fox,1841,382,126,40,87,76,43,17,1848,1722,1682,1332,589,514,181,201,915,926,295,674,490,0,,416
15:16:21,6476.928,Fox,1843,381,126,40,87,75,42,16,1848,1722,1682,1332,589,514,180,201,915,928,296,675,491,0,,415
15:16:21,6477.478,Fox,1843,381,124,44,87,75,42,16,1850,1726,1682,1332,589,514,180,201,915,928,296,675,491,0,,415
15:16:21,6477.948,Fox,1845,382,126,44,87,75,42,15,1852,1726,1682,1332,589,514,180,202,916,929,296,675,492,0,,416
15:16:21,6478.168,Fox,1845,382,126,42,89,75,41,16,1852,1726,1684,1332,589,515,180,202,916,929,296,675,492,0,,416
15:16:21,6478.945,Fox,1845,378,126,42,87,74,41,15,1852,1726,1684,1334,589,515,180,198,916,929,297,677,493,0,,412
15:16:22,6479.845,Fox,1847,378,128,42,86,74,40,15,1854,1726,1684,1335,589,516,180,198,917,930,297,678,494,0,,412
15:16:23,6480.746,Fox,1849,380,128,42,88,74,40,15,1856,1728,1686,1335,589,516,181,199,918,931,297,678,494,0,,414
15:16:23,6481.345,Fox,1851,381,126,44,87,74,40,15,1856,1730,1686,1335,589,516,181,200,919,932,297,679,494,0,,415
15:16:23,6481.646,Fox,1851,381,128,44,85,76,40,15,1858,1730,1686,1337,589,516,181,200,919,932,297,679,494,0,,415
15:16:24,6482.503,Fox,1853,380,128,46,82,76,38,17,1860,1732,1686,1339,589,518,180,200,919,934,297,682,494,0,,414
15:16:24,6483.104,Fox,1855,381,130,46,80,77,38,17,1862,1732,1686,1340,589,518,179,202,919,936,297,683,494,0,,415
15:16:24,6483.704,Fox,1861,384,134,46,78,77,38,16,1866,1732,1686,1340,589,518,179,205,921,940,299,683,495,0,,418
15:16:25,6484.304,Fox,1865,387,136,44,79,77,38,16,1868,1732,1688,1340,589,518,181,206,924,941,300,683,495,0,,421
15:16:25,6484.903,Fox,1867,388,142,40,83,77,38,15,1874,1732,1692,1340,589,518,182,206,925,942,300,683,496,0,,422
15:16:25,6485.204,Fox,1867,387,142,40,83,77,38,14,1874,1732,1692,1340,589,518,181,206,925,942,300,683,497,0,,421
15:16:26,6486.403,Fox,1867,387,140,38,87,77,38,14,1874,1734,1696,1340,589,518,181,206,925,942,300,683,497,0,,421
15:16:26,6486.897,Fox,1869,388,136,42,87,77,38,13,1874,1738,1696,1340,589,518,180,208,925,944,300,684,497,0,,422
15:16:26,6487.28,Fox,1871,390,136,44,87,77,38,13,1876,1740,1696,1340,589,518,181,209,926,945,300,684,497,0,,424
15:16:26,6487.448,Fox,1871,390,138,44,87,77,38,13,1878,1740,1696,1340,589,518,181,209,926,945,300,684,497,0,,424
15:16:26,6488.012,Fox,1873,392,140,42,89,77,38,13,1880,1740,1698,1340,589,518,183,209,928,945,300,684,497,0,,426
15:16:26,6488.483,Fox,1873,390,138,44,88,76,38,13,1880,1742,1698,1340,589,518,181,209,928,945,300,686,497,0,,424
15:16:27,6489.083,Fox,1873,387,138,44,88,74,38,12,1880,1742,1698,1340,589,518,181,206,928,945,300,688,498,0,,421
15:16:28,6490.283,Fox,1873,387,138,44,88,74,36,14,1880,1742,1698,1340,589,520,181,206,928,945,300,688,498,0,,421
15:16:29,6491.783,Fox,1881,395,146,42,88,76,36,14,1888,1742,1700,1342,589,520,185,210,932,949,300,688,498,0,,429
15:16:29,6492.383,Fox,1883,397,148,42,84,80,35,15,1890,1742,1700,1346,589,521,186,211,933,950,300,688,498,0,,431
15:16:29,6493.583,Fox,1883,397,148,38,88,79,36,15,1890,1742,1704,1346,590,521,186,211,933,950,300,688,498,0,,431
15:16:30,6494.183,Fox,1887,398,148,40,86,78,36,15,1892,1744,1704,1346,590,521,184,214,934,953,301,690,498,0,,432
15:16:30,6494.783,Fox,1887,398,150,40,86,78,35,16,1894,1744,1704,1346,590,522,184,214,934,953,301,690,498,0,,432
15:16:30,6495.083,Fox,1887,398,148,42,86,78,35,16,1894,1746,1704,1346,590,522,184,214,934,953,301,690,498,0,,432
15:16:30,6495.683,Fox,1887,398,148,40,88,78,35,16,1894,1746,1706,1346,590,522,184,214,934,953,301,690,498,0,,432
15:16:31,6497.183,Fox,1887,398,146,38,90,80,34,17,1894,1748,1710,1348,590,523,184,214,934,953,301,690,498,0,,432
15:16:32,6497.783,Fox,1887,396,144,40,90,79,33,17,1894,1750,1710,1348,590,523,183,213,934,953,301,692,498,0,,430
15:16:32,6498.383,Fox,1889,398,140,44,88,81,33,17,1894,1754,1710,1350,590,523,185,213,936,953,301,692,498,0,,432
15:16:32,6498.983,Fox,1889,395,140,46,88,78,33,17,1896,1756,1710,1350,590,523,185,210,936,953,303,693,498,0,,429
15:16:33,6499.283,Fox,1889,395,140,46,85,81,33,17,1896,1756,1710,1353,590,523,185,210,936,953,303,693,498,0,,429
15:16:33,6500.183,Fox,1889,394,140,44,87,80,33,17,1896,1756,1712,1353,590,523,185,209,936,953,303,694,498,0,,428
15:16:33,6500.783,Fox,1893,394,140,44,83,80,32,18,1896,1756,1712,1355,590,524,187,207,940,953,303,698,498,0,,428
15:16:34,6501.083,Fox,1893,394,142,46,83,80,32,18,1900,1758,1712,1355,590,524,187,207,940,953,303,698,498,0,,428
15:16:34,6501.983,Fox,1893,393,142,46,83,78,33,18,1900,1758,1712,1355,591,524,187,206,940,953,303,699,498,0,,427
15:16:34,6502.583,Fox,1893,393,140,44,87,77,33,19,1900,1760,1716,1355,592,525,187,206,940,953,303,699,498,0,,427
15:16:35,6503.183,Fox,1897,396,142,44,84,79,33,19,1902,1760,1716,1357,592,525,187,209,941,956,303,700,498,0,,430
15:16:35,6503.783,Fox,1903,399,148,44,81,79,33,19,1908,1760,1716,1359,592,525,189,210,944,959,303,703,498,0,,433
15:16:35,6504.083,Fox,1903,397,150,42,83,77,33,19,1910,1760,1718,1359,592,525,189,208,944,959,305,703,498,0,,431
15:16:36,6504.983,Fox,1905,398,148,46,81,78,33,19,1912,1764,1718,1360,592,525,188,210,944,961,305,704,498,0,,432
15:16:36,6505.583,Fox,1905,398,144,50,79,80,33,19,1912,1768,1718,1362,592,525,188,210,944,961,305,704,498,0,,432
15:16:36,6506.183,Fox,1905,397,142,52,79,79,33,19,1912,1770,1718,1362,592,525,188,209,944,961,306,704,498,0,,431
15:16:37,6506.483,Fox,1905,395,142,52,78,78,33,19,1912,1770,1718,1363,592,525,187,208,944,961,307,705,498,0,,429
15:16:37,6507.383,Fox,1905,395,138,56,76,80,33,19,1912,1774,1718,1365,592,525,187,208,944,961,307,705,498,0,,429
15:16:38,6507.983,Fox,1907,396,140,54,77,78,35,19,1914,1774,1720,1365,594,525,187,209,945,962,307,706,498,0,,430
15:16:38,6508.283,Fox,1907,396,138,56,77,78,35,19,1914,1776,1720,1365,594,525,187,209,945,962,307,706,498,0,,430
15:16:38,6509.183,Fox,1909,397,140,56,76,77,36,19,1916,1776,1720,1365,595,525,186,211,945,964,307,707,498,0,,431
15:16:39,6509.783,Fox,1911,398,142,56,75,77,36,19,1918,1776,1720,1365,595,525,186,212,946,965,307,708,498,0,,432
15:16:39,6510.983,Fox,1913,398,144,54,76,76,36,19,1920,1776,1722,1365,595,525,185,213,946,967,307,710,498,0,,432
15:16:40,6511.883,Fox,1913,398,144,54,70,82,34,21,1920,1776,1722,1371,595,527,185,213,946,967,307,710,498,0,,432
15:16:41,6512.783,Fox,1915,398,144,54,70,81,34,20,1920,1776,1722,1371,595,527,185,213,947,968,307,711,499,0,,432
15:16:41,6513.083,Fox,1915,397,146,54,70,80,34,20,1922,1776,1722,1371,595,527,185,212,947,968,307,712,499,0,,431
15:16:41,6513.683,Fox,1915,395,146,54,70,78,34,20,1922,1776,1722,1371,595,527,185,210,947,968,308,713,499,0,,429
15:16:42,6514.583,Fox,1915,394,146,54,69,79,34,19,1922,1776,1722,1372,595,527,184,210,947,968,308,713,500,0,,428
15:16:42,6514.883,Fox,1915,394,144,56,69,79,34,19,1922,1778,1722,1372,595,527,184,210,947,968,308,713,500,0,,428
15:16:43,6516.083,Fox,1917,394,144,54,73,77,34,19,1924,1780,1726,1372,595,527,184,210,949,968,308,715,500,0,,428
15:16:43,6516.683,Fox,1919,395,146,54,73,76,34,19,1926,1780,1726,1372,595,527,185,210,950,969,308,716,500,0,,429
15:16:44,6517.283,Fox,1919,393,146,54,72,75,34,19,1926,1780,1726,1373,595,527,185,208,950,969,308,718,500,0,,427
15:16:44,6518.183,Fox,1919,389,144,56,72,71,34,19,1926,1782,1726,1373,595,527,184,205,950,969,310,720,500,0,,423
15:16:44,6518.783,Fox,1919,388,140,60,72,71,34,18,1926,1786,1726,1373,595,527,183,205,950,969,310,720,501,0,,422
15:16:45,6519.236,Fox,1923,390,144,58,73,69,34,19,1930,1786,1728,1373,596,528,182,208,951,972,310,722,501,0,,424
15:16:45,6519.836,Fox,1925,391,144,56,73,70,34,19,1930,1786,1730,1374,596,528,182,209,952,973,310,723,501,0,,425
15:16:45,6520.436,Fox,1925,390,144,58,71,70,36,18,1932,1788,1730,1376,598,528,182,208,952,973,310,723,502,0,,424
15:16:46,6521.309,Fox,1925,390,144,56,71,72,36,18,1932,1788,1732,1378,598,528,182,208,952,973,310,723,502,0,,424
15:16:46,6521.908,Fox,1929,391,146,56,69,72,36,17,1934,1788,1732,1378,598,528,181,210,954,975,312,723,503,0,,425
15:16:46,6522.208,Fox,1929,390,144,60,69,72,36,16,1936,1792,1732,1378,598,528,181,209,954,975,312,723,504,0,,424
15:16:47,6523.108,Fox,1929,388,144,60,67,74,35,15,1936,1792,1732,1380,598,529,180,208,954,975,312,723,506,0,,422
15:16:47,6523.708,Fox,1929,388,140,64,67,74,35,15,1936,1796,1732,1380,598,529,180,208,954,975,312,723,506,0,,422
15:16:48,6524.309,Fox,1933,390,140,66,65,74,35,15,1938,1798,1732,1380,598,529,181,209,957,976,313,724,506,0,,424
15:16:48,6524.862,Fox,1935,392,144,64,66,75,33,17,1942,1798,1734,1381,598,531,182,210,958,977,313,724,506,0,,426
15:16:48,6525.462,Fox,1935,392,144,60,69,75,34,17,1942,1798,1738,1382,599,531,182,210,958,977,313,724,506,0,,426
15:16:48,6525.762,Fox,1935,392,144,58,71,73,36,17,1942,1798,1740,1382,601,531,182,210,958,977,313,724,506,0,,426
15:16:49,6526.662,Fox,1937,393,142,60,70,73,36,17,1942,1800,1740,1383,602,531,183,210,959,978,313,725,506,0,,427
15:16:49,6527.262,Fox,1937,393,142,60,72,73,36,17,1944,1802,1742,1383,602,531,183,210,959,978,313,725,506,0,,427
15:16:50,6528.162,Fox,1943,395,148,60,68,74,36,16,1950,1802,1742,1385,602,531,184,211,963,980,315,726,507,0,,429
15:16:50,6528.462,Fox,1943,395,148,60,64,77,37,16,1950,1802,1742,1389,603,531,184,211,963,980,315,726,507,0,,429
15:16:51,6529.962,Fox,1943,393,148,60,64,73,39,16,1950,1802,1742,1389,605,531,184,209,963,980,315,728,507,0,,427
15:16:51,6530.562,Fox,1943,393,148,60,63,73,40,16,1950,1802,1742,1390,606,531,184,209,963,980,315,728,507,0,,427
15:16:52,6531.762,Fox,1945,394,150,60,60,75,40,16,1952,1802,1742,1392,606,531,184,210,964,981,315,729,507,0,,428
15:16:52,6532.062,Fox,1945,392,146,64,58,75,40,16,1952,1806,1742,1394,606,531,184,208,964,981,315,731,507,0,,426
15:16:53,6532.962,Fox,1947,393,144,64,59,73,41,17,1952,1808,1744,1394,608,532,183,210,964,983,315,732,507,0,,427
15:16:53,6533.562,Fox,1947,393,144,64,59,73,43,17,1954,1810,1746,1396,610,532,183,210,964,983,315,732,507,0,,427
15:16:53,6534.162,Fox,1949,394,144,64,57,74,43,17,1954,1810,1746,1398,610,532,183,211,965,984,315,733,507,0,,428
15:16:54,6534.762,Fox,1951,396,146,66,55,76,43,17,1958,1812,1746,1400,610,532,185,211,967,984,315,733,507,0,,430
15:16:54,6535.662,Fox,1951,396,146,64,57,75,44,17,1958,1812,1748,1400,611,532,185,211,967,984,315,733,507,0,,430
15:16:55,6536.562,Fox,1951,396,146,60,61,75,44,17,1958,1812,1752,1400,611,532,185,211,967,984,315,733,507,0,,430
15:16:55,6537.162,Fox,1953,397,148,58,63,75,44,16,1960,1812,1754,1400,611,532,185,212,968,985,315,734,507,0,,431
15:16:56,6537.762,Fox,1955,398,146,58,65,75,44,15,1960,1814,1756,1400,611,532,184,214,968,987,315,734,508,0,,432
15:16:56,6538.362,Fox,1957,400,150,58,65,75,43,16,1964,1814,1756,1400,611,533,185,215,969,988,315,734,508,0,,434
15:16:57,6538.962,Fox,1958,400,152,58,64,75,43,16,1966,1814,1756,1401,611,533,184,216,969,989,315,735,508,0,,434
15:16:57,6539.562,Fox,1958,399,150,58,66,75,43,15,1966,1816,1758,1401,611,533,184,215,969,989,315,735,509,0,,433
15:16:57,6540.162,Fox,1962,402,152,58,65,75,43,15,1968,1816,1758,1401,611,533,185,217,971,991,316,735,509,0,,436
15:16:58,6540.762,Fox,1964,404,156,58,65,74,42,17,1972,1816,1758,1401,612,535,186,218,972,992,316,735,509,0,,438
15:16:58,6541.362,Fox,1966,404,156,56,64,75,43,16,1972,1816,1760,1403,613,535,185,219,972,994,316,736,510,0,,438
15:16:58,6541.962,Fox,1968,404,158,56,64,73,43,16,1974,1816,1760,1403,613,535,186,218,974,994,316,738,510,0,,438
15:16:59,6542.262,Fox,1968,402,158,58,64,71,43,16,1976,1818,1760,1403,613,535,185,217,974,994,317,739,510,0,,436
15:16:59,6543.462,Fox,1968,401,154,58,68,71,42,16,1976,1822,1764,1403,613,536,185,216,974,994,317,739,511,0,,435
15:16:59,6544.062,Fox,1968,401,154,54,72,71,42,16,1976,1822,1768,1403,613,536,185,216,974,994,317,739,511,0,,435
15:17:00,6544.962,Fox,1970,403,156,52,73,72,42,16,1978,1822,1770,1404,613,536,186,217,975,995,317,739,511,0,,437
15:17:00,6545.562,Fox,1970,403,156,50,73,74,42,16,1978,1822,1772,1406,613,536,186,217,975,995,317,739,511,0,,437
15:17:01,6546.162,Fox,1972,404,158,48,74,74,42,16,1980,1822,1774,1406,613,536,187,217,977,995,317,740,511,0,,438
15:17:01,6546.762,Fox,1974,406,156,48,76,74,42,16,1980,1824,1776,1406,613,536,187,219,977,997,317,740,511,0,,440
15:17:01,6547.062,Fox,1974,406,158,48,72,78,42,16,1982,1824,1776,1410,613,536,187,219,977,997,317,740,511,0,,440
15:17:02,6547.962,Fox,1980,409,164,48,71,76,42,16,1988,1824,1776,1410,613,536,185,224,978,1002,317,743,511,0,,443
15:17:02,6548.562,Fox,1982,409,166,48,70,76,42,15,1990,1824,1776,1411,613,536,186,223,980,1002,317,744,512,0,,443
15:17:02,6549.462,Fox,1984,410,168,48,70,71,46,15,1992,1824,1776,1411,617,536,187,223,981,1003,317,745,512,0,,444
15:17:04,6551.727,Fox,1984,410,168,48,70,69,48,15,1992,1824,1776,1411,619,536,187,223,981,1003,317,745,512,0,,444
15:17:04,6552.327,Fox,1984,409,166,50,69,69,48,15,1992,1826,1776,1412,619,536,187,222,981,1003,317,746,512,0,,443
15:17:05,6553.786,Fox,1984,409,164,50,67,73,48,15,1992,1828,1778,1416,619,536,187,222,981,1003,317,746,512,0,,443
15:17:05,6554.386,Fox,1986,410,162,52,66,73,48,15,1992,1830,1778,1416,619,536,188,222,983,1003,317,747,512,0,,444
15:17:05,6554.888,Fox,1986,410,156,58,68,71,50,15,1994,1838,1780,1416,621,536,188,222,983,1003,317,747,512,0,,444
15:17:05,6555.549,Fox,1986,410,148,66,68,71,50,15,1994,1846,1780,1416,621,536,188,222,983,1003,317,747,512,0,,444
15:17:06,6556.449,Fox,1988,411,148,66,68,71,51,15,1996,1848,1782,1417,622,536,187,224,983,1005,317,748,512,0,,445
15:17:06,6557.049,Fox,1990,412,150,64,70,70,51,15,1998,1848,1784,1417,622,536,187,225,984,1006,317,749,512,0,,446
15:17:07,6557.649,Fox,1992,412,152,62,69,71,51,15,2000,1848,1786,1420,622,536,187,225,985,1007,317,751,512,0,,446
15:17:07,6558.549,Fox,1996,414,156,60,71,68,52,15,2004,1848,1788,1420,623,536,188,226,987,1009,317,753,512,0,,448
15:17:08,6559.149,Fox,1998,411,158,60,71,64,52,14,2006,1848,1788,1420,623,536,186,225,987,1011,319,755,513,0,,445
15:17:08,6560.049,Fox,2000,413,158,62,71,64,52,14,2008,1850,1788,1420,623,536,188,225,989,1011,319,755,513,0,,447
15:17:09,6560.649,Fox,2000,413,156,60,74,63,54,14,2008,1852,1792,1421,625,536,188,225,989,1011,319,755,513,0,,447
15:17:09,6561.249,Fox,2000,412,156,60,74,63,54,13,2008,1852,1792,1421,625,536,187,225,989,1011,319,755,514,0,,446
15:17:09,6562.142,Fox,2002,413,158,56,78,62,54,13,2010,1852,1796,1421,625,536,186,227,989,1013,319,756,514,0,,447
15:17:10,6562.727,Fox,2008,418,160,56,79,62,54,13,2014,1854,1798,1421,625,536,188,230,992,1016,319,757,514,0,,452
15:17:10,6563.327,Fox,2010,418,162,58,75,64,54,13,2018,1856,1798,1425,625,536,189,229,993,1017,319,759,514,0,,452
15:17:11,6564.527,Fox,2012,420,162,60,74,65,54,13,2020,1858,1798,1426,625,536,190,230,994,1018,319,759,514,0,,454
15:17:11,6565.127,Fox,2012,420,160,60,76,64,55,13,2020,1860,1800,1426,626,536,190,230,994,1018,319,759,514,0,,454
15:17:12,6565.976,Fox,2014,421,160,60,77,64,55,13,2022,1862,1802,1426,626,536,189,232,994,1020,319,760,514,0,,455
15:17:12,6566.576,Fox,2016,423,154,66,77,64,55,13,2022,1868,1802,1426,626,536,190,233,995,1021,319,760,514,0,,457
15:17:13,6567.176,Fox,2016,423,152,70,77,64,52,16,2024,1872,1802,1426,626,539,190,233,995,1021,319,760,514,0,,457
15:17:13,6567.776,Fox,2018,424,152,72,77,63,52,16,2026,1874,1802,1426,626,539,190,234,996,1022,319,761,514,0,,458
15:17:14,6568.376,Fox,2020,426,154,72,75,65,52,16,2028,1874,1802,1428,626,539,192,234,998,1022,319,761,514,0,,460
15:17:14,6568.976,Fox,2020,425,154,72,75,65,52,15,2028,1874,1802,1428,626,539,192,233,998,1022,319,761,515,0,,459
15:17:15,6569.876,Fox,2020,424,152,74,75,64,52,15,2028,1876,1802,1428,626,539,192,232,998,1022,319,762,515,0,,458
15:17:15,6570.476,Fox,2020,423,150,76,75,63,50,17,2028,1878,1802,1428,626,541,192,231,998,1022,319,763,515,0,,457
15:17:16,6571.076,Fox,2022,423,148,74,78,64,50,15,2028,1880,1806,1429,626,541,193,230,1000,1022,319,763,517,0,,457
15:17:16,6571.676,Fox,2022,423,150,72,80,64,50,15,2030,1880,1808,1429,626,541,193,230,1000,1022,319,763,517,0,,457
15:17:16,6572.276,Fox,2026,425,152,70,82,62,49,16,2032,1880,1810,1429,626,542,193,232,1001,1025,320,764,517,0,,459
15:17:17,6572.876,Fox,2026,424,154,70,82,61,49,16,2034,1880,1810,1429,626,542,193,231,1001,1025,321,764,517,0,,458
15:17:17,6573.476,Fox,2026,423,154,68,84,61,48,16,2034,1880,1812,1429,626,543,193,230,1001,1025,321,764,518,0,,457
15:17:18,6574.076,Fox,2028,422,154,68,84,59,48,15,2034,1880,1812,1429,626,543,193,229,1002,1026,321,766,519,0,,456
15:17:18,6574.676,Fox,2028,421,148,76,83,59,46,17,2036,1888,1812,1429,626,545,192,229,1002,1026,321,767,519,0,,455
15:17:18,6574.976,Fox,2028,421,146,78,83,59,46,17,2036,1890,1812,1429,626,545,192,229,1002,1026,321,767,519,0,,455
15:17:19,6575.876,Fox,2032,424,148,78,82,59,46,17,2038,1890,1812,1429,626,545,192,232,1003,1029,322,767,519,0,,458
15:17:19,6576.476,Fox,2032,423,150,76,80,61,47,17,2040,1890,1814,1432,627,545,191,232,1003,1029,323,767,519,0,,457
15:17:20,6577.076,Fox,2032,423,146,80,80,61,47,17,2040,1894,1814,1432,627,545,191,232,1003,1029,323,767,519,0,,457
15:17:21,6578.576,Fox,2032,422,146,78,82,60,47,17,2040,1894,1816,1432,627,545,191,231,1003,1029,323,768,519,0,,456
15:17:21,6578.876,Fox,2032,421,146,78,82,59,47,17,2040,1894,1816,1432,627,545,191,230,1003,1029,323,769,519,0,,455
15:17:21,6579.776,Fox,2032,420,146,78,80,60,46,18,2040,1894,1816,1434,627,546,191,229,1003,1029,323,770,519,0,,454
15:17:22,6580.076,Fox,2032,417,146,78,78,59,46,18,2040,1894,1816,1436,627,546,191,226,1003,1029,323,773,519,0,,451
15:17:22,6580.976,Fox,2038,421,150,76,79,58,46,18,2044,1894,1818,1436,627,546,192,229,1006,1032,323,775,519,0,,455
15:17:23,6581.576,Fox,2038,419,150,78,77,58,46,18,2046,1896,1818,1438,627,546,192,227,1006,1032,323,777,519,0,,453
15:17:23,6582.176,Fox,2040,418,150,74,80,56,46,18,2046,1896,1822,1438,627,546,193,225,1008,1032,324,779,519,0,,452
15:17:23,6582.476,Fox,2040,418,152,74,80,56,46,18,2048,1896,1822,1438,627,546,193,225,1008,1032,324,779,519,0,,452
15:17:24,6583.376,Fox,2044,420,156,74,80,55,44,19,2052,1896,1822,1438,627,548,193,227,1010,1034,325,779,520,0,,454
15:17:24,6583.676,Fox,2044,418,152,78,80,53,44,19,2052,1900,1822,1438,627,548,193,225,1010,1034,325,781,520,0,,452
15:17:25,6584.576,Fox,2048,421,156,78,79,53,44,19,2056,1900,1822,1438,627,548,194,227,1012,1036,325,782,520,0,,455
15:17:25,6585.176,Fox,2048,421,156,76,80,54,44,19,2056,1900,1824,1439,627,548,194,227,1012,1036,325,782,520,0,,455
15:17:25,6585.776,Fox,2048,421,154,78,79,54,44,20,2056,1902,1824,1440,628,549,194,227,1012,1036,325,782,520,0,,455
15:17:26,6586.376,Fox,2050,421,150,84,75,55,45,20,2058,1908,1824,1443,629,549,193,228,1012,1038,327,782,520,0,,455
15:17:26,6586.676,Fox,2050,420,148,86,75,55,45,19,2058,1910,1824,1443,629,549,193,227,1012,1038,327,782,521,0,,454
15:17:27,6587.576,Fox,2052,421,148,88,73,56,44,20,2060,1912,1824,1445,629,550,193,228,1013,1039,328,782,521,0,,455
15:17:27,6588.176,Fox,2052,420,148,88,73,55,44,20,2060,1912,1824,1445,629,550,193,227,1013,1039,328,783,521,0,,454
15:17:28,6589.076,Fox,2054,422,150,88,73,55,44,20,2062,1912,1824,1445,629,550,194,228,1014,1040,328,783,521,0,,456
15:17:28,6589.976,Fox,2054,420,150,88,73,54,44,19,2062,1912,1824,1445,629,550,194,226,1014,1040,328,785,521,0,,454
15:17:29,6590.876,Fox,2056,421,148,88,75,53,44,19,2062,1914,1826,1445,629,550,194,227,1015,1041,329,785,521,0,,455
15:17:29,6591.476,Fox,2058,422,152,88,75,53,44,18,2066,1914,1826,1445,629,550,195,227,1016,1042,329,785,522,0,,456
15:17:30,6592.076,Fox,2060,424,150,90,75,51,46,18,2066,1916,1826,1445,631,550,196,228,1017,1043,329,785,522,0,,458
15:17:30,6592.676,Fox,2062,425,150,88,79,50,46,18,2068,1918,1830,1445,631,550,196,229,1018,1044,329,786,522,0,,459
15:17:31,6593.276,Fox,2062,425,152,84,81,50,48,18,2070,1918,1834,1447,633,550,196,229,1018,1044,329,786,522,0,,459
15:17:31,6593.876,Fox,2062,425,150,78,87,52,48,18,2070,1920,1842,1449,633,550,196,229,1018,1044,329,786,522,0,,459
15:17:31,6594.476,Fox,2064,427,150,74,91,50,50,18,2070,1920,1846,1449,635,550,197,230,1019,1045,329,786,522,0,,461
15:17:32,6595.076,Fox,2066,428,152,72,92,50,50,18,2072,1920,1848,1449,635,550,196,232,1019,1047,329,787,522,0,,462
15:17:32,6595.676,Fox,2070,431,154,74,91,50,50,18,2076,1922,1848,1449,635,550,198,233,1022,1048,329,788,522,0,,465
15:17:32,6595.976,Fox,2070,431,156,74,90,51,50,18,2078,1922,1848,1450,635,550,198,233,1022,1048,329,788,522,0,,465
15:17:33,6596.876,Fox,2070,431,156,74,87,50,54,18,2078,1922,1848,1453,639,550,198,233,1022,1048,329,788,522,0,,465
15:17:33,6597.176,Fox,2070,431,156,74,86,51,54,18,2078,1922,1848,1454,639,550,198,233,1022,1048,329,788,522,0,,465
15:17:34,6597.715,Fox,2070,431,156,74,85,52,54,18,2078,1922,1848,1455,639,550,198,233,1022,1048,329,788,522,0,,465
15:17:34,6598.615,Fox,2072,432,154,74,86,52,54,18,2078,1924,1850,1455,639,550,198,234,1023,1049,329,789,522,0,,466
15:17:35,6599.215,Fox,2072,430,154,74,87,52,54,17,2080,1926,1852,1455,639,550,197,233,1023,1049,329,790,523,0,,464
15:17:35,6599.815,Fox,2078,434,158,74,85,53,51,19,2084,1926,1852,1456,639,552,197,237,1025,1053,329,792,523,0,,468
15:17:36,6600.415,Fox,2080,435,160,74,85,52,50,20,2086,1926,1852,1456,639,553,198,237,1027,1053,329,793,523,0,,469
15:17:36,6601.015,Fox,2084,438,165,72,86,52,50,20,2091,1926,1854,1456,639,553,198,240,1028,1056,329,794,523,0,,472
15:17:37,6601.615,Fox,2086,440,169,72,84,54,50,20,2095,1926,1854,1458,639,553,198,242,1028,1058,329,794,523,0,,474
15:17:37,6602.215,Fox,2088,442,167,74,86,54,50,20,2097,1930,1856,1458,639,553,198,244,1028,1060,329,794,523,0,,476
15:17:37,6602.815,Fox,2092,443,167,74,86,53,50,20,2099,1932,1858,1458,639,553,197,246,1030,1062,330,796,523,0,,477
15:17:38,6603.415,Fox,2092,442,169,74,86,52,50,20,2101,1932,1858,1458,639,553,197,245,1030,1062,331,796,523,0,,476
15:17:38,6603.715,Fox,2092,440,169,72,85,54,50,19,2101,1932,1860,1461,639,553,196,244,1030,1062,331,797,524,0,,474
15:17:39,6604.615,Fox,2092,440,167,72,83,58,50,19,2101,1934,1862,1465,639,553,196,244,1030,1062,331,797,524,0,,474
15:17:39,6605.215,Fox,2092,440,165,68,87,60,50,19,2101,1936,1868,1467,639,553,196,244,1030,1062,331,797,524,0,,474
15:17:39,6606.115,Fox,2092,439,165,62,91,62,48,20,2101,1936,1874,1469,639,555,196,243,1030,1062,331,797,525,0,,473
15:17:40,6606.415,Fox,2092,439,165,62,90,63,48,20,2101,1936,1874,1470,639,555,196,243,1030,1062,331,797,525,0,,473
15:17:40,6607.315,Fox,2092,437,161,66,89,62,48,20,2101,1940,1874,1471,639,555,194,243,1030,1062,333,797,525,0,,471
15:17:40,6607.615,Fox,2092,437,159,68,89,62,48,20,2101,1942,1874,1471,639,555,194,243,1030,1062,333,797,525,0,,471
15:17:41,6608.215,Fox,2092,437,159,66,91,62,48,20,2101,1942,1876,1471,639,555,194,243,1030,1062,333,797,525,0,,471
15:17:42,6609.115,Fox,2094,438,161,64,93,61,48,20,2103,1942,1878,1471,639,555,194,244,1031,1063,333,798,525,0,,472
15:17:42,6609.715,Fox,2096,439,159,64,95,60,48,20,2103,1944,1880,1471,639,555,195,244,1032,1064,334,798,525,0,,473
15:17:42,6610.015,Fox,2096,439,161,64,95,60,48,20,2105,1944,1880,1471,639,555,195,244,1032,1064,334,798,525,0,,473
15:17:43,6610.915,Fox,2096,438,155,70,94,60,48,20,2105,1950,1880,1471,639,555,194,244,1032,1064,334,799,525,0,,472
15:17:43,6611.515,Fox,2100,441,159,70,94,59,48,20,2109,1950,1880,1471,639,555,197,244,1035,1065,334,800,525,0,,475
15:17:44,6612.115,Fox,2102,442,161,70,94,58,48,20,2111,1950,1880,1471,639,555,196,246,1035,1067,335,800,525,0,,476
15:17:44,6613.015,Fox,2104,442,163,62,100,58,48,20,2113,1950,1888,1471,639,555,194,248,1035,1069,335,802,525,0,,476
15:17:45,6613.915,Fox,2106,443,163,60,100,58,49,20,2113,1950,1890,1473,640,555,193,250,1035,1071,335,803,525,0,,477
15:17:45,6614.515,Fox,2106,442,163,62,100,58,49,19,2115,1952,1890,1473,640,555,193,249,1035,1071,335,803,526,0,,476
15:17:46,6615.415,Fox,2106,442,163,60,100,60,49,19,2115,1952,1892,1475,640,555,193,249,1035,1071,335,803,526,0,,476
15:17:46,6616.015,Fox,2106,440,161,60,102,59,49,18,2115,1954,1894,1475,640,555,193,247,1035,1071,336,803,527,0,,474
15:17:47,6616.615,Fox,2110,443,165,60,102,58,49,18,2119,1954,1894,1475,640,555,196,247,1039,1071,336,804,527,0,,477
15:17:47,6617.194,Fox,2114,445,163,62,99,59,49,18,2119,1956,1894,1476,640,555,196,249,1041,1073,336,806,527,0,,479
15:17:47,6617.763,Fox,2116,446,165,64,95,63,49,17,2123,1958,1894,1480,640,555,196,250,1041,1075,336,806,528,0,,480
15:17:47,6618.046,Fox,2116,446,167,64,95,63,49,17,2125,1958,1894,1480,640,555,196,250,1041,1075,336,806,528,0,,480
15:17:48,6619.247,Fox,2116,446,167,64,93,65,49,17,2125,1958,1894,1482,640,555,196,250,1041,1075,336,806,528,0,,480
15:17:49,6620.146,Fox,2116,446,165,64,95,64,50,17,2125,1960,1896,1482,641,555,196,250,1041,1075,336,806,528,0,,480
15:17:49,6621.046,Fox,2116,446,161,68,95,64,50,17,2125,1964,1896,1482,641,555,196,250,1041,1075,336,806,528,0,,480
15:17:50,6621.646,Fox,2116,445,159,70,94,64,50,17,2125,1966,1896,1483,641,555,196,249,1041,1075,336,807,528,0,,479
15:17:50,6622.443,Fox,2116,445,159,66,97,65,50,17,2125,1966,1900,1484,641,555,196,249,1041,1075,336,807,528,0,,479
15:17:50,6623.043,Fox,2116,445,155,70,95,67,50,17,2125,1970,1900,1486,641,555,196,249,1041,1075,336,807,528,0,,479
15:17:51,6623.643,Fox,2116,442,153,72,94,66,50,16,2125,1972,1900,1487,641,555,196,246,1041,1075,336,809,529,0,,476
15:17:51,6624.543,Fox,2116,440,151,70,98,64,50,16,2125,1974,1904,1487,641,555,195,245,1041,1075,337,810,529,0,,474
15:17:52,6625.143,Fox,2116,440,149,66,103,65,50,16,2125,1976,1910,1488,641,555,195,245,1041,1075,337,810,529,0,,474
15:17:52,6625.443,Fox,2116,439,149,66,103,65,50,15,2125,1976,1910,1488,641,555,195,244,1041,1075,337,810,530,0,,473
15:17:53,6626.343,Fox,2116,438,149,64,104,66,50,14,2125,1976,1912,1489,641,555,195,243,1041,1075,337,810,531,0,,472
15:17:54,6627.843,Fox,2118,440,149,66,104,64,52,14,2127,1978,1912,1489,643,555,196,244,1042,1076,337,810,531,0,,474
15:17:54,6629.043,Fox,2118,440,147,66,106,64,52,14,2127,1980,1914,1489,643,555,196,244,1042,1076,337,810,531,0,,474
15:17:55,6629.643,Fox,2120,440,147,68,105,63,52,14,2129,1982,1914,1489,643,555,196,244,1043,1077,337,812,531,0,,474
15:17:55,6630.243,Fox,2122,440,149,66,106,62,52,14,2131,1982,1916,1489,643,555,197,243,1045,1077,338,813,531,0,,474
15:17:56,6630.843,Fox,2122,440,143,70,108,62,51,15,2131,1988,1918,1489,643,556,197,243,1045,1077,338,813,531,0,,474
15:17:56,6631.443,Fox,2124,442,141,72,104,66,51,15,2131,1990,1918,1493,643,556,198,244,1046,1078,338,813,531,0,,476
15:17:56,6632.043,Fox,2126,443,143,72,104,67,51,15,2135,1992,1920,1494,643,556,197,246,1046,1080,339,813,531,0,,477
15:17:57,6632.643,Fox,2128,445,145,72,102,69,51,15,2137,1992,1920,1496,643,556,199,246,1048,1080,339,813,531,0,,479
15:17:57,6633.543,Fox,2134,448,149,72,100,68,51,15,2141,1992,1920,1496,643,556,200,248,1052,1082,339,816,531,0,,482
15:17:58,6634.143,Fox,2134,448,151,70,101,69,51,15,2143,1992,1922,1497,643,556,200,248,1052,1082,339,816,531,0,,482
15:17:59,6635.643,Fox,2136,444,153,70,100,64,51,15,2145,1992,1922,1497,643,556,198,246,1053,1083,339,822,531,0,,478
15:17:59,6636.243,Fox,2140,446,155,70,98,64,51,15,2147,1992,1922,1497,643,556,199,247,1056,1084,339,824,531,0,,480
15:17:59,6636.543,Fox,2140,445,157,70,97,65,51,14,2149,1992,1922,1498,643,556,199,246,1056,1084,339,824,532,0,,479
15:18:00,6637.443,Fox,2142,447,155,70,99,65,51,14,2149,1994,1924,1498,643,556,200,247,1057,1085,339,824,532,0,,481
15:18:01,6638.043,Fox,2146,449,161,68,101,63,51,14,2155,1994,1926,1498,643,556,198,251,1057,1089,339,826,532,0,,483
15:18:01,6638.621,Fox,2148,450,161,68,100,60,54,14,2155,1994,1926,1499,646,556,198,252,1058,1090,339,827,532,0,,484
15:18:01,6639.089,Fox,2148,450,161,70,100,60,53,15,2157,1996,1926,1499,646,557,198,252,1058,1090,339,827,532,0,,484
15:18:01,6639.422,Fox,2148,450,159,72,100,60,52,16,2157,1998,1926,1499,646,558,198,252,1058,1090,339,827,532,0,,484
15:18:01,6640.186,Fox,2148,450,157,70,104,59,53,16,2157,2000,1930,1499,647,558,198,252,1058,1090,339,827,532,0,,484
15:18:01,6640.343,Fox,2148,449,157,70,104,59,53,15,2157,2000,1930,1499,647,558,197,252,1058,1090,339,827,533,0,,483
15:18:02,6641.243,Fox,2152,452,155,72,104,60,53,15,2159,2004,1932,1501,647,558,199,253,1061,1091,339,828,533,0,,486
15:18:02,6641.843,Fox,2152,451,155,74,104,60,53,14,2161,2006,1932,1501,647,558,198,253,1061,1091,339,828,534,0,,485
15:18:03,6642.443,Fox,2154,452,157,74,99,64,53,14,2163,2006,1932,1505,647,558,197,255,1061,1093,339,829,534,0,,486
15:18:03,6643.043,Fox,2154,451,155,74,101,64,53,13,2163,2008,1934,1505,647,558,197,254,1061,1093,339,829,535,0,,485
15:18:04,6643.644,Fox,2156,453,155,72,103,64,53,13,2163,2008,1936,1505,647,558,198,255,1062,1094,339,829,535,0,,487
15:18:04,6643.943,Fox,2156,453,157,72,103,64,53,13,2165,2008,1936,1505,647,558,198,255,1062,1094,339,829,535,0,,487
15:18:05,6645.144,Fox,2156,453,155,74,103,64,51,15,2165,2010,1936,1505,647,560,198,255,1062,1094,339,829,535,0,,487
15:18:05,6645.743,Fox,2160,454,149,76,104,65,51,14,2165,2016,1940,1506,647,560,198,256,1064,1096,340,830,536,0,,488
15:18:05,6646.043,Fox,2160,454,151,76,106,65,51,14,2169,2018,1942,1506,647,560,198,256,1064,1096,340,830,536,0,,488
15:18:06,6646.943,Fox,2162,456,153,76,106,65,50,15,2171,2018,1942,1506,647,561,199,257,1065,1097,340,830,536,0,,490
15:18:06,6647.543,Fox,2162,454,151,78,106,63,50,15,2171,2020,1942,1506,647,561,199,255,1065,1097,341,831,536,0,,488
15:18:07,6648.443,Fox,2162,452,151,76,108,61,50,15,2171,2020,1944,1506,647,561,197,255,1065,1097,341,833,536,0,,486
15:18:08,6649.043,Fox,2164,454,151,78,108,61,50,15,2173,2022,1944,1506,647,561,197,257,1065,1099,341,833,536,0,,488
15:18:08,6649.644,Fox,2164,453,149,74,114,59,51,15,2173,2024,1950,1506,648,561,197,256,1065,1099,341,834,536,0,,487
15:18:09,6650.543,Fox,2164,450,148,76,114,57,51,14,2174,2026,1950,1506,648,561,197,253,1065,1099,342,835,537,0,,484
15:18:09,6651.144,Fox,2164,449,146,78,114,55,52,14,2174,2028,1950,1506,649,561,197,252,1065,1099,343,835,537,0,,483
15:18:10,6651.743,Fox,2168,451,148,78,113,54,52,14,2176,2028,1950,1507,649,561,197,254,1066,1102,344,836,537,0,,485
15:18:10,6652.043,Fox,2168,449,150,78,113,52,52,14,2178,2028,1950,1507,649,561,195,254,1066,1102,344,838,537,0,,483
15:18:11,6653.243,Fox,2168,449,150,76,112,55,52,14,2178,2028,1952,1510,649,561,195,254,1066,1102,344,838,537,0,,483
15:18:11,6653.843,Fox,2172,452,152,76,109,57,52,14,2180,2028,1952,1513,649,561,198,254,1070,1102,344,839,537,0,,486
15:18:11,6654.443,Fox,2176,454,154,76,104,63,52,13,2184,2030,1954,1519,649,561,198,256,1071,1105,344,840,538,0,,488
15:18:12,6655.043,Fox,2176,454,154,78,101,66,52,13,2186,2032,1954,1522,649,561,198,256,1071,1105,344,840,538,0,,488
15:18:12,6655.644,Fox,2182,458,156,78,99,68,52,13,2190,2034,1956,1524,649,561,198,260,1073,1109,344,842,538,0,,492
15:18:13,6655.943,Fox,2182,457,158,76,101,67,52,13,2192,2034,1958,1524,649,561,198,259,1073,1109,344,843,538,0,,491
15:18:13,6656.843,Fox,2182,456,158,76,101,66,52,13,2192,2034,1958,1524,650,562,198,258,1073,1109,344,843,539,0,,490
15:18:14,6657.443,Fox,2186,457,160,78,101,63,52,13,2196,2036,1958,1524,650,562,199,258,1076,1110,345,845,539,0,,491
15:18:14,6658.043,Fox,2188,457,162,78,100,62,50,15,2198,2036,1958,1524,650,564,198,259,1076,1112,345,847,539,0,,491
15:18:14,6658.644,Fox,2188,456,160,78,102,62,50,14,2198,2038,1960,1524,650,564,198,258,1076,1112,345,847,540,0,,490
15:18:15,6659.243,Fox,2192,459,158,78,102,63,50,14,2198,2040,1962,1526,650,564,198,261,1077,1115,345,848,540,0,,493
15:18:15,6659.543,Fox,2192,459,162,76,103,64,50,14,2202,2040,1964,1527,650,564,198,261,1077,1115,345,848,540,0,,493
15:18:15,6660.144,Fox,2192,459,162,74,105,64,50,14,2202,2040,1966,1527,650,564,198,261,1077,1115,345,848,540,0,,493
15:18:16,6661.644,Fox,2192,459,162,70,107,64,52,14,2202,2040,1970,1529,652,564,198,261,1077,1115,345,848,540,0,,493
15:18:17,6662.243,Fox,2192,458,162,68,109,63,52,14,2202,2040,1972,1529,652,564,198,260,1077,1115,345,849,540,0,,492
15:18:17,6662.843,Fox,2194,459,162,66,109,64,52,14,2202,2040,1974,1530,652,564,199,260,1079,1115,345,850,540,0,,493
15:18:18,6663.443,Fox,2198,461,166,64,109,64,50,16,2206,2040,1976,1532,652,566,199,262,1081,1117,346,851,540,0,,495
15:18:18,6664.043,Fox,2198,461,162,70,107,66,50,16,2208,2046,1976,1534,652,566,199,262,1081,1117,346,851,540,0,,495
15:18:19,6664.644,Fox,2198,461,162,70,105,68,49,17,2208,2046,1976,1536,652,567,199,262,1081,1117,346,851,540,0,,495
15:18:19,6665.543,Fox,2198,461,160,72,100,73,49,17,2208,2048,1976,1541,652,567,199,262,1081,1117,346,851,540,0,,495
15:18:20,6666.406,Fox,2198,461,156,74,96,79,48,18,2208,2052,1978,1547,652,568,199,262,1081,1117,346,851,540,0,,495
15:18:21,6667.006,Fox,2202,465,160,74,96,79,48,18,2212,2052,1978,1547,652,568,201,264,1083,1119,346,851,540,0,,499
15:18:21,6667.306,Fox,2202,465,156,76,98,79,46,20,2212,2056,1980,1547,652,570,201,264,1083,1119,346,851,540,0,,499
15:18:22,6668.506,Fox,2204,466,156,74,100,79,45,20,2212,2056,1982,1547,652,571,201,265,1084,1120,346,851,541,0,,500
15:18:22,6669.106,Fox,2204,466,156,70,103,82,45,20,2214,2058,1988,1550,652,571,201,265,1084,1120,346,851,541,0,,500
15:18:23,6669.706,Fox,2204,465,156,68,105,80,46,20,2214,2058,1990,1550,653,571,201,264,1084,1120,346,852,541,0,,499
15:18:23,6670.606,Fox,2204,463,154,68,107,78,44,22,2214,2060,1992,1550,653,573,201,262,1084,1120,346,854,541,0,,497
15:18:24,6671.206,Fox,2208,467,158,68,107,78,42,24,2218,2060,1992,1550,653,575,203,264,1086,1122,346,854,541,0,,501
15:18:24,6671.806,Fox,2210,468,158,70,106,78,42,24,2220,2062,1992,1550,653,575,203,265,1087,1123,346,855,541,0,,502
15:18:24,6672.106,Fox,2210,467,158,70,106,77,42,24,2220,2062,1992,1550,653,575,203,264,1087,1123,346,856,541,0,,501
15:18:25,6673.006,Fox,2212,468,160,70,106,76,41,25,2222,2062,1992,1550,653,576,203,265,1088,1124,346,857,541,0,,502
15:18:25,6673.606,Fox,2214,469,160,70,98,83,41,25,2222,2062,1992,1557,653,576,203,266,1089,1125,346,858,541,0,,503
15:18:26,6674.206,Fox,2214,469,158,74,97,84,41,25,2224,2066,1992,1558,653,576,203,266,1089,1125,346,858,541,0,,503
15:18:26,6675.406,Fox,2218,471,156,76,96,84,41,24,2224,2068,1992,1558,653,576,204,267,1092,1126,346,860,541,0,,505
15:18:27,6676.006,Fox,2226,474,164,76,92,85,41,24,2234,2070,1994,1562,653,576,206,268,1097,1129,346,865,541,0,,508
15:18:27,6676.306,Fox,2226,473,166,76,92,84,41,24,2236,2070,1994,1562,653,576,205,268,1097,1129,346,866,541,0,,507
15:18:28,6677.506,Fox,2228,475,166,76,94,84,41,24,2238,2072,1996,1562,653,576,205,270,1097,1131,346,866,541,0,,509
15:18:28,6678.406,Fox,2228,474,162,78,96,83,40,25,2238,2076,1998,1562,653,577,205,269,1097,1131,346,867,541,0,,508
15:18:29,6679.006,Fox,2232,474,162,78,96,82,39,25,2240,2078,2000,1562,653,578,204,270,1099,1133,346,870,542,0,,508
15:18:29,6679.606,Fox,2234,474,164,74,99,80,40,25,2242,2078,2004,1562,654,578,204,270,1100,1134,346,872,542,0,,508
15:18:29,6680.177,Fox,2236,475,166,72,98,82,40,25,2244,2078,2006,1564,654,578,203,272,1100,1136,347,872,542,0,,509
15:18:30,6680.739,Fox,2238,476,170,72,98,81,41,24,2248,2078,2006,1564,655,578,203,273,1101,1137,347,872,543,0,,510
15:18:30,6681.607,Fox,2238,476,168,72,100,81,41,24,2248,2080,2008,1564,655,578,203,273,1101,1137,347,872,543,0,,510
15:18:30,6682.178,Fox,2240,477,170,72,99,81,41,24,2250,2080,2008,1564,655,578,202,275,1101,1139,347,873,543,0,,511
15:18:31,6682.778,Fox,2240,477,164,78,98,82,41,24,2250,2086,2008,1565,655,578,202,275,1101,1139,347,873,543,0,,511
15:18:31,6683.377,Fox,2244,480,166,78,99,82,41,24,2254,2088,2010,1565,655,578,204,276,1104,1140,347,874,543,0,,514
15:18:32,6683.978,Fox,2244,480,161,79,103,82,41,24,2254,2093,2014,1565,655,578,204,276,1104,1140,347,874,543,0,,514
15:18:32,6684.578,Fox,2244,478,159,77,107,80,41,24,2254,2095,2018,1565,655,578,203,275,1104,1140,348,875,543,0,,512
15:18:32,6685.178,Fox,2246,479,159,79,102,84,41,24,2256,2097,2018,1569,655,578,203,276,1105,1141,348,876,543,0,,513
15:18:33,6685.778,Fox,2248,480,157,81,100,87,41,24,2258,2101,2020,1573,655,578,203,277,1106,1142,348,877,543,0,,514
15:18:33,6686.377,Fox,2252,483,161,81,99,87,41,24,2262,2101,2020,1573,655,578,205,278,1109,1143,349,877,543,0,,517
15:18:34,6686.978,Fox,2252,482,161,79,99,89,36,28,2262,2101,2022,1575,655,582,205,277,1109,1143,349,878,543,0,,516
15:18:34,6687.578,Fox,2254,481,163,79,98,88,36,27,2264,2101,2022,1575,655,582,206,275,1111,1143,350,879,544,0,,515
15:18:34,6687.877,Fox,2254,481,163,77,100,88,36,27,2264,2101,2024,1575,655,582,206,275,1111,1143,350,879,544,0,,515
15:18:35,6688.778,Fox,2254,481,163,75,102,88,36,27,2264,2101,2026,1575,655,582,206,275,1111,1143,350,879,544,0,,515
15:18:35,6689.678,Fox,2254,481,163,73,103,89,34,29,2264,2101,2028,1576,655,584,206,275,1111,1143,350,879,544,0,,515
15:18:36,6690.578,Fox,2258,483,167,73,103,86,35,29,2268,2101,2028,1576,656,584,208,275,1114,1144,350,881,544,0,,517
15:18:36,6691.178,Fox,2258,482,167,73,101,88,35,28,2268,2101,2028,1578,656,584,207,275,1114,1144,350,881,545,0,,516
15:18:37,6691.778,Fox,2258,477,165,75,100,86,35,26,2268,2103,2028,1579,656,584,203,274,1114,1144,350,884,547,0,,511
15:18:37,6692.641,Fox,2260,477,165,75,99,87,33,28,2270,2105,2030,1581,656,586,202,275,1114,1146,350,886,547,0,,511
15:18:38,6693.773,Fox,2264,478,165,71,102,85,33,28,2270,2105,2034,1581,656,586,202,276,1116,1148,351,888,547,0,,512
15:18:38,6694.073,Fox,2264,478,165,75,102,85,33,28,2274,2109,2034,1581,656,586,202,276,1116,1148,351,888,547,0,,512
15:18:39,6694.974,Fox,2266,479,163,77,101,86,33,27,2274,2111,2034,1582,656,586,202,277,1117,1149,351,888,548,0,,513
15:18:39,6695.573,Fox,2268,480,163,77,102,86,33,27,2276,2113,2036,1582,656,586,202,278,1118,1150,352,888,548,0,,514
15:18:39,6696.173,Fox,2272,482,167,77,101,85,32,28,2280,2113,2036,1582,656,587,201,281,1119,1153,352,890,548,0,,516
15:18:40,6696.773,Fox,2272,482,167,79,101,85,32,28,2282,2115,2036,1582,656,587,201,281,1119,1153,352,890,548,0,,516
15:18:40,6697.374,Fox,2274,484,167,75,105,83,34,28,2282,2115,2040,1582,658,587,203,281,1121,1153,352,890,548,0,,518
15:18:41,6697.974,Fox,2274,484,169,75,105,80,35,30,2284,2115,2040,1582,661,589,203,281,1121,1153,352,890,548,0,,518
15:18:41,6698.573,Fox,2276,485,171,75,102,81,36,30,2286,2115,2040,1584,662,589,203,282,1122,1154,352,891,548,0,,519
15:18:42,6699.474,Fox,2278,487,167,79,102,81,36,30,2286,2119,2040,1584,662,589,204,283,1123,1155,352,891,548,0,,521
15:18:42,6700.073,Fox,2278,487,165,83,102,80,37,30,2288,2123,2040,1584,663,589,204,283,1123,1155,352,891,548,0,,521
15:18:42,6700.673,Fox,2280,489,165,85,102,79,38,30,2290,2125,2040,1584,664,589,206,283,1125,1155,352,891,548,0,,523
15:18:43,6701.273,Fox,2282,491,167,85,99,82,38,30,2292,2125,2040,1587,664,589,207,284,1126,1156,352,891,548,0,,525
15:18:43,6701.874,Fox,2288,490,169,85,95,79,38,30,2294,2125,2040,1588,664,589,207,283,1130,1158,354,896,548,0,,524
15:18:43,6702.474,Fox,2288,489,173,79,101,78,37,31,2298,2125,2046,1588,664,590,207,282,1130,1158,354,897,548,0,,523
15:18:44,6703.073,Fox,2290,484,175,79,100,72,37,31,2300,2125,2046,1588,664,590,207,277,1131,1159,355,903,548,0,,518
15:18:45,6703.974,Fox,2290,484,175,77,100,74,37,31,2300,2125,2048,1590,664,590,207,277,1131,1159,355,903,548,0,,518
15:18:45,6704.573,Fox,2290,484,175,73,104,74,37,31,2300,2125,2052,1590,664,590,207,277,1131,1159,355,903,548,0,,518
15:18:46,6705.773,Fox,2292,481,177,69,107,70,37,31,2302,2125,2056,1590,664,590,207,274,1133,1159,356,907,548,0,,515
15:18:46,6706.073,Fox,2292,480,177,69,105,72,37,30,2302,2125,2056,1592,664,590,206,274,1133,1159,356,907,549,0,,514
15:18:47,6706.974,Fox,2294,481,179,69,102,74,37,30,2304,2125,2056,1594,664,590,206,275,1134,1160,356,908,549,0,,515
15:18:47,6707.573,Fox,2294,480,179,67,104,74,37,29,2304,2125,2058,1594,664,590,206,274,1134,1160,356,908,550,0,,514
15:18:48,6708.773,Fox,2298,483,181,65,105,74,37,29,2306,2125,2060,1595,664,590,206,277,1135,1163,356,909,550,0,,517
15:18:48,6709.374,Fox,2300,484,185,65,104,74,37,29,2310,2125,2060,1595,664,590,207,277,1137,1163,356,910,550,0,,518
15:18:49,6709.974,Fox,2300,482,185,65,100,77,37,28,2310,2125,2060,1599,664,590,207,275,1137,1163,357,910,551,0,,516
15:18:49,6710.573,Fox,2300,481,183,65,102,77,37,27,2310,2127,2062,1599,664,590,206,275,1137,1163,357,910,552,0,,515
15:18:50,6711.474,Fox,2300,481,183,65,102,75,39,27,2310,2127,2062,1599,666,590,206,275,1137,1163,357,910,552,0,,515
15:18:51,6712.673,Fox,2300,478,181,63,106,70,41,27,2310,2129,2066,1599,668,590,206,272,1137,1163,357,913,552,0,,512
15:18:51,6713.273,Fox,2300,475,179,65,104,69,41,27,2310,2131,2066,1601,668,590,206,269,1137,1163,357,916,552,0,,509
15:18:52,6713.874,Fox,2300,475,179,63,106,69,40,28,2310,2131,2068,1601,668,591,206,269,1137,1163,357,916,552,0,,509
15:18:52,6714.474,Fox,2302,477,177,63,108,69,40,28,2310,2133,2070,1601,668,591,207,270,1138,1164,357,916,552,0,,511
15:18:53,6715.073,Fox,2306,480,179,65,105,71,40,28,2314,2135,2070,1603,668,591,207,273,1139,1167,357,917,552,0,,514
15:18:53,6715.673,Fox,2310,482,179,67,103,71,40,28,2316,2137,2070,1603,668,591,207,275,1141,1169,357,919,552,0,,516
15:18:53,6716.273,Fox,2312,482,179,69,102,73,40,27,2320,2141,2072,1605,668,591,207,275,1142,1170,357,920,553,0,,516
15:18:54,6716.874,Fox,2314,481,181,67,105,71,40,27,2324,2143,2076,1605,668,591,206,275,1143,1171,357,923,553,0,,515
15:18:54,6717.15,Fox,2314,478,181,65,107,70,40,25,2324,2143,2078,1605,668,591,206,272,1143,1171,357,924,555,0,,512
15:18:55,6718.325,Fox,2316,479,181,67,106,70,40,25,2326,2145,2078,1605,668,591,206,273,1144,1172,357,925,555,0,,513
15:18:55,6718.912,Fox,2316,476,179,69,105,68,40,25,2326,2147,2078,1606,668,591,205,271,1144,1172,357,928,555,0,,510
15:18:55,6719.461,Fox,2318,477,177,71,105,67,40,25,2326,2149,2078,1606,668,591,205,272,1145,1173,357,929,555,0,,511
15:18:55,6720.034,Fox,2318,477,179,69,103,71,40,25,2328,2149,2080,1610,668,591,205,272,1145,1173,357,929,555,0,,511
15:18:55,6720.604,Fox,2320,479,173,75,101,73,40,25,2328,2155,2080,1612,668,591,206,273,1146,1174,357,929,555,0,,513
15:18:56,6721.191,Fox,2320,479,175,69,107,73,40,25,2330,2155,2086,1612,668,591,206,273,1146,1174,357,929,555,0,,513
15:18:56,6721.791,Fox,2320,479,173,69,108,74,40,25,2330,2157,2088,1613,668,591,206,273,1146,1174,357,929,555,0,,513
15:18:57,6722.391,Fox,2320,479,173,64,111,76,40,25,2330,2157,2093,1615,668,591,206,273,1146,1174,357,929,555,0,,513
15:18:57,6722.991,Fox,2320,479,173,62,113,76,39,26,2330,2157,2095,1615,668,592,206,273,1146,1174,357,929,555,0,,513
15:18:58,6723.591,Fox,2322,477,173,60,113,75,38,26,2330,2157,2097,1617,668,593,203,274,1146,1176,359,930,556,0,,511
15:18:58,6724.191,Fox,2324,477,171,60,116,75,38,25,2332,2161,2101,1618,668,593,202,275,1147,1177,359,931,557,0,,511
15:18:58,6724.791,Fox,2326,478,173,60,115,75,38,25,2334,2161,2101,1618,668,593,202,276,1148,1178,359,932,557,0,,512
15:18:59,6725.391,Fox,2328,477,175,62,114,73,38,25,2338,2163,2101,1618,668,593,202,275,1149,1179,360,934,557,0,,511
15:19:00,6726.591,Fox,2330,479,175,64,113,74,38,25,2340,2165,2101,1619,668,593,202,277,1149,1181,360,934,557,0,,513
15:19:00,6727.191,Fox,2332,478,175,64,112,72,38,25,2340,2165,2101,1619,668,593,202,276,1150,1182,360,937,557,0,,512
15:19:01,6727.791,Fox,2332,476,177,64,110,74,37,24,2342,2165,2101,1621,668,593,201,275,1150,1182,360,938,558,0,,510
15:19:01,6728.691,Fox,2332,475,173,68,108,76,37,23,2342,2169,2101,1623,668,593,200,275,1150,1182,360,939,558,0,,509
15:19:02,6729.591,Fox,2332,474,171,70,103,80,36,24,2342,2171,2101,1628,668,594,200,274,1150,1182,360,940,558,0,,508
15:19:02,6730.191,Fox,2334,475,173,68,103,81,36,24,2344,2171,2103,1629,668,594,200,275,1151,1183,360,941,558,0,,509
15:19:02,6730.491,Fox,2334,475,173,68,103,81,34,26,2344,2171,2103,1629,668,596,200,275,1151,1183,360,941,558,0,,509
15:19:03,6731.391,Fox,2336,476,175,66,104,82,34,25,2346,2171,2105,1630,668,596,201,275,1152,1184,360,941,559,0,,510
15:19:03,6731.991,Fox,2336,476,173,68,104,82,32,27,2346,2173,2105,1630,668,598,201,275,1152,1184,360,941,559,0,,510
15:19:04,6732.835,Fox,2338,477,172,65,108,82,32,26,2346,2174,2109,1630,668,598,202,275,1153,1185,360,941,560,0,,511
15:19:04,6733.366,Fox,2340,477,174,63,110,81,32,25,2348,2174,2111,1630,668,598,202,275,1154,1186,361,941,561,0,,511
15:19:05,6733.966,Fox,2342,476,178,63,110,78,32,25,2352,2174,2111,1630,668,598,204,272,1156,1186,361,944,561,0,,510
15:19:05,6734.566,Fox,2344,477,174,65,111,78,28,29,2352,2178,2113,1630,668,602,203,274,1156,1188,361,945,561,0,,511
15:19:06,6735.166,Fox,2348,479,176,65,109,78,28,29,2354,2178,2113,1630,668,602,202,277,1157,1191,361,947,561,0,,513
15:19:06,6735.766,Fox,2350,478,180,63,110,75,29,29,2358,2178,2115,1630,669,602,203,275,1159,1191,361,950,561,0,,512
15:19:07,6736.366,Fox,2350,478,180,65,110,75,29,29,2360,2180,2115,1630,669,602,203,275,1159,1191,361,950,561,0,,512
15:19:07,6736.966,Fox,2350,478,176,69,110,75,29,29,2360,2184,2115,1630,669,602,203,275,1159,1191,361,950,561,0,,512
15:19:07,6737.566,Fox,2350,476,174,71,110,75,29,27,2360,2186,2115,1630,669,602,203,273,1159,1191,361,950,563,0,,510
15:19:08,6738.166,Fox,2350,476,170,71,112,77,29,27,2360,2190,2119,1632,669,602,203,273,1159,1191,361,950,563,0,,510
15:19:08,6738.766,Fox,2350,475,168,69,115,78,29,26,2360,2192,2123,1633,669,602,203,272,1159,1191,361,950,564,0,,509
15:19:09,6739.366,Fox,2350,474,168,67,116,79,29,25,2360,2192,2125,1634,669,602,203,271,1159,1191,361,950,565,0,,508
15:19:09,6740.266,Fox,2350,473,164,71,112,83,29,24,2360,2196,2125,1638,669,602,202,271,1159,1191,361,950,566,0,,507
15:19:10,6740.866,Fox,2354,476,164,73,109,85,29,24,2362,2198,2125,1640,669,602,203,273,1161,1193,361,951,566,0,,510
15:19:10,6741.466,Fox,2356,477,168,73,108,85,29,24,2366,2198,2125,1640,669,602,203,274,1162,1194,361,952,566,0,,511
15:19:11,6742.066,Fox,2356,476,164,77,107,86,29,23,2366,2202,2125,1641,669,602,203,273,1162,1194,361,952,567,0,,510
15:19:11,6742.966,Fox,2360,476,166,77,105,86,29,21,2368,2202,2125,1641,669,602,203,273,1164,1196,362,953,569,0,,510
15:19:12,6743.566,Fox,2362,476,170,77,104,85,29,21,2372,2202,2125,1641,669,602,203,273,1165,1197,362,955,569,0,,510
15:19:12,6744.166,Fox,2366,478,174,77,101,86,29,21,2376,2202,2125,1643,669,602,203,275,1167,1199,362,957,569,0,,512
15:19:12,6744.766,Fox,2368,478,176,77,97,88,30,20,2378,2202,2125,1647,670,602,203,275,1168,1200,362,958,570,0,,512
15:19:13,6745.066,Fox,2368,478,176,77,96,89,30,20,2378,2202,2125,1648,670,602,203,275,1168,1200,362,958,570,0,,512
15:19:13,6745.966,Fox,2368,478,172,81,96,89,30,20,2378,2206,2125,1648,670,602,203,275,1168,1200,362,958,570,0,,512
15:19:14,6746.266,Fox,2368,478,170,83,94,91,30,20,2378,2208,2125,1650,670,602,203,275,1168,1200,362,958,570,0,,512
15:19:14,6747.166,Fox,2370,478,172,83,94,88,32,19,2380,2208,2125,1650,672,602,203,275,1169,1201,363,958,571,0,,512
15:19:15,6747.766,Fox,2374,482,174,83,92,90,32,19,2382,2208,2125,1652,672,602,205,277,1171,1203,363,958,571,0,,516
15:19:15,6748.366,Fox,2374,478,176,83,92,86,32,19,2384,2208,2125,1652,672,602,205,273,1171,1203,363,962,571,0,,512
15:19:15,6748.966,Fox,2376,479,178,81,92,87,32,19,2386,2208,2127,1653,672,602,205,274,1172,1204,363,963,571,0,,513
15:19:15,6749.54,Fox,2378,480,176,85,90,88,32,19,2388,2212,2127,1654,672,602,206,274,1174,1204,363,964,571,0,,514
15:19:16,6750.14,Fox,2384,485,178,85,88,89,32,19,2390,2212,2127,1655,672,602,210,275,1179,1205,363,965,571,0,,519
15:19:16,6750.74,Fox,2384,485,182,83,90,89,32,19,2394,2212,2129,1655,672,602,210,275,1179,1205,363,965,571,0,,519
15:19:16,6751.34,Fox,2384,485,180,83,92,89,31,20,2394,2214,2131,1655,672,603,210,275,1179,1205,363,965,571,0,,519
15:19:17,6751.94,Fox,2384,484,180,83,92,88,31,20,2394,2214,2131,1655,672,603,210,274,1179,1205,363,966,571,0,,518
15:19:18,6752.84,Fox,2388,486,182,81,92,88,31,20,2396,2214,2133,1655,672,603,210,276,1181,1207,363,968,571,0,,520
15:19:18,6753.14,Fox,2388,486,184,79,92,90,31,20,2398,2214,2135,1657,672,603,210,276,1181,1207,363,968,571,0,,520
15:19:18,6754.034,Fox,2390,487,180,81,93,90,31,20,2398,2218,2137,1658,672,603,212,275,1183,1207,364,968,571,0,,521
15:19:19,6754.634,Fox,2390,487,180,79,95,92,31,20,2400,2220,2141,1660,672,603,212,275,1183,1207,364,968,571,0,,521
15:19:19,6754.934,Fox,2390,487,180,77,97,90,33,20,2400,2220,2143,1660,674,603,212,275,1183,1207,364,968,571,0,,521
15:19:20,6755.834,Fox,2390,486,178,79,97,89,34,19,2400,2222,2143,1660,675,603,212,274,1183,1207,364,968,572,0,,520
15:19:20,6756.434,Fox,2392,486,176,81,94,90,34,19,2400,2224,2143,1662,675,603,213,273,1185,1207,365,969,572,0,,520
15:19:20,6757.034,Fox,2394,486,180,79,95,90,34,18,2404,2224,2145,1662,675,603,211,275,1185,1209,365,970,573,0,,520
15:19:21,6757.634,Fox,2396,486,182,75,96,89,35,19,2406,2224,2149,1664,677,604,212,274,1187,1209,365,972,573,0,,520
15:19:21,6758.234,Fox,2398,487,180,79,94,90,35,19,2408,2228,2149,1665,677,604,211,276,1187,1211,365,973,573,0,,521
15:19:22,6758.834,Fox,2400,488,174,85,95,88,37,19,2410,2236,2151,1665,679,604,211,277,1188,1212,365,974,573,0,,522
15:19:22,6759.434,Fox,2400,486,174,81,99,86,38,18,2410,2236,2155,1665,680,604,211,275,1188,1212,365,975,574,0,,520
15:19:23,6760.034,Fox,2408,492,174,81,101,80,43,17,2412,2238,2157,1665,685,604,212,280,1190,1218,365,976,575,0,,526
15:19:23,6760.634,Fox,2408,491,180,81,101,79,43,17,2418,2238,2157,1665,685,604,212,279,1190,1218,365,977,575,0,,525
15:19:23,6760.934,Fox,2408,490,180,81,101,79,43,16,2418,2238,2157,1665,685,604,212,278,1190,1218,365,977,576,0,,524
15:19:24,6761.834,Fox,2408,490,176,85,101,79,43,16,2418,2242,2157,1665,685,604,212,278,1190,1218,365,977,576,0,,524
15:19:24,6762.434,Fox,2410,491,176,85,102,79,43,16,2420,2244,2159,1665,685,604,212,279,1191,1219,365,978,576,0,,525
15:19:25,6763.034,Fox,2412,492,176,85,99,83,43,16,2422,2246,2161,1669,685,604,212,280,1192,1220,365,979,576,0,,526
15:19:25,6763.634,Fox,2412,492,174,85,101,83,43,16,2422,2248,2163,1669,685,604,212,280,1192,1220,365,979,576,0,,526
15:19:25,6764.234,Fox,2414,492,174,85,101,81,43,16,2422,2248,2163,1669,685,604,211,281,1192,1222,365,981,576,0,,526
15:19:26,6764.834,Fox,2416,490,176,87,101,78,43,15,2426,2250,2163,1669,685,604,211,279,1193,1223,366,983,577,0,,524
15:19:26,6765.434,Fox,2418,491,176,85,100,80,41,17,2426,2250,2165,1672,685,606,211,280,1194,1224,367,983,577,0,,525
15:19:27,6766.034,Fox,2418,489,174,89,100,78,41,17,2428,2254,2165,1672,685,606,211,278,1194,1224,367,985,577,0,,523
15:19:27,6766.334,Fox,2418,489,174,89,98,80,41,17,2428,2254,2165,1674,685,606,211,278,1194,1224,367,985,577,0,,523
15:19:28,6767.234,Fox,2422,490,174,85,100,74,46,17,2428,2254,2169,1674,690,606,211,279,1196,1226,368,987,577,0,,524
15:19:28,6767.834,Fox,2424,491,178,87,99,74,46,17,2434,2256,2169,1674,690,606,211,280,1197,1227,369,987,577,0,,525
15:19:28,6768.434,Fox,2426,491,178,87,98,75,46,17,2436,2258,2171,1676,690,606,210,281,1198,1228,369,989,577,0,,525
15:19:28,6769.034,Fox,2426,481,174,91,98,66,46,16,2436,2262,2171,1676,690,606,208,273,1198,1228,369,998,578,0,,515
15:19:29,6769.604,Fox,2428,482,174,91,96,66,47,16,2436,2262,2171,1677,691,606,208,274,1199,1229,369,999,578,0,,516
15:19:29,6770.187,Fox,2432,484,178,91,97,65,47,16,2442,2264,2173,1677,691,606,208,276,1201,1231,369,1001,578,0,,518
15:19:29,6770.691,Fox,2432,484,178,91,96,66,47,16,2442,2264,2173,1678,691,606,208,276,1201,1231,369,1001,578,0,,518
15:19:30,6771.77,Fox,2434,479,178,90,96,60,47,16,2442,2264,2174,1678,691,606,208,271,1203,1231,370,1007,578,0,,513
15:19:30,6772.07,Fox,2434,479,180,90,96,60,47,16,2444,2264,2174,1678,691,606,208,271,1203,1231,370,1007,578,0,,513
15:19:30,6772.83,Fox,2434,478,180,88,96,62,47,15,2444,2264,2176,1680,691,606,208,270,1203,1231,370,1007,579,0,,512
15:19:30,6773.273,Fox,2434,476,176,90,97,61,47,15,2444,2268,2178,1681,691,606,208,268,1203,1231,370,1009,579,0,,510
15:19:30,6773.573,Fox,2434,475,176,90,97,60,47,15,2444,2268,2178,1681,691,606,207,268,1203,1231,370,1010,579,0,,509
15:19:31,6774.473,Fox,2436,476,178,90,95,61,47,15,2446,2268,2178,1682,691,606,207,269,1204,1232,370,1011,579,0,,510
15:19:31,6775.073,Fox,2438,477,180,88,96,61,47,15,2448,2268,2180,1683,691,606,208,269,1206,1232,370,1012,579,0,,511
15:19:32,6775.673,Fox,2438,475,178,86,100,61,46,14,2448,2270,2184,1683,691,606,207,268,1206,1232,370,1013,580,0,,509
15:19:32,6776.273,Fox,2438,475,178,84,102,61,43,17,2448,2270,2186,1683,691,609,207,268,1206,1232,370,1013,580,0,,509
15:19:33,6776.874,Fox,2438,475,174,84,104,63,43,17,2448,2274,2190,1685,691,609,207,268,1206,1232,370,1013,580,0,,509
15:19:33,6777.473,Fox,2440,476,176,82,102,66,43,17,2450,2274,2192,1688,691,609,207,269,1207,1233,370,1014,580,0,,510
15:19:33,6778.073,Fox,2442,477,176,84,101,66,42,18,2452,2276,2192,1689,691,610,207,270,1208,1234,370,1015,580,0,,511
15:19:34,6778.673,Fox,2446,479,172,84,105,63,43,18,2452,2280,2196,1689,692,610,206,273,1209,1237,371,1016,580,0,,513
15:19:34,6779.273,Fox,2448,480,176,84,106,59,47,18,2458,2282,2198,1689,696,610,207,273,1211,1237,372,1016,580,0,,514
15:19:35,6780.173,Fox,2452,484,176,86,106,59,47,18,2460,2284,2198,1689,696,610,208,276,1212,1240,372,1016,580,0,,518
15:19:35,6780.773,Fox,2454,481,180,82,108,56,47,18,2464,2284,2202,1691,696,610,208,273,1213,1241,372,1021,580,0,,515
15:19:36,6781.374,Fox,2454,479,178,84,105,57,47,18,2464,2286,2202,1694,696,610,208,271,1213,1241,372,1023,580,0,,513
15:19:36,6781.673,Fox,2454,479,178,84,104,58,47,18,2464,2286,2202,1695,696,610,208,271,1213,1241,372,1023,580,0,,513
15:19:36,6782.573,Fox,2458,480,176,86,98,61,47,18,2464,2288,2202,1699,696,610,207,273,1215,1243,372,1026,580,0,,514
15:19:37,6783.173,Fox,2458,480,178,88,95,64,47,18,2468,2290,2202,1702,696,610,207,273,1215,1243,372,1026,580,0,,514
15:19:37,6784.073,Fox,2458,478,176,90,93,64,47,18,2468,2292,2202,1704,696,610,207,271,1215,1243,372,1028,580,0,,512
15:19:38,6784.673,Fox,2458,478,170,92,95,66,47,18,2468,2298,2206,1706,696,610,207,271,1215,1243,372,1028,580,0,,512
15:19:38,6785.273,Fox,2458,477,170,90,97,66,47,17,2468,2298,2208,1706,696,610,206,271,1215,1243,372,1028,581,0,,511
15:19:38,6785.874,Fox,2458,475,168,92,97,65,47,16,2468,2300,2208,1706,696,610,206,269,1215,1243,372,1029,582,0,,509
15:19:39,6786.173,Fox,2458,474,168,92,97,64,47,16,2468,2300,2208,1706,696,610,206,268,1215,1243,372,1030,582,0,,508
15:19:39,6787.333,Fox,2462,478,170,92,97,64,47,16,2470,2300,2208,1706,696,610,210,268,1219,1243,372,1030,582,0,,512
15:19:40,6787.933,Fox,2464,479,172,92,96,64,47,16,2472,2300,2208,1706,696,610,210,269,1220,1244,373,1030,582,0,,513
15:19:40,6788.533,Fox,2466,480,174,90,100,63,47,16,2476,2302,2212,1706,696,610,210,270,1221,1245,373,1031,582,0,,514
15:19:40,6788.833,Fox,2466,480,174,90,100,63,46,17,2476,2302,2212,1706,696,611,210,270,1221,1245,373,1031,582,0,,514
15:19:41,6789.733,Fox,2468,481,174,92,99,63,46,17,2478,2304,2212,1706,696,611,210,271,1222,1246,373,1032,582,0,,515
15:19:41,6790.333,Fox,2470,483,176,90,101,63,46,17,2480,2304,2214,1706,696,611,211,272,1223,1247,373,1032,582,0,,517
15:19:42,6790.933,Fox,2472,484,178,90,99,64,46,17,2482,2304,2214,1707,696,611,211,273,1224,1248,373,1033,582,0,,518
15:19:42,6791.833,Fox,2474,485,176,94,98,64,46,17,2484,2308,2214,1708,696,611,211,274,1225,1249,373,1034,582,0,,519
15:19:43,6792.433,Fox,2474,485,174,92,102,64,46,17,2484,2310,2218,1708,696,611,211,274,1225,1249,373,1034,582,0,,519
15:19:43,6793.333,Fox,2474,482,174,90,102,63,46,17,2484,2310,2220,1710,696,611,211,271,1225,1249,373,1037,582,0,,516
15:19:43,6793.633,Fox,2474,482,174,90,100,65,46,17,2484,2310,2220,1712,696,611,211,271,1225,1249,373,1037,582,0,,516
15:19:44,6794.533,Fox,2476,483,174,88,99,67,45,18,2484,2310,2222,1714,696,612,211,272,1226,1250,374,1037,582,0,,517
15:19:44,6795.133,Fox,2476,482,176,86,101,67,44,18,2486,2310,2224,1714,696,612,211,271,1226,1250,374,1038,582,0,,516
15:19:45,6795.733,Fox,2478,482,176,86,98,68,44,18,2486,2310,2224,1716,696,612,212,270,1228,1250,375,1039,582,0,,516
15:19:45,6796.033,Fox,2478,482,178,86,98,68,44,18,2488,2310,2224,1716,696,612,212,270,1228,1250,375,1039,582,0,,516
15:19:45,6796.933,Fox,2480,480,178,82,101,66,44,17,2488,2310,2228,1716,696,612,212,268,1230,1250,375,1042,583,0,,514
15:19:46,6797.533,Fox,2482,480,178,76,108,63,46,17,2490,2312,2236,1716,698,612,212,268,1231,1251,375,1044,583,0,,514
15:19:46,6798.133,Fox,2482,480,176,80,106,65,46,17,2492,2316,2236,1718,698,612,212,268,1231,1251,375,1044,583,0,,514
15:19:47,6799.033,Fox,2482,479,172,82,106,67,43,19,2492,2320,2238,1720,698,614,212,267,1231,1251,375,1045,583,0,,513
15:19:47,6799.633,Fox,2484,480,170,86,103,69,43,19,2494,2324,2238,1722,698,614,211,269,1231,1253,375,1046,583,0,,514
15:19:47,6800.195,Fox,2486,482,170,84,105,67,45,19,2494,2324,2240,1722,700,614,211,271,1231,1255,375,1046,583,0,,516
15:19:48,6800.795,Fox,2488,483,172,82,107,67,45,18,2496,2324,2242,1722,700,614,211,272,1231,1257,375,1046,584,0,,517
15:19:48,6801.095,Fox,2488,483,172,82,109,67,45,18,2498,2326,2244,1722,700,614,211,272,1231,1257,375,1046,584,0,,517
15:19:48,6801.995,Fox,2490,484,174,78,113,66,45,18,2500,2326,2248,1722,700,614,210,274,1231,1259,376,1046,584,0,,518
15:19:49,6802.595,Fox,2490,483,172,80,113,66,45,17,2500,2328,2248,1722,700,614,210,273,1231,1259,376,1047,584,0,,517
15:19:49,6803.495,Fox,2490,482,170,80,115,65,46,16,2500,2330,2250,1722,701,614,209,273,1231,1259,376,1047,585,0,,516
15:19:50,6804.095,Fox,2490,479,170,80,115,62,46,16,2500,2330,2250,1722,701,614,209,270,1231,1259,376,1050,585,0,,513
15:19:50,6804.395,Fox,2490,479,170,76,119,62,46,16,2500,2330,2254,1722,701,614,209,270,1231,1259,376,1050,585,0,,513
15:19:51,6806.495,Fox,2494,479,170,76,120,59,46,16,2502,2332,2256,1722,701,614,209,270,1232,1262,378,1052,585,0,,513
15:19:51,6807.095,Fox,2494,476,170,76,122,56,46,16,2504,2334,2258,1722,701,614,209,267,1232,1262,380,1053,585,0,,510
15:19:52,6807.695,Fox,2494,475,168,74,126,55,46,16,2504,2336,2262,1722,701,614,209,266,1232,1262,380,1054,585,0,,509
15:19:52,6808.295,Fox,2498,477,170,76,124,54,47,16,2508,2338,2262,1722,702,614,209,268,1234,1264,380,1056,585,0,,511
15:19:52,6808.895,Fox,2502,478,172,74,124,53,47,16,2510,2338,2264,1722,702,614,209,269,1236,1266,381,1058,585,0,,512
15:19:52,6809.495,Fox,2502,478,172,76,122,55,47,16,2512,2340,2264,1724,702,614,209,269,1236,1266,381,1058,585,0,,512
15:19:53,6810.095,Fox,2502,478,170,78,122,55,47,16,2512,2342,2264,1724,702,614,209,269,1236,1266,381,1058,585,0,,512
15:19:53,6810.995,Fox,2504,479,172,78,121,55,47,16,2514,2342,2264,1724,702,614,210,269,1238,1266,382,1058,585,0,,513
15:19:54,6811.595,Fox,2504,479,172,74,124,56,47,16,2514,2342,2268,1725,702,614,210,269,1238,1266,382,1058,585,0,,513
15:19:54,6811.854,Fox,2504,478,172,74,123,57,47,15,2514,2342,2268,1726,702,614,209,269,1238,1266,382,1058,586,0,,512
15:19:54,6812.646,Fox,2504,478,170,76,123,57,47,15,2514,2344,2268,1726,702,614,209,269,1238,1266,382,1058,586,0,,512
15:19:54,6813.517,Fox,2504,478,170,76,122,55,50,15,2514,2344,2268,1727,705,614,209,269,1238,1266,382,1058,586,0,,512
15:19:55,6814.117,Fox,2504,475,168,76,122,54,51,14,2514,2346,2270,1729,706,614,209,266,1238,1266,382,1060,587,0,,509
15:19:55,6814.716,Fox,2504,473,168,76,122,52,51,14,2514,2346,2270,1729,706,614,208,265,1238,1266,382,1062,587,0,,507
15:19:56,6815.316,Fox,2504,472,168,72,123,53,52,14,2514,2346,2274,1732,707,614,208,264,1238,1266,383,1062,587,0,,506
15:19:56,6815.917,Fox,2506,473,166,74,121,53,54,13,2514,2348,2274,1734,709,614,208,265,1238,1268,383,1062,588,0,,507
15:19:56,6816.517,Fox,2512,478,164,76,123,53,54,12,2516,2352,2276,1734,709,614,211,267,1241,1271,383,1062,589,0,,512
15:19:57,6817.117,Fox,2512,477,170,74,125,52,53,13,2522,2352,2278,1734,709,615,211,266,1241,1271,383,1063,589,0,,511
15:19:57,6817.716,Fox,2512,477,168,72,127,54,53,13,2522,2354,2282,1736,709,615,211,266,1241,1271,383,1063,589,0,,511
15:19:58,6818.316,Fox,2512,471,164,76,125,50,52,14,2522,2358,2282,1738,709,616,211,260,1241,1271,385,1067,589,0,,505
15:19:58,6818.917,Fox,2512,470,162,76,127,49,52,14,2522,2360,2284,1738,709,616,211,259,1241,1271,385,1068,589,0,,504
15:19:58,6819.517,Fox,2514,470,164,76,125,49,52,14,2524,2360,2284,1739,709,616,211,259,1242,1272,385,1070,589,0,,504
15:19:58,6820.105,Fox,2518,472,166,74,123,52,52,13,2526,2360,2286,1743,709,616,212,260,1245,1273,386,1070,590,0,,506
15:19:59,6820.705,Fox,2518,472,168,74,122,53,52,13,2528,2360,2286,1744,709,616,212,260,1245,1273,386,1070,590,0,,506
15:19:59,6821.245,Fox,2520,474,168,72,124,53,52,13,2528,2360,2288,1744,709,616,213,261,1246,1274,386,1070,590,0,,508
15:19:59,6821.73,Fox,2524,476,174,70,124,53,52,13,2534,2360,2290,1744,709,616,215,261,1250,1274,386,1072,590,0,,510
15:20:00,6822.529,Fox,2526,477,176,68,126,53,52,12,2536,2360,2292,1744,709,616,217,260,1252,1274,386,1072,591,0,,511
15:20:00,6823.129,Fox,2526,477,176,66,124,57,52,12,2536,2360,2294,1748,709,616,217,260,1252,1274,386,1072,591,0,,511
15:20:00,6823.662,Fox,2526,477,172,66,128,57,52,12,2536,2364,2298,1748,709,616,217,260,1252,1274,386,1072,591,0,,511
15:20:01,6824.261,Fox,2526,477,170,66,128,59,52,12,2536,2366,2300,1750,709,616,217,260,1252,1274,386,1072,591,0,,511
15:20:02,6825.761,Fox,2530,479,172,68,125,60,52,12,2540,2368,2300,1752,709,616,217,262,1253,1277,386,1074,591,0,,513
15:20:02,6826.361,Fox,2530,479,168,72,125,60,52,12,2540,2372,2300,1752,709,616,217,262,1253,1277,386,1074,591,0,,513
15:20:02,6826.961,Fox,2530,478,164,74,127,59,52,12,2540,2376,2302,1752,709,616,217,261,1253,1277,386,1075,591,0,,512
15:20:03,6827.861,Fox,2534,479,166,76,124,59,51,13,2544,2378,2302,1754,709,617,217,262,1255,1279,386,1078,591,0,,513
15:20:03,6828.461,Fox,2536,480,168,74,124,60,51,13,2546,2378,2304,1756,709,617,219,261,1257,1279,386,1079,591,0,,514
15:20:03,6828.761,Fox,2536,479,168,74,124,60,51,12,2546,2378,2304,1756,709,617,219,260,1257,1279,386,1079,592,0,,513
15:20:04,6830.261,Fox,2542,480,168,72,126,57,51,12,2548,2380,2308,1756,709,617,218,262,1259,1283,386,1084,592,0,,514
15:20:05,6830.861,Fox,2544,482,170,74,126,59,51,12,2554,2384,2310,1758,709,617,220,262,1261,1283,386,1084,592,0,,516
15:20:05,6831.461,Fox,2548,484,172,74,124,59,51,12,2556,2384,2310,1758,709,617,219,265,1262,1286,386,1086,592,0,,518
15:20:05,6832.062,Fox,2548,484,170,78,123,60,51,12,2558,2388,2310,1759,709,617,219,265,1262,1286,386,1086,592,0,,518
15:20:06,6832.662,Fox,2550,484,170,80,123,58,51,12,2560,2390,2310,1759,709,617,218,266,1263,1287,386,1088,592,0,,518
15:20:06,6833.261,Fox,2550,484,166,84,122,59,51,12,2560,2394,2310,1760,709,617,218,266,1263,1287,386,1088,592,0,,518
15:20:06,6833.861,Fox,2552,484,168,84,119,60,52,11,2562,2394,2310,1762,710,617,217,267,1264,1288,386,1090,592,0,,518
15:20:07,6834.761,Fox,2552,482,168,84,119,58,50,13,2562,2394,2310,1762,710,619,217,265,1264,1288,386,1092,592,0,,516
15:20:07,6835.662,Fox,2552,481,164,88,114,62,47,16,2562,2398,2310,1766,710,622,216,265,1264,1288,386,1093,592,0,,515
15:20:08,6836.261,Fox,2558,484,164,84,113,64,46,17,2562,2398,2314,1769,710,623,214,270,1265,1293,386,1096,592,0,,518
15:20:08,6836.861,Fox,2560,484,169,84,114,64,46,16,2569,2400,2316,1769,710,623,213,271,1266,1294,386,1097,593,0,,518
15:20:09,6837.461,Fox,2560,484,171,80,114,68,45,17,2571,2400,2320,1773,710,624,213,271,1266,1294,386,1097,593,0,,518
15:20:09,6838.062,Fox,2560,484,171,76,118,68,45,17,2571,2400,2324,1773,710,624,213,271,1266,1294,386,1097,593,0,,518
15:20:09,6838.361,Fox,2560,484,171,76,118,68,44,18,2571,2400,2324,1773,710,625,213,271,1266,1294,386,1097,593,0,,518
15:20:10,6839.261,Fox,2560,484,169,78,115,71,44,18,2571,2402,2324,1776,710,625,213,271,1266,1294,386,1097,593,0,,518
15:20:10,6839.861,Fox,2562,484,169,78,114,72,45,17,2573,2404,2326,1778,711,625,213,271,1267,1295,386,1098,594,0,,518
15:20:10,6840.162,Fox,2562,483,167,80,114,72,45,16,2573,2406,2326,1778,711,625,212,271,1267,1295,386,1098,595,0,,517
15:20:11,6841.062,Fox,2564,485,165,80,113,75,45,16,2573,2408,2328,1781,711,625,212,273,1267,1297,386,1098,595,0,,519
15:20:11,6841.662,Fox,2566,487,167,82,113,75,45,16,2577,2410,2328,1781,711,625,212,275,1267,1299,386,1098,595,0,,521
15:20:11,6841.961,Fox,2566,487,167,80,115,74,46,16,2577,2410,2330,1781,712,625,212,275,1267,1299,386,1098,595,0,,521
15:20:12,6842.861,Fox,2566,487,159,88,115,74,46,16,2577,2418,2330,1781,712,625,212,275,1267,1299,386,1098,595,0,,521
15:20:12,6843.461,Fox,2568,489,161,88,115,74,46,16,2579,2418,2330,1781,712,625,212,277,1267,1301,386,1098,595,0,,523
15:20:13,6844.961,Fox,2570,490,161,88,114,76,46,16,2581,2420,2332,1783,712,625,212,278,1268,1302,386,1099,595,0,,524
15:20:14,6845.562,Fox,2572,492,159,88,114,78,46,16,2581,2422,2334,1785,712,625,212,280,1268,1304,386,1099,595,0,,526
15:20:14,6846.162,Fox,2572,492,161,86,116,78,46,16,2583,2422,2336,1785,712,625,212,280,1268,1304,386,1099,595,0,,526
15:20:14,6846.461,Fox,2572,492,161,84,118,78,46,16,2583,2422,2338,1785,712,625,212,280,1268,1304,386,1099,595,0,,526
15:20:15,6847.361,Fox,2578,494,159,88,116,77,46,15,2585,2426,2338,1785,712,625,210,284,1269,1309,388,1100,596,0,,528
15:20:15,6847.961,Fox,2584,497,165,86,116,76,46,15,2591,2426,2340,1785,712,625,210,287,1272,1312,388,1103,596,0,,531
15:20:16,6848.562,Fox,2590,502,169,86,113,80,45,16,2597,2428,2342,1789,712,626,214,288,1277,1313,388,1104,596,0,,536
15:20:16,6849.162,Fox,2592,502,175,86,112,79,44,17,2603,2428,2342,1789,712,627,215,287,1279,1313,388,1106,596,0,,536
15:20:16,6849.761,Fox,2600,508,181,86,111,77,45,17,2609,2428,2342,1789,713,627,215,293,1281,1319,389,1107,596,0,,542
15:20:17,6850.361,Fox,2600,508,177,92,110,78,43,19,2611,2434,2342,1790,713,629,215,293,1281,1319,389,1107,596,0,,542
15:20:17,6851.261,Fox,2604,510,177,92,111,77,43,19,2613,2436,2344,1790,713,629,215,295,1283,1321,389,1109,596,0,,544
15:20:17,6851.562,Fox,2604,510,179,92,111,77,43,19,2615,2436,2344,1790,713,629,215,295,1283,1321,389,1109,596,0,,544
15:20:17,6852.34,Fox,2606,509,181,92,110,75,43,19,2617,2436,2344,1790,713,629,215,294,1284,1322,391,1110,596,0,,543
15:20:18,6852.94,Fox,2608,511,177,96,110,77,43,19,2619,2442,2346,1792,713,629,216,295,1285,1323,391,1110,596,0,,545
15:20:18,6853.84,Fox,2608,509,177,96,109,76,43,19,2619,2442,2346,1793,713,629,214,295,1285,1323,393,1110,596,0,,543
15:20:19,6854.44,Fox,2612,511,181,94,110,75,43,19,2623,2442,2348,1793,713,629,213,298,1286,1326,394,1111,596,0,,545
15:20:19,6855.04,Fox,2614,512,179,92,112,77,43,18,2623,2444,2352,1795,713,629,214,298,1288,1326,394,1112,596,0,,546
15:20:20,6855.64,Fox,2614,510,181,92,111,77,43,17,2625,2444,2352,1796,713,629,213,297,1288,1326,394,1113,597,0,,544
15:20:20,6855.94,Fox,2614,506,181,90,113,73,43,17,2625,2444,2354,1796,713,629,213,293,1288,1326,396,1115,597,0,,540
15:20:21,6856.84,Fox,2616,507,181,86,116,73,43,17,2625,2444,2358,1796,713,629,212,295,1288,1328,396,1116,597,0,,541
15:20:21,6857.44,Fox,2616,506,181,86,117,73,43,17,2627,2446,2360,1797,713,629,211,295,1288,1328,396,1117,597,0,,540
15:20:22,6858.04,Fox,2616,505,179,88,112,77,43,17,2627,2448,2360,1802,713,629,211,294,1288,1328,396,1118,597,0,,539
15:20:22,6858.94,Fox,2616,502,179,88,111,76,43,16,2627,2448,2360,1802,713,629,210,292,1288,1328,396,1120,598,0,,536
15:20:23,6859.54,Fox,2618,502,181,88,108,77,43,16,2629,2448,2360,1804,713,629,210,292,1289,1329,396,1122,598,0,,536
15:20:23,6860.14,Fox,2618,501,179,90,108,77,43,15,2629,2450,2360,1804,713,629,210,291,1289,1329,396,1122,599,0,,535
15:20:24,6861.04,Fox,2618,500,177,92,104,80,43,15,2629,2452,2360,1807,713,629,209,291,1289,1329,396,1123,599,0,,534
15:20:24,6861.94,Fox,2620,501,173,96,104,81,43,15,2631,2458,2362,1808,713,629,208,293,1289,1331,396,1124,599,0,,535
15:20:24,6862.509,Fox,2620,501,173,92,105,84,43,15,2631,2458,2366,1811,713,629,208,293,1289,1331,396,1124,599,0,,535
15:20:24,6863.093,Fox,2622,502,171,96,104,84,43,15,2633,2462,2366,1811,713,629,209,293,1291,1331,396,1125,599,0,,536
15:20:25,6863.688,Fox,2624,503,169,98,101,86,43,15,2633,2464,2366,1813,713,629,209,294,1292,1332,396,1126,599,0,,537
15:20:25,6864.253,Fox,2624,503,171,94,105,86,43,15,2635,2464,2370,1813,713,629,209,294,1292,1332,396,1126,599,0,,537
15:20:25,6864.979,Fox,2624,503,171,92,104,89,43,15,2635,2464,2372,1816,713,629,209,294,1292,1332,396,1126,599,0,,537
15:20:25,6865.471,Fox,2624,503,167,92,108,89,43,15,2635,2468,2376,1816,713,629,209,294,1292,1332,396,1126,599,0,,537
15:20:26,6865.957,Fox,2626,503,167,90,109,89,43,14,2635,2468,2378,1816,713,629,209,294,1293,1333,397,1126,600,0,,537
15:20:26,6866.476,Fox,2626,502,169,90,109,87,44,14,2637,2468,2378,1816,715,629,208,294,1293,1333,397,1127,600,0,,536
15:20:26,6866.752,Fox,2626,502,169,90,108,88,44,14,2637,2468,2378,1817,715,629,208,294,1293,1333,397,1127,600,0,,536
15:20:27,6867.653,Fox,2628,502,169,90,106,89,44,13,2637,2468,2378,1818,715,629,206,296,1293,1335,397,1128,601,0,,536
15:20:27,6868.252,Fox,2628,502,171,88,106,90,45,13,2639,2468,2380,1820,716,629,206,296,1293,1335,397,1128,601,0,,536
15:20:28,6869.153,Fox,2628,502,171,84,108,92,45,13,2639,2468,2384,1822,716,629,206,296,1293,1335,397,1128,601,0,,536
15:20:28,6869.752,Fox,2630,503,171,84,108,92,45,12,2639,2468,2384,1822,716,629,207,296,1294,1336,397,1128,602,0,,537
15:20:29,6870.353,Fox,2630,503,169,86,110,92,45,12,2641,2472,2386,1822,716,629,207,296,1294,1336,397,1128,602,0,,537
15:20:29,6870.953,Fox,2632,504,167,86,112,90,46,12,2641,2474,2388,1822,717,629,206,298,1294,1338,397,1129,602,0,,538
15:20:30,6871.553,Fox,2632,503,167,82,118,89,46,12,2643,2476,2394,1822,717,629,206,297,1294,1338,397,1130,602,0,,537
15:20:30,6872.153,Fox,2632,502,167,82,115,91,46,12,2643,2476,2394,1825,717,629,206,296,1294,1338,397,1131,602,0,,536
15:20:30,6872.453,Fox,2632,502,165,84,115,91,46,12,2643,2478,2394,1825,717,629,206,296,1294,1338,397,1131,602,0,,536
15:20:31,6873.353,Fox,2632,501,163,86,115,90,45,13,2643,2480,2394,1825,717,630,205,296,1294,1338,397,1132,602,0,,535
15:20:32,6873.953,Fox,2632,499,161,86,117,88,45,13,2643,2482,2396,1825,717,630,205,294,1294,1338,397,1134,602,0,,533
15:20:32,6874.553,Fox,2632,496,159,86,117,87,45,13,2643,2484,2398,1827,717,630,205,291,1294,1338,397,1137,602,0,,530
15:20:33,6875.153,Fox,2634,496,159,86,116,85,46,13,2643,2484,2398,1827,718,630,206,290,1296,1338,397,1139,602,0,,530
15:20:33,6875.752,Fox,2636,497,161,84,116,87,46,12,2645,2484,2400,1829,718,630,206,291,1297,1339,397,1139,603,0,,531
15:20:33,6876.053,Fox,2636,497,163,84,116,86,47,12,2647,2484,2400,1829,719,630,206,291,1297,1339,397,1139,603,0,,531
15:20:34,6876.953,Fox,2636,496,163,84,114,85,49,12,2647,2484,2400,1831,721,630,206,290,1297,1339,397,1140,603,0,,530
15:20:35,6877.553,Fox,2636,496,161,86,113,84,51,12,2647,2486,2400,1832,723,630,206,290,1297,1339,397,1140,603,0,,530
15:20:36,6878.153,Fox,2644,500,169,82,112,85,51,12,2655,2486,2404,1835,723,630,210,290,1303,1341,397,1144,603,0,,534
15:20:36,6878.752,Fox,2644,500,167,82,114,85,51,12,2655,2488,2406,1835,723,630,210,290,1303,1341,397,1144,603,0,,534
15:20:37,6879.353,Fox,2644,500,167,80,115,86,51,12,2655,2488,2408,1836,723,630,210,290,1303,1341,397,1144,603,0,,534
15:20:38,6880.252,Fox,2646,502,167,80,116,87,51,12,2657,2490,2410,1837,723,630,210,292,1303,1343,397,1144,603,0,,536
15:20:38,6880.853,Fox,2648,504,165,82,116,87,51,12,2657,2492,2410,1837,723,630,211,293,1304,1344,397,1144,603,0,,538
15:20:39,6881.453,Fox,2648,501,167,74,122,86,51,12,2659,2492,2418,1839,723,630,211,290,1304,1344,397,1147,603,0,,535
15:20:39,6882.353,Fox,2648,501,165,76,120,88,50,13,2659,2494,2418,1841,723,631,211,290,1304,1344,397,1147,603,0,,535
15:20:40,6883.252,Fox,2648,501,163,78,119,89,50,13,2659,2496,2418,1842,723,631,211,290,1304,1344,397,1147,603,0,,535
15:20:40,6883.853,Fox,2652,503,163,78,114,94,50,13,2661,2498,2420,1847,723,631,211,292,1306,1346,397,1149,603,0,,537
15:20:41,6884.153,Fox,2652,503,165,76,116,94,50,13,2663,2498,2422,1847,723,631,211,292,1306,1346,397,1149,603,0,,537
15:20:41,6884.752,Fox,2652,503,163,78,114,96,48,15,2663,2500,2422,1849,723,633,211,292,1306,1346,397,1149,603,0,,537
15:20:42,6885.953,Fox,2652,502,163,74,118,96,48,14,2663,2500,2426,1849,723,633,210,292,1306,1346,397,1149,604,0,,536
15:20:43,6887.153,Fox,2652,500,163,72,120,94,49,13,2663,2500,2428,1849,724,633,209,291,1306,1346,397,1150,605,0,,534
15:20:43,6887.688,Fox,2658,505,167,72,117,96,49,13,2667,2500,2428,1851,724,633,211,294,1309,1349,397,1151,605,0,,539
15:20:43,6888.225,Fox,2658,502,169,72,117,92,51,12,2669,2500,2428,1851,726,633,210,292,1309,1349,397,1153,606,0,,536
15:20:44,6888.825,Fox,2658,502,169,68,120,93,51,12,2669,2500,2432,1852,726,633,210,292,1309,1349,397,1153,606,0,,536
15:20:44,6889.425,Fox,2662,504,167,70,121,93,50,12,2671,2504,2434,1852,726,633,210,294,1310,1352,397,1155,606,0,,538
15:20:45,6889.725,Fox,2662,504,169,68,123,93,50,12,2673,2504,2436,1852,726,633,210,294,1310,1352,397,1155,606,0,,538
15:20:45,6890.625,Fox,2668,506,171,68,116,97,50,11,2675,2504,2436,1856,726,633,210,296,1313,1355,397,1158,607,0,,540
15:20:46,6891.225,Fox,2670,508,171,66,121,98,50,11,2679,2508,2442,1857,726,633,212,296,1315,1355,397,1158,607,0,,542
15:20:46,6891.825,Fox,2674,508,171,70,119,96,50,11,2683,2512,2442,1857,726,633,214,294,1319,1355,397,1162,607,0,,542
15:20:47,6892.425,Fox,2677,509,173,70,119,94,48,13,2685,2512,2442,1857,726,635,213,296,1320,1357,397,1164,607,0,,543
15:20:47,6893.025,Fox,2679,509,179,70,119,92,48,13,2691,2512,2442,1857,726,635,214,295,1322,1357,397,1166,607,0,,543
15:20:47,6893.625,Fox,2681,511,177,70,121,90,49,14,2691,2514,2444,1857,728,636,216,295,1324,1357,397,1166,607,0,,545
15:20:48,6893.925,Fox,2681,510,179,70,121,89,49,14,2693,2514,2444,1857,728,636,216,294,1324,1357,397,1167,607,0,,544
15:20:48,6895.125,Fox,2681,509,179,70,121,88,47,16,2693,2514,2444,1857,728,638,216,293,1324,1357,397,1168,607,0,,543
15:20:49,6895.725,Fox,2681,509,179,68,123,88,47,16,2693,2514,2446,1857,728,638,216,293,1324,1357,397,1168,607,0,,543
15:20:49,6896.625,Fox,2687,513,181,66,121,91,44,18,2695,2514,2448,1861,728,640,219,294,1327,1360,397,1170,607,0,,547
15:20:50,6897.225,Fox,2689,509,185,66,119,87,41,21,2699,2514,2448,1863,728,643,218,291,1329,1360,397,1176,607,0,,543
15:20:50,6897.825,Fox,2689,508,187,66,115,91,39,22,2701,2514,2448,1867,728,645,218,290,1329,1360,397,1176,608,0,,542
15:20:50,6898.425,Fox,2693,510,187,66,113,91,39,22,2701,2514,2448,1869,728,645,219,291,1331,1362,398,1177,608,0,,544
15:20:50,6898.725,Fox,2693,509,189,66,115,91,39,21,2705,2516,2450,1869,728,645,219,290,1331,1362,398,1177,609,0,,543
15:20:51,6899.625,Fox,2695,510,183,70,117,91,39,20,2705,2522,2452,1869,728,645,221,289,1333,1362,398,1177,610,0,,544
15:20:51,6900.225,Fox,2701,511,191,66,119,88,39,20,2713,2522,2456,1870,728,645,223,288,1338,1363,398,1182,610,0,,545
15:20:51,6900.525,Fox,2701,511,191,64,121,88,39,20,2713,2522,2458,1870,728,645,223,288,1338,1363,398,1182,610,0,,545
15:20:52,6901.425,Fox,2703,511,191,62,121,88,39,20,2713,2522,2460,1871,728,645,224,287,1340,1363,398,1184,610,0,,545
15:20:53,6902.025,Fox,2703,509,191,60,125,86,39,20,2715,2524,2464,1871,728,645,224,285,1340,1363,398,1186,610,0,,543
15:20:53,6902.925,Fox,2703,508,187,64,123,86,40,20,2715,2528,2464,1873,729,645,224,284,1340,1363,398,1187,610,0,,542
15:20:54,6903.825,Fox,2707,511,191,64,122,86,40,20,2719,2528,2464,1873,729,645,225,286,1342,1365,398,1188,610,0,,545
15:20:54,6904.425,Fox,2707,511,185,66,126,86,35,25,2719,2534,2468,1873,729,650,225,286,1342,1365,398,1188,610,0,,545
15:20:54,6905.025,Fox,2707,510,185,66,126,84,36,25,2719,2534,2468,1873,730,650,225,285,1342,1365,398,1189,610,0,,544
15:20:55,6905.625,Fox,2707,509,183,68,124,85,36,25,2719,2536,2468,1875,730,650,225,284,1342,1365,398,1190,610,0,,543
15:20:55,6906.225,Fox,2707,509,183,68,123,86,36,25,2719,2536,2468,1876,730,650,225,284,1342,1365,398,1190,610,0,,543
15:20:56,6907.125,Fox,2709,510,183,68,119,88,36,26,2719,2536,2468,1879,731,651,225,285,1343,1366,399,1190,610,0,,544
15:20:56,6907.725,Fox,2711,510,185,68,118,88,35,26,2721,2536,2468,1879,731,651,226,284,1345,1366,399,1192,610,0,,544
15:20:57,6908.325,Fox,2715,512,183,72,115,89,35,26,2723,2540,2468,1881,731,651,226,286,1347,1368,399,1194,610,0,,546
15:20:57,6908.925,Fox,2715,512,187,68,119,86,38,26,2727,2540,2472,1881,734,651,226,286,1347,1368,399,1194,610,0,,546
15:20:57,6909.525,Fox,2715,512,187,66,120,87,38,26,2727,2540,2474,1882,734,651,226,286,1347,1368,399,1194,610,0,,546
15:20:58,6909.825,Fox,2715,512,187,64,122,87,38,26,2727,2540,2476,1882,734,651,226,286,1347,1368,399,1194,610,0,,546
15:20:58,6910.725,Fox,2717,513,185,68,121,87,38,26,2729,2544,2476,1882,734,651,226,287,1348,1369,399,1195,610,0,,547
15:20:59,6911.325,Fox,2719,515,183,68,123,87,38,26,2729,2546,2478,1882,734,651,227,288,1349,1370,399,1195,610,0,,549
15:20:59,6911.925,Fox,2719,515,185,66,124,88,38,26,2731,2546,2480,1883,734,651,227,288,1349,1370,399,1195,610,0,,549
15:20:59,6912.525,Fox,2721,514,187,64,125,86,38,26,2733,2546,2482,1883,734,651,227,287,1350,1371,399,1198,610,0,,548
15:21:00,6913.125,Fox,2721,514,181,68,125,85,41,26,2733,2552,2484,1885,737,651,227,287,1350,1371,399,1198,610,0,,548
15:21:00,6913.725,Fox,2723,515,181,70,125,85,41,25,2735,2554,2484,1885,737,651,227,288,1350,1373,399,1198,611,0,,549
15:21:01,6914.325,Fox,2727,519,179,74,125,85,41,25,2737,2558,2484,1885,737,651,228,291,1351,1376,399,1198,611,0,,553
15:21:01,6914.925,Fox,2729,519,183,74,123,86,41,24,2741,2558,2484,1886,737,651,227,292,1351,1378,399,1199,612,0,,553
15:21:01,6915.225,Fox,2729,519,181,76,122,87,41,24,2741,2560,2484,1887,737,651,227,292,1351,1378,399,1199,612,0,,553
15:21:01,6916.226,Fox,2729,518,181,74,124,87,40,24,2741,2560,2486,1887,737,652,226,292,1351,1378,399,1199,613,0,,552
15:21:01,6916.715,Fox,2729,518,179,76,122,89,38,26,2741,2562,2486,1889,737,654,226,292,1351,1378,399,1199,613,0,,552
15:21:02,6917.152,Fox,2731,519,179,74,119,93,38,26,2741,2562,2488,1893,737,654,227,292,1353,1378,399,1200,613,0,,553
15:21:02,6917.673,Fox,2733,520,181,74,117,94,38,26,2743,2562,2488,1894,737,654,227,293,1354,1379,399,1201,613,0,,554
15:21:02,6918.273,Fox,2737,521,187,72,119,91,38,26,2749,2562,2490,1894,737,654,230,291,1357,1380,399,1204,613,0,,555
15:21:02,6919.173,Fox,2737,521,180,77,121,89,40,26,2749,2569,2492,1894,739,654,230,291,1357,1380,399,1204,613,0,,555
15:21:03,6919.773,Fox,2737,519,178,79,121,88,40,25,2749,2571,2492,1894,739,654,228,291,1357,1380,399,1205,614,0,,553
15:21:03,6920.673,Fox,2739,519,178,77,122,87,40,25,2749,2571,2494,1894,739,654,227,292,1357,1382,399,1207,614,0,,553
15:21:04,6921.273,Fox,2739,518,180,77,122,84,42,25,2751,2571,2494,1894,741,654,227,291,1357,1382,399,1208,614,0,,552
15:21:04,6921.573,Fox,2739,518,180,75,124,84,42,25,2751,2571,2496,1894,741,654,227,291,1357,1382,399,1208,614,0,,552
15:21:04,6922.474,Fox,2739,517,178,75,124,84,43,25,2751,2573,2498,1896,743,654,227,290,1357,1382,399,1209,614,0,,551
15:21:05,6923.073,Fox,2739,517,178,73,124,86,43,25,2751,2573,2500,1898,743,654,227,290,1357,1382,399,1209,614,0,,551
15:21:05,6924.273,Fox,2741,518,174,77,124,84,45,24,2751,2577,2500,1898,745,654,228,290,1358,1383,399,1209,615,0,,552
15:21:06,6924.874,Fox,2741,518,176,77,122,86,45,24,2753,2577,2500,1900,745,654,228,290,1358,1383,399,1209,615,0,,552
15:21:06,6925.474,Fox,2741,518,176,77,120,87,46,24,2753,2577,2500,1902,746,654,228,290,1358,1383,399,1209,615,0,,552
15:21:06,6926.073,Fox,2741,518,174,79,116,91,46,24,2753,2579,2500,1906,746,654,228,290,1358,1383,399,1209,615,0,,552
15:21:06,6926.374,Fox,2741,517,174,79,115,91,46,24,2753,2579,2500,1907,746,654,227,290,1358,1383,399,1210,615,0,,551
15:21:07,6927.573,Fox,2741,515,172,79,117,88,47,24,2753,2581,2502,1907,747,654,227,288,1358,1383,399,1212,615,0,,549
15:21:08,6928.173,Fox,2741,514,172,77,119,88,47,23,2753,2581,2504,1907,747,654,227,287,1358,1383,399,1212,616,0,,548
15:21:08,6928.773,Fox,2753,518,182,79,112,87,47,23,2765,2583,2504,1909,747,654,227,291,1365,1388,399,1220,616,0,,552
15:21:08,6929.374,Fox,2753,518,182,75,114,88,48,23,2765,2583,2508,1911,748,654,227,291,1365,1388,399,1220,616,0,,552
15:21:09,6929.974,Fox,2753,518,180,75,114,90,48,23,2765,2585,2510,1913,748,654,227,291,1365,1388,399,1220,616,0,,552
15:21:09,6930.508,Fox,2753,518,174,79,115,91,48,23,2765,2591,2512,1914,748,654,227,291,1365,1388,399,1220,616,0,,552
15:21:09,6931.108,Fox,2753,518,168,85,114,92,48,23,2765,2597,2512,1915,748,654,227,291,1365,1388,399,1220,616,0,,552
15:21:10,6931.708,Fox,2753,517,162,91,112,94,48,22,2765,2603,2512,1917,748,654,227,290,1365,1388,399,1220,617,0,,551
15:21:10,6932.282,Fox,2757,521,160,95,110,98,48,22,2769,2609,2514,1921,748,654,228,293,1366,1391,399,1220,617,0,,555
15:21:10,6932.523,Fox,2757,521,158,97,110,98,48,22,2769,2611,2514,1921,748,654,228,293,1366,1391,399,1220,617,0,,555
15:21:10,6933.032,Fox,2757,520,158,97,110,97,48,22,2769,2611,2514,1921,748,654,228,292,1366,1391,399,1221,617,0,,554
15:21:11,6934.069,Fox,2759,522,156,101,110,97,48,22,2771,2615,2514,1921,748,654,229,293,1367,1392,399,1221,617,0,,556
15:21:11,6934.668,Fox,2759,522,156,101,108,99,48,22,2771,2615,2514,1923,748,654,229,293,1367,1392,399,1221,617,0,,556
15:21:12,6935.269,Fox,2769,526,162,103,107,96,46,22,2779,2617,2514,1923,748,656,228,298,1370,1399,401,1223,619,0,,560
15:21:12,6935.869,Fox,2771,526,162,105,107,94,46,22,2781,2619,2514,1923,748,656,228,298,1370,1401,401,1225,619,0,,560
15:21:12,6936.469,Fox,2771,525,164,105,107,94,46,21,2783,2619,2514,1923,748,656,228,297,1370,1401,401,1225,620,0,,559
15:21:13,6937.369,Fox,2771,524,160,107,109,94,46,20,2783,2623,2516,1923,748,656,228,296,1370,1401,401,1225,621,0,,558
15:21:13,6937.969,Fox,2771,524,158,103,115,94,44,22,2783,2625,2522,1923,748,658,228,296,1370,1401,401,1225,621,0,,558
15:21:14,6938.569,Fox,2773,526,160,103,112,95,46,22,2785,2625,2522,1926,750,658,228,298,1370,1403,401,1225,621,0,,560
15:21:14,6939.168,Fox,2775,527,162,103,110,95,47,22,2787,2625,2522,1928,751,658,229,298,1371,1404,401,1226,621,0,,561
15:21:14,6939.933,Fox,2777,527,162,105,108,96,46,22,2789,2627,2522,1930,751,658,227,300,1371,1406,401,1228,621,0,,561
15:21:14,6940.438,Fox,2781,530,166,105,106,97,46,22,2793,2627,2522,1932,751,658,228,302,1373,1408,401,1229,621,0,,564
15:21:15,6940.983,Fox,2783,531,166,103,108,96,46,22,2793,2627,2524,1932,751,658,229,302,1374,1409,401,1230,621,0,,565
15:21:15,6941.583,Fox,2783,531,168,99,110,98,46,22,2795,2627,2528,1934,751,658,229,302,1374,1409,401,1230,621,0,,565
15:21:16,6942.183,Fox,2785,533,168,101,104,103,47,22,2797,2629,2528,1940,752,658,230,303,1375,1410,401,1230,621,0,,567
15:21:16,6942.783,Fox,2785,532,168,95,110,102,47,22,2797,2629,2534,1940,752,658,230,302,1375,1410,401,1231,621,0,,566
15:21:16,6943.295,Fox,2791,536,170,95,108,102,47,22,2799,2629,2534,1940,752,658,232,304,1379,1412,401,1233,621,0,,570
15:21:16,6943.705,Fox,2791,536,174,93,110,101,48,22,2803,2629,2536,1940,753,658,232,304,1379,1412,401,1233,621,0,,570
15:21:16,6944.106,Fox,2791,535,174,93,109,102,48,21,2803,2629,2536,1941,753,658,232,303,1379,1412,401,1234,621,0,,569
15:21:17,6944.693,Fox,2797,537,174,95,105,102,48,21,2805,2631,2536,1943,753,658,229,308,1379,1418,403,1236,621,0,,571
15:21:17,6945.293,Fox,2799,535,180,95,104,99,48,21,2811,2631,2536,1943,753,658,228,307,1380,1419,405,1238,621,0,,569
15:21:18,6945.893,Fox,2801,535,178,97,104,97,47,22,2811,2633,2536,1943,753,659,230,305,1382,1419,405,1240,621,0,,569
15:21:18,6946.493,Fox,2801,533,178,99,100,99,47,22,2813,2635,2536,1947,753,659,230,303,1382,1419,405,1242,621,0,,567
15:21:18,6946.793,Fox,2801,532,178,95,104,98,47,22,2813,2635,2540,1947,753,659,230,302,1382,1419,405,1243,621,0,,566
15:21:18,6947.393,Fox,2801,532,178,95,103,99,47,22,2813,2635,2540,1948,753,659,230,302,1382,1419,405,1243,621,0,,566
15:21:19,6948.293,Fox,2801,531,178,95,103,98,48,21,2813,2635,2540,1948,754,659,229,302,1382,1419,405,1243,622,0,,565
15:21:19,6949.193,Fox,2801,531,176,93,104,101,48,21,2813,2637,2544,1951,754,659,229,302,1382,1419,405,1243,622,0,,565
15:21:20,6949.793,Fox,2803,530,176,91,103,101,48,21,2813,2637,2546,1953,754,659,230,300,1384,1419,406,1245,622,0,,564
15:21:20,6950.393,Fox,2803,529,178,91,102,101,48,21,2815,2637,2546,1954,754,659,230,299,1384,1419,406,1246,622,0,,563
15:21:20,6950.993,Fox,2803,528,176,93,102,100,46,23,2815,2639,2546,1954,754,661,230,298,1384,1419,406,1247,622,0,,562
15:21:21,6951.593,Fox,2803,528,176,87,107,101,45,24,2815,2639,2552,1955,754,662,230,298,1384,1419,406,1247,622,0,,562
15:21:21,6951.893,Fox,2803,528,176,85,106,104,45,24,2815,2639,2554,1958,754,662,230,298,1384,1419,406,1247,622,0,,562
15:21:21,6952.793,Fox,2803,528,174,83,110,103,45,25,2815,2641,2558,1958,755,663,230,298,1384,1419,406,1247,622,0,,562
15:21:21,6953.393,Fox,2803,527,174,83,110,103,43,26,2815,2641,2558,1958,755,665,230,297,1384,1419,406,1247,623,0,,561
15:21:22,6953.993,Fox,2811,528,172,83,108,101,42,26,2815,2643,2560,1960,755,665,229,299,1387,1424,406,1254,623,0,,562
15:21:22,6954.593,Fox,2815,532,182,83,108,101,42,26,2825,2643,2560,1960,755,665,230,302,1388,1427,406,1254,623,0,,566
15:21:22,6955.187,Fox,2819,534,188,81,110,99,42,26,2831,2643,2562,1960,755,665,231,303,1390,1429,406,1256,623,0,,568
15:21:22,6955.738,Fox,2819,534,188,81,110,97,44,26,2831,2643,2562,1960,757,665,231,303,1390,1429,406,1256,623,0,,568
15:21:23,6956.29,Fox,2821,535,188,81,109,98,44,25,2831,2643,2562,1961,757,665,232,303,1391,1430,406,1256,624,0,,569
15:21:23,6956.864,Fox,2823,536,190,81,106,100,44,25,2833,2643,2562,1963,757,665,233,303,1393,1430,406,1257,624,0,,570
15:21:23,6957.464,Fox,2825,536,194,81,105,100,44,24,2837,2643,2562,1963,757,665,233,303,1394,1431,406,1258,625,0,,570
15:21:24,6958.064,Fox,2827,536,194,76,112,98,44,24,2839,2645,2569,1963,757,665,233,303,1395,1432,406,1260,625,0,,570
15:21:24,6958.664,Fox,2829,537,194,76,113,96,46,24,2841,2647,2571,1963,759,665,234,303,1397,1432,406,1261,625,0,,571
15:21:24,6959.264,Fox,2829,537,194,76,111,98,46,24,2841,2647,2571,1965,759,665,234,303,1397,1432,406,1261,625,0,,571
15:21:25,6960.164,Fox,2831,539,194,76,110,99,46,24,2841,2647,2571,1966,759,665,234,305,1397,1434,406,1261,625,0,,573
15:21:25,6960.764,Fox,2831,539,188,84,107,102,46,24,2843,2655,2571,1969,759,665,234,305,1397,1434,406,1261,625,0,,573
15:21:25,6961.364,Fox,2831,538,188,82,106,104,46,24,2843,2655,2573,1971,759,665,233,305,1397,1434,406,1262,625,0,,572
15:21:26,6961.964,Fox,2831,537,188,82,104,104,47,24,2843,2655,2573,1973,760,665,233,304,1397,1434,406,1263,625,0,,571
15:21:26,6962.527,Fox,2831,536,188,80,103,106,47,24,2843,2655,2575,1976,760,665,233,303,1397,1434,406,1264,625,0,,570
15:21:26,6962.827,Fox,2831,536,186,80,105,106,47,24,2843,2657,2577,1976,760,665,233,303,1397,1434,406,1264,625,0,,570
15:21:27,6964.027,Fox,2831,535,184,82,105,105,47,24,2843,2659,2577,1976,760,665,233,302,1397,1434,406,1265,625,0,,569
15:21:27,6964.627,Fox,2833,536,186,80,105,106,47,24,2845,2659,2579,1978,760,665,234,302,1399,1434,406,1266,625,0,,570
15:21:28,6965.527,Fox,2835,536,188,80,105,106,47,22,2847,2659,2579,1978,760,665,234,302,1399,1436,406,1266,627,0,,570
15:21:28,6966.127,Fox,2835,536,188,78,107,105,48,22,2847,2659,2581,1978,761,665,234,302,1399,1436,406,1266,627,0,,570
15:21:29,6966.727,Fox,2835,536,184,82,107,105,48,22,2847,2663,2581,1978,761,665,234,302,1399,1436,406,1266,627,0,,570
15:21:29,6967.327,Fox,2837,537,184,80,108,105,48,22,2847,2663,2583,1978,761,665,234,303,1400,1437,406,1267,627,0,,571
15:21:29,6967.927,Fox,2845,543,192,80,106,105,48,22,2855,2663,2583,1978,761,665,238,305,1406,1439,406,1269,627,0,,577
15:21:30,6968.527,Fox,2849,543,198,78,106,105,48,20,2861,2663,2585,1978,761,665,236,307,1408,1441,408,1269,629,0,,577
15:21:30,6969.127,Fox,2851,544,200,72,111,104,49,20,2863,2663,2591,1979,762,665,236,308,1409,1442,408,1270,629,0,,578
15:21:30,6969.727,Fox,2853,544,200,66,117,102,49,20,2863,2663,2597,1979,762,665,237,307,1411,1442,408,1272,629,0,,578
15:21:30,6970.327,Fox,2859,547,204,64,118,102,51,20,2871,2667,2603,1983,764,665,239,308,1416,1443,408,1275,629,0,,581
15:21:31,6970.911,Fox,2859,546,202,60,124,100,52,20,2871,2669,2609,1983,765,665,239,307,1416,1443,408,1276,629,0,,580
15:21:31,6971.511,Fox,2859,546,202,58,124,102,51,21,2871,2669,2611,1985,765,666,239,307,1416,1443,408,1276,629,0,,580
15:21:32,6972.411,Fox,2863,550,202,60,124,104,51,21,2875,2673,2613,1987,765,666,242,308,1419,1444,408,1276,629,0,,584
15:21:32,6973.011,Fox,2869,552,202,58,122,105,51,20,2875,2673,2615,1989,765,666,242,310,1421,1448,408,1279,630,0,,586
15:21:32,6973.554,Fox,2869,551,202,62,123,106,51,19,2881,2679,2617,1990,765,666,242,309,1421,1448,408,1279,631,0,,585
15:21:32,6974.224,Fox,2871,553,202,62,125,106,51,19,2883,2681,2619,1990,765,666,242,311,1421,1450,408,1279,631,0,,587
15:21:33,6974.824,Fox,2871,552,198,66,125,105,51,19,2883,2685,2619,1990,766,666,242,310,1421,1450,409,1279,631,0,,586
15:21:33,6975.724,Fox,2873,553,192,68,129,103,53,18,2883,2691,2623,1990,768,666,243,310,1422,1451,409,1279,632,0,,587
15:21:33,6976.302,Fox,2873,551,194,68,129,102,53,17,2885,2691,2623,1990,768,666,243,308,1422,1451,409,1280,633,0,,585
15:21:34,6976.836,Fox,2877,552,196,68,129,102,53,16,2889,2693,2625,1991,768,666,246,306,1426,1451,409,1282,634,0,,586
15:21:34,6977.365,Fox,2877,552,196,68,129,100,54,17,2889,2693,2625,1991,770,667,246,306,1426,1451,409,1282,634,0,,586
15:21:34,6977.606,Fox,2877,552,196,68,128,101,54,17,2889,2693,2625,1992,770,667,246,306,1426,1451,409,1282,634,0,,586
15:21:34,6978.107,Fox,2877,552,196,66,130,101,54,17,2889,2693,2627,1992,770,667,246,306,1426,1451,409,1282,634,0,,586
15:21:35,6978.986,Fox,2881,556,198,66,130,101,54,17,2891,2693,2627,1992,770,667,247,309,1427,1454,409,1282,634,0,,590
15:21:35,6979.586,Fox,2881,556,194,72,129,102,53,18,2893,2699,2627,1993,770,668,247,309,1427,1454,409,1282,634,0,,590
15:21:36,6980.187,Fox,2881,556,192,74,129,102,53,18,2893,2701,2627,1993,770,668,247,309,1427,1454,409,1282,634,0,,590
15:21:36,6981.086,Fox,2881,555,192,72,131,100,55,17,2893,2701,2629,1993,772,668,247,308,1427,1454,409,1282,635,0,,589
15:21:36,6981.386,Fox,2881,555,188,76,129,102,55,17,2893,2705,2629,1995,772,668,247,308,1427,1454,409,1282,635,0,,589
15:21:41,6982.586,Fox,2883,556,186,78,127,103,55,17,2893,2707,2629,1997,772,668,247,309,1428,1455,409,1283,635,0,,590
15:21:41,6983.187,Fox,2885,557,182,82,127,104,55,17,2895,2713,2631,1999,772,668,247,310,1429,1456,409,1284,635,0,,591
15:21:41,6983.786,Fox,2893,560,186,82,123,104,56,15,2899,2713,2631,2001,773,668,248,312,1434,1459,409,1287,637,0,,594
15:21:42,6984.386,Fox,2899,565,194,82,124,103,57,15,2909,2715,2633,2001,774,668,250,315,1437,1462,410,1287,637,0,,599
15:21:42,6984.687,Fox,2899,565,196,82,124,103,57,15,2911,2715,2633,2001,774,668,250,315,1437,1462,410,1287,637,0,,599
15:21:42,6985.586,Fox,2909,571,204,80,123,103,57,14,2919,2715,2635,2001,774,668,251,320,1442,1467,410,1290,638,0,,605
15:21:43,6986.187,Fox,2909,569,206,80,123,103,57,12,2921,2715,2635,2001,774,668,251,318,1442,1467,410,1290,640,0,,603
15:21:43,6986.786,Fox,2909,567,202,84,123,101,57,12,2921,2719,2635,2001,774,668,251,316,1442,1467,410,1292,640,0,,601
15:21:43,6987.386,Fox,2911,567,202,82,125,99,56,13,2921,2719,2637,2001,774,669,250,317,1443,1468,410,1294,640,0,,601
15:21:44,6987.986,Fox,2915,571,208,82,125,99,56,13,2927,2719,2637,2001,774,669,252,319,1445,1470,410,1294,640,0,,605
15:21:44,6988.586,Fox,2915,571,208,82,122,102,56,13,2927,2719,2637,2004,774,669,252,319,1445,1470,410,1294,640,0,,605
15:21:45,6989.486,Fox,2919,575,212,80,124,102,56,13,2931,2719,2639,2004,774,669,252,323,1445,1474,410,1294,640,0,,609
15:21:45,6990.086,Fox,2919,574,210,82,120,102,59,13,2931,2721,2639,2007,777,669,251,323,1445,1474,410,1295,640,0,,608
15:21:45,6990.687,Fox,2921,576,208,84,119,102,60,13,2931,2723,2639,2008,778,669,252,324,1446,1475,410,1295,640,0,,610
15:21:46,6991.286,Fox,2921,573,206,86,120,100,60,13,2933,2727,2641,2009,779,669,251,322,1446,1475,410,1298,640,0,,607
15:21:47,6992.486,Fox,2923,575,208,84,122,100,60,13,2935,2727,2643,2009,779,669,252,323,1447,1476,410,1298,640,0,,609
15:21:47,6992.786,Fox,2923,575,208,84,121,101,60,13,2935,2727,2643,2010,779,669,252,323,1447,1476,410,1298,640,0,,609
15:21:47,6993.687,Fox,2925,577,206,86,121,101,60,13,2935,2729,2643,2010,779,669,253,324,1448,1477,410,1298,640,0,,611
15:21:48,6994.286,Fox,2925,577,206,88,121,101,60,13,2937,2731,2643,2010,779,669,253,324,1448,1477,410,1298,640,0,,611
15:21:48,6994.886,Fox,2929,579,208,88,120,100,60,13,2939,2731,2643,2010,779,669,252,327,1449,1480,411,1299,640,0,,613
15:21:48,6995.486,Fox,2931,581,210,90,120,100,60,13,2943,2733,2643,2010,779,669,253,328,1450,1481,411,1299,640,0,,615
15:21:49,6996.086,Fox,2937,584,216,90,117,100,60,13,2949,2733,2643,2010,779,669,252,332,1452,1485,411,1302,640,0,,618
15:21:49,6996.687,Fox,2937,583,214,90,119,99,60,13,2949,2735,2645,2010,779,669,252,331,1452,1485,411,1303,640,0,,617
15:21:50,6997.286,Fox,2937,583,210,92,121,99,60,13,2949,2739,2647,2010,779,669,252,331,1452,1485,411,1303,640,0,,617
15:21:50,6997.886,Fox,2937,579,208,94,119,99,59,12,2949,2741,2647,2012,779,669,250,329,1452,1485,411,1306,641,0,,613
15:21:50,6998.486,Fox,2937,578,208,94,114,103,59,12,2949,2741,2647,2017,779,669,250,328,1452,1485,411,1307,641,0,,612
15:21:51,6999.086,Fox,2947,583,218,94,109,103,59,12,2959,2741,2647,2017,779,669,251,332,1458,1489,412,1311,641,0,,617
15:21:51,6999.386,Fox,2947,582,218,86,117,102,59,12,2959,2741,2655,2017,779,669,251,331,1458,1489,412,1312,641,0,,616
15:21:52,7000.286,Fox,2949,579,218,88,117,97,59,12,2961,2743,2655,2017,779,669,251,328,1458,1491,412,1317,641,0,,613
15:21:52,7000.886,Fox,2949,579,212,94,117,95,61,12,2961,2749,2655,2017,781,669,251,328,1458,1491,412,1317,641,0,,613
15:21:52,7001.486,Fox,2951,579,212,92,118,94,61,12,2961,2749,2657,2018,781,669,252,327,1459,1492,413,1318,641,0,,613
15:21:52,7002.086,Fox,2951,579,214,92,116,96,61,12,2963,2749,2657,2020,781,669,252,327,1459,1492,413,1318,641,0,,613
15:21:53,7002.687,Fox,2955,580,216,90,116,96,61,11,2965,2749,2659,2020,781,669,252,328,1462,1493,413,1320,642,0,,614
15:21:53,7003.286,Fox,2963,586,224,90,111,99,61,11,2973,2749,2659,2023,781,669,252,334,1464,1499,413,1322,642,0,,620
15:21:53,7003.886,Fox,2965,587,224,92,111,98,60,12,2975,2751,2659,2023,781,670,253,334,1466,1499,413,1323,642,0,,621
15:21:54,7004.486,Fox,2965,584,226,92,109,97,59,13,2977,2751,2659,2025,781,671,253,331,1466,1499,413,1326,642,0,,618
15:21:54,7005.386,Fox,2965,584,226,88,113,97,59,13,2977,2751,2663,2025,781,671,253,331,1466,1499,413,1326,642,0,,618
15:21:55,7005.687,Fox,2965,584,226,88,113,97,58,14,2977,2751,2663,2025,781,672,253,331,1466,1499,413,1326,642,0,,618
15:21:55,7006.886,Fox,2965,583,226,88,113,95,60,13,2977,2751,2663,2025,783,672,253,330,1466,1499,413,1326,643,0,,617
15:21:56,7007.486,Fox,2969,586,228,90,109,98,60,13,2981,2753,2663,2028,783,672,254,332,1468,1501,413,1327,643,0,,620
15:21:56,7008.086,Fox,2969,586,228,90,109,98,59,14,2981,2753,2663,2028,783,673,254,332,1468,1501,413,1327,643,0,,620
15:21:57,7009.286,Fox,2969,584,228,84,115,96,59,14,2981,2753,2669,2028,783,673,254,330,1468,1501,413,1329,643,0,,618
15:21:57,7009.886,Fox,2971,585,228,84,113,95,61,14,2981,2753,2669,2030,785,673,256,329,1470,1501,413,1330,643,0,,619
15:21:58,7010.486,Fox,2975,587,232,82,111,94,64,14,2985,2753,2671,2032,788,673,257,330,1473,1502,413,1332,643,0,,621
15:21:58,7011.086,Fox,2979,589,238,80,111,94,64,14,2991,2753,2673,2032,788,673,257,332,1475,1504,413,1334,643,0,,623
15:21:58,7011.687,Fox,2983,591,226,90,112,93,64,14,2991,2765,2675,2032,788,673,258,333,1477,1506,414,1335,643,0,,625
15:21:59,7012.286,Fox,2983,590,230,86,111,97,64,14,2995,2765,2679,2037,788,673,258,332,1477,1506,414,1336,643,0,,624
15:21:59,7012.886,Fox,2985,590,232,82,115,95,63,15,2997,2765,2683,2037,788,674,256,334,1477,1508,414,1338,643,0,,624
15:21:59,7013.486,Fox,2985,590,232,80,114,98,63,15,2997,2765,2685,2040,788,674,256,334,1477,1508,414,1338,643,0,,624
15:22:00,7014.086,Fox,2985,590,232,74,120,98,62,16,2997,2765,2691,2040,788,675,256,334,1477,1508,414,1338,643,0,,624
15:22:00,7014.386,Fox,2985,590,232,74,119,99,60,18,2997,2765,2691,2041,788,677,256,334,1477,1508,414,1338,643,0,,624
15:22:01,7015.286,Fox,2989,591,228,76,120,97,58,20,2997,2769,2693,2041,788,679,256,335,1480,1509,414,1341,643,0,,625
15:22:01,7015.886,Fox,2989,591,232,76,119,96,60,20,3001,2769,2693,2042,790,679,256,335,1480,1509,414,1341,643,0,,625
15:22:01,7016.486,Fox,2993,593,236,76,117,96,60,20,3005,2769,2693,2042,790,679,255,338,1481,1512,414,1343,643,0,,627
15:22:02,7016.786,Fox,2993,593,234,78,117,96,60,20,3005,2771,2693,2042,790,679,255,338,1481,1512,414,1343,643,0,,627
15:22:02,7017.986,Fox,2993,592,226,80,123,95,60,20,3005,2779,2699,2042,790,679,255,337,1481,1512,414,1344,643,0,,626
15:22:03,7018.586,Fox,2993,591,224,80,118,100,61,20,3005,2781,2701,2049,791,679,254,337,1481,1512,414,1345,643,0,,625
15:22:03,7019.187,Fox,2993,589,222,82,117,100,62,18,3005,2783,2701,2050,792,679,253,336,1481,1512,414,1345,645,0,,623
15:22:03,7019.786,Fox,2993,589,222,78,121,99,63,18,3005,2783,2705,2050,793,679,253,336,1481,1512,414,1345,645,0,,623
15:22:04,7020.986,Fox,2993,587,222,76,123,97,63,18,3005,2783,2707,2050,793,679,253,334,1481,1512,414,1347,645,0,,621
15:22:04,7021.586,Fox,2997,588,220,72,127,96,63,18,3005,2785,2713,2051,793,679,253,335,1483,1514,415,1349,645,0,,622
15:22:05,7022.187,Fox,2999,588,222,74,127,93,65,17,3009,2787,2713,2051,795,679,253,335,1484,1515,415,1350,646,0,,622
15:22:05,7022.786,Fox,3001,590,222,74,129,91,67,17,3011,2789,2715,2051,797,679,253,337,1484,1517,415,1350,646,0,,624
15:22:06,7023.386,Fox,3001,590,220,78,125,95,67,17,3013,2793,2715,2055,797,679,253,337,1484,1517,415,1350,646,0,,624
15:22:06,7024.286,Fox,3003,591,220,80,125,94,68,16,3015,2795,2715,2055,798,679,254,337,1485,1518,415,1350,647,0,,625
15:22:07,7025.187,Fox,3003,591,218,78,127,96,68,16,3015,2797,2719,2057,798,679,254,337,1485,1518,415,1350,647,0,,625
15:22:07,7025.786,Fox,3005,592,218,78,126,92,70,18,3015,2797,2719,2057,802,681,254,338,1486,1519,415,1351,647,0,,626
15:22:07,7026.386,Fox,3005,592,214,84,126,92,70,18,3017,2803,2719,2057,802,681,254,338,1486,1519,415,1351,647,0,,626
15:22:08,7026.986,Fox,3005,590,214,84,124,92,70,18,3017,2803,2719,2059,802,681,254,336,1486,1519,415,1353,647,0,,624
15:22:08,7027.586,Fox,3005,590,208,90,122,94,70,18,3017,2809,2719,2061,802,681,254,336,1486,1519,415,1353,647,0,,624
15:22:09,7028.187,Fox,3007,590,208,92,121,94,70,17,3019,2811,2719,2061,802,681,255,335,1488,1519,415,1354,648,0,,624
15:22:09,7028.786,Fox,3009,591,206,92,123,94,70,16,3019,2813,2721,2061,802,681,256,335,1489,1520,415,1354,649,0,,625
15:22:09,7029.386,Fox,3009,591,208,90,120,99,70,16,3021,2813,2723,2066,802,681,256,335,1489,1520,415,1354,649,0,,625
15:22:10,7029.986,Fox,3009,591,208,86,120,103,70,16,3021,2813,2727,2070,802,681,256,335,1489,1520,415,1354,649,0,,625
15:22:10,7030.586,Fox,3015,595,210,86,116,105,68,18,3023,2813,2727,2073,802,683,257,338,1492,1523,415,1356,649,0,,629
15:22:10,7030.886,Fox,3015,595,214,86,116,105,68,18,3027,2813,2727,2073,802,683,257,338,1492,1523,415,1356,649,0,,629
15:22:10,7031.767,Fox,3019,598,214,84,112,110,68,18,3027,2813,2729,2079,802,683,258,340,1494,1525,415,1357,649,0,,632
15:22:11,7032.066,Fox,3019,598,218,84,112,109,69,18,3031,2813,2729,2079,803,683,258,340,1494,1525,415,1357,649,0,,632
15:22:11,7032.966,Fox,3021,599,218,84,113,109,69,18,3033,2815,2731,2080,803,683,257,342,1494,1527,415,1358,649,0,,633
15:22:11,7033.566,Fox,3023,600,218,82,114,109,69,18,3033,2815,2733,2081,803,683,257,343,1495,1528,415,1359,649,0,,634
15:22:12,7033.866,Fox,3023,600,220,82,112,111,69,18,3035,2815,2733,2083,803,683,257,343,1495,1528,415,1359,649,0,,634
15:22:12,7034.767,Fox,3027,599,224,80,110,112,69,16,3039,2815,2735,2085,803,683,256,343,1496,1531,415,1362,651,0,,633
15:22:13,7035.667,Fox,3027,597,224,76,114,110,69,16,3039,2815,2739,2085,803,683,256,341,1496,1531,415,1364,651,0,,631
15:22:13,7035.966,Fox,3027,596,224,74,112,113,69,16,3039,2815,2741,2089,803,683,256,340,1496,1531,415,1365,651,0,,630
15:22:14,7037.167,Fox,3029,597,216,84,110,114,69,16,3041,2825,2741,2090,803,683,256,341,1497,1532,415,1366,651,0,,631
15:22:14,7037.676,Fox,3029,597,210,90,110,114,69,16,3041,2831,2741,2090,803,683,256,341,1497,1532,415,1366,651,0,,631
15:22:14,7038.235,Fox,3031,598,212,90,109,114,69,16,3043,2831,2741,2090,803,683,256,342,1498,1533,415,1367,651,0,,632
15:22:14,7038.706,Fox,3031,598,212,88,109,116,69,16,3043,2831,2743,2092,803,683,256,342,1498,1533,415,1367,651,0,,632
15:22:15,7039.306,Fox,3033,598,210,84,114,115,69,16,3043,2833,2749,2092,803,683,257,341,1500,1533,416,1368,651,0,,632
15:22:15,7039.89,Fox,3035,600,212,86,114,115,69,16,3047,2835,2749,2092,803,683,258,342,1501,1534,416,1368,651,0,,634
15:22:15,7040.41,Fox,3039,601,214,88,112,114,68,17,3051,2837,2749,2092,803,684,256,345,1501,1538,416,1371,651,0,,635
15:22:15,7040.897,Fox,3039,601,212,90,112,113,69,17,3051,2839,2749,2092,804,684,256,345,1501,1538,416,1371,651,0,,635
15:22:15,7041.131,Fox,3039,599,210,92,111,112,69,17,3051,2841,2749,2093,804,684,256,343,1501,1538,416,1373,651,0,,633
15:22:16,7042.102,Fox,3039,597,210,90,113,110,68,18,3051,2841,2751,2093,804,685,256,341,1501,1538,416,1375,651,0,,631
15:22:16,7042.702,Fox,3041,599,212,90,113,108,70,18,3053,2841,2751,2093,806,685,258,341,1503,1538,416,1375,651,0,,633
15:22:16,7043.301,Fox,3043,599,210,92,113,105,71,18,3053,2843,2751,2093,807,685,260,339,1505,1538,418,1375,651,0,,633
15:22:17,7043.901,Fox,3049,603,214,92,109,107,71,18,3057,2843,2751,2095,807,685,260,343,1507,1542,418,1377,651,0,,637
15:22:17,7044.202,Fox,3049,603,218,92,109,107,71,18,3061,2843,2751,2095,807,685,260,343,1507,1542,418,1377,651,0,,637
15:22:18,7045.102,Fox,3051,604,218,92,107,108,71,18,3061,2843,2751,2097,807,685,259,345,1507,1544,418,1378,651,0,,638
15:22:18,7045.702,Fox,3051,604,220,90,107,110,71,18,3063,2843,2753,2099,807,685,259,345,1507,1544,418,1378,651,0,,638
15:22:19,7046.901,Fox,3051,603,220,90,107,109,69,20,3063,2843,2753,2099,807,687,259,344,1507,1544,418,1379,651,0,,637
15:22:19,7047.202,Fox,3051,599,218,92,107,104,70,20,3063,2845,2753,2099,808,687,259,340,1507,1544,419,1382,651,0,,633
15:22:19,7048.085,Fox,3053,599,218,94,106,104,70,19,3065,2847,2753,2100,808,687,258,341,1508,1545,419,1383,652,0,,633
15:22:20,7048.386,Fox,3053,598,218,94,106,104,70,18,3065,2847,2753,2100,808,687,258,340,1508,1545,419,1383,653,0,,632
15:22:20,7049.286,Fox,3057,602,222,94,106,104,70,18,3069,2847,2753,2100,808,687,260,342,1510,1547,419,1383,653,0,,636
15:22:20,7049.874,Fox,3057,601,222,82,116,106,70,17,3069,2847,2765,2102,808,687,260,341,1510,1547,419,1383,654,0,,635
15:22:21,7050.474,Fox,3057,601,214,90,116,106,70,17,3069,2855,2765,2102,808,687,260,341,1510,1547,419,1383,654,0,,635
15:22:21,7051.074,Fox,3057,600,208,96,116,106,67,19,3069,2861,2765,2102,808,690,260,340,1510,1547,419,1383,655,0,,634
15:22:21,7051.674,Fox,3059,602,208,98,115,107,67,19,3071,2863,2765,2103,808,690,261,341,1511,1548,419,1383,655,0,,636
15:22:22,7052.274,Fox,3061,601,208,98,114,105,67,19,3071,2863,2765,2103,808,690,261,340,1513,1548,419,1386,655,0,,635
15:22:22,7052.874,Fox,3063,601,202,106,112,106,67,18,3073,2871,2765,2105,808,690,261,340,1515,1548,419,1387,656,0,,635
15:22:23,7053.474,Fox,3067,603,204,102,115,105,67,18,3075,2871,2769,2105,808,690,261,342,1517,1550,419,1389,656,0,,637
15:22:23,7054.074,Fox,3067,603,208,102,115,103,69,18,3079,2871,2769,2105,810,690,261,342,1517,1550,419,1389,656,0,,637
15:22:23,7054.374,Fox,3067,603,208,102,115,102,70,18,3079,2871,2769,2105,811,690,261,342,1517,1550,419,1389,656,0,,637
15:22:24,7055.274,Fox,3069,604,204,104,116,100,72,18,3079,2875,2771,2105,813,690,261,343,1518,1551,419,1390,656,0,,638
15:22:24,7055.874,Fox,3069,603,200,110,116,97,75,17,3081,2881,2771,2105,816,690,261,342,1518,1551,419,1390,657,0,,637
15:22:25,7056.774,Fox,3071,604,200,100,126,96,74,18,3081,2881,2781,2105,816,691,260,344,1518,1553,419,1391,657,0,,638
15:22:25,7057.374,Fox,3073,605,200,100,125,98,74,18,3083,2883,2783,2107,816,691,260,345,1519,1554,419,1392,657,0,,639
15:22:25,7057.674,Fox,3073,605,202,100,124,99,74,18,3085,2883,2783,2108,816,691,260,345,1519,1554,419,1392,657,0,,639
15:22:26,7058.874,Fox,3075,606,202,102,123,99,72,20,3087,2885,2783,2108,816,693,261,345,1521,1554,420,1392,657,0,,640
15:22:26,7059.474,Fox,3079,609,200,106,122,99,70,22,3089,2889,2783,2108,816,695,263,346,1524,1555,420,1393,657,0,,643
15:22:26,7060.074,Fox,3079,607,202,104,120,101,70,22,3091,2889,2785,2112,816,695,263,344,1524,1555,420,1395,657,0,,641
15:22:27,7060.674,Fox,3083,610,206,102,122,100,70,22,3095,2889,2787,2112,816,695,264,346,1525,1558,420,1396,657,0,,644
15:22:27,7061.274,Fox,3087,612,208,100,123,100,70,21,3097,2889,2789,2112,816,695,266,346,1528,1559,421,1396,658,0,,646
15:22:27,7061.751,Fox,3087,612,206,100,125,102,68,23,3099,2893,2793,2114,816,697,266,346,1528,1559,421,1396,658,0,,646
15:22:28,7062.874,Fox,3087,612,206,98,126,103,67,24,3099,2893,2795,2115,816,698,266,346,1528,1559,421,1396,658,0,,646
15:22:28,7063.4,Fox,3089,614,208,96,128,101,69,24,3101,2893,2797,2115,818,698,267,347,1529,1560,421,1396,658,0,,648
15:22:29,7064,Fox,3091,616,210,96,128,101,69,24,3103,2893,2797,2115,818,698,267,349,1529,1562,421,1396,658,0,,650
15:22:29,7064.9,Fox,3091,613,210,90,134,97,69,25,3103,2893,2803,2115,819,699,267,346,1529,1562,421,1399,658,0,,647
15:22:29,7065.5,Fox,3093,613,210,92,131,98,70,24,3105,2895,2803,2117,820,699,268,345,1531,1562,421,1400,659,0,,647
15:22:30,7066.1,Fox,3093,613,208,88,135,100,70,24,3105,2897,2809,2119,820,699,268,345,1531,1562,421,1400,659,0,,647
15:22:30,7066.7,Fox,3097,613,202,94,136,99,70,22,3107,2905,2811,2119,820,699,267,346,1532,1565,421,1402,661,0,,647
15:22:30,7067.3,Fox,3097,609,198,98,138,96,70,21,3109,2911,2813,2119,820,699,266,343,1532,1565,421,1405,662,0,,643
15:22:31,7068.2,Fox,3101,609,192,106,138,92,70,21,3111,2919,2813,2119,820,699,266,343,1533,1568,421,1409,662,0,,643
15:22:31,7068.8,Fox,3105,612,194,108,137,92,70,21,3115,2921,2813,2119,820,699,268,344,1536,1569,422,1409,662,0,,646
15:22:32,7069.4,Fox,3111,614,198,108,133,92,70,21,3119,2921,2813,2122,820,699,269,345,1539,1572,423,1412,662,0,,648
15:22:32,7070,Fox,3111,608,202,108,131,89,70,20,3123,2921,2813,2124,820,699,268,340,1539,1572,424,1416,663,0,,642
15:22:32,7070.57,Fox,3113,609,198,114,131,88,70,20,3125,2927,2813,2124,820,699,269,340,1540,1573,424,1417,663,0,,643
15:22:32,7071.111,Fox,3117,610,200,112,129,90,70,19,3127,2927,2815,2126,820,699,270,340,1543,1574,424,1419,664,0,,644
15:22:33,7071.664,Fox,3117,609,202,112,127,92,70,18,3129,2927,2815,2128,820,699,270,339,1543,1574,424,1419,665,0,,643
15:22:33,7072.264,Fox,3119,610,200,116,126,92,70,18,3131,2931,2815,2129,820,699,271,339,1544,1575,424,1420,665,0,,644
15:22:33,7072.864,Fox,3121,611,200,116,122,95,70,18,3131,2931,2815,2133,820,699,271,340,1545,1576,424,1421,665,0,,645
15:22:34,7073.464,Fox,3121,611,202,116,120,97,70,18,3133,2931,2815,2135,820,699,271,340,1545,1576,424,1421,665,0,,645
15:22:34,7073.764,Fox,3121,610,200,118,118,98,70,18,3133,2933,2815,2137,820,699,271,339,1545,1576,424,1422,665,0,,644
15:22:34,7074.664,Fox,3125,612,202,118,112,103,70,17,3135,2933,2815,2142,820,699,271,341,1547,1578,425,1422,666,0,,646
15:22:35,7075.264,Fox,3127,613,204,120,112,103,70,16,3139,2935,2815,2142,820,699,272,341,1548,1579,425,1422,667,0,,647
15:22:35,7075.771,Fox,3127,613,204,110,120,105,70,16,3139,2935,2825,2144,820,699,272,341,1548,1579,425,1422,667,0,,647
15:22:35,7076.371,Fox,3127,610,204,104,126,101,68,19,3139,2935,2831,2144,822,702,272,338,1548,1579,425,1425,667,0,,644
15:22:36,7076.671,Fox,3127,610,202,106,126,101,68,19,3139,2937,2831,2144,822,702,272,338,1548,1579,425,1425,667,0,,644
15:22:36,7077.571,Fox,3131,611,202,108,125,99,68,19,3141,2939,2831,2144,822,702,272,339,1550,1581,425,1428,667,0,,645
15:22:36,7078.171,Fox,3135,613,202,108,125,101,68,19,3145,2943,2835,2146,822,702,272,341,1552,1583,425,1430,667,0,,647
15:22:37,7078.771,Fox,3139,616,200,112,124,103,68,19,3149,2949,2837,2149,822,702,273,343,1553,1586,425,1431,667,0,,650
15:22:37,7079.071,Fox,3139,615,202,110,126,103,68,18,3151,2949,2839,2149,822,702,273,342,1553,1586,425,1431,668,0,,649
15:22:37,7079.671,Fox,3139,615,202,108,128,103,67,19,3151,2949,2841,2149,822,703,273,342,1553,1586,425,1431,668,0,,649
15:22:38,7080.571,Fox,3139,613,202,108,125,104,67,19,3151,2949,2841,2152,822,703,273,340,1553,1586,425,1433,668,0,,647
15:22:38,7081.171,Fox,3139,608,202,108,125,100,67,18,3151,2949,2841,2152,822,703,273,335,1553,1586,425,1437,669,0,,642
15:22:38,7081.771,Fox,3141,609,192,116,120,104,68,19,3151,2959,2843,2159,824,704,273,336,1553,1588,425,1438,669,0,,643
15:22:39,7082.371,Fox,3143,605,194,116,119,99,68,19,3153,2959,2843,2159,824,704,274,331,1555,1588,425,1444,669,0,,639
15:22:39,7082.971,Fox,3145,607,196,118,119,99,68,19,3157,2961,2843,2159,824,704,276,331,1557,1588,425,1444,669,0,,641
15:22:39,7083.571,Fox,3145,606,196,118,117,99,69,19,3157,2961,2843,2161,825,704,276,330,1557,1588,425,1445,669,0,,640
15:22:40,7083.871,Fox,3145,605,196,118,117,98,69,19,3157,2961,2843,2161,825,704,275,330,1557,1588,425,1446,669,0,,639
15:22:40,7084.471,Fox,3145,605,194,120,117,98,69,19,3157,2963,2843,2161,825,704,275,330,1557,1588,425,1446,669,0,,639
15:22:40,7085.411,Fox,3145,605,192,122,113,102,69,19,3157,2965,2843,2165,825,704,275,330,1557,1588,425,1446,669,0,,639
15:22:41,7086.011,Fox,3145,605,184,128,115,101,69,20,3157,2973,2845,2165,826,705,275,330,1557,1588,425,1446,669,0,,639
15:22:41,7086.611,Fox,3145,604,182,128,117,101,69,19,3157,2975,2847,2165,826,705,275,329,1557,1588,425,1446,670,0,,638
15:22:41,7087.211,Fox,3149,606,180,130,117,99,69,19,3157,2977,2847,2165,826,705,275,331,1559,1590,425,1448,670,0,,640
15:22:42,7087.811,Fox,3151,607,184,130,116,99,69,19,3161,2977,2847,2165,826,705,275,332,1560,1591,425,1449,670,0,,641
15:22:42,7088.411,Fox,3155,609,188,130,114,99,69,19,3165,2977,2847,2165,826,705,274,335,1561,1594,425,1451,670,0,,643
15:22:42,7089.011,Fox,3155,605,190,122,120,97,69,19,3167,2977,2855,2167,826,705,273,332,1561,1594,425,1455,670,0,,639
15:22:43,7089.611,Fox,3155,605,190,116,126,97,69,19,3167,2977,2861,2167,826,705,273,332,1561,1594,425,1455,670,0,,639
15:22:43,7090.211,Fox,3155,604,186,118,126,98,69,19,3167,2981,2863,2169,826,705,272,332,1561,1594,426,1455,670,0,,638
15:22:43,7090.811,Fox,3159,606,190,118,126,96,69,19,3171,2981,2863,2169,826,705,271,335,1562,1597,426,1457,670,0,,640
15:22:44,7091.411,Fox,3167,606,196,110,132,90,71,17,3177,2981,2871,2169,828,705,271,335,1567,1600,428,1461,672,0,,640
15:22:44,7092.011,Fox,3167,606,198,110,132,88,73,17,3179,2981,2871,2169,830,705,271,335,1567,1600,428,1461,672,0,,640
15:22:44,7092.311,Fox,3167,606,198,110,131,89,73,17,3179,2981,2871,2170,830,705,271,335,1567,1600,428,1461,672,0,,640
15:22:45,7093.211,Fox,3167,606,194,114,129,91,72,18,3179,2985,2871,2172,830,706,271,335,1567,1600,428,1461,672,0,,640
15:22:45,7093.811,Fox,3167,605,188,116,133,90,71,19,3179,2991,2875,2172,830,707,271,334,1567,1600,428,1462,672,0,,639
15:22:46,7094.411,Fox,3167,605,188,110,138,91,71,19,3179,2991,2881,2173,830,707,271,334,1567,1600,428,1462,672,0,,639
15:22:46,7095.011,Fox,3169,606,186,114,137,91,71,19,3181,2995,2881,2173,830,707,270,336,1567,1602,428,1463,672,0,,640
15:22:46,7095.611,Fox,3169,606,184,114,137,93,71,19,3181,2997,2883,2175,830,707,270,336,1567,1602,428,1463,672,0,,640
15:22:47,7096.211,Fox,3171,607,184,114,132,97,69,21,3181,2997,2883,2179,830,709,270,337,1568,1603,428,1464,672,0,,641
15:22:47,7096.811,Fox,3171,606,186,114,130,99,69,20,3183,2997,2883,2181,830,709,270,336,1568,1603,428,1464,673,0,,640
15:22:47,7097.411,Fox,3171,604,186,112,132,97,69,20,3183,2997,2885,2181,830,709,269,335,1568,1603,429,1465,673,0,,638
15:22:48,7098.011,Fox,3171,602,186,108,136,93,71,20,3183,2997,2889,2181,832,709,268,334,1568,1603,429,1467,673,0,,636
15:22:48,7098.611,Fox,3171,601,182,112,136,92,71,20,3183,3001,2889,2181,832,709,268,333,1568,1603,429,1468,673,0,,635
15:22:48,7099.211,Fox,3171,599,178,116,135,91,70,21,3183,3005,2889,2182,832,710,268,331,1568,1603,429,1470,673,0,,633
15:22:49,7099.811,Fox,3175,601,178,116,132,92,70,21,3183,3005,2889,2185,832,710,270,331,1571,1604,430,1471,673,0,,635
15:22:49,7100.411,Fox,3179,602,182,112,135,90,70,21,3187,3005,2893,2185,832,710,268,334,1572,1607,431,1473,673,0,,636
15:22:49,7100.711,Fox,3179,600,186,112,135,88,70,21,3191,3005,2893,2185,832,710,268,332,1572,1607,431,1475,673,0,,634
15:22:50,7102.211,Fox,3183,603,190,112,135,88,70,20,3195,3005,2893,2185,832,710,271,332,1575,1608,431,1475,674,0,,637
15:22:50,7102.511,Fox,3183,603,190,112,133,90,70,20,3195,3005,2893,2187,832,710,271,332,1575,1608,431,1475,674,0,,637
15:22:51,7103.411,Fox,3189,607,190,112,133,87,71,20,3195,3005,2893,2187,834,711,274,333,1580,1609,431,1477,674,0,,641
15:22:51,7104.011,Fox,3189,607,196,110,135,87,71,20,3201,3005,2895,2187,834,711,274,333,1580,1609,431,1477,674,0,,641
15:22:52,7104.911,Fox,3189,606,192,110,139,87,70,20,3201,3009,2899,2187,834,711,273,333,1580,1609,431,1478,674,0,,640
15:22:52,7105.511,Fox,3189,605,190,102,149,86,70,20,3201,3011,2909,2187,834,711,273,332,1580,1609,431,1479,674,0,,639
15:22:53,7106.111,Fox,3189,605,188,102,149,87,71,20,3201,3013,2911,2189,835,711,273,332,1580,1609,431,1479,674,0,,639
15:22:53,7107.011,Fox,3189,605,186,94,159,87,70,21,3201,3015,2921,2189,835,712,273,332,1580,1609,431,1479,674,0,,639
15:22:53,7107.611,Fox,3197,607,194,94,158,82,70,21,3209,3015,2921,2189,835,712,274,333,1585,1612,431,1485,674,0,,641
15:22:54,7107.911,Fox,3197,607,194,94,158,82,68,23,3209,3015,2921,2189,835,714,274,333,1585,1612,431,1485,674,0,,641
15:22:54,7108.811,Fox,3199,609,194,94,160,82,67,24,3211,3017,2923,2189,835,715,275,334,1586,1613,431,1485,674,0,,643
15:22:54,7109.111,Fox,3199,609,194,90,164,82,67,24,3211,3017,2927,2189,835,715,275,334,1586,1613,431,1485,674,0,,643
15:22:55,7110.011,Fox,3201,610,196,90,163,82,67,24,3213,3017,2927,2189,835,715,275,335,1587,1614,431,1486,674,0,,644
15:22:55,7110.611,Fox,3203,610,196,86,159,88,67,24,3213,3017,2931,2197,835,715,275,335,1587,1616,432,1487,674,0,,644
15:22:55,7110.911,Fox,3203,609,196,88,159,87,67,24,3215,3019,2931,2197,835,715,275,334,1587,1616,432,1488,674,0,,643
15:22:56,7112.111,Fox,3205,608,194,88,160,85,68,23,3215,3021,2933,2197,836,715,275,333,1588,1617,432,1490,675,0,,642
15:22:56,7112.711,Fox,3209,609,196,88,160,82,67,24,3217,3021,2933,2197,836,716,276,333,1591,1618,433,1492,675,0,,643
15:22:57,7113.311,Fox,3209,606,198,90,160,79,65,26,3221,3023,2933,2197,836,718,275,331,1591,1618,433,1495,675,0,,640
15:22:57,7113.911,Fox,3209,605,194,92,159,82,65,25,3221,3027,2935,2200,836,718,275,330,1591,1618,433,1495,676,0,,639
15:22:58,7115.111,Fox,3209,605,190,94,161,82,64,26,3221,3031,2937,2200,836,719,275,330,1591,1618,433,1495,676,0,,639
15:22:58,7115.928,Fox,3209,605,188,94,161,84,64,26,3221,3033,2939,2202,836,719,275,330,1591,1618,433,1495,676,0,,639
15:22:59,7116.528,Fox,3215,608,190,92,163,82,65,26,3225,3035,2943,2202,837,719,276,332,1595,1620,434,1497,676,0,,642
15:22:59,7117.127,Fox,3219,607,194,86,160,85,67,25,3229,3035,2949,2210,839,719,276,331,1597,1622,434,1501,677,0,,641
15:22:59,7117.728,Fox,3219,606,192,90,158,87,67,24,3231,3039,2949,2212,839,719,276,330,1597,1622,434,1501,678,0,,640
15:23:00,7118.328,Fox,3219,606,192,90,158,87,65,26,3231,3039,2949,2212,839,721,276,330,1597,1622,434,1501,678,0,,640
15:23:00,7119.228,Fox,3221,605,194,90,157,85,65,26,3233,3039,2949,2212,839,721,275,330,1597,1624,434,1504,678,0,,639
15:23:01,7119.828,Fox,3223,606,194,92,157,84,65,26,3235,3041,2949,2212,839,721,274,332,1597,1626,434,1505,678,0,,640
15:23:01,7120.127,Fox,3223,606,194,82,165,85,66,26,3235,3041,2959,2214,840,721,274,332,1597,1626,434,1505,678,0,,640
15:23:01,7121.028,Fox,3223,606,192,84,163,86,67,26,3235,3043,2959,2216,841,721,274,332,1597,1626,434,1505,678,0,,640
15:23:02,7121.627,Fox,3223,606,192,82,163,88,66,27,3235,3043,2961,2218,841,722,274,332,1597,1626,434,1505,678,0,,640
15:23:02,7122.228,Fox,3227,608,194,84,157,92,65,28,3239,3045,2961,2222,841,723,275,333,1600,1627,434,1507,678,0,,642
15:23:02,7122.828,Fox,3229,610,192,84,157,94,65,28,3239,3047,2963,2224,841,723,276,334,1601,1628,434,1507,678,0,,644
15:23:03,7123.428,Fox,3231,611,190,88,156,92,67,28,3241,3051,2963,2224,843,723,277,334,1603,1628,434,1508,678,0,,645
15:23:03,7124.028,Fox,3231,610,192,84,158,94,67,27,3243,3051,2967,2226,843,723,277,333,1603,1628,434,1508,679,0,,644
15:23:03,7124.627,Fox,3233,610,192,76,166,92,67,27,3243,3051,2975,2226,843,723,278,332,1605,1628,435,1509,679,0,,644
15:23:04,7125.228,Fox,3237,611,196,76,163,92,69,27,3249,3053,2977,2230,845,723,277,334,1605,1632,435,1512,679,0,,645
15:23:04,7125.528,Fox,3237,608,196,76,163,90,69,26,3249,3053,2977,2230,845,723,276,332,1605,1632,435,1514,680,0,,642
15:23:04,7126.428,Fox,3237,607,192,80,161,92,69,25,3249,3057,2977,2232,845,723,275,332,1605,1632,435,1514,681,0,,641
15:23:04,7127.028,Fox,3239,601,188,84,155,92,69,23,3249,3061,2977,2238,846,723,271,330,1605,1634,435,1520,683,0,,635
15:23:05,7127.627,Fox,3239,601,190,84,155,92,67,25,3251,3061,2977,2238,846,725,271,330,1605,1634,435,1520,683,0,,635
15:23:05,7128.228,Fox,3241,601,188,86,155,89,68,25,3251,3063,2977,2238,848,726,271,330,1606,1635,435,1521,684,0,,635
15:23:05,7128.528,Fox,3241,601,190,82,159,89,67,26,3253,3063,2981,2238,848,727,271,330,1606,1635,435,1521,684,0,,635
15:23:06,7129.428,Fox,3243,602,192,82,158,89,67,26,3255,3063,2981,2238,848,727,271,331,1607,1636,435,1522,684,0,,636
15:23:06,7130.028,Fox,3247,605,194,82,158,89,67,25,3257,3063,2981,2238,848,727,273,332,1610,1637,435,1523,684,0,,639
15:23:07,7130.627,Fox,3249,605,194,84,158,88,66,25,3259,3065,2981,2238,848,727,273,332,1611,1638,435,1525,684,0,,639
15:23:07,7131.228,Fox,3249,604,196,82,160,88,66,24,3261,3065,2983,2238,848,727,273,331,1611,1638,435,1525,685,0,,638
15:23:07,7131.828,Fox,3251,605,194,82,161,90,66,24,3263,3069,2987,2240,848,727,274,331,1613,1638,435,1526,685,0,,639
15:23:07,7132.127,Fox,3251,605,194,78,165,90,66,24,3263,3069,2991,2240,848,727,274,331,1613,1638,435,1526,685,0,,639
15:23:08,7133.028,Fox,3251,603,194,74,169,88,66,24,3263,3069,2995,2240,848,727,274,329,1613,1638,436,1527,685,0,,637
15:23:08,7133.627,Fox,3255,605,196,74,167,88,66,24,3265,3069,2995,2240,848,727,274,331,1615,1640,436,1529,685,0,,639
15:23:09,7134.228,Fox,3255,605,196,74,169,88,66,24,3267,3071,2997,2240,848,727,274,331,1615,1640,436,1529,685,0,,639
15:23:09,7134.828,Fox,3261,607,202,74,167,87,66,23,3273,3071,2997,2240,848,727,274,333,1618,1643,436,1532,686,0,,641
15:23:09,7135.127,Fox,3261,607,200,76,167,87,66,23,3273,3073,2997,2240,848,727,274,333,1618,1643,436,1532,686,0,,641
15:23:09,7135.869,Fox,3261,607,198,78,161,93,66,23,3273,3075,2997,2246,848,727,274,333,1618,1643,436,1532,686,0,,641
15:23:09,7136.369,Fox,3261,607,194,82,158,96,66,23,3273,3079,2997,2249,848,727,274,333,1618,1643,436,1532,686,0,,641
15:23:10,7136.925,Fox,3263,609,194,78,158,100,66,23,3273,3079,3001,2253,848,727,275,334,1619,1644,436,1532,686,0,,643
15:23:10,7137.524,Fox,3263,608,196,74,162,98,67,23,3275,3079,3005,2253,849,727,275,333,1619,1644,436,1533,686,0,,642
15:23:10,7138.344,Fox,3267,609,198,76,160,98,65,24,3279,3081,3005,2255,849,729,274,335,1621,1646,436,1535,687,0,,643
15:23:11,7139.208,Fox,3269,609,198,76,157,100,65,23,3279,3081,3005,2257,849,729,274,335,1622,1647,436,1536,688,0,,643
15:23:11,7139.809,Fox,3269,609,198,78,156,101,65,23,3281,3083,3005,2258,849,729,274,335,1622,1647,436,1536,688,0,,643
15:23:11,7140.708,Fox,3269,608,196,80,155,101,65,23,3281,3085,3005,2259,849,729,274,334,1622,1647,436,1537,688,0,,642
15:23:12,7141.608,Fox,3275,612,200,82,154,100,65,23,3287,3087,3005,2259,849,729,275,337,1625,1650,437,1538,688,0,,646
15:23:12,7142.203,Fox,3277,612,200,84,152,100,65,23,3289,3089,3005,2261,849,729,276,336,1627,1650,437,1540,688,0,,646
15:23:13,7142.779,Fox,3277,606,198,86,152,95,65,22,3289,3091,3005,2261,849,729,276,330,1627,1650,437,1545,689,0,,640
15:23:13,7143.379,Fox,3277,606,194,86,156,95,65,22,3289,3095,3009,2261,849,729,276,330,1627,1650,437,1545,689,0,,640
15:23:13,7143.979,Fox,3277,606,192,86,158,95,63,24,3289,3097,3011,2261,849,731,276,330,1627,1650,437,1545,689,0,,640
15:23:14,7144.58,Fox,3279,607,190,86,159,95,63,24,3289,3099,3013,2261,849,731,275,332,1627,1652,437,1546,689,0,,641
15:23:14,7145.179,Fox,3283,609,194,86,157,95,63,24,3293,3099,3013,2261,849,731,275,334,1629,1654,437,1548,689,0,,643
15:23:14,7145.479,Fox,3283,609,196,84,159,95,63,24,3295,3099,3015,2261,849,731,275,334,1629,1654,437,1548,689,0,,643
15:23:15,7146.379,Fox,3283,608,194,86,158,95,63,24,3295,3101,3015,2262,849,731,275,333,1629,1654,437,1549,689,0,,642
15:23:15,7146.979,Fox,3287,611,194,88,158,94,63,24,3297,3103,3015,2262,849,731,276,335,1631,1656,437,1550,689,0,,645
15:23:15,7147.58,Fox,3287,611,196,86,158,96,61,26,3299,3103,3017,2264,849,733,276,335,1631,1656,437,1550,689,0,,645
15:23:16,7148.479,Fox,3289,612,196,88,158,96,58,28,3301,3105,3017,2264,849,736,277,335,1632,1657,437,1550,690,0,,646
15:23:16,7148.779,Fox,3289,611,196,88,158,96,58,27,3301,3105,3017,2264,849,736,276,335,1632,1657,437,1550,691,0,,645
15:23:17,7149.679,Fox,3289,611,192,90,154,102,58,27,3301,3109,3019,2270,849,736,276,335,1632,1657,437,1550,691,0,,645
15:23:17,7150.279,Fox,3289,611,192,88,150,108,58,27,3301,3109,3021,2276,849,736,276,335,1632,1657,437,1550,691,0,,645
15:23:17,7150.879,Fox,3291,612,192,90,148,110,58,26,3303,3111,3021,2278,849,736,276,336,1633,1658,437,1550,692,0,,646
15:23:18,7151.424,Fox,3295,616,188,94,148,110,58,26,3303,3115,3021,2278,849,736,279,337,1636,1659,437,1550,692,0,,650
15:23:18,7152.024,Fox,3299,617,192,92,148,113,58,26,3311,3119,3027,2283,849,736,279,338,1638,1661,437,1553,692,0,,651
15:23:18,7152.324,Fox,3299,617,188,96,148,113,58,26,3311,3123,3027,2283,849,736,279,338,1638,1661,437,1553,692,0,,651
15:23:19,7153.524,Fox,3299,617,186,94,152,113,56,28,3311,3125,3031,2283,849,738,279,338,1638,1661,437,1553,692,0,,651
15:23:19,7154.125,Fox,3299,614,182,96,150,116,56,26,3311,3129,3033,2287,849,738,278,336,1638,1661,437,1554,694,0,,648
15:23:19,7154.424,Fox,3299,613,182,96,150,116,56,25,3311,3129,3033,2287,849,738,278,335,1638,1661,437,1554,695,0,,647
15:23:20,7155.324,Fox,3301,613,182,96,145,119,58,25,3313,3131,3035,2293,851,738,279,334,1640,1661,437,1556,695,0,,647
15:23:20,7155.924,Fox,3301,613,180,94,147,121,57,26,3313,3133,3039,2295,851,739,279,334,1640,1661,437,1556,695,0,,647
15:23:21,7157.125,Fox,3303,614,180,94,146,121,56,27,3313,3133,3039,2295,851,740,279,335,1641,1662,438,1556,695,0,,648
15:23:21,7157.724,Fox,3305,615,178,98,144,122,55,28,3315,3137,3039,2297,851,741,280,335,1642,1663,438,1557,695,0,,649
15:23:21,7158.266,Fox,3309,615,178,98,145,120,54,28,3317,3139,3041,2297,851,741,282,333,1646,1663,438,1561,695,0,,649
15:23:22,7158.866,Fox,3309,612,182,98,141,122,54,27,3321,3139,3041,2301,851,741,281,331,1646,1663,438,1563,696,0,,646
15:23:22,7159.766,Fox,3309,612,182,96,143,122,52,29,3321,3139,3043,2301,851,743,281,331,1646,1663,438,1563,696,0,,646
15:23:23,7160.366,Fox,3313,614,182,98,141,122,50,31,3323,3141,3043,2301,851,745,281,333,1648,1665,438,1565,696,0,,648
15:23:23,7160.966,Fox,3315,615,182,98,142,124,50,31,3327,3145,3047,2304,851,745,282,333,1650,1665,438,1566,696,0,,649
15:23:23,7161.565,Fox,3319,616,180,98,146,121,50,31,3329,3149,3051,2304,851,745,284,332,1653,1666,440,1567,696,0,,650
15:23:23,7162.166,Fox,3325,618,186,100,145,118,50,31,3337,3151,3051,2304,851,745,285,333,1657,1668,440,1571,696,0,,652
15:23:24,7163.343,Fox,3327,617,188,100,145,115,46,35,3339,3151,3051,2304,851,749,285,332,1658,1669,440,1574,696,0,,651
15:23:25,7163.943,Fox,3329,616,190,98,147,112,46,35,3341,3151,3053,2304,851,749,285,331,1659,1670,442,1575,696,0,,650
15:23:25,7164.843,Fox,3333,618,190,98,147,110,48,35,3343,3153,3055,2306,853,749,285,333,1661,1672,443,1576,696,0,,652
15:23:25,7165.443,Fox,3333,618,190,94,149,114,48,35,3345,3155,3061,2310,853,749,285,333,1661,1672,443,1576,696,0,,652
15:23:26,7166.043,Fox,3335,619,188,96,140,122,48,35,3345,3157,3061,2319,853,749,286,333,1662,1673,443,1577,696,0,,653
15:23:26,7166.643,Fox,3335,619,190,94,141,122,49,35,3347,3157,3063,2320,854,749,286,333,1662,1673,443,1577,696,0,,653
15:23:26,7167.243,Fox,3335,619,190,94,134,126,52,35,3347,3157,3063,2327,857,749,286,333,1662,1673,443,1577,696,0,,653
15:23:27,7167.843,Fox,3343,621,190,94,133,121,53,34,3347,3157,3063,2328,858,749,288,333,1667,1676,445,1580,697,0,,655
15:23:27,7168.443,Fox,3345,617,200,94,133,116,53,33,3357,3157,3063,2328,858,749,288,329,1668,1677,446,1584,698,0,,651
15:23:27,7169.043,Fox,3347,616,202,94,133,114,54,31,3359,3157,3063,2328,859,749,286,330,1668,1679,446,1585,700,0,,650
15:23:28,7169.643,Fox,3349,618,204,92,131,118,53,32,3361,3157,3065,2332,859,750,287,331,1669,1680,446,1585,700,0,,652
15:23:28,7170.243,Fox,3353,620,205,96,130,117,53,32,3366,3161,3065,2332,859,750,286,334,1670,1683,446,1587,700,0,,654
15:23:28,7170.843,Fox,3357,622,207,94,134,117,53,30,3370,3163,3069,2332,859,750,287,335,1672,1685,446,1587,702,0,,656
15:23:29,7171.443,Fox,3365,626,207,98,128,119,53,30,3374,3167,3069,2336,859,750,284,342,1673,1692,446,1591,702,0,,660
15:23:29,7172.043,Fox,3369,630,213,98,128,117,55,30,3380,3167,3069,2336,861,750,286,344,1675,1694,446,1591,702,0,,664
15:23:30,7172.643,Fox,3373,634,217,98,126,119,55,30,3384,3167,3069,2338,861,750,289,345,1678,1695,446,1591,702,0,,668
15:23:30,7172.943,Fox,3373,634,219,96,128,119,55,30,3386,3167,3071,2338,861,750,289,345,1678,1695,446,1591,702,0,,668
15:23:30,7173.843,Fox,3373,634,215,98,130,119,55,30,3386,3171,3073,2338,861,750,289,345,1678,1695,446,1591,702,0,,668
15:23:31,7174.443,Fox,3375,635,209,104,130,121,55,29,3388,3179,3075,2340,861,750,290,345,1679,1696,446,1591,703,0,,669
15:23:31,7175.043,Fox,3383,639,211,100,133,116,57,29,3390,3179,3079,2340,863,750,288,351,1681,1702,447,1594,703,0,,673
15:23:31,7175.643,Fox,3383,637,217,100,131,116,57,29,3396,3179,3079,2342,863,750,287,350,1681,1702,447,1596,703,0,,671
15:23:32,7176.543,Fox,3385,634,219,100,128,114,57,29,3398,3179,3079,2344,863,750,286,348,1682,1703,447,1601,703,0,,668
15:23:32,7177.143,Fox,3387,631,219,98,127,112,57,29,3398,3179,3081,2347,863,750,287,344,1683,1704,448,1605,703,0,,665
15:23:32,7177.743,Fox,3391,634,221,100,121,117,57,29,3402,3181,3081,2352,863,750,288,346,1685,1706,448,1606,703,0,,668
15:23:33,7178.343,Fox,3395,638,223,98,123,117,56,30,3404,3181,3083,2352,863,751,290,348,1687,1708,448,1606,703,0,,672
15:23:33,7178.943,Fox,3395,638,227,96,125,117,56,30,3408,3181,3085,2352,863,751,290,348,1687,1708,448,1606,703,0,,672
15:23:33,7179.543,Fox,3397,639,227,98,124,117,56,30,3410,3183,3085,2352,863,751,289,350,1687,1710,448,1607,703,0,,673
15:23:34,7180.443,Fox,3403,642,233,96,126,114,53,33,3416,3183,3087,2352,863,754,290,352,1691,1712,448,1610,703,0,,676
15:23:34,7181.043,Fox,3407,645,233,92,121,122,53,33,3416,3183,3091,2361,863,754,291,354,1693,1714,448,1611,703,0,,679
15:23:34,7181.343,Fox,3407,645,237,92,121,122,53,33,3420,3183,3091,2361,863,754,291,354,1693,1714,448,1611,703,0,,679
15:23:35,7182.243,Fox,3415,649,241,88,122,121,53,33,3424,3183,3095,2363,863,754,291,358,1697,1718,448,1615,703,0,,683
15:23:35,7182.843,Fox,3415,647,241,88,126,117,55,33,3428,3187,3099,2363,865,754,291,356,1697,1718,448,1617,703,0,,681
15:23:36,7183.743,Fox,3415,647,237,92,125,117,56,33,3428,3191,3099,2364,866,754,291,356,1697,1718,448,1617,703,0,,681
15:23:36,7184.343,Fox,3417,640,237,92,123,110,56,33,3428,3191,3099,2366,866,754,292,348,1699,1718,448,1626,703,0,,674
15:23:36,7184.943,Fox,3417,637,235,94,118,114,55,34,3430,3195,3101,2373,866,755,291,346,1699,1718,448,1629,703,0,,671
15:23:37,7185.543,Fox,3419,637,235,92,117,115,55,34,3430,3195,3103,2375,866,755,291,346,1700,1719,448,1631,703,0,,671
15:23:37,7186.143,Fox,3421,636,237,92,116,115,54,33,3432,3195,3103,2376,866,755,291,345,1702,1719,448,1633,704,0,,670
15:23:38,7186.743,Fox,3423,638,235,96,118,115,54,33,3436,3201,3105,2376,866,755,292,346,1703,1720,448,1633,704,0,,672
15:23:38,7187.343,Fox,3427,639,237,96,117,115,54,31,3438,3201,3105,2376,866,755,292,347,1705,1722,448,1634,706,0,,673
15:23:38,7187.943,Fox,3433,641,241,94,117,113,54,31,3442,3201,3107,2376,866,755,292,349,1708,1725,448,1638,706,0,,675
15:23:39,7188.543,Fox,3437,643,245,92,118,112,54,31,3446,3201,3109,2376,866,755,292,351,1710,1727,448,1640,706,0,,677
15:23:39,7189.143,Fox,3437,643,249,92,116,114,54,31,3450,3201,3109,2378,866,755,292,351,1710,1727,448,1640,706,0,,677
15:23:39,7189.743,Fox,3437,643,249,88,120,114,54,31,3450,3201,3113,2378,866,755,292,351,1710,1727,448,1640,706,0,,677
15:23:40,7190.343,Fox,3439,643,241,92,123,114,54,30,3450,3209,3117,2378,866,755,292,351,1712,1727,448,1641,707,0,,677
15:23:40,7190.943,Fox,3441,645,245,86,129,114,54,30,3454,3209,3123,2378,866,755,293,352,1713,1728,448,1641,707,0,,679
15:23:41,7191.843,Fox,3441,645,243,86,129,116,51,33,3454,3211,3125,2380,866,758,293,352,1713,1728,448,1641,707,0,,679
15:23:41,7192.443,Fox,3441,642,243,82,131,116,51,32,3454,3211,3129,2382,866,758,292,350,1713,1728,448,1643,708,0,,676
15:23:41,7193.043,Fox,3441,642,241,84,127,120,47,36,3454,3213,3129,2386,866,762,292,350,1713,1728,448,1643,708,0,,676
15:23:42,7193.643,Fox,3441,641,239,84,127,122,46,36,3454,3215,3131,2388,866,763,292,349,1713,1728,448,1643,709,0,,675
15:23:42,7194.243,Fox,3445,637,239,82,128,115,46,36,3454,3215,3133,2388,866,763,290,347,1715,1730,449,1650,709,0,,671
15:23:42,7194.843,Fox,3447,636,243,82,126,115,46,35,3458,3215,3133,2390,866,763,290,346,1716,1731,449,1652,710,0,,670
15:23:42,7195.143,Fox,3447,631,243,84,126,110,46,35,3460,3217,3133,2390,866,763,289,342,1716,1731,449,1657,710,0,,665
15:23:43,7196.043,Fox,3447,630,239,84,130,107,48,35,3460,3221,3137,2390,868,763,289,341,1716,1731,449,1658,710,0,,664
15:23:43,7196.643,Fox,3449,630,241,82,131,106,48,35,3462,3221,3139,2390,868,763,289,341,1717,1732,449,1660,710,0,,664
15:23:44,7197.543,Fox,3449,629,241,82,130,106,48,35,3462,3221,3139,2391,868,763,289,340,1717,1732,449,1661,710,0,,663
15:23:44,7198.143,Fox,3451,629,241,82,127,107,48,35,3462,3221,3139,2394,868,763,287,342,1717,1734,449,1663,710,0,,663
15:23:45,7198.743,Fox,3451,628,243,80,129,106,48,35,3464,3221,3141,2394,868,763,287,341,1717,1734,449,1664,710,0,,662
15:23:45,7199.343,Fox,3451,628,237,82,133,106,48,35,3464,3227,3145,2394,868,763,287,341,1717,1734,449,1664,710,0,,662
15:23:45,7199.943,Fox,3453,629,235,82,136,106,48,35,3466,3231,3149,2394,868,763,287,342,1718,1735,449,1665,710,0,,663
15:23:46,7200.543,Fox,3453,628,235,80,138,106,48,34,3466,3231,3151,2394,868,763,287,341,1718,1735,449,1665,711,0,,662
15:23:46,7201.143,Fox,3453,623,235,80,138,102,47,34,3466,3231,3151,2394,868,764,285,338,1718,1735,449,1669,712,0,,657
15:23:46,7202.043,Fox,3457,624,237,82,136,101,47,34,3470,3233,3151,2394,868,764,285,339,1720,1737,449,1672,712,0,,658
15:23:47,7202.343,Fox,3457,620,235,84,136,97,46,35,3470,3235,3151,2394,868,765,285,335,1720,1737,449,1676,712,0,,654
15:23:47,7203.243,Fox,3457,616,235,82,138,93,45,36,3470,3235,3153,2394,868,766,284,332,1720,1737,449,1680,712,0,,650
15:23:47,7203.843,Fox,3461,619,235,80,137,95,45,36,3470,3235,3155,2397,868,766,286,333,1723,1738,449,1681,712,0,,653
15:23:48,7204.443,Fox,3465,618,239,78,137,92,45,36,3474,3235,3157,2399,868,766,286,332,1724,1741,449,1686,712,0,,652
15:23:48,7205.043,Fox,3465,616,239,82,135,94,45,34,3478,3239,3157,2401,868,766,284,332,1724,1741,449,1686,714,0,,650
15:23:49,7205.643,Fox,3467,618,239,84,135,94,45,34,3480,3241,3157,2401,868,766,285,333,1725,1742,449,1686,714,0,,652
15:23:49,7206.243,Fox,3467,617,237,86,133,95,45,34,3480,3243,3157,2403,868,766,285,332,1725,1742,449,1687,714,0,,651
15:23:50,7207.723,Fox,3469,618,235,88,131,95,46,34,3480,3245,3157,2404,869,766,284,334,1725,1744,449,1688,714,0,,652
15:23:50,7208.323,Fox,3474,621,237,92,129,95,46,34,3486,3249,3157,2404,869,766,286,335,1729,1745,449,1690,714,0,,655
15:23:50,7208.623,Fox,3474,620,239,88,133,94,46,34,3488,3249,3161,2404,869,766,286,334,1729,1745,449,1691,714,0,,654
15:23:51,7209.523,Fox,3474,620,239,84,137,94,46,34,3488,3249,3165,2404,869,766,286,334,1729,1745,449,1691,714,0,,654
15:23:51,7210.123,Fox,3474,619,237,84,138,94,46,34,3488,3251,3167,2405,869,766,286,333,1729,1745,449,1692,714,0,,653
15:23:51,7210.723,Fox,3476,620,239,84,136,91,50,34,3490,3251,3167,2406,873,766,285,335,1729,1747,449,1693,714,0,,654
15:23:52,7211.323,Fox,3476,616,237,86,136,85,52,34,3490,3253,3167,2406,875,766,284,332,1729,1747,449,1697,714,0,,650
15:23:52,7211.923,Fox,3478,617,239,82,140,84,52,34,3492,3253,3171,2406,875,766,285,332,1730,1748,449,1698,714,0,,651
15:23:53,7212.523,Fox,3480,614,239,78,141,85,52,33,3494,3255,3177,2411,875,766,284,330,1731,1749,449,1702,715,0,,648
15:23:53,7213.123,Fox,3482,616,237,80,143,85,52,33,3496,3259,3179,2411,875,766,285,331,1732,1750,449,1702,715,0,,650
15:23:53,7213.723,Fox,3484,614,235,82,138,89,50,32,3496,3261,3179,2415,875,768,285,329,1734,1750,449,1703,718,0,,648
15:23:53,7214.023,Fox,3484,614,237,82,138,89,50,32,3498,3261,3179,2415,875,768,285,329,1734,1750,449,1703,718,0,,648
15:23:54,7214.923,Fox,3484,607,235,84,136,84,50,32,3498,3263,3179,2417,875,768,282,325,1734,1750,449,1710,718,0,,641
15:23:54,7215.823,Fox,3484,605,235,84,134,84,50,32,3498,3263,3179,2419,875,768,282,323,1734,1750,449,1712,718,0,,639
15:23:55,7216.423,Fox,3484,604,233,84,133,85,51,32,3498,3265,3181,2422,876,768,282,322,1734,1750,449,1713,718,0,,638
15:23:55,7217.023,Fox,3484,595,231,86,133,76,51,32,3498,3267,3181,2422,876,768,280,315,1734,1750,449,1722,718,0,,629
15:23:55,7217.623,Fox,3484,595,225,90,135,76,51,32,3498,3273,3183,2422,876,768,280,315,1734,1750,449,1722,718,0,,629
15:23:56,7218.823,Fox,3490,599,229,90,133,76,52,31,3502,3273,3183,2423,877,768,283,316,1738,1752,449,1723,719,0,,633
15:23:56,7219.423,Fox,3490,597,231,90,133,76,50,31,3504,3273,3183,2423,877,770,283,314,1738,1752,449,1723,721,0,,631
15:23:57,7220.323,Fox,3492,598,229,92,132,75,51,31,3504,3275,3183,2424,878,770,282,316,1738,1754,449,1724,721,0,,632
15:23:57,7220.923,Fox,3492,597,227,96,132,75,51,30,3506,3279,3183,2424,878,770,282,315,1738,1754,449,1724,722,0,,631
15:23:57,7221.523,Fox,3496,600,227,92,132,78,51,30,3506,3279,3187,2427,878,770,285,315,1742,1754,449,1725,722,0,,634
15:23:58,7222.123,Fox,3496,598,229,90,132,80,51,30,3510,3281,3191,2431,878,770,283,315,1742,1754,450,1726,722,0,,632
15:23:58,7222.723,Fox,3496,596,229,90,132,78,51,30,3510,3281,3191,2431,878,770,282,314,1742,1754,450,1728,722,0,,630
15:23:58,7223.378,Fox,3498,598,229,86,136,78,50,31,3510,3281,3195,2431,878,771,283,315,1743,1755,450,1728,722,0,,632
15:23:58,7223.561,Fox,3498,598,231,86,136,78,50,31,3512,3281,3195,2431,878,771,283,315,1743,1755,450,1728,722,0,,632
15:23:58,7224.239,Fox,3502,599,225,92,132,80,50,30,3512,3287,3195,2433,878,771,285,314,1747,1755,450,1730,723,0,,633
15:23:59,7224.659,Fox,3502,596,227,88,138,78,50,29,3516,3289,3201,2433,878,771,284,312,1747,1755,450,1732,724,0,,630
15:23:59,7225.559,Fox,3504,596,227,88,134,80,50,29,3516,3289,3201,2436,878,771,283,313,1747,1757,450,1734,724,0,,630
15:23:59,7226.159,Fox,3510,601,231,88,129,84,50,29,3520,3289,3201,2440,878,771,284,317,1749,1761,450,1735,724,0,,635
15:24:00,7226.459,Fox,3510,599,235,88,129,82,50,29,3524,3289,3201,2440,878,771,284,315,1749,1761,450,1737,724,0,,633
15:24:00,7227.059,Fox,3510,598,235,88,127,84,49,29,3524,3289,3201,2442,878,771,283,315,1749,1761,450,1738,724,0,,632
15:24:01,7227.959,Fox,3516,601,235,92,124,84,49,29,3528,3293,3201,2442,878,771,285,316,1754,1762,450,1741,724,0,,635
15:24:01,7228.559,Fox,3520,604,237,94,124,84,48,29,3532,3295,3201,2442,878,771,285,319,1755,1765,450,1742,724,0,,638
15:24:01,7229.159,Fox,3522,604,241,86,131,83,46,31,3536,3295,3209,2442,878,773,284,320,1755,1767,450,1744,724,0,,638
15:24:01,7229.759,Fox,3524,601,241,88,128,81,45,32,3538,3297,3209,2444,879,775,283,318,1755,1769,450,1748,725,0,,635
15:24:02,7230.359,Fox,3526,602,239,88,129,80,46,32,3538,3299,3211,2444,880,775,284,318,1757,1769,450,1749,725,0,,636
15:24:02,7230.959,Fox,3528,603,241,88,125,83,46,32,3540,3299,3211,2447,880,775,284,319,1758,1770,450,1750,725,0,,637
15:24:02,7231.559,Fox,3532,606,241,88,127,82,46,32,3542,3301,3213,2447,880,775,285,321,1760,1772,450,1751,725,0,,640
15:24:03,7232.159,Fox,3532,604,245,86,128,81,47,31,3546,3301,3215,2447,881,775,284,320,1760,1772,450,1752,726,0,,638
15:24:03,7232.759,Fox,3536,606,247,86,126,81,47,31,3548,3301,3215,2447,881,775,283,323,1761,1775,450,1754,726,0,,640
15:24:03,7233.359,Fox,3538,608,251,86,125,82,47,31,3552,3301,3215,2448,881,775,284,324,1762,1776,450,1754,726,0,,642
15:24:04,7233.959,Fox,3542,611,251,86,126,82,47,31,3554,3303,3217,2448,881,775,286,325,1765,1777,450,1755,726,0,,645
15:24:04,7234.559,Fox,3542,610,245,90,129,83,47,30,3556,3311,3221,2449,881,775,285,325,1765,1777,450,1755,727,0,,644
15:24:04,7235.159,Fox,3546,612,247,90,126,84,45,32,3558,3311,3221,2450,881,777,285,327,1767,1779,451,1756,727,0,,646
15:24:05,7235.759,Fox,3548,610,251,90,123,83,46,31,3562,3311,3221,2453,882,777,285,325,1769,1779,451,1759,728,0,,644
15:24:05,7236.359,Fox,3552,612,253,90,122,82,46,31,3564,3311,3221,2453,882,777,286,326,1772,1780,452,1760,728,0,,646
15:24:05,7236.959,Fox,3552,611,255,90,122,81,46,31,3566,3311,3221,2453,882,777,286,325,1772,1780,452,1761,728,0,,645
15:24:06,7237.559,Fox,3552,610,255,86,125,82,46,30,3566,3311,3225,2454,882,777,286,324,1772,1780,452,1761,729,0,,644
15:24:06,7238.159,Fox,3556,612,257,84,128,81,46,30,3570,3313,3229,2454,882,777,286,326,1774,1782,452,1763,729,0,,646
15:24:06,7238.759,Fox,3562,616,259,82,127,82,46,30,3572,3313,3231,2456,882,777,289,327,1779,1783,452,1765,729,0,,650
15:24:07,7239.359,Fox,3562,616,263,82,126,83,46,30,3576,3313,3231,2457,882,777,289,327,1779,1783,452,1765,729,0,,650
15:24:07,7239.959,Fox,3562,615,261,84,126,83,46,29,3576,3315,3231,2457,882,777,289,326,1779,1783,452,1765,730,0,,649
15:24:07,7240.559,Fox,3562,614,259,84,127,83,44,31,3576,3317,3233,2458,882,779,289,325,1779,1783,452,1766,730,0,,648
15:24:08,7241.159,Fox,3562,613,255,86,127,85,44,30,3576,3321,3235,2460,882,779,288,325,1779,1783,452,1766,731,0,,647
15:24:08,7241.759,Fox,3564,614,257,86,127,84,44,30,3578,3321,3235,2460,882,779,287,327,1779,1785,452,1767,731,0,,648
15:24:09,7242.659,Fox,3566,615,257,86,123,87,44,30,3578,3321,3235,2463,882,779,288,327,1781,1785,452,1768,731,0,,649
15:24:09,7243.259,Fox,3568,616,255,86,124,88,44,31,3580,3325,3239,2466,883,780,289,327,1782,1786,452,1769,731,0,,650
15:24:09,7243.859,Fox,3570,614,257,88,124,83,46,30,3584,3327,3239,2466,885,780,289,325,1783,1787,452,1773,731,0,,648
15:24:10,7244.459,Fox,3576,618,257,90,125,83,45,30,3588,3331,3241,2466,885,780,289,329,1785,1791,452,1775,731,0,,652
15:24:10,7245.059,Fox,3578,617,255,94,125,82,45,30,3592,3337,3243,2467,885,780,289,328,1786,1792,452,1778,731,0,,651
15:24:10,7245.959,Fox,3578,616,253,94,125,83,45,30,3592,3339,3245,2469,885,780,289,327,1786,1792,452,1779,731,0,,650
15:24:11,7246.559,Fox,3580,616,253,92,129,81,45,30,3594,3341,3249,2469,885,780,290,326,1787,1793,453,1780,731,0,,650
15:24:11,7247.459,Fox,3582,617,253,94,127,81,46,30,3596,3343,3249,2471,886,780,289,328,1787,1795,453,1781,731,0,,651
15:24:11,7247.759,Fox,3582,617,251,96,127,81,46,30,3596,3345,3249,2471,886,780,289,328,1787,1795,453,1781,731,0,,651
15:24:12,7248.659,Fox,3584,618,253,94,125,84,46,30,3598,3345,3251,2474,886,780,290,328,1789,1795,453,1782,731,0,,652
15:24:12,7249.259,Fox,3586,615,251,96,125,82,45,28,3598,3347,3251,2474,886,781,289,326,1790,1796,453,1784,734,0,,649
15:24:12,7249.859,Fox,3588,615,255,94,126,81,46,27,3602,3347,3253,2475,887,781,289,326,1790,1798,453,1785,735,0,,649
15:24:13,7250.459,Fox,3590,616,257,92,124,84,46,27,3604,3347,3255,2479,887,781,289,327,1791,1799,453,1786,735,0,,650
15:24:13,7251.059,Fox,3592,617,247,100,123,86,46,27,3604,3357,3257,2482,887,781,289,328,1792,1800,453,1787,735,0,,651
15:24:13,7251.659,Fox,3594,619,247,100,121,90,46,27,3606,3359,3259,2486,887,781,291,328,1794,1800,453,1787,735,0,,653
15:24:14,7252.259,Fox,3594,619,247,100,122,91,46,27,3608,3361,3261,2487,887,781,291,328,1794,1800,453,1787,735,0,,653
15:24:14,7252.859,Fox,3596,620,244,103,123,92,46,26,3610,3366,3263,2488,887,781,292,328,1795,1801,453,1787,736,0,,654
15:24:14,7253.38,Fox,3598,621,240,107,122,93,45,26,3610,3370,3263,2489,887,781,292,329,1796,1802,453,1788,736,0,,655
15:24:14,7253.826,Fox,3600,622,244,107,121,94,44,26,3614,3370,3263,2490,887,782,292,330,1796,1804,453,1788,737,0,,656
15:24:14,7254.233,Fox,3600,620,236,115,121,92,45,25,3614,3378,3263,2490,889,783,292,328,1796,1804,453,1788,739,0,,654
15:24:15,7254.937,Fox,3602,621,234,115,123,93,45,25,3616,3382,3267,2491,889,783,292,329,1797,1805,453,1789,739,0,,655
15:24:15,7255.537,Fox,3602,616,230,119,123,89,45,24,3616,3386,3267,2491,889,783,291,325,1797,1805,453,1793,740,0,,650
15:24:15,7255.837,Fox,3602,616,230,113,129,89,45,24,3616,3386,3273,2491,889,783,291,325,1797,1805,453,1793,740,0,,650
15:24:16,7256.737,Fox,3604,617,230,113,126,91,45,24,3616,3386,3273,2493,889,783,291,326,1798,1806,453,1794,740,0,,651
15:24:16,7257.337,Fox,3606,618,232,115,124,92,45,24,3620,3388,3273,2495,889,783,292,326,1800,1806,453,1795,740,0,,652
15:24:16,7257.937,Fox,3608,619,226,123,123,92,45,24,3622,3396,3273,2495,889,783,291,328,1800,1808,454,1795,740,0,,653
15:24:17,7258.537,Fox,3608,616,226,121,125,89,44,25,3622,3396,3275,2495,889,784,291,325,1800,1808,454,1798,740,0,,650
15:24:17,7259.137,Fox,3608,616,224,123,123,86,49,25,3622,3398,3275,2497,894,784,291,325,1800,1808,454,1798,740,0,,650
15:24:17,7259.737,Fox,3610,615,226,119,126,83,51,24,3624,3398,3279,2498,896,784,292,323,1801,1809,454,1800,741,0,,649
15:24:17,7260.337,Fox,3612,616,222,123,121,87,51,24,3624,3402,3279,2502,896,784,291,325,1801,1811,454,1801,741,0,,650
15:24:18,7260.937,Fox,3612,616,222,123,121,87,51,26,3626,3404,3281,2504,898,786,291,325,1801,1811,454,1801,741,0,,650
15:24:18,7261.237,Fox,3612,616,218,127,121,87,51,26,3626,3408,3281,2504,898,786,291,325,1801,1811,454,1801,741,0,,650
15:24:18,7262.137,Fox,3614,616,218,129,121,87,51,24,3628,3410,3281,2504,898,786,291,325,1801,1813,454,1801,743,0,,650
15:24:19,7262.737,Fox,3616,618,220,123,127,87,49,26,3630,3410,3287,2504,898,788,293,325,1803,1813,454,1801,743,0,,652
15:24:19,7263.337,Fox,3620,620,216,127,127,87,49,26,3632,3416,3289,2504,898,788,292,328,1804,1816,454,1803,743,0,,654
15:24:19,7263.937,Fox,3620,619,214,131,125,89,49,25,3634,3420,3289,2506,898,788,291,328,1804,1816,454,1803,744,0,,653
15:24:20,7264.537,Fox,3624,620,218,131,120,91,48,26,3638,3420,3289,2510,898,789,291,329,1806,1818,454,1806,744,0,,654
15:24:20,7265.137,Fox,3626,621,210,139,120,91,48,25,3638,3428,3289,2510,898,789,291,330,1807,1819,454,1806,745,0,,655
15:24:20,7265.737,Fox,3628,623,214,139,120,91,47,26,3642,3428,3289,2510,898,790,293,330,1809,1819,454,1806,745,0,,657
15:24:21,7266.337,Fox,3630,624,216,135,124,89,48,26,3644,3428,3293,2510,899,790,294,330,1811,1819,454,1807,745,0,,658
15:24:21,7266.937,Fox,3636,628,220,133,124,89,48,26,3648,3428,3295,2510,899,790,295,333,1814,1822,454,1809,745,0,,662
15:24:21,7267.537,Fox,3640,629,222,135,123,87,48,26,3652,3430,3295,2510,899,790,294,335,1816,1824,454,1812,745,0,,663
15:24:22,7268.052,Fox,3640,629,224,133,125,87,48,26,3654,3430,3297,2510,899,790,294,335,1816,1824,454,1812,745,0,,663
15:24:22,7268.397,Fox,3642,630,222,133,126,87,48,26,3654,3432,3299,2510,899,790,293,337,1816,1826,454,1813,745,0,,664
15:24:22,7268.793,Fox,3644,631,226,133,125,87,48,26,3658,3432,3299,2510,899,790,292,339,1816,1828,454,1814,745,0,,665
15:24:22,7269.278,Fox,3644,631,222,137,122,90,48,26,3658,3436,3299,2513,899,790,292,339,1816,1828,454,1814,745,0,,665
15:24:22,7269.878,Fox,3644,627,220,137,123,88,48,25,3658,3438,3301,2514,899,790,291,336,1816,1828,454,1817,746,0,,661
15:24:23,7270.478,Fox,3644,627,216,141,119,92,48,25,3658,3442,3301,2518,899,790,291,336,1816,1828,454,1817,746,0,,661
15:24:23,7270.987,Fox,3644,625,212,145,119,92,48,23,3658,3446,3301,2518,899,790,291,334,1816,1828,454,1817,748,0,,659
15:24:23,7271.481,Fox,3644,625,208,149,119,91,49,23,3658,3450,3301,2518,900,790,291,334,1816,1828,454,1817,748,0,,659
15:24:23,7272.081,Fox,3644,624,208,147,121,90,49,23,3658,3450,3303,2518,900,790,291,333,1816,1828,454,1818,748,0,,658
15:24:24,7272.681,Fox,3644,623,208,147,117,94,49,22,3658,3450,3303,2522,900,790,291,332,1816,1828,454,1818,749,0,,657
15:24:24,7273.281,Fox,3646,622,206,141,119,97,49,22,3658,3452,3311,2527,900,790,291,331,1817,1829,454,1821,749,0,,656
15:24:24,7273.881,Fox,3650,624,210,143,119,96,49,21,3664,3454,3311,2527,900,790,293,331,1820,1830,454,1822,750,0,,658
15:24:25,7274.481,Fox,3656,629,214,143,119,95,48,22,3668,3454,3311,2527,900,791,294,335,1822,1834,454,1823,750,0,,663
15:24:25,7275.081,Fox,3660,630,220,143,117,94,48,22,3674,3454,3311,2527,900,791,293,337,1823,1837,454,1826,750,0,,664
15:24:25,7275.855,Fox,3660,628,220,143,117,94,48,20,3674,3454,3311,2527,900,791,292,336,1823,1837,454,1826,752,0,,662
15:24:26,7276.755,Fox,3662,623,222,141,116,90,48,20,3676,3454,3313,2529,900,791,291,332,1825,1837,454,1833,752,0,,657
15:24:26,7277.055,Fox,3662,623,218,145,116,90,48,20,3676,3458,3313,2529,900,791,291,332,1825,1837,454,1833,752,0,,657
15:24:27,7277.956,Fox,3664,624,216,147,115,90,48,20,3676,3460,3313,2529,900,791,292,332,1827,1837,454,1834,752,0,,658
15:24:27,7278.555,Fox,3666,624,218,145,116,89,48,20,3678,3460,3315,2530,900,791,292,332,1828,1838,454,1836,752,0,,658
15:24:27,7279.155,Fox,3668,621,218,145,117,85,48,20,3680,3462,3317,2530,900,791,290,331,1829,1839,454,1841,752,0,,655
15:24:27,7279.755,Fox,3668,621,220,141,121,85,48,20,3682,3462,3321,2530,900,791,290,331,1829,1839,454,1841,752,0,,655
15:24:27,7280.055,Fox,3668,620,220,141,121,84,48,20,3682,3462,3321,2530,900,791,290,330,1829,1839,454,1842,752,0,,654
15:24:28,7280.956,Fox,3670,620,220,143,121,82,48,20,3684,3464,3321,2530,900,791,290,330,1830,1840,454,1844,752,0,,654
15:24:28,7281.555,Fox,3676,622,224,141,121,80,48,20,3688,3464,3323,2530,900,791,291,331,1834,1842,455,1847,752,0,,656
15:24:29,7282.155,Fox,3676,619,226,137,122,81,48,19,3690,3464,3327,2533,900,791,290,329,1834,1842,455,1849,753,0,,653
15:24:29,7282.755,Fox,3680,618,226,137,118,80,50,19,3692,3466,3329,2537,902,791,291,327,1837,1843,455,1854,753,0,,652
15:24:29,7283.355,Fox,3684,622,228,129,126,80,50,19,3694,3466,3337,2537,902,791,291,331,1837,1847,455,1854,753,0,,656
15:24:30,7283.956,Fox,3688,623,234,129,122,81,50,19,3700,3466,3337,2539,902,791,291,332,1839,1849,455,1857,753,0,,657
15:24:30,7284.555,Fox,3690,623,234,131,124,80,50,18,3704,3470,3339,2539,902,791,291,332,1840,1850,455,1858,754,0,,657
15:24:30,7285.456,Fox,3690,622,234,129,123,83,50,17,3704,3470,3341,2542,902,791,290,332,1840,1850,455,1858,755,0,,656
15:24:31,7286.055,Fox,3690,619,234,127,125,81,50,16,3704,3470,3343,2542,902,791,289,330,1840,1850,455,1860,756,0,,653
15:24:31,7286.655,Fox,3690,617,230,129,127,77,52,16,3704,3474,3345,2542,904,791,288,329,1840,1850,455,1862,756,0,,651
15:24:31,7287.255,Fox,3692,618,228,133,126,76,53,16,3706,3478,3345,2542,905,791,288,330,1841,1851,455,1863,756,0,,652
15:24:31,7287.555,Fox,3692,618,228,131,128,76,53,16,3706,3478,3347,2542,905,791,288,330,1841,1851,455,1863,756,0,,652
15:24:32,7288.155,Fox,3692,618,226,133,128,76,53,16,3706,3480,3347,2542,905,791,288,330,1841,1851,455,1863,756,0,,652
15:24:33,7289.655,Fox,3694,620,226,123,133,81,53,16,3706,3480,3357,2547,905,791,289,331,1842,1852,455,1863,756,0,,654
15:24:33,7290.255,Fox,3700,621,234,121,132,80,53,15,3714,3480,3359,2547,905,791,288,333,1845,1855,455,1867,757,0,,655
15:24:33,7290.855,Fox,3700,618,228,125,133,79,53,14,3714,3486,3361,2548,905,791,287,331,1845,1855,455,1869,758,0,,652
15:24:33,7291.456,Fox,3700,617,226,122,138,79,53,13,3714,3488,3366,2548,905,791,287,330,1845,1855,455,1869,759,0,,651
15:24:34,7292.055,Fox,3700,614,226,118,141,78,53,12,3714,3488,3370,2549,905,791,286,328,1845,1855,455,1871,760,0,,648
15:24:34,7292.655,Fox,3700,612,226,114,143,78,53,12,3714,3488,3374,2551,905,791,286,326,1845,1855,455,1873,760,0,,646
15:24:34,7293.255,Fox,3700,612,224,110,149,78,51,14,3714,3490,3380,2551,905,793,286,326,1845,1855,455,1873,760,0,,646
15:24:35,7293.855,Fox,3700,612,224,106,153,78,51,14,3714,3490,3384,2551,905,793,286,326,1845,1855,455,1873,760,0,,646
15:24:35,7294.456,Fox,3702,613,224,106,153,79,51,14,3716,3492,3386,2552,905,793,286,327,1846,1856,455,1874,760,0,,647
15:24:36,7295.055,Fox,3704,612,224,108,150,80,51,13,3718,3494,3386,2555,905,793,284,328,1846,1858,455,1876,761,0,,646
15:24:36,7295.956,Fox,3706,613,222,108,151,80,51,13,3718,3496,3388,2555,905,793,284,329,1847,1859,455,1877,761,0,,647
15:24:36,7296.555,Fox,3706,613,222,102,159,80,51,13,3720,3498,3396,2555,905,793,284,329,1847,1859,455,1877,761,0,,647
15:24:37,7298.055,Fox,3706,613,222,100,158,82,52,13,3720,3498,3398,2558,906,793,284,329,1847,1859,455,1877,761,0,,647
15:24:37,7298.655,Fox,3708,613,222,98,157,82,53,13,3720,3498,3400,2561,907,793,284,329,1848,1860,455,1879,761,0,,647
15:24:38,7299.255,Fox,3710,611,226,94,159,81,53,12,3724,3498,3404,2562,907,793,285,326,1850,1860,455,1882,762,0,,645
15:24:38,7299.855,Fox,3712,609,226,90,162,76,55,12,3724,3498,3408,2562,909,793,285,324,1851,1861,455,1886,762,0,,643
15:24:38,7300.155,Fox,3712,609,228,90,162,76,55,12,3726,3498,3408,2562,909,793,285,324,1851,1861,455,1886,762,0,,643
15:24:38,7300.755,Fox,3712,608,228,88,162,78,55,11,3726,3498,3410,2564,909,793,285,323,1851,1861,455,1886,763,0,,642
15:24:39,7301.655,Fox,3718,613,226,88,165,80,55,11,3730,3504,3416,2566,909,793,285,328,1852,1866,455,1887,763,0,,647
15:24:39,7302.255,Fox,3718,608,228,88,165,75,53,13,3732,3504,3416,2566,909,795,285,323,1852,1866,455,1892,763,0,,642
15:24:39,7302.555,Fox,3718,608,228,84,169,75,53,13,3732,3504,3420,2566,909,795,285,323,1852,1866,455,1892,763,0,,642
15:24:40,7303.456,Fox,3722,610,226,82,171,75,53,13,3732,3506,3424,2566,909,795,285,325,1854,1868,455,1894,763,0,,644
15:24:40,7304.055,Fox,3724,611,232,78,172,77,52,14,3738,3506,3428,2568,909,796,286,325,1856,1868,455,1895,763,0,,645
15:24:40,7304.655,Fox,3724,609,228,82,170,78,50,15,3738,3510,3428,2570,909,798,286,323,1856,1868,455,1896,764,0,,643
15:24:41,7305.255,Fox,3726,608,230,82,168,77,49,16,3740,3510,3428,2571,909,799,287,321,1858,1868,456,1898,764,0,,642
15:24:41,7306.155,Fox,3726,608,230,80,170,74,52,16,3740,3510,3430,2571,912,799,287,321,1858,1868,456,1898,764,0,,642
15:24:42,7306.755,Fox,3726,607,228,82,166,77,52,16,3740,3512,3430,2575,912,799,287,320,1858,1868,456,1899,764,0,,641
15:24:42,7307.355,Fox,3732,611,226,84,167,73,55,16,3742,3516,3432,2575,915,799,289,322,1862,1870,456,1901,764,0,,645
15:24:42,7307.956,Fox,3738,614,232,80,169,72,55,16,3748,3516,3436,2575,915,799,290,324,1866,1872,456,1904,764,0,,648
15:24:43,7308.555,Fox,3746,620,240,80,169,72,55,16,3758,3518,3438,2575,915,799,293,327,1871,1875,458,1904,764,0,,654
15:24:43,7309.155,Fox,3750,624,238,82,171,74,54,17,3762,3524,3442,2577,915,800,295,329,1873,1877,458,1904,764,0,,658
15:24:43,7309.456,Fox,3750,624,240,78,175,74,54,17,3764,3524,3446,2577,915,800,295,329,1873,1877,458,1904,764,0,,658
15:24:44,7310.355,Fox,3750,623,240,74,178,73,55,17,3764,3524,3450,2578,916,800,295,328,1873,1877,458,1905,764,0,,657
15:24:44,7310.956,Fox,3750,621,234,80,176,73,55,17,3764,3530,3450,2580,916,800,295,326,1873,1877,458,1907,764,0,,655
15:24:44,7311.555,Fox,3750,621,230,84,175,74,55,17,3764,3534,3450,2581,916,800,295,326,1873,1877,458,1907,764,0,,655
15:24:44,7312.155,Fox,3750,621,228,82,177,76,55,17,3764,3536,3454,2583,916,800,295,326,1873,1877,458,1907,764,0,,655
15:24:45,7312.456,Fox,3750,620,226,84,176,76,53,19,3764,3538,3454,2584,916,802,295,325,1873,1877,458,1908,764,0,,654
15:24:45,7313.655,Fox,3754,622,226,86,175,75,53,19,3766,3540,3454,2584,916,802,295,327,1874,1880,458,1910,764,0,,656
15:24:45,7313.956,Fox,3754,622,226,88,175,75,53,19,3768,3542,3454,2584,916,802,295,327,1874,1880,458,1910,764,0,,656
15:24:46,7314.855,Fox,3756,623,224,92,174,75,53,19,3770,3546,3454,2584,916,802,294,329,1874,1882,458,1911,764,0,,657
15:24:46,7315.456,Fox,3758,624,224,94,171,77,54,18,3772,3548,3454,2587,917,802,295,329,1875,1883,458,1911,765,0,,658
15:24:47,7316.055,Fox,3758,624,220,94,175,77,54,18,3772,3552,3458,2587,917,802,295,329,1875,1883,458,1911,765,0,,658
15:24:47,7316.655,Fox,3758,624,218,94,171,83,54,18,3772,3554,3460,2593,917,802,295,329,1875,1883,458,1911,765,0,,658
15:24:47,7316.956,Fox,3758,624,216,96,171,83,54,18,3772,3556,3460,2593,917,802,295,329,1875,1883,458,1911,765,0,,658
15:24:47,7317.732,Fox,3760,626,216,96,173,83,54,18,3774,3558,3462,2593,917,802,296,330,1876,1884,458,1911,765,0,,660
15:24:48,7317.91,Fox,3760,626,214,98,173,83,54,18,3774,3560,3462,2593,917,802,296,330,1876,1884,458,1911,765,0,,660
15:24:48,7318.255,Fox,3760,626,212,100,173,83,54,18,3774,3562,3462,2593,917,802,296,330,1876,1884,458,1911,765,0,,660
15:24:48,7318.751,Fox,3762,628,210,102,172,82,56,18,3774,3564,3462,2594,919,802,297,331,1877,1885,458,1911,765,0,,662
15:24:48,7319.069,Fox,3762,628,210,104,172,81,57,18,3776,3566,3462,2594,920,802,297,331,1877,1885,458,1911,765,0,,662
15:24:48,7319.521,Fox,3762,627,210,102,174,80,57,18,3776,3566,3464,2594,920,802,297,330,1877,1885,458,1912,765,0,,661
15:24:49,7320.122,Fox,3770,631,218,102,168,82,55,20,3784,3566,3464,2598,920,804,299,332,1883,1887,458,1916,765,0,,665
15:24:49,7320.722,Fox,3770,628,214,106,168,81,55,18,3784,3570,3464,2598,920,804,299,329,1883,1887,458,1917,767,0,,662
15:24:49,7321.322,Fox,3770,627,212,106,169,82,53,19,3784,3572,3466,2599,920,805,299,328,1883,1887,458,1918,767,0,,661
15:24:49,7321.921,Fox,3774,628,210,110,168,81,52,19,3786,3576,3466,2599,920,805,299,329,1885,1889,458,1921,767,0,,662
15:24:50,7322.521,Fox,3778,630,214,110,166,81,52,19,3790,3576,3466,2599,920,805,298,332,1886,1892,458,1923,767,0,,664
15:24:50,7323.122,Fox,3782,632,220,106,165,83,53,19,3796,3576,3470,2603,921,805,298,334,1887,1895,458,1925,767,0,,666
15:24:50,7323.722,Fox,3784,633,222,106,164,83,53,19,3798,3576,3470,2603,921,805,297,336,1887,1897,458,1926,767,0,,667
15:24:51,7324.322,Fox,3788,635,224,108,163,81,54,19,3802,3578,3470,2603,922,805,298,337,1890,1898,458,1928,767,0,,669
15:24:51,7324.921,Fox,3794,639,228,108,162,81,54,18,3806,3578,3470,2603,922,805,299,340,1892,1902,458,1929,768,0,,673
15:24:52,7325.521,Fox,3794,639,228,106,166,81,54,18,3808,3580,3474,2603,922,805,299,340,1892,1902,458,1929,768,0,,673
15:24:53,7326.122,Fox,3794,639,226,104,170,81,54,18,3808,3582,3478,2603,922,805,299,340,1892,1902,458,1929,768,0,,673
15:24:53,7326.722,Fox,3794,639,224,104,169,83,55,18,3808,3584,3480,2606,923,805,299,340,1892,1902,458,1929,768,0,,673
15:24:53,7327.322,Fox,3794,639,218,110,168,84,55,18,3808,3590,3480,2607,923,805,299,340,1892,1902,458,1929,768,0,,673
15:24:54,7327.921,Fox,3796,641,216,112,168,84,55,18,3808,3592,3480,2607,923,805,301,340,1894,1902,458,1929,768,0,,675
15:24:54,7328.521,Fox,3802,644,224,112,164,84,56,18,3816,3592,3480,2608,924,805,302,342,1898,1904,458,1932,768,0,,678
15:24:54,7329.122,Fox,3802,644,222,112,164,86,56,18,3816,3594,3482,2610,924,805,302,342,1898,1904,458,1932,768,0,,678
15:24:55,7329.722,Fox,3802,644,222,106,170,86,56,18,3816,3594,3488,2610,924,805,302,342,1898,1904,458,1932,768,0,,678
15:24:55,7330.322,Fox,3804,643,222,108,168,85,56,18,3818,3596,3488,2611,924,805,301,342,1899,1905,458,1935,768,0,,677
15:24:55,7331.222,Fox,3804,640,220,110,168,82,56,18,3818,3598,3488,2611,924,805,300,340,1899,1905,458,1938,768,0,,674
15:24:56,7331.822,Fox,3806,641,222,108,170,81,56,18,3820,3598,3490,2611,924,805,302,339,1901,1905,458,1939,768,0,,675
15:24:56,7332.421,Fox,3808,642,218,112,168,82,56,18,3820,3602,3490,2612,924,805,302,340,1902,1906,458,1940,768,0,,676
15:24:57,7333.021,Fox,3808,640,218,112,170,80,56,18,3822,3604,3492,2612,924,805,302,338,1902,1906,458,1942,768,0,,674
15:24:57,7333.622,Fox,3808,637,218,110,166,84,53,20,3822,3604,3494,2618,924,807,302,335,1902,1906,458,1945,768,0,,671
15:24:57,7334.222,Fox,3810,639,216,110,168,83,54,20,3822,3606,3496,2618,925,807,303,336,1903,1907,458,1945,768,0,,673
15:24:58,7334.822,Fox,3814,642,218,112,167,83,54,20,3826,3608,3496,2618,925,807,304,338,1905,1909,458,1946,768,0,,676
15:24:58,7335.421,Fox,3820,647,220,112,169,83,54,19,3830,3610,3498,2618,925,807,307,340,1909,1911,458,1946,769,0,,681
15:24:58,7336.021,Fox,3824,647,226,112,168,81,54,18,3836,3610,3498,2618,925,807,307,340,1912,1912,458,1949,770,0,,681
15:24:59,7336.622,Fox,3832,653,232,116,166,81,54,18,3846,3614,3498,2618,925,807,310,343,1917,1915,458,1951,770,0,,687
15:24:59,7337.222,Fox,3834,652,232,116,164,80,54,18,3846,3614,3498,2619,925,807,308,344,1917,1917,458,1954,770,0,,686
15:25:00,7337.822,Fox,3838,653,232,118,164,77,54,18,3848,3616,3498,2619,925,807,309,344,1919,1919,458,1957,770,0,,687
15:25:00,7338.421,Fox,3842,653,238,118,162,75,54,18,3854,3616,3498,2619,925,807,309,344,1921,1921,458,1961,770,0,,687
15:25:00,7339.021,Fox,3844,655,240,118,160,77,54,18,3856,3616,3498,2621,925,807,310,345,1922,1922,458,1961,770,0,,689
15:25:01,7339.622,Fox,3846,656,242,120,159,77,54,18,3860,3618,3498,2622,925,807,311,345,1923,1923,458,1962,770,0,,690
15:25:01,7340.222,Fox,3850,657,244,116,162,78,53,18,3864,3620,3504,2624,925,807,312,345,1925,1925,458,1965,770,0,,691
15:25:01,7340.822,Fox,3854,658,244,118,161,77,53,17,3866,3622,3504,2624,925,807,311,347,1927,1927,458,1967,771,0,,692
15:25:02,7341.122,Fox,3854,656,246,118,161,75,53,17,3868,3622,3504,2624,925,807,310,346,1927,1927,458,1969,771,0,,690
15:25:02,7342.021,Fox,3854,655,246,116,162,73,55,17,3868,3622,3506,2625,927,807,310,345,1927,1927,458,1970,771,0,,689
15:25:02,7342.622,Fox,3856,656,244,118,160,74,55,17,3868,3624,3506,2626,927,807,311,345,1929,1927,458,1971,771,0,,690
15:25:03,7343.222,Fox,3862,659,246,116,161,75,55,16,3872,3626,3510,2627,927,807,312,347,1932,1930,458,1973,772,0,,693
15:25:03,7343.822,Fox,3866,661,250,116,156,78,57,14,3876,3626,3510,2632,929,807,314,347,1934,1932,458,1973,774,0,,695
15:25:03,7344.122,Fox,3866,659,254,116,156,76,57,14,3880,3626,3510,2632,929,807,314,345,1934,1932,458,1975,774,0,,693
15:25:04,7345.021,Fox,3868,660,252,116,156,75,58,15,3880,3628,3512,2634,931,808,315,345,1935,1933,458,1976,774,0,,694
15:25:04,7345.622,Fox,3870,658,252,114,158,73,59,14,3882,3630,3516,2635,932,808,313,345,1935,1935,458,1979,775,0,,692
15:25:04,7346.222,Fox,3878,664,253,118,156,73,59,14,3887,3634,3516,2635,932,808,317,347,1941,1937,458,1981,775,0,,698
15:25:05,7346.822,Fox,3880,663,259,118,152,74,59,14,3893,3634,3516,2638,932,808,316,347,1942,1938,458,1984,775,0,,697
15:25:05,7347.421,Fox,3882,663,257,118,155,72,60,14,3895,3638,3520,2638,933,808,317,346,1944,1938,458,1986,775,0,,697
15:25:06,7348.021,Fox,3884,665,257,116,157,74,57,17,3897,3640,3524,2640,933,811,317,348,1944,1940,458,1986,775,0,,699
15:25:06,7348.622,Fox,3888,668,257,118,156,74,57,17,3899,3642,3524,2640,933,811,317,351,1945,1943,458,1987,775,0,,702
15:25:06,7349.222,Fox,3888,668,259,116,160,74,55,19,3903,3644,3528,2640,933,813,317,351,1945,1943,458,1987,775,0,,702
15:25:07,7349.822,Fox,3890,670,255,118,158,80,55,19,3905,3650,3532,2646,933,813,319,351,1947,1943,458,1987,775,0,,704
15:25:07,7350.421,Fox,3896,672,255,118,160,78,55,19,3909,3654,3536,2647,933,813,319,353,1949,1947,458,1991,775,0,,706
15:25:07,7351.021,Fox,3898,674,257,116,160,80,55,19,3911,3654,3538,2649,933,813,320,354,1950,1948,458,1991,775,0,,708
15:25:08,7351.622,Fox,3900,675,255,120,158,81,55,19,3913,3658,3538,2650,933,813,321,354,1952,1948,458,1992,775,0,,709
15:25:08,7352.222,Fox,3902,677,257,118,156,85,55,19,3915,3658,3540,2654,933,813,323,354,1954,1948,458,1992,775,0,,711
15:25:09,7352.822,Fox,3906,678,259,116,153,88,55,18,3917,3658,3542,2658,933,813,322,356,1956,1950,458,1994,776,0,,712
15:25:09,7353.419,Fox,3906,677,263,112,150,94,55,18,3921,3658,3546,2665,933,813,322,355,1956,1950,458,1995,776,0,,711
15:25:09,7354.019,Fox,3906,674,263,110,149,95,54,18,3921,3658,3548,2668,934,814,321,353,1956,1950,458,1997,777,0,,708
15:25:10,7354.619,Fox,3906,673,263,106,150,97,54,18,3921,3658,3552,2671,934,814,321,352,1956,1950,458,1998,777,0,,707
15:25:10,7355.219,Fox,3906,672,263,104,152,97,54,17,3921,3658,3554,2671,934,814,320,352,1956,1950,458,1998,778,0,,706
15:25:10,7355.819,Fox,3906,670,263,102,154,96,54,16,3921,3658,3556,2671,934,814,320,350,1956,1950,458,1999,779,0,,704
15:25:11,7356.419,Fox,3906,670,257,106,154,98,53,17,3921,3664,3558,2673,934,815,320,350,1956,1950,458,1999,779,0,,704
15:25:11,7357.019,Fox,3910,671,255,106,149,104,53,17,3923,3668,3562,2681,934,815,322,349,1960,1950,458,2002,779,0,,705
15:25:11,7357.619,Fox,3912,672,253,110,150,103,54,17,3927,3674,3564,2681,935,815,322,350,1961,1951,458,2003,779,0,,706
15:25:12,7358.219,Fox,3916,676,257,108,151,102,55,18,3931,3674,3566,2682,937,816,322,354,1961,1955,458,2003,779,0,,710
15:25:12,7358.819,Fox,3922,679,259,108,149,101,55,18,3933,3674,3566,2682,937,816,321,358,1963,1959,458,2006,779,0,,713
15:25:13,7359.419,Fox,3926,679,263,106,147,103,55,18,3939,3676,3570,2686,937,816,320,359,1965,1961,458,2010,779,0,,713
15:25:13,7360.019,Fox,3930,680,269,104,146,104,55,17,3945,3676,3572,2688,937,816,317,363,1965,1965,458,2012,780,0,,714
15:25:13,7360.608,Fox,3932,678,269,100,145,106,54,17,3945,3676,3576,2692,937,816,317,361,1967,1965,458,2016,780,0,,712
15:25:14,7361.208,Fox,3932,678,269,102,143,108,54,17,3947,3678,3576,2694,937,816,317,361,1967,1965,458,2016,780,0,,712
15:25:14,7361.508,Fox,3932,678,267,104,143,108,54,17,3947,3680,3576,2694,937,816,317,361,1967,1965,458,2016,780,0,,712
15:25:15,7362.408,Fox,3934,679,265,106,138,112,54,17,3947,3682,3576,2698,937,816,318,361,1969,1965,458,2017,780,0,,713
15:25:15,7363.008,Fox,3938,680,269,104,136,114,54,16,3951,3682,3578,2700,937,816,317,363,1970,1968,458,2019,781,0,,714
15:25:15,7363.608,Fox,3938,678,269,106,136,114,54,14,3953,3684,3578,2700,937,816,315,363,1970,1968,458,2019,783,0,,712
15:25:16,7364.208,Fox,3938,675,265,108,134,117,54,12,3953,3688,3580,2704,937,816,314,361,1970,1968,458,2020,785,0,,709
15:25:16,7364.808,Fox,3940,677,263,108,136,117,54,12,3953,3690,3582,2704,937,816,315,362,1971,1969,458,2020,785,0,,711
15:25:16,7365.408,Fox,3942,677,265,108,137,117,54,11,3957,3692,3584,2704,937,816,316,361,1973,1969,458,2021,786,0,,711
15:25:17,7366.008,Fox,3942,676,263,104,143,114,56,11,3957,3694,3590,2704,939,816,316,360,1973,1969,458,2022,786,0,,710
15:25:17,7366.608,Fox,3944,676,259,108,143,114,56,11,3959,3700,3592,2705,939,816,316,360,1974,1970,458,2024,786,0,,710
15:25:18,7367.208,Fox,3946,676,255,112,143,112,55,12,3959,3704,3592,2705,939,817,314,362,1974,1972,458,2026,786,0,,710
15:25:18,7367.808,Fox,3948,678,257,110,144,113,54,13,3961,3704,3594,2706,939,818,314,364,1974,1974,458,2026,786,0,,712
15:25:18,7368.408,Fox,3948,677,259,110,143,114,53,13,3963,3704,3594,2707,939,818,313,364,1974,1974,458,2027,786,0,,711
15:25:19,7369.008,Fox,3950,677,259,108,143,114,53,13,3963,3704,3596,2709,939,818,313,364,1974,1976,458,2029,786,0,,711
15:25:19,7369.608,Fox,3950,677,261,108,139,118,52,14,3965,3704,3596,2713,939,819,313,364,1974,1976,458,2029,786,0,,711
15:25:19,7370.208,Fox,3950,676,259,108,138,120,52,14,3965,3706,3598,2716,939,819,313,363,1974,1976,458,2030,786,0,,710
15:25:20,7370.808,Fox,3956,678,261,106,137,119,52,14,3967,3706,3600,2718,939,819,313,365,1976,1980,458,2034,786,0,,712
15:25:20,7371.408,Fox,3958,678,267,104,138,119,52,13,3973,3706,3602,2718,939,819,313,365,1977,1981,458,2035,787,0,,712
15:25:21,7372.008,Fox,3960,679,267,102,140,118,52,13,3973,3706,3604,2718,939,819,313,366,1977,1983,458,2036,787,0,,713
15:25:21,7372.608,Fox,3960,679,267,102,140,120,52,13,3975,3708,3606,2720,939,819,313,366,1977,1983,458,2036,787,0,,713
15:25:21,7373.208,Fox,3960,679,261,106,142,120,51,14,3975,3714,3608,2720,939,820,313,366,1977,1983,458,2036,787,0,,713
15:25:22,7374.108,Fox,3960,679,261,104,144,120,51,14,3975,3714,3610,2720,939,820,313,366,1977,1983,458,2036,787,0,,713
15:25:23,7375.008,Fox,3960,677,261,100,148,118,51,14,3975,3714,3614,2720,939,820,313,364,1977,1983,458,2038,787,0,,711
15:25:23,7375.308,Fox,3960,676,261,100,148,115,53,14,3975,3714,3614,2720,941,820,313,363,1977,1983,458,2039,787,0,,710
15:25:24,7376.208,Fox,3960,676,261,98,147,116,55,14,3975,3714,3616,2723,943,820,313,363,1977,1983,458,2039,787,0,,710
15:25:24,7377.108,Fox,3960,675,259,100,145,118,54,14,3975,3716,3616,2725,943,820,313,362,1977,1983,458,2040,787,0,,709
15:25:25,7377.708,Fox,3962,676,259,102,144,118,54,14,3977,3718,3616,2725,943,820,313,363,1978,1984,458,2041,787,0,,710
15:25:25,7378.308,Fox,3962,671,259,100,144,116,54,13,3977,3718,3618,2727,943,820,311,360,1978,1984,458,2045,788,0,,705
15:25:25,7378.908,Fox,3962,669,257,100,146,113,56,12,3977,3720,3620,2727,945,820,311,358,1978,1984,458,2046,789,0,,703
15:25:26,7379.508,Fox,3964,668,259,98,148,110,56,12,3979,3720,3622,2727,945,820,310,358,1978,1986,458,2049,789,0,,702
15:25:26,7380.108,Fox,3964,667,259,98,146,111,56,12,3979,3720,3622,2729,945,820,310,357,1978,1986,458,2050,789,0,,701
15:25:27,7380.708,Fox,3964,664,259,98,146,108,55,13,3979,3720,3622,2729,945,821,310,354,1978,1986,458,2053,789,0,,698
15:25:27,7381.308,Fox,3966,664,259,96,148,106,53,15,3979,3720,3624,2729,945,823,311,353,1979,1987,458,2055,789,0,,698
15:25:28,7381.908,Fox,3966,661,257,98,149,104,53,15,3981,3724,3626,2730,945,823,311,350,1979,1987,458,2058,789,0,,695
15:25:28,7382.808,Fox,3966,659,255,100,149,101,55,14,3981,3726,3626,2730,947,823,311,348,1979,1987,458,2059,790,0,,693
15:25:28,7383.408,Fox,3966,657,255,98,151,99,55,14,3981,3726,3628,2730,947,823,311,346,1979,1987,458,2061,790,0,,691
15:25:29,7384.008,Fox,3966,657,255,96,151,101,55,14,3981,3726,3630,2732,947,823,311,346,1979,1987,458,2061,790,0,,691
15:25:29,7384.608,Fox,3970,656,253,100,152,97,55,14,3985,3732,3632,2732,947,823,312,344,1981,1989,459,2065,790,0,,690
15:25:30,7385.208,Fox,3972,657,255,98,154,96,54,15,3987,3732,3634,2732,947,824,312,345,1981,1991,459,2066,790,0,,691
15:25:30,7385.808,Fox,3972,656,255,94,155,98,54,15,3987,3732,3638,2735,947,824,311,345,1981,1991,459,2067,790,0,,690
15:25:30,7386.408,Fox,3974,657,251,98,151,99,56,15,3987,3736,3638,2738,949,824,311,346,1982,1992,459,2068,790,0,,691
15:25:31,7387.008,Fox,3976,658,251,96,154,99,55,16,3989,3738,3642,2738,949,825,310,348,1982,1994,459,2069,790,0,,692
15:25:31,7387.608,Fox,3978,657,253,94,153,99,55,16,3991,3738,3644,2740,949,825,308,349,1983,1995,459,2072,790,0,,691
15:25:32,7388.167,Fox,3982,660,255,92,157,95,58,16,3995,3740,3648,2740,952,825,309,351,1985,1997,459,2073,790,0,,694
15:25:32,7388.767,Fox,3984,660,259,88,161,93,58,16,3999,3740,3652,2740,952,825,310,350,1986,1998,459,2075,790,0,,694
15:25:32,7389.367,Fox,3986,662,261,86,163,93,58,16,4001,3740,3654,2740,952,825,311,351,1987,1999,459,2075,790,0,,696
15:25:33,7389.967,Fox,3988,662,261,84,163,95,58,16,4003,3742,3658,2744,952,825,312,350,1988,2000,459,2077,790,0,,696
15:25:33,7390.567,Fox,3988,661,255,90,162,95,58,16,4003,3748,3658,2745,952,825,312,349,1988,2000,459,2078,790,0,,695
15:25:34,7391.167,Fox,3988,660,245,100,162,94,58,16,4003,3758,3658,2745,952,825,312,348,1988,2000,459,2079,790,0,,694
15:25:34,7391.767,Fox,3988,658,241,104,162,93,57,16,4003,3762,3658,2745,952,825,311,347,1988,2000,459,2081,790,0,,692
15:25:35,7392.367,Fox,3988,657,239,106,160,94,56,17,4003,3764,3658,2747,952,826,311,346,1988,2000,459,2082,790,0,,691
15:25:35,7393.567,Fox,3994,662,243,106,158,95,56,17,4007,3764,3658,2748,952,826,313,349,1991,2003,459,2083,790,0,,696
15:25:36,7394.167,Fox,3998,664,249,106,155,96,56,17,4013,3764,3658,2750,952,826,314,350,1993,2005,459,2085,790,0,,698
15:25:37,7395.067,Fox,4000,662,249,100,158,96,56,16,4013,3764,3664,2752,952,826,313,349,1993,2007,459,2088,791,0,,696
15:25:37,7395.667,Fox,4000,658,251,96,160,95,56,15,4015,3764,3668,2754,952,826,310,348,1993,2007,459,2091,792,0,,692
15:25:37,7396.267,Fox,4004,657,251,92,166,90,56,15,4017,3766,3674,2754,952,826,310,347,1995,2009,459,2096,792,0,,691
15:25:38,7396.867,Fox,4004,655,251,94,166,88,52,19,4019,3768,3674,2754,952,830,310,345,1995,2009,459,2098,792,0,,689
15:25:38,7397.467,Fox,4004,655,249,96,166,88,50,21,4019,3770,3674,2754,952,832,310,345,1995,2009,459,2098,792,0,,689
15:25:38,7398.067,Fox,4004,655,247,96,168,88,50,21,4019,3772,3676,2754,952,832,310,345,1995,2009,459,2098,792,0,,689
15:25:39,7398.667,Fox,4006,656,247,96,167,87,49,23,4019,3772,3676,2754,953,834,310,346,1996,2010,459,2099,792,0,,690
15:25:39,7399.267,Fox,4008,657,249,94,168,87,49,23,4021,3772,3678,2754,953,834,310,347,1997,2011,459,2100,792,0,,691
15:25:40,7399.867,Fox,4012,658,253,92,168,87,49,22,4025,3772,3680,2754,953,834,310,348,1999,2013,459,2102,793,0,,692
15:25:40,7400.467,Fox,4018,661,257,92,164,88,51,22,4031,3774,3682,2758,955,834,312,349,2004,2014,460,2104,793,0,,695
15:25:40,7401.067,Fox,4020,663,259,92,163,89,51,22,4033,3774,3682,2759,955,834,313,350,2005,2015,460,2104,793,0,,697
15:25:41,7401.667,Fox,4022,664,259,94,162,89,51,22,4035,3776,3682,2759,955,834,314,350,2007,2015,460,2105,793,0,,698
15:25:41,7402.267,Fox,4024,665,261,92,162,90,51,22,4037,3776,3684,2761,955,834,313,352,2007,2017,460,2106,793,0,,699
15:25:42,7402.867,Fox,4026,664,255,94,167,88,51,22,4039,3784,3690,2761,955,834,312,352,2007,2019,460,2109,793,0,,698
15:25:42,7403.467,Fox,4026,664,257,94,163,92,51,22,4041,3784,3690,2765,955,834,312,352,2007,2019,460,2109,793,0,,698
15:25:42,7404.067,Fox,4028,665,257,90,166,92,50,23,4041,3784,3694,2765,955,835,312,353,2008,2020,460,2110,793,0,,699
15:25:43,7404.667,Fox,4032,667,259,88,169,91,50,23,4045,3786,3698,2765,955,835,311,356,2009,2023,460,2112,793,0,,701
15:25:43,7405.267,Fox,4034,668,259,88,170,93,50,23,4049,3790,3702,2767,955,835,310,358,2009,2025,460,2113,793,0,,702
15:25:44,7405.867,Fox,4034,668,253,92,172,93,50,23,4049,3796,3704,2767,955,835,310,358,2009,2025,460,2113,793,0,,702
15:25:44,7406.467,Fox,4036,669,251,94,170,94,50,23,4049,3798,3704,2769,955,835,310,359,2010,2026,460,2114,793,0,,703
15:25:44,7407.067,Fox,4038,669,249,98,170,92,50,23,4051,3802,3704,2769,955,835,310,359,2011,2027,461,2115,793,0,,703
15:25:45,7407.667,Fox,4040,668,249,102,167,94,50,21,4055,3806,3704,2772,955,835,311,357,2012,2028,461,2116,795,0,,702
15:25:45,7408.267,Fox,4042,667,249,102,165,95,50,21,4057,3808,3706,2775,955,835,312,355,2014,2028,461,2119,795,0,,701
15:25:45,7409.167,Fox,4046,669,253,102,164,94,50,21,4061,3808,3706,2775,955,835,312,357,2016,2030,461,2121,795,0,,703
15:25:46,7409.767,Fox,4050,671,253,102,161,95,50,21,4061,3808,3706,2777,955,835,314,357,2019,2031,461,2123,795,0,,705
15:25:46,7410.335,Fox,4054,674,257,102,156,98,51,21,4065,3808,3706,2781,956,835,316,358,2022,2032,461,2124,795,0,,708
15:25:46,7410.935,Fox,4054,672,259,104,154,98,51,21,4069,3810,3706,2783,956,835,316,356,2022,2032,461,2126,795,0,,706
15:25:47,7411.535,Fox,4056,674,255,102,160,100,51,21,4071,3816,3714,2785,956,835,316,358,2022,2034,461,2126,795,0,,708
15:25:47,7412.735,Fox,4060,676,259,102,158,101,50,21,4075,3816,3714,2786,956,835,318,358,2025,2035,461,2128,795,0,,710
15:25:48,7413.335,Fox,4064,677,259,104,156,100,50,21,4077,3818,3714,2787,956,835,319,358,2027,2037,461,2131,795,0,,711
15:25:48,7413.935,Fox,4066,677,261,104,152,100,52,21,4079,3818,3714,2790,958,835,318,359,2027,2039,461,2133,795,0,,711
15:25:49,7414.535,Fox,4072,680,265,106,150,99,52,21,4085,3820,3714,2791,958,835,319,361,2031,2041,461,2136,795,0,,714
15:25:49,7415.135,Fox,4072,680,267,106,146,103,52,21,4087,3820,3714,2795,958,835,319,361,2031,2041,461,2136,795,0,,714
15:25:49,7415.735,Fox,4074,681,267,106,147,103,52,21,4089,3822,3716,2796,958,835,320,361,2033,2041,461,2137,795,0,,715
15:25:50,7416.335,Fox,4076,682,269,104,146,105,52,21,4091,3822,3718,2798,958,835,321,361,2035,2041,461,2138,795,0,,716
15:25:50,7416.935,Fox,4084,687,271,104,144,103,53,21,4093,3822,3718,2800,959,835,324,363,2039,2045,461,2141,795,0,,721
15:25:50,7417.535,Fox,4092,694,279,106,144,104,53,21,4105,3826,3720,2801,959,835,326,368,2042,2050,461,2142,795,0,,728
15:25:51,7418.135,Fox,4092,692,277,110,143,104,53,20,4107,3830,3720,2802,959,835,326,366,2042,2050,461,2143,796,0,,726
15:25:51,7418.735,Fox,4100,697,279,116,139,105,53,20,4115,3836,3720,2803,959,835,328,369,2047,2053,461,2146,796,0,,731
15:25:51,7419.335,Fox,4108,701,271,126,137,105,52,19,4117,3846,3720,2803,959,835,328,373,2050,2058,461,2149,797,0,,735
15:25:52,7419.935,Fox,4110,702,279,126,135,106,52,19,4125,3846,3720,2805,959,835,329,373,2051,2059,461,2150,797,0,,736
15:25:52,7420.535,Fox,4112,702,277,124,138,106,50,20,4125,3848,3724,2806,959,837,328,374,2051,2061,461,2151,798,0,,736
15:25:52,7421.135,Fox,4114,703,273,130,135,108,50,20,4127,3854,3724,2809,959,837,329,374,2053,2061,461,2152,798,0,,737
15:25:53,7421.399,Fox,4114,703,273,130,137,108,50,20,4129,3856,3726,2809,959,837,329,374,2053,2061,461,2152,798,0,,737
15:25:53,7422.299,Fox,4114,703,269,134,137,106,52,20,4129,3860,3726,2809,961,837,329,374,2053,2061,461,2152,798,0,,737
15:25:53,7422.899,Fox,4116,705,267,134,141,106,52,20,4131,3864,3730,2809,961,837,330,375,2054,2062,461,2152,798,0,,739
15:25:54,7423.5,Fox,4118,706,267,134,141,107,52,20,4133,3866,3732,2811,961,837,330,376,2055,2063,461,2153,798,0,,740
15:25:54,7424.1,Fox,4118,705,265,136,141,107,50,21,4133,3868,3732,2811,961,839,330,375,2055,2063,461,2153,799,0,,739
15:25:54,7424.876,Fox,4118,705,265,132,144,108,49,22,4133,3868,3736,2812,961,840,330,375,2055,2063,461,2153,799,0,,739
15:25:55,7425.477,Fox,4120,706,265,132,141,112,49,22,4135,3870,3738,2816,961,840,330,376,2056,2064,461,2154,799,0,,740
15:25:55,7426.077,Fox,4128,709,265,138,135,113,49,22,4141,3876,3738,2820,961,840,331,378,2060,2068,461,2159,799,0,,743
15:25:56,7426.676,Fox,4132,713,267,140,136,114,49,22,4147,3880,3740,2821,961,840,331,382,2060,2072,461,2159,799,0,,747
15:25:56,7426.977,Fox,4132,713,267,140,136,111,52,22,4147,3880,3740,2821,964,840,331,382,2060,2072,461,2159,799,0,,747
15:25:56,7427.876,Fox,4136,712,267,142,136,108,51,21,4149,3882,3740,2821,964,840,330,382,2061,2075,461,2163,800,0,,746
15:25:56,7428.476,Fox,4136,712,266,143,137,109,51,21,4151,3885,3742,2822,964,840,330,382,2061,2075,461,2163,800,0,,746
15:25:57,7429.076,Fox,4140,713,258,145,141,109,51,20,4151,3893,3748,2824,964,840,329,384,2063,2077,461,2165,801,0,,747
15:25:57,7429.676,Fox,4140,712,260,137,151,108,51,20,4155,3895,3758,2824,964,840,329,383,2063,2077,461,2166,801,0,,746
15:25:58,7430.276,Fox,4142,713,260,135,154,108,51,20,4157,3897,3762,2825,964,840,329,384,2064,2078,461,2167,801,0,,747
15:25:58,7430.876,Fox,4144,714,260,135,155,108,51,20,4159,3899,3764,2825,964,840,330,384,2066,2078,461,2168,801,0,,748
15:25:58,7431.476,Fox,4144,710,256,139,152,108,51,19,4159,3903,3764,2828,964,840,329,381,2066,2078,461,2171,802,0,,744
15:25:59,7432.076,Fox,4146,710,258,139,150,108,51,19,4161,3903,3764,2830,964,840,329,381,2066,2080,461,2173,802,0,,744
15:25:59,7432.676,Fox,4146,710,256,141,150,107,52,19,4161,3905,3764,2830,965,840,329,381,2066,2080,461,2173,802,0,,744
15:25:59,7433.276,Fox,4148,710,250,147,147,108,52,19,4161,3911,3764,2832,965,840,328,382,2067,2081,461,2175,802,0,,744
15:26:00,7433.876,Fox,4148,708,250,149,146,107,52,19,4163,3913,3764,2833,965,840,328,380,2067,2081,461,2177,802,0,,742
15:26:00,7434.476,Fox,4148,704,248,151,145,104,52,19,4163,3915,3764,2834,965,840,328,376,2067,2081,461,2181,802,0,,738
15:26:00,7435.024,Fox,4148,704,246,149,149,104,51,20,4163,3917,3768,2834,965,841,328,376,2067,2081,461,2181,802,0,,738
15:26:01,7435.624,Fox,4148,704,242,153,145,108,51,20,4163,3921,3768,2838,965,841,328,376,2067,2081,461,2181,802,0,,738
15:26:01,7435.924,Fox,4148,703,242,151,147,107,51,20,4163,3921,3770,2838,965,841,327,376,2067,2081,461,2182,802,0,,737
15:26:01,7436.824,Fox,4148,702,242,149,147,108,49,22,4163,3921,3772,2840,965,843,327,375,2067,2081,461,2183,802,0,,736
15:26:02,7437.424,Fox,4148,700,242,149,147,104,51,22,4163,3921,3772,2840,967,843,327,373,2067,2081,461,2185,802,0,,734
15:26:02,7438.324,Fox,4148,697,242,149,147,101,51,22,4163,3921,3772,2840,967,843,327,370,2067,2081,461,2188,802,0,,731
15:26:03,7438.924,Fox,4150,699,242,147,146,103,52,22,4163,3921,3774,2843,968,843,329,370,2069,2081,461,2188,802,0,,733
15:26:03,7439.524,Fox,4150,697,242,149,144,104,52,21,4165,3923,3774,2845,968,843,329,368,2069,2081,461,2189,803,0,,731
15:26:03,7440.124,Fox,4156,701,240,151,145,103,52,21,4167,3927,3776,2845,968,843,329,372,2071,2085,461,2191,803,0,,735
15:26:04,7440.724,Fox,4160,703,242,155,145,101,52,21,4173,3931,3776,2845,969,843,328,375,2072,2088,461,2193,803,0,,737
15:26:04,7441.324,Fox,4168,708,246,149,149,102,52,21,4179,3933,3784,2847,969,843,331,377,2078,2090,461,2196,803,0,,742
15:26:04,7441.924,Fox,4174,712,248,155,149,98,54,21,4187,3939,3784,2847,971,843,334,378,2082,2092,461,2198,803,0,,746
15:26:05,7442.524,Fox,4174,711,244,161,147,100,54,20,4189,3945,3784,2849,971,843,334,377,2082,2092,461,2198,804,0,,745
15:26:05,7443.124,Fox,4176,712,246,159,148,100,53,21,4191,3945,3786,2849,971,844,334,378,2083,2093,461,2199,804,0,,746
15:26:05,7443.724,Fox,4180,713,244,157,149,98,55,21,4191,3947,3790,2851,973,844,335,378,2085,2095,461,2202,804,0,,747
15:26:06,7444.324,Fox,4182,713,248,151,153,98,55,21,4195,3947,3796,2852,973,844,334,379,2086,2096,461,2204,804,0,,747
15:26:06,7444.924,Fox,4188,715,254,149,150,99,53,23,4201,3947,3798,2854,973,846,334,381,2089,2099,461,2208,804,0,,749
15:26:06,7445.524,Fox,4188,715,252,149,152,100,54,23,4203,3951,3802,2856,974,846,334,381,2089,2099,461,2208,804,0,,749
15:26:07,7446.124,Fox,4188,715,250,147,153,101,56,23,4203,3953,3806,2859,976,846,334,381,2089,2099,461,2208,804,0,,749
15:26:07,7446.724,Fox,4192,717,252,145,153,99,58,23,4205,3953,3808,2859,978,846,335,382,2092,2100,461,2210,804,0,,751
15:26:07,7447.324,Fox,4194,717,256,145,148,102,58,23,4209,3953,3808,2863,979,847,333,384,2092,2102,461,2211,805,0,,751
15:26:08,7447.924,Fox,4196,717,252,149,145,102,60,22,4209,3957,3808,2865,981,847,334,383,2094,2102,461,2212,806,0,,751
15:26:08,7448.524,Fox,4198,718,254,149,141,104,61,22,4211,3957,3808,2868,982,847,333,385,2094,2104,461,2213,806,0,,752
15:26:08,7449.124,Fox,4198,715,254,151,137,106,61,21,4213,3959,3808,2872,982,847,333,382,2094,2104,461,2215,807,0,,749
15:26:09,7449.724,Fox,4198,714,254,143,145,104,62,21,4213,3959,3816,2872,983,847,332,382,2094,2104,461,2216,807,0,,748
15:26:09,7450.324,Fox,4198,712,252,145,143,104,62,21,4213,3961,3816,2874,983,847,331,381,2094,2104,461,2218,807,0,,746
15:26:09,7450.624,Fox,4198,710,250,147,141,103,64,20,4213,3963,3816,2876,985,847,331,379,2094,2104,461,2219,808,0,,744
15:26:10,7451.524,Fox,4200,708,252,145,143,99,64,20,4215,3963,3818,2876,985,847,332,376,2095,2105,461,2223,808,0,,742
15:26:10,7452.124,Fox,4204,709,252,147,143,96,64,20,4217,3965,3818,2876,985,847,332,377,2097,2107,461,2226,808,0,,743
15:26:11,7452.724,Fox,4204,708,254,147,143,94,65,20,4219,3965,3818,2876,987,848,332,376,2097,2107,461,2226,809,0,,742
15:26:11,7453.324,Fox,4204,708,252,147,145,90,69,20,4219,3967,3820,2876,991,848,332,376,2097,2107,461,2226,809,0,,742
15:26:11,7453.924,Fox,4204,707,246,151,147,87,71,20,4219,3973,3822,2876,993,848,332,375,2097,2107,461,2227,809,0,,741
15:26:12,7454.524,Fox,4206,705,246,151,146,85,71,19,4219,3973,3822,2876,993,848,331,374,2098,2108,461,2230,810,0,,739
15:26:12,7455.124,Fox,4210,707,250,153,143,86,71,19,4225,3975,3822,2877,993,848,331,376,2100,2110,461,2232,810,0,,741
15:26:12,7455.724,Fox,4210,706,250,151,142,88,71,19,4225,3975,3824,2880,993,848,330,376,2100,2110,461,2233,810,0,,740
15:26:13,7456.324,Fox,4214,708,254,147,139,93,69,21,4229,3975,3828,2885,993,850,330,378,2102,2112,461,2235,810,0,,742
15:26:13,7456.924,Fox,4214,707,254,141,141,96,68,22,4229,3975,3834,2889,993,851,330,377,2102,2112,461,2236,810,0,,741
15:26:13,7457.524,Fox,4218,710,256,137,144,96,68,22,4231,3975,3838,2889,993,851,333,377,2106,2112,461,2237,810,0,,744
15:26:14,7457.824,Fox,4218,709,258,129,152,94,69,22,4233,3975,3846,2889,995,851,333,376,2106,2112,461,2238,810,0,,743
15:26:14,7458.724,Fox,4218,709,258,127,154,94,69,22,4233,3975,3848,2889,995,851,333,376,2106,2112,461,2238,810,0,,743
15:26:15,7459.624,Fox,4218,707,258,121,160,93,69,21,4233,3975,3854,2889,995,851,332,375,2106,2112,461,2239,811,0,,741
15:26:15,7460.224,Fox,4218,706,256,121,161,92,70,21,4233,3977,3856,2890,996,851,332,374,2106,2112,461,2240,811,0,,740
15:26:15,7460.824,Fox,4222,708,256,117,163,93,69,21,4233,3977,3860,2891,996,852,334,374,2109,2113,461,2241,812,0,,742
15:26:15,7461.424,Fox,4222,708,260,113,166,94,69,21,4237,3977,3864,2892,996,852,334,374,2109,2113,461,2241,812,0,,742
15:26:16,7462.024,Fox,4222,703,258,113,168,89,68,22,4237,3979,3866,2892,996,853,333,370,2109,2113,461,2246,812,0,,737
15:26:16,7462.624,Fox,4226,705,258,111,167,90,68,22,4237,3979,3868,2893,996,853,333,372,2111,2115,461,2248,812,0,,739
15:26:17,7463.224,Fox,4228,707,264,111,164,92,69,22,4243,3979,3868,2896,997,853,335,372,2113,2115,461,2248,812,0,,741
15:26:17,7463.524,Fox,4228,706,264,111,162,93,69,22,4243,3979,3868,2898,997,853,335,371,2113,2115,461,2249,812,0,,740
15:26:17,7464.424,Fox,4228,706,262,109,165,94,68,23,4243,3981,3872,2899,997,854,335,371,2113,2115,461,2249,812,0,,740
15:26:17,7464.724,Fox,4228,706,262,105,169,94,68,23,4243,3981,3876,2899,997,854,335,371,2113,2115,461,2249,812,0,,740
15:26:18,7465.624,Fox,4230,708,262,101,167,100,68,23,4243,3981,3880,2905,997,854,336,372,2114,2116,461,2249,812,0,,742
15:26:18,7466.224,Fox,4232,709,266,101,163,101,70,23,4247,3981,3880,2908,999,854,335,374,2114,2118,461,2250,812,0,,743
15:26:19,7466.824,Fox,4234,710,268,99,164,101,70,23,4249,3981,3882,2908,999,854,335,375,2115,2119,461,2251,812,0,,744
15:26:19,7467.424,Fox,4234,710,264,98,169,101,70,23,4249,3985,3887,2908,999,854,335,375,2115,2119,461,2251,812,0,,744
15:26:19,7467.942,Fox,4234,708,262,94,175,99,70,23,4249,3987,3893,2908,999,854,335,373,2115,2119,461,2253,812,0,,742
15:26:20,7468.542,Fox,4236,709,264,92,176,99,70,23,4251,3987,3895,2908,999,854,335,374,2116,2120,461,2254,812,0,,743
15:26:20,7469.142,Fox,4240,711,264,90,175,100,70,23,4251,3987,3897,2909,999,854,335,376,2118,2122,461,2256,812,0,,745
15:26:20,7469.742,Fox,4242,712,266,90,177,99,70,23,4255,3989,3899,2909,1000,854,336,376,2120,2122,461,2257,812,0,,746
15:26:21,7470.342,Fox,4244,713,268,88,181,98,70,23,4259,3991,3903,2909,1000,854,336,377,2121,2123,461,2258,812,0,,747
15:26:21,7470.942,Fox,4248,712,268,90,183,93,70,23,4263,3995,3905,2909,1000,854,337,375,2124,2124,461,2263,812,0,,746
15:26:22,7471.542,Fox,4248,711,264,90,185,94,69,24,4263,3999,3909,2911,1000,855,337,374,2124,2124,461,2264,812,0,,745
15:26:22,7472.142,Fox,4250,712,262,90,182,97,70,24,4263,4001,3911,2915,1001,855,337,375,2125,2125,461,2265,812,0,,746
15:26:22,7472.742,Fox,4252,712,264,90,184,95,70,24,4267,4003,3913,2915,1001,855,336,376,2126,2126,461,2267,812,0,,746
15:26:23,7473.342,Fox,4254,710,266,88,186,92,69,24,4269,4003,3915,2915,1001,855,333,377,2127,2127,461,2271,812,0,,744
15:26:23,7473.942,Fox,4258,711,268,86,188,88,70,24,4271,4003,3917,2915,1002,855,331,380,2127,2131,461,2274,812,0,,745
15:26:23,7474.542,Fox,4258,708,270,82,192,85,70,24,4273,4003,3921,2915,1002,855,331,377,2127,2131,461,2277,812,0,,742
15:26:24,7475.142,Fox,4260,704,272,82,191,81,70,23,4275,4003,3921,2915,1002,855,330,374,2128,2132,461,2282,813,0,,738
15:26:24,7475.742,Fox,4262,705,274,82,191,80,70,23,4277,4003,3921,2915,1002,855,329,376,2128,2134,461,2283,813,0,,739
15:26:24,7476.342,Fox,4264,707,272,86,189,82,70,23,4279,4007,3921,2917,1002,855,330,377,2129,2135,461,2283,813,0,,741
15:26:25,7476.942,Fox,4264,707,266,92,187,84,70,23,4279,4013,3921,2919,1002,855,330,377,2129,2135,461,2283,813,0,,741
15:26:25,7477.542,Fox,4266,707,266,92,187,84,70,21,4279,4013,3921,2919,1002,855,331,376,2130,2136,461,2283,815,0,,741
15:26:25,7478.142,Fox,4266,707,266,92,188,85,70,21,4281,4015,3923,2920,1002,855,331,376,2130,2136,461,2283,815,0,,741
15:26:26,7478.742,Fox,4266,706,266,88,192,84,70,21,4281,4015,3927,2920,1002,855,330,376,2130,2136,461,2284,815,0,,740
15:26:26,7479.342,Fox,4268,704,264,88,195,79,71,22,4283,4019,3931,2920,1004,856,330,374,2132,2136,461,2288,815,0,,738
15:26:26,7479.928,Fox,4276,708,266,86,194,78,71,22,4285,4019,3933,2920,1005,856,330,378,2136,2140,463,2290,815,0,,742
15:26:26,7480.391,Fox,4276,708,272,80,199,79,71,22,4291,4019,3939,2921,1005,856,330,378,2136,2140,463,2290,815,0,,742
15:26:26,7480.747,Fox,4280,710,274,78,200,77,72,22,4293,4019,3941,2921,1007,856,331,379,2139,2141,463,2292,815,0,,744
15:26:27,7481.347,Fox,4286,710,280,74,202,73,70,24,4299,4019,3945,2921,1007,858,330,380,2142,2144,463,2298,815,0,,744
15:26:27,7481.946,Fox,4286,708,280,74,203,72,70,24,4301,4021,3947,2922,1007,858,330,378,2142,2144,463,2300,815,0,,742
15:26:28,7482.546,Fox,4286,705,276,78,203,69,69,25,4301,4025,3947,2922,1007,859,330,375,2142,2144,463,2303,815,0,,739
15:26:28,7483.146,Fox,4288,706,270,84,202,69,68,26,4301,4031,3947,2922,1007,860,330,376,2143,2145,463,2304,815,0,,740
15:26:28,7483.747,Fox,4290,706,270,84,197,74,69,25,4303,4033,3949,2928,1008,860,330,376,2144,2146,463,2305,816,0,,740
15:26:29,7484.347,Fox,4290,706,270,82,201,74,69,25,4305,4035,3953,2928,1008,860,330,376,2144,2146,463,2305,816,0,,740
15:26:29,7484.946,Fox,4292,707,268,84,201,74,67,26,4305,4037,3953,2928,1008,861,330,377,2144,2148,463,2306,816,0,,741
15:26:29,7485.546,Fox,4292,704,268,86,199,74,67,25,4307,4039,3953,2930,1008,861,330,374,2144,2148,463,2308,817,0,,738
15:26:30,7486.146,Fox,4292,703,266,86,200,74,67,25,4307,4041,3955,2931,1008,861,330,373,2144,2148,463,2309,817,0,,737
15:26:30,7486.747,Fox,4296,703,266,84,201,71,67,25,4307,4041,3957,2931,1008,861,331,372,2147,2149,463,2313,817,0,,737
15:26:31,7487.347,Fox,4296,702,266,88,199,72,67,25,4311,4045,3957,2933,1008,861,330,372,2147,2149,463,2314,817,0,,736
15:26:31,7487.946,Fox,4304,706,266,90,200,68,69,24,4315,4049,3959,2933,1010,861,332,374,2151,2153,463,2317,818,0,,740
15:26:31,7488.546,Fox,4304,705,270,88,202,68,68,24,4319,4049,3961,2933,1010,861,331,374,2151,2153,463,2318,818,0,,739
15:26:32,7489.146,Fox,4308,702,274,86,201,64,68,24,4323,4049,3963,2935,1010,861,330,372,2152,2156,463,2325,818,0,,736
15:26:32,7489.747,Fox,4310,703,272,88,194,70,68,24,4323,4051,3963,2941,1010,861,329,374,2152,2158,463,2326,818,0,,737
15:26:33,7490.347,Fox,4310,703,270,90,190,76,68,24,4325,4055,3965,2947,1010,861,329,374,2152,2158,463,2326,818,0,,737
15:26:33,7490.946,Fox,4316,706,272,92,185,78,68,24,4329,4057,3965,2950,1010,861,330,376,2156,2160,463,2329,818,0,,740
15:26:33,7491.546,Fox,4316,705,274,92,184,79,68,23,4331,4057,3965,2951,1010,861,329,376,2156,2160,463,2329,819,0,,739
15:26:34,7492.146,Fox,4318,706,270,90,190,79,67,23,4331,4061,3971,2951,1010,861,329,377,2157,2161,463,2330,819,0,,740
15:26:34,7492.747,Fox,4318,706,268,92,192,79,67,23,4333,4065,3973,2951,1010,861,329,377,2157,2161,463,2330,819,0,,740
15:26:35,7493.646,Fox,4320,707,266,94,194,78,67,23,4335,4069,3975,2951,1010,861,330,377,2158,2162,463,2331,819,0,,741
15:26:35,7494.247,Fox,4324,709,266,96,194,76,67,23,4337,4071,3975,2951,1010,861,330,379,2160,2164,463,2333,819,0,,743
15:26:36,7494.847,Fox,4324,708,268,96,194,76,67,22,4339,4071,3975,2951,1010,861,330,378,2160,2164,463,2333,820,0,,742
15:26:36,7495.446,Fox,4332,711,264,100,189,77,67,21,4339,4075,3975,2953,1010,861,331,380,2165,2167,463,2337,821,0,,745
15:26:36,7496.046,Fox,4334,712,270,102,187,78,65,23,4347,4077,3975,2954,1010,863,331,381,2166,2168,463,2338,821,0,,746
15:26:37,7496.646,Fox,4336,709,272,104,185,75,65,23,4351,4079,3975,2956,1010,863,331,378,2167,2169,463,2343,821,0,,743
15:26:37,7497.247,Fox,4338,709,266,110,183,76,65,22,4351,4085,3975,2957,1010,863,330,379,2168,2170,463,2344,822,0,,743
15:26:38,7497.847,Fox,4342,711,268,112,181,76,65,22,4355,4087,3975,2957,1010,863,330,381,2170,2172,463,2346,822,0,,745
15:26:38,7498.446,Fox,4344,712,268,114,181,76,65,21,4357,4089,3975,2957,1010,863,329,383,2170,2174,463,2346,823,0,,746
15:26:38,7499.046,Fox,4352,718,272,114,183,76,63,21,4363,4091,3977,2957,1010,863,330,388,2173,2179,463,2348,823,0,,752
15:26:39,7499.646,Fox,4352,718,274,116,181,78,63,21,4367,4093,3977,2959,1010,863,330,388,2173,2179,463,2348,823,0,,752
15:26:39,7500.247,Fox,4354,719,264,128,180,78,63,21,4369,4105,3977,2959,1010,863,330,389,2174,2180,463,2349,823,0,,753
15:26:39,7500.847,Fox,4354,718,262,128,181,78,63,21,4369,4107,3979,2960,1010,863,330,388,2174,2180,463,2350,823,0,,752
15:26:40,7501.446,Fox,4354,716,254,136,181,76,63,21,4369,4115,3979,2960,1010,863,330,386,2174,2180,463,2352,823,0,,750
15:26:40,7502.046,Fox,4354,715,252,138,176,80,63,21,4369,4117,3979,2965,1011,863,330,385,2174,2180,463,2353,823,0,,749
15:26:41,7502.646,Fox,4360,717,248,144,175,79,63,21,4373,4125,3981,2965,1011,863,329,388,2176,2184,463,2357,823,0,,751
15:26:41,7503.247,Fox,4361,717,250,144,175,78,63,21,4375,4125,3981,2965,1011,863,329,388,2177,2184,463,2358,823,0,,751
15:26:42,7503.847,Fox,4367,719,256,146,170,79,62,22,4383,4127,3981,2967,1012,865,328,391,2179,2188,463,2361,824,0,,753
15:26:42,7504.446,Fox,4369,720,254,148,166,82,62,22,4383,4129,3981,2970,1012,865,328,392,2180,2189,463,2362,824,0,,754
15:26:42,7505.046,Fox,4371,721,256,148,163,82,64,22,4385,4129,3981,2973,1014,865,328,393,2181,2190,463,2363,824,0,,755
15:26:43,7505.646,Fox,4371,720,256,146,165,83,64,22,4387,4131,3985,2975,1014,865,328,392,2181,2190,463,2364,824,0,,754
15:26:44,7506.247,Fox,4373,721,256,146,164,85,64,22,4389,4133,3987,2977,1014,865,328,393,2182,2191,463,2365,824,0,,755
15:26:44,7506.847,Fox,4379,725,258,146,159,88,64,22,4391,4133,3987,2981,1014,865,329,396,2184,2195,463,2367,824,0,,759
15:26:44,7507.146,Fox,4379,725,262,146,159,87,65,22,4395,4133,3987,2981,1015,865,329,396,2184,2195,463,2367,824,0,,759
15:26:45,7508.046,Fox,4379,720,260,146,161,82,65,22,4395,4135,3989,2981,1015,865,328,392,2184,2195,463,2372,824,0,,754
15:26:45,7508.646,Fox,4379,720,254,150,163,80,67,22,4395,4141,3991,2981,1017,865,328,392,2184,2195,463,2372,824,0,,754
15:26:45,7509.247,Fox,4385,724,250,152,165,80,67,22,4397,4147,3995,2981,1017,865,329,395,2187,2198,463,2374,824,0,,758
15:26:46,7509.847,Fox,4385,722,254,148,168,77,69,22,4401,4147,3999,2982,1019,865,329,393,2187,2198,463,2376,824,0,,756
15:26:46,7510.446,Fox,4387,723,254,148,165,79,71,22,4403,4149,4001,2986,1021,865,330,393,2189,2198,463,2377,824,0,,757
15:26:46,7511.046,Fox,4397,732,256,148,167,77,72,22,4407,4151,4003,2986,1022,865,334,398,2194,2203,463,2378,824,0,,766
15:26:47,7511.646,Fox,4403,735,268,148,167,74,72,22,4419,4151,4003,2986,1022,865,332,403,2195,2208,463,2381,824,0,,769
15:26:47,7512.247,Fox,4409,739,268,152,165,75,71,22,4423,4155,4003,2987,1022,865,333,406,2198,2211,463,2383,824,0,,773
15:26:48,7512.847,Fox,4415,740,268,154,164,72,71,21,4425,4157,4003,2987,1022,865,330,410,2199,2216,463,2387,825,0,,774
15:26:48,7513.446,Fox,4423,746,274,156,162,72,70,22,4433,4159,4003,2987,1022,866,331,415,2202,2221,463,2389,825,0,,780
15:26:49,7514.046,Fox,4431,750,286,156,158,72,70,22,4445,4159,4003,2987,1022,866,330,420,2205,2226,463,2393,825,0,,784
15:26:49,7514.646,Fox,4431,750,286,154,161,71,72,22,4447,4161,4007,2988,1024,866,330,420,2205,2226,463,2393,825,0,,784
15:26:49,7515.247,Fox,4433,748,288,148,166,69,72,21,4449,4161,4013,2988,1024,866,331,417,2207,2226,463,2396,826,0,,782
15:26:50,7516.146,Fox,4435,743,286,150,164,65,72,20,4449,4163,4013,2989,1024,866,329,414,2208,2227,463,2402,827,0,,777
15:26:50,7516.747,Fox,4435,739,288,148,163,65,70,21,4451,4163,4015,2992,1024,868,329,410,2208,2227,465,2403,828,0,,773
15:26:51,7517.347,Fox,4435,738,288,146,162,67,70,21,4451,4163,4017,2995,1024,868,329,409,2208,2227,465,2404,828,0,,772
15:26:51,7517.946,Fox,4435,738,288,144,161,70,70,21,4451,4163,4019,2998,1024,868,329,409,2208,2227,465,2404,828,0,,772
15:26:52,7518.546,Fox,4437,738,290,144,155,75,70,20,4453,4163,4019,3003,1024,868,330,408,2210,2227,465,2405,829,0,,772
15:26:52,7519.146,Fox,4437,737,290,144,153,77,70,19,4453,4163,4019,3005,1024,868,330,407,2210,2227,465,2405,830,0,,771
15:26:53,7519.747,Fox,4445,744,296,144,150,79,70,19,4459,4163,4019,3007,1024,868,331,413,2212,2233,465,2406,830,0,,778
15:26:53,7520.347,Fox,4447,745,300,142,147,83,68,21,4463,4163,4021,3011,1024,870,331,414,2213,2234,465,2407,830,0,,779
15:26:53,7520.946,Fox,4447,744,300,138,150,83,68,21,4463,4163,4025,3012,1024,870,331,413,2213,2234,465,2408,830,0,,778
15:26:54,7521.546,Fox,4449,745,302,132,155,83,68,21,4465,4163,4031,3013,1024,870,331,414,2213,2236,465,2409,830,0,,779
15:26:54,7522.146,Fox,4457,749,304,132,153,85,68,19,4469,4165,4033,3016,1024,870,333,416,2217,2240,465,2411,832,0,,783
15:26:55,7522.747,Fox,4461,749,308,132,150,86,68,19,4475,4167,4035,3020,1024,870,333,416,2219,2242,465,2415,832,0,,783
15:26:55,7523.347,Fox,4461,748,304,136,152,85,68,19,4477,4173,4037,3020,1024,870,333,415,2219,2242,465,2416,832,0,,782
15:26:56,7523.946,Fox,4461,745,298,140,154,83,66,20,4477,4179,4039,3020,1024,872,333,412,2219,2242,465,2418,833,0,,779
15:26:56,7524.546,Fox,4461,745,290,146,155,84,66,20,4477,4187,4041,3021,1024,872,333,412,2219,2242,465,2418,833,0,,779
15:26:56,7525.146,Fox,4461,744,288,148,149,87,68,20,4477,4189,4041,3027,1026,872,333,411,2219,2242,465,2419,833,0,,778
15:26:57,7525.747,Fox,4461,744,286,146,149,91,65,23,4477,4191,4045,3031,1026,875,333,411,2219,2242,465,2419,833,0,,778
15:26:57,7526.347,Fox,4463,743,288,142,152,89,65,23,4479,4191,4049,3031,1026,875,333,410,2220,2243,465,2422,833,0,,777
15:26:58,7526.946,Fox,4465,744,286,146,150,89,66,23,4481,4195,4049,3032,1027,875,333,411,2221,2244,465,2423,833,0,,778
15:26:58,7527.546,Fox,4465,742,280,152,147,92,65,22,4481,4201,4049,3035,1027,875,331,411,2221,2244,465,2424,834,0,,776
15:26:58,7528.146,Fox,4467,741,280,152,143,96,64,22,4483,4203,4051,3041,1027,875,330,411,2221,2246,465,2427,834,0,,775
15:26:59,7528.747,Fox,4471,743,282,148,145,95,65,22,4485,4203,4055,3042,1028,875,331,412,2224,2247,465,2429,834,0,,777
15:26:59,7529.347,Fox,4475,740,282,148,144,90,66,22,4487,4205,4057,3044,1029,875,330,410,2225,2250,465,2436,834,0,,774
15:27:00,7529.946,Fox,4481,742,286,152,140,90,66,22,4495,4209,4057,3046,1029,875,332,410,2229,2252,465,2440,834,0,,776
15:27:00,7530.546,Fox,4485,742,288,148,139,91,66,22,4497,4209,4061,3049,1029,875,331,411,2231,2254,465,2444,834,0,,776
15:27:01,7531.146,Fox,4485,739,290,146,143,88,66,22,4501,4211,4065,3049,1029,875,331,408,2231,2254,465,2447,834,0,,773
15:27:01,7531.747,Fox,4487,740,290,144,145,89,66,22,4503,4213,4069,3051,1029,875,333,407,2233,2254,465,2448,834,0,,774
15:27:01,7532.347,Fox,4491,742,294,144,140,92,66,22,4507,4213,4069,3055,1029,875,331,411,2233,2258,466,2449,834,0,,776
15:27:02,7532.946,Fox,4491,741,294,142,140,92,68,21,4507,4213,4071,3057,1031,875,330,411,2233,2258,466,2449,835,0,,775
15:27:02,7533.546,Fox,4495,743,296,142,137,93,68,21,4509,4213,4071,3058,1031,875,330,413,2235,2260,466,2451,835,0,,777
15:27:03,7534.146,Fox,4495,742,296,140,139,94,68,21,4511,4215,4075,3060,1031,875,329,413,2235,2260,466,2452,835,0,,776
15:27:03,7534.747,Fox,4495,739,294,138,141,91,70,21,4511,4217,4079,3062,1033,875,329,410,2235,2260,466,2455,835,0,,773
15:27:04,7535.347,Fox,4497,740,294,138,143,90,70,21,4513,4219,4081,3062,1033,875,328,412,2235,2262,466,2456,835,0,,774
15:27:04,7535.946,Fox,4499,741,296,132,148,90,69,22,4515,4219,4087,3062,1033,876,329,412,2237,2262,466,2457,835,0,,775
15:27:05,7536.546,Fox,4505,743,298,132,147,88,69,21,4517,4219,4087,3062,1033,876,329,414,2240,2265,466,2460,836,0,,777
15:27:05,7536.847,Fox,4505,742,302,130,149,88,69,20,4521,4219,4089,3062,1033,876,328,414,2240,2265,466,2460,837,0,,776
15:27:06,7537.747,Fox,4507,743,298,134,150,87,69,21,4523,4225,4091,3062,1034,877,328,415,2241,2266,466,2461,837,0,,777
15:27:06,7538.347,Fox,4507,743,298,126,158,87,69,21,4523,4225,4099,3062,1034,877,328,415,2241,2266,466,2461,837,0,,777
15:27:06,7538.946,Fox,4511,744,296,122,165,87,69,19,4525,4229,4107,3063,1034,877,329,415,2243,2268,466,2462,839,0,,778
15:27:07,7539.546,Fox,4511,744,298,122,164,86,71,19,4527,4229,4107,3064,1036,877,329,415,2243,2268,466,2462,839,0,,778
15:27:07,7540.146,Fox,4511,744,296,116,168,90,71,19,4527,4231,4115,3068,1036,877,329,415,2243,2268,466,2462,839,0,,778
15:27:08,7540.747,Fox,4515,744,296,110,171,91,72,18,4529,4233,4123,3072,1037,877,328,416,2243,2272,466,2465,840,0,,778
15:27:08,7541.347,Fox,4515,739,298,108,170,89,72,18,4531,4233,4125,3075,1037,877,327,412,2243,2272,466,2470,840,0,,773
15:27:08,7541.946,Fox,4515,736,298,106,168,90,72,18,4531,4233,4127,3079,1037,877,326,410,2243,2272,466,2473,840,0,,770
15:27:09,7542.546,Fox,4517,736,300,104,168,90,73,17,4533,4233,4129,3080,1038,877,326,410,2244,2273,466,2474,841,0,,770
15:27:09,7543.146,Fox,4521,738,302,104,168,88,73,17,4535,4233,4129,3080,1038,877,327,411,2245,2276,466,2476,841,0,,772
15:27:10,7543.747,Fox,4521,733,301,108,168,84,72,17,4538,4237,4129,3080,1038,877,327,406,2245,2276,466,2481,841,0,,767
15:27:10,7544.347,Fox,4521,732,301,106,168,86,72,16,4538,4237,4131,3082,1038,877,326,406,2245,2276,466,2481,842,0,,766
15:27:11,7544.946,Fox,4521,729,301,104,167,87,72,15,4538,4237,4133,3085,1038,877,326,403,2245,2276,466,2483,843,0,,763
15:27:11,7545.847,Fox,4521,727,295,110,167,85,72,15,4538,4243,4133,3085,1038,877,326,401,2245,2276,466,2485,843,0,,761
15:27:12,7546.446,Fox,4523,725,297,110,166,82,72,15,4540,4243,4133,3085,1038,877,325,400,2246,2277,466,2489,843,0,,759
15:27:12,7547.046,Fox,4525,725,297,108,167,82,72,14,4540,4243,4135,3086,1038,877,323,402,2246,2279,466,2490,844,0,,759
15:27:12,7547.646,Fox,4525,724,299,100,175,81,72,14,4542,4243,4143,3086,1038,877,322,402,2246,2279,466,2491,844,0,,758
15:27:13,7548.247,Fox,4527,723,301,96,177,80,72,14,4544,4243,4147,3088,1038,877,321,402,2246,2281,466,2494,844,0,,757
15:27:13,7548.847,Fox,4529,723,299,100,177,78,72,14,4546,4247,4147,3088,1038,877,321,402,2247,2282,466,2496,844,0,,757
15:27:14,7549.446,Fox,4529,722,297,98,179,78,73,14,4546,4249,4151,3090,1039,877,321,401,2247,2282,466,2497,844,0,,756
15:27:14,7550.046,Fox,4531,724,297,98,177,80,73,14,4546,4249,4151,3092,1039,877,323,401,2249,2282,466,2497,844,0,,758
15:27:14,7550.646,Fox,4531,720,299,94,181,77,73,13,4548,4249,4155,3092,1039,877,323,397,2249,2282,466,2500,845,0,,754
15:27:15,7551.247,Fox,4531,716,297,96,179,76,72,13,4548,4251,4155,3094,1039,878,322,394,2249,2282,466,2503,846,0,,750
15:27:15,7551.847,Fox,4533,717,297,94,181,75,72,13,4548,4251,4157,3094,1039,878,324,393,2251,2282,466,2504,846,0,,751
15:27:16,7552.446,Fox,4535,717,297,96,182,74,72,13,4552,4255,4159,3095,1039,878,323,394,2252,2283,466,2506,846,0,,751
15:27:16,7553.046,Fox,4537,716,293,100,177,76,72,13,4552,4259,4159,3099,1039,878,324,392,2254,2283,467,2508,846,0,,750
15:27:16,7553.646,Fox,4537,711,291,102,179,73,71,12,4554,4263,4161,3099,1039,878,323,388,2254,2283,467,2512,847,0,,745
15:27:17,7554.247,Fox,4537,710,291,102,177,74,70,13,4554,4263,4161,3101,1039,879,322,388,2254,2283,467,2513,847,0,,744
15:27:17,7554.847,Fox,4539,707,291,100,178,71,70,12,4554,4263,4163,3101,1039,879,322,385,2255,2284,467,2517,848,0,,741
15:27:17,7555.436,Fox,4539,706,289,104,178,70,70,12,4556,4267,4163,3101,1039,879,322,384,2255,2284,467,2518,848,0,,740
15:27:18,7556.335,Fox,4541,704,289,106,177,69,69,11,4558,4269,4163,3101,1039,879,322,382,2257,2284,467,2521,849,0,,738
15:27:18,7556.936,Fox,4541,703,285,110,177,68,69,11,4558,4273,4163,3101,1039,879,321,382,2257,2284,467,2522,849,0,,737
15:27:19,7557.536,Fox,4541,699,285,110,177,64,69,11,4558,4273,4163,3101,1039,879,319,380,2257,2284,467,2526,849,0,,733
15:27:19,7558.136,Fox,4543,700,283,112,176,64,69,11,4558,4275,4163,3101,1039,879,319,381,2258,2285,467,2527,849,0,,734
15:27:20,7558.436,Fox,4543,700,283,114,176,64,69,11,4560,4277,4163,3101,1039,879,319,381,2258,2285,467,2527,849,0,,734
15:27:20,7559.335,Fox,4545,701,283,116,173,65,70,11,4562,4279,4163,3103,1040,879,318,383,2258,2287,467,2528,849,0,,735
15:27:21,7559.936,Fox,4545,701,283,116,173,63,70,13,4562,4279,4163,3103,1042,881,318,383,2258,2287,467,2528,849,0,,735
15:27:21,7560.536,Fox,4545,701,281,116,175,63,70,13,4562,4281,4165,3103,1042,881,318,383,2258,2287,467,2528,849,0,,735
15:27:22,7561.436,Fox,4547,701,283,110,178,64,70,13,4564,4281,4171,3105,1042,881,316,385,2258,2289,467,2530,849,0,,735
15:27:22,7562.036,Fox,4547,700,281,108,182,63,70,13,4564,4283,4175,3105,1042,881,316,384,2258,2289,467,2531,849,0,,734
15:27:23,7562.636,Fox,4549,697,281,102,189,59,70,13,4566,4285,4183,3105,1042,881,316,381,2259,2290,467,2536,849,0,,731
15:27:23,7563.236,Fox,4549,692,275,102,193,57,70,12,4566,4291,4189,3107,1042,881,316,376,2259,2290,468,2540,849,0,,726
15:27:23,7563.835,Fox,4551,693,273,106,193,56,70,12,4568,4295,4189,3107,1042,881,317,376,2261,2290,468,2541,849,0,,727
15:27:24,7564.436,Fox,4555,689,269,110,194,50,68,13,4570,4301,4191,3107,1042,883,317,372,2263,2292,468,2548,850,0,,723
15:27:24,7565.036,Fox,4555,688,271,106,198,49,68,13,4572,4301,4195,3107,1042,883,316,372,2263,2292,468,2549,850,0,,722
15:27:25,7565.636,Fox,4561,692,273,104,199,48,68,13,4574,4301,4197,3107,1042,883,319,373,2268,2293,468,2551,850,0,,726
15:27:25,7566.236,Fox,4561,692,275,100,201,52,68,13,4578,4303,4203,3111,1042,883,319,373,2268,2293,468,2551,850,0,,726
15:27:25,7566.835,Fox,4563,688,273,102,198,49,68,13,4578,4305,4203,3113,1042,883,317,371,2269,2294,468,2557,850,0,,722
15:27:26,7567.436,Fox,4569,691,277,102,195,49,68,13,4582,4305,4203,3113,1042,883,318,373,2273,2296,468,2560,850,0,,725
15:27:26,7568.036,Fox,4569,690,279,100,199,48,68,13,4586,4307,4207,3113,1042,883,318,372,2273,2296,468,2561,850,0,,724
15:27:27,7568.636,Fox,4571,691,281,98,198,50,68,13,4588,4307,4209,3115,1042,883,318,373,2274,2297,468,2562,850,0,,725
15:27:27,7569.236,Fox,4573,693,281,96,198,52,68,13,4588,4307,4211,3117,1042,883,319,374,2275,2298,468,2562,850,0,,727
15:27:27,7569.835,Fox,4573,692,279,98,198,53,68,13,4590,4311,4213,3119,1042,883,319,373,2275,2298,468,2563,850,0,,726
15:27:28,7570.436,Fox,4575,693,281,98,194,56,68,13,4592,4311,4213,3122,1042,883,318,375,2275,2300,468,2564,850,0,,727
15:27:28,7571.036,Fox,4575,691,273,106,192,56,68,13,4592,4319,4213,3124,1042,883,318,373,2275,2300,468,2566,850,0,,725
15:27:28,7571.636,Fox,4575,689,273,106,191,55,68,13,4592,4319,4213,3125,1042,883,318,371,2275,2300,468,2568,850,0,,723
15:27:29,7571.936,Fox,4575,689,269,110,191,55,68,13,4592,4323,4213,3125,1042,883,318,371,2275,2300,468,2568,850,0,,723
15:27:29,7572.786,Fox,4577,690,269,110,192,55,68,13,4594,4325,4215,3125,1042,883,318,372,2276,2301,468,2569,850,0,,724
15:27:30,7573.686,Fox,4577,690,265,110,196,55,68,13,4594,4329,4219,3125,1042,883,318,372,2276,2301,468,2569,850,0,,724
15:27:30,7573.986,Fox,4577,689,263,112,196,54,68,13,4594,4331,4219,3125,1042,883,318,371,2276,2301,468,2570,850,0,,723
15:27:30,7574.886,Fox,4579,687,263,112,195,51,66,15,4594,4331,4219,3125,1042,885,318,369,2277,2302,468,2574,850,0,,721
15:27:31,7575.486,Fox,4581,687,265,114,190,54,66,15,4598,4333,4219,3129,1042,885,319,368,2279,2302,468,2576,850,0,,721
15:27:31,7576.086,Fox,4585,690,265,112,188,57,65,16,4598,4333,4221,3132,1042,886,320,370,2281,2304,468,2577,850,0,,724
15:27:32,7576.686,Fox,4589,690,269,110,191,55,65,15,4604,4335,4225,3132,1042,886,319,371,2281,2308,468,2580,851,0,,724
15:27:32,7577.286,Fox,4591,692,269,114,189,57,65,15,4608,4339,4225,3134,1042,886,320,372,2282,2309,468,2580,851,0,,726
15:27:33,7577.886,Fox,4591,692,269,110,191,59,64,16,4608,4339,4229,3136,1042,887,320,372,2282,2309,468,2580,851,0,,726
15:27:33,7578.486,Fox,4593,693,263,118,189,60,64,16,4610,4347,4229,3137,1042,887,319,374,2282,2311,468,2581,851,0,,727
15:27:34,7579.086,Fox,4595,694,263,116,192,60,62,18,4612,4349,4233,3137,1042,889,319,375,2283,2312,468,2582,851,0,,728
15:27:34,7579.686,Fox,4597,696,261,118,192,60,62,18,4612,4351,4233,3137,1042,889,320,376,2284,2313,468,2582,851,0,,730
15:27:34,7580.286,Fox,4597,696,261,120,192,60,62,18,4614,4353,4233,3137,1042,889,320,376,2284,2313,468,2582,851,0,,730
15:27:35,7580.886,Fox,4597,696,257,124,191,61,60,20,4614,4357,4233,3138,1042,891,320,376,2284,2313,468,2582,851,0,,730
15:27:35,7581.486,Fox,4601,698,257,126,188,62,60,20,4616,4359,4233,3139,1042,891,319,379,2285,2316,468,2584,851,0,,732
15:27:35,7582.086,Fox,4601,697,251,134,183,66,60,20,4618,4367,4233,3144,1042,891,319,378,2285,2316,468,2585,851,0,,731
15:27:36,7582.386,Fox,4601,697,251,130,185,67,61,20,4618,4367,4237,3146,1043,891,319,378,2285,2316,468,2585,851,0,,731
15:27:36,7583.286,Fox,4603,698,249,132,184,67,60,21,4618,4369,4237,3147,1043,892,319,379,2286,2317,468,2586,851,0,,732
15:27:37,7583.886,Fox,4605,697,253,132,184,64,59,22,4622,4369,4237,3147,1043,893,320,377,2288,2317,468,2589,851,0,,731
15:27:37,7584.486,Fox,4609,699,255,126,186,66,58,23,4624,4369,4243,3149,1043,894,319,380,2289,2320,468,2591,851,0,,733
15:27:37,7585.086,Fox,4611,700,259,126,184,67,55,26,4628,4369,4243,3151,1043,897,319,381,2290,2321,468,2592,851,0,,734
15:27:38,7585.686,Fox,4611,698,253,132,184,65,54,27,4628,4375,4243,3151,1043,898,318,380,2290,2321,468,2594,851,0,,732
15:27:38,7586.286,Fox,4617,702,255,134,179,68,54,27,4632,4377,4243,3154,1043,898,319,383,2293,2324,468,2596,851,0,,736
15:27:39,7586.886,Fox,4619,702,251,140,174,72,54,26,4634,4383,4243,3158,1043,898,319,383,2294,2325,468,2597,852,0,,736
15:27:39,7587.486,Fox,4619,702,251,138,178,72,53,27,4636,4385,4247,3158,1043,899,319,383,2294,2325,468,2597,852,0,,736
15:27:39,7588.086,Fox,4623,703,253,138,179,72,51,27,4640,4387,4249,3158,1043,901,317,386,2295,2328,468,2599,853,0,,737
15:27:40,7588.686,Fox,4623,701,253,138,178,70,52,27,4640,4387,4249,3159,1044,901,317,384,2295,2328,468,2601,853,0,,735
15:27:40,7589.286,Fox,4623,700,251,140,176,71,52,27,4640,4389,4249,3161,1044,901,316,384,2295,2328,468,2602,853,0,,734
15:27:41,7589.886,Fox,4623,699,245,144,176,73,51,27,4640,4395,4251,3163,1044,901,316,383,2295,2328,468,2603,853,0,,733
15:27:41,7590.486,Fox,4623,698,245,140,180,73,47,30,4640,4395,4255,3163,1044,905,315,383,2295,2328,468,2603,854,0,,732
15:27:41,7591.086,Fox,4623,696,245,138,179,74,46,31,4640,4395,4257,3166,1044,906,314,382,2295,2328,468,2605,854,0,,730
15:27:42,7591.686,Fox,4623,694,245,136,177,76,44,33,4640,4395,4259,3170,1044,908,314,380,2295,2328,468,2607,854,0,,728
15:27:42,7592.286,Fox,4623,692,239,138,178,77,44,33,4640,4401,4263,3173,1044,908,314,378,2295,2328,468,2609,854,0,,726
15:27:43,7592.886,Fox,4623,691,239,138,178,76,44,33,4640,4401,4263,3173,1045,908,313,378,2295,2328,468,2610,854,0,,725
15:27:43,7593.486,Fox,4627,693,241,138,178,76,44,33,4644,4403,4265,3175,1045,908,314,379,2297,2330,468,2612,854,0,,727
15:27:43,7594.086,Fox,4629,692,233,146,179,74,44,33,4646,4413,4267,3175,1045,908,313,379,2298,2331,468,2615,854,0,,726
15:27:44,7594.386,Fox,4629,691,227,150,177,77,44,33,4646,4419,4269,3179,1045,908,313,378,2298,2331,468,2616,854,0,,725
15:27:44,7595.286,Fox,4629,690,221,152,177,80,42,35,4646,4425,4273,3183,1045,910,313,377,2298,2331,468,2617,854,0,,724
15:27:45,7596.186,Fox,4635,693,213,158,172,84,42,35,4646,4433,4275,3187,1045,910,311,382,2299,2336,469,2619,854,0,,727
15:27:45,7596.786,Fox,4641,696,211,168,173,82,42,35,4656,4445,4277,3188,1045,910,308,388,2299,2342,469,2622,854,0,,730
15:27:46,7597.386,Fox,4643,694,211,168,174,79,42,35,4658,4447,4279,3188,1045,910,306,388,2299,2344,469,2626,854,0,,728
15:27:46,7597.986,Fox,4645,693,213,170,173,78,42,34,4662,4449,4279,3188,1045,910,304,389,2299,2346,469,2628,855,0,,727
15:27:46,7598.586,Fox,4649,694,215,170,171,78,42,33,4664,4449,4279,3190,1045,910,304,390,2301,2348,469,2631,855,0,,728
15:27:47,7599.186,Fox,4653,695,217,170,165,84,42,32,4668,4451,4281,3198,1045,910,304,391,2303,2350,469,2633,856,0,,729
15:27:47,7599.786,Fox,4653,692,219,170,163,83,42,32,4670,4451,4281,3200,1045,910,303,389,2303,2350,469,2636,856,0,,726
15:27:48,7600.686,Fox,4653,689,219,168,159,88,41,31,4670,4451,4283,3206,1045,911,303,386,2303,2350,469,2637,858,0,,723
15:27:48,7601.286,Fox,4653,689,217,162,160,95,41,31,4670,4453,4291,3213,1045,911,303,386,2303,2350,469,2637,858,0,,723
15:27:49,7601.886,Fox,4655,689,219,162,158,96,41,30,4672,4453,4291,3215,1045,911,303,386,2304,2351,469,2638,859,0,,723
15:27:49,7602.486,Fox,4657,690,215,160,164,97,41,30,4674,4459,4299,3217,1045,911,304,386,2306,2351,469,2639,859,0,,724
15:27:50,7603.086,Fox,4661,693,211,162,163,99,41,30,4674,4463,4301,3219,1045,911,306,387,2309,2352,469,2640,859,0,,727
15:27:50,7603.686,Fox,4661,692,215,162,163,98,39,32,4678,4463,4301,3219,1045,913,306,386,2309,2352,469,2641,859,0,,726
15:27:50,7604.286,Fox,4663,692,215,164,163,96,39,32,4680,4465,4301,3219,1045,913,307,385,2310,2353,469,2643,859,0,,726
15:27:51,7604.886,Fox,4669,693,215,166,161,95,39,32,4684,4469,4303,3221,1045,913,307,386,2314,2355,469,2648,859,0,,727
15:27:51,7605.486,Fox,4673,694,213,170,159,97,39,31,4688,4475,4305,3223,1045,913,308,386,2317,2356,469,2650,860,0,,728
15:27:52,7606.086,Fox,4675,693,215,172,158,95,39,31,4692,4477,4305,3223,1045,913,307,386,2317,2358,469,2653,860,0,,727
15:27:52,7606.686,Fox,4675,691,215,170,160,93,39,31,4692,4477,4307,3223,1045,913,307,384,2317,2358,469,2655,860,0,,725
15:27:52,7607.286,Fox,4675,691,215,170,158,95,38,32,4692,4477,4307,3225,1045,914,307,384,2317,2358,469,2655,860,0,,725
15:27:53,7607.886,Fox,4677,691,217,170,150,101,38,32,4694,4477,4307,3232,1045,914,307,384,2318,2359,469,2657,860,0,,725
15:27:53,7608.486,Fox,4677,688,217,166,150,102,38,32,4694,4477,4311,3236,1045,914,307,381,2318,2359,469,2660,860,0,,722
15:27:53,7609.086,Fox,4679,687,217,164,153,100,38,32,4696,4479,4315,3236,1045,914,306,381,2318,2361,469,2663,860,0,,721
15:27:54,7609.686,Fox,4681,689,217,162,154,103,37,33,4698,4481,4319,3239,1045,915,307,382,2319,2362,469,2663,860,0,,723
15:27:54,7610.286,Fox,4681,688,217,158,158,102,37,33,4698,4481,4323,3239,1045,915,307,381,2319,2362,469,2664,860,0,,722
15:27:55,7610.886,Fox,4683,690,217,160,154,106,37,33,4700,4483,4323,3243,1045,915,308,382,2320,2363,469,2664,860,0,,724
15:27:55,7611.486,Fox,4683,690,215,160,156,105,37,34,4700,4485,4325,3243,1046,916,308,382,2320,2363,469,2664,860,0,,724
15:27:55,7612.086,Fox,4685,690,215,158,158,103,39,34,4702,4487,4329,3245,1048,916,310,380,2322,2363,469,2666,860,0,,724
15:27:56,7612.686,Fox,4685,688,207,164,158,103,39,34,4702,4495,4331,3247,1048,916,308,380,2322,2363,469,2668,860,0,,722
15:27:56,7613.286,Fox,4690,688,207,166,156,100,39,34,4704,4497,4331,3247,1048,916,308,380,2325,2365,469,2673,860,0,,722
15:27:57,7613.886,Fox,4692,688,207,168,155,101,39,34,4708,4501,4333,3249,1048,916,309,379,2327,2365,469,2675,860,0,,722
15:27:57,7614.486,Fox,4694,688,207,170,155,99,39,34,4710,4503,4333,3249,1048,916,310,378,2329,2365,469,2677,860,0,,722
15:27:57,7615.086,Fox,4698,688,209,172,154,98,39,34,4716,4507,4335,3251,1048,916,310,378,2331,2367,469,2681,860,0,,722
15:27:58,7615.686,Fox,4700,688,209,168,157,98,39,33,4716,4507,4339,3251,1048,916,309,379,2332,2368,469,2682,861,0,,722
15:27:58,7616.286,Fox,4706,692,213,170,156,96,40,33,4722,4509,4339,3251,1049,916,309,383,2334,2372,469,2684,861,0,,726
15:27:59,7616.886,Fox,4708,693,215,164,164,95,38,35,4726,4511,4347,3251,1049,918,309,384,2335,2373,469,2685,861,0,,727
15:27:59,7617.486,Fox,4716,696,217,162,163,93,37,36,4728,4511,4349,3251,1049,919,309,387,2340,2376,469,2690,861,0,,730
15:27:59,7618.086,Fox,4718,696,223,162,165,91,37,36,4736,4513,4351,3251,1049,919,309,387,2340,2378,469,2692,861,0,,730
15:28:00,7618.686,Fox,4718,694,221,162,167,89,35,38,4736,4515,4353,3251,1049,921,309,385,2340,2378,469,2694,861,0,,728
15:28:00,7619.286,Fox,4718,692,219,160,171,85,37,38,4736,4517,4357,3251,1051,921,309,383,2340,2378,469,2696,861,0,,726
15:28:01,7619.886,Fox,4720,693,215,162,172,85,37,38,4736,4521,4359,3251,1051,921,309,384,2341,2379,469,2697,861,0,,727
15:28:01,7620.486,Fox,4724,695,215,156,180,83,37,38,4738,4523,4367,3251,1051,921,310,385,2344,2380,469,2699,861,0,,729
15:28:01,7621.086,Fox,4726,696,219,156,178,83,37,39,4742,4523,4367,3252,1052,922,310,386,2345,2381,469,2700,861,0,,730
15:28:02,7621.686,Fox,4728,694,219,156,177,80,39,39,4744,4525,4369,3254,1054,922,310,384,2346,2382,469,2704,861,0,,728
15:28:02,7622.286,Fox,4730,693,221,158,172,82,39,39,4748,4527,4369,3259,1054,922,311,382,2347,2383,469,2707,861,0,,727
15:28:03,7622.886,Fox,4738,696,223,158,164,85,39,39,4750,4527,4369,3264,1054,922,311,385,2351,2387,469,2712,861,0,,730
15:28:03,7623.486,Fox,4744,696,229,160,156,87,39,39,4758,4529,4369,3271,1054,922,312,384,2355,2389,469,2718,861,0,,730
15:28:03,7624.086,Fox,4744,695,231,156,161,87,39,39,4762,4531,4375,3272,1054,922,311,384,2355,2389,469,2719,861,0,,729
15:28:04,7624.986,Fox,4746,688,231,148,167,80,39,39,4762,4531,4383,3274,1054,922,311,377,2356,2390,469,2728,861,0,,722
15:28:04,7625.586,Fox,4750,690,233,150,162,84,37,40,4766,4533,4383,3278,1054,924,312,378,2358,2392,469,2729,862,0,,724
15:28:05,7626.186,Fox,4750,688,231,152,163,84,37,39,4768,4537,4385,3279,1054,924,312,376,2358,2392,469,2730,863,0,,722
15:28:05,7626.786,Fox,4750,687,230,151,162,86,37,39,4768,4538,4387,3282,1054,924,312,375,2358,2392,469,2731,863,0,,721
15:28:05,7627.386,Fox,4752,688,232,149,164,85,37,39,4770,4538,4389,3282,1054,924,312,376,2359,2393,469,2732,863,0,,722
15:28:06,7627.986,Fox,4756,691,234,147,165,85,37,39,4772,4538,4391,3282,1054,924,314,377,2362,2394,469,2733,863,0,,725
15:28:06,7628.586,Fox,4758,690,238,143,167,84,37,39,4776,4538,4395,3283,1054,924,312,378,2362,2396,469,2736,863,0,,724
15:28:07,7629.186,Fox,4762,689,236,145,163,83,37,39,4776,4540,4395,3285,1054,924,313,376,2365,2397,469,2741,863,0,,723
15:28:07,7629.786,Fox,4762,685,240,145,162,80,37,39,4780,4540,4395,3286,1054,924,313,372,2365,2397,469,2745,863,0,,719
15:28:07,7630.386,Fox,4764,685,240,145,161,82,37,38,4782,4542,4397,3288,1054,924,313,372,2366,2398,469,2746,864,0,,719
15:28:08,7630.986,Fox,4764,682,238,143,165,79,37,38,4782,4544,4401,3288,1054,924,312,370,2366,2398,470,2748,864,0,,716
15:28:08,7631.886,Fox,4764,680,236,143,167,78,37,37,4782,4546,4403,3288,1054,924,312,368,2366,2398,470,2749,865,0,,714
15:28:09,7632.486,Fox,4764,678,236,133,177,76,37,37,4782,4546,4413,3288,1054,924,310,368,2366,2398,470,2751,865,0,,712
15:28:09,7633.086,Fox,4764,678,234,129,181,78,37,37,4782,4548,4419,3290,1054,924,310,368,2366,2398,470,2751,865,0,,712
15:28:09,7633.686,Fox,4764,675,234,123,186,77,37,36,4782,4548,4425,3291,1054,924,309,366,2366,2398,470,2754,865,0,,709
15:28:10,7634.286,Fox,4764,674,234,117,191,78,37,35,4782,4548,4431,3292,1054,924,309,365,2366,2398,470,2754,866,0,,708
15:28:10,7634.886,Fox,4764,671,232,111,199,76,36,35,4782,4550,4439,3292,1054,924,308,363,2366,2398,470,2757,866,0,,705
15:28:10,7635.486,Fox,4764,671,230,105,207,75,37,35,4782,4552,4447,3292,1055,924,308,363,2366,2398,470,2757,866,0,,705
15:28:11,7636.086,Fox,4768,671,230,107,206,74,37,33,4784,4554,4447,3292,1055,924,308,363,2369,2399,470,2759,868,0,,705
15:28:11,7636.686,Fox,4768,671,232,105,204,78,37,33,4786,4554,4449,3296,1055,924,308,363,2369,2399,470,2759,868,0,,705
15:28:12,7637.886,Fox,4770,672,232,105,204,80,37,32,4788,4556,4451,3298,1055,924,308,364,2370,2400,470,2759,869,0,,706
15:28:13,7639.386,Fox,4774,674,232,107,200,82,36,33,4790,4558,4451,3300,1055,925,309,365,2373,2401,470,2761,869,0,,708
15:28:13,7639.986,Fox,4776,675,234,105,201,82,36,33,4792,4558,4453,3300,1055,925,310,365,2375,2401,470,2762,869,0,,709
15:28:13,7640.586,Fox,4778,675,238,105,200,82,36,32,4796,4558,4453,3300,1055,925,311,364,2377,2401,470,2764,869,0,,709
15:28:14,7641.186,Fox,4780,675,238,99,208,80,35,33,4798,4560,4461,3300,1055,926,312,363,2379,2401,470,2766,869,0,,709
15:28:14,7641.786,Fox,4780,669,238,97,210,75,35,32,4798,4560,4463,3300,1055,926,312,357,2379,2401,470,2771,870,0,,703
15:28:14,7642.386,Fox,4780,666,236,99,210,72,33,34,4798,4562,4463,3300,1055,928,311,355,2379,2401,470,2774,870,0,,700
15:28:15,7642.986,Fox,4782,663,238,97,210,70,33,33,4800,4562,4465,3302,1055,928,309,354,2380,2402,470,2779,870,0,,697
15:28:15,7643.586,Fox,4784,663,238,89,218,68,33,33,4800,4562,4473,3302,1055,928,308,355,2380,2404,470,2781,870,0,,697
15:28:15,7644.186,Fox,4784,663,238,87,222,68,33,33,4802,4564,4477,3302,1055,928,308,355,2380,2404,470,2781,870,0,,697
15:28:16,7644.786,Fox,4784,660,238,87,218,67,35,33,4802,4564,4477,3306,1057,928,306,354,2380,2404,470,2784,870,0,,694
15:28:16,7645.386,Fox,4788,659,236,89,216,64,35,33,4802,4566,4477,3306,1057,928,307,352,2383,2405,470,2789,870,0,,693
15:28:16,7645.986,Fox,4792,662,242,89,216,63,34,34,4808,4566,4477,3306,1057,929,308,354,2385,2407,470,2790,870,0,,696
15:28:16,7646.586,Fox,4794,663,244,91,216,63,34,33,4812,4568,4477,3306,1057,929,309,354,2386,2408,470,2790,871,0,,697
15:28:17,7647.186,Fox,4794,660,242,93,216,60,32,35,4812,4570,4477,3306,1057,931,309,351,2386,2408,470,2793,871,0,,694
15:28:17,7647.786,Fox,4798,662,244,93,212,64,30,37,4816,4572,4479,3310,1057,933,308,354,2387,2411,471,2794,871,0,,696
15:28:17,7648.386,Fox,4798,661,242,93,213,64,30,37,4816,4574,4481,3311,1057,933,307,354,2387,2411,471,2795,871,0,,695
15:28:17,7648.686,Fox,4798,659,238,97,213,62,30,37,4816,4578,4481,3311,1057,933,307,352,2387,2411,471,2797,871,0,,693
15:28:18,7649.286,Fox,4798,658,238,95,215,62,30,36,4816,4578,4483,3311,1057,933,307,351,2387,2411,471,2797,872,0,,692
15:28:18,7650.186,Fox,4802,660,234,95,216,63,30,36,4816,4582,4487,3313,1057,933,306,354,2388,2414,471,2799,872,0,,694
15:28:18,7650.786,Fox,4804,661,236,95,219,63,30,36,4822,4586,4491,3313,1057,933,305,356,2388,2416,471,2800,872,0,,695
15:28:19,7651.215,Fox,4804,661,234,91,221,67,30,36,4822,4588,4497,3317,1057,933,305,356,2388,2416,471,2800,872,0,,695
15:28:19,7651.815,Fox,4804,659,234,91,219,67,28,38,4822,4588,4497,3319,1057,935,305,354,2388,2416,471,2802,872,0,,693
15:28:19,7652.416,Fox,4806,659,232,89,220,69,28,37,4822,4590,4501,3321,1057,935,306,353,2390,2416,471,2803,873,0,,693
15:28:20,7653.015,Fox,4806,659,232,89,219,72,28,37,4824,4592,4503,3324,1057,935,306,353,2390,2416,471,2803,873,0,,693
15:28:20,7653.615,Fox,4806,659,232,85,223,72,28,37,4824,4592,4507,3324,1057,935,306,353,2390,2416,471,2803,873,0,,693
15:28:20,7654.515,Fox,4808,657,232,85,220,71,28,37,4824,4592,4507,3326,1057,935,304,353,2390,2418,471,2807,873,0,,691
15:28:21,7655.115,Fox,4808,656,234,81,223,71,28,37,4826,4592,4511,3327,1057,935,304,352,2390,2418,471,2808,873,0,,690
15:28:21,7655.715,Fox,4808,656,232,83,221,73,28,37,4826,4594,4511,3329,1057,935,304,352,2390,2418,471,2808,873,0,,690
15:28:21,7656.315,Fox,4808,652,232,83,219,73,28,35,4826,4594,4511,3331,1057,935,303,349,2390,2418,471,2810,875,0,,686
15:28:21,7656.916,Fox,4810,653,232,81,219,74,28,35,4826,4594,4513,3332,1057,935,304,349,2392,2418,471,2811,875,0,,687
15:28:22,7657.515,Fox,4812,651,234,79,218,73,28,35,4828,4594,4515,3334,1057,935,300,351,2392,2420,471,2815,875,0,,685
15:28:22,7658.115,Fox,4816,653,234,77,221,74,28,35,4832,4598,4521,3336,1057,935,299,354,2393,2423,471,2817,875,0,,687
15:28:22,7658.416,Fox,4816,653,236,77,221,74,28,35,4834,4598,4521,3336,1057,935,299,354,2393,2423,471,2817,875,0,,687
15:28:23,7659.315,Fox,4824,654,234,81,220,71,28,34,4838,4604,4523,3336,1057,935,299,355,2399,2425,471,2823,876,0,,688
15:28:23,7659.916,Fox,4826,655,234,85,217,73,28,34,4842,4608,4523,3338,1057,935,299,356,2400,2426,471,2824,876,0,,689
15:28:23,7660.515,Fox,4830,655,240,81,219,70,30,33,4848,4608,4527,3338,1059,935,299,356,2402,2428,471,2827,877,0,,689
15:28:24,7661.115,Fox,4830,655,238,83,219,70,30,33,4848,4610,4527,3338,1059,935,299,356,2402,2428,471,2827,877,0,,689
15:28:24,7662.015,Fox,4830,654,236,83,214,77,30,32,4848,4612,4529,3345,1059,935,299,355,2402,2428,471,2827,878,0,,688
15:28:24,7662.57,Fox,4832,654,234,83,212,79,28,34,4848,4614,4531,3349,1059,937,300,354,2403,2429,471,2829,878,0,,688
15:28:25,7663.17,Fox,4832,652,236,83,208,83,26,34,4850,4614,4531,3353,1059,937,298,354,2403,2429,471,2831,878,0,,686
15:28:25,7663.77,Fox,4834,653,236,81,209,82,27,34,4850,4614,4533,3353,1060,937,297,356,2403,2431,471,2832,878,0,,687
15:28:25,7664.37,Fox,4836,654,236,83,211,81,26,35,4854,4618,4535,3353,1060,938,298,356,2405,2431,471,2833,878,0,,688
15:28:26,7664.97,Fox,4838,653,236,80,212,81,26,34,4854,4618,4538,3355,1060,938,296,357,2405,2433,471,2835,879,0,,687
15:28:26,7665.57,Fox,4840,651,238,80,209,81,26,33,4856,4618,4538,3357,1060,938,296,355,2406,2434,471,2838,880,0,,685
15:28:26,7666.17,Fox,4842,649,240,82,208,80,26,31,4860,4620,4538,3357,1060,938,294,355,2406,2436,471,2840,882,0,,683
15:28:27,7666.77,Fox,4842,649,238,84,206,82,24,33,4860,4622,4538,3359,1060,940,294,355,2406,2436,471,2840,882,0,,683
15:28:27,7667.37,Fox,4842,649,234,88,206,82,24,33,4860,4626,4538,3359,1060,940,294,355,2406,2436,471,2840,882,0,,683
15:28:27,7667.97,Fox,4844,646,234,88,207,80,24,31,4862,4628,4540,3359,1060,940,291,355,2406,2438,471,2843,884,0,,680
15:28:28,7668.57,Fox,4849,643,238,86,203,78,25,30,4866,4628,4542,3362,1061,940,288,355,2409,2440,471,2850,885,0,,677
15:28:28,7669.17,Fox,4851,642,234,92,203,74,26,30,4868,4634,4542,3362,1062,940,287,355,2411,2440,471,2853,885,0,,676
15:28:28,7669.77,Fox,4853,641,236,92,198,78,26,30,4872,4636,4544,3369,1062,940,286,355,2412,2441,471,2856,885,0,,675
15:28:28,7670.07,Fox,4853,639,236,90,200,76,26,30,4872,4636,4546,3369,1062,940,285,354,2412,2441,471,2858,885,0,,673
15:28:29,7670.67,Fox,4853,639,232,94,197,79,24,32,4872,4640,4546,3372,1062,942,285,354,2412,2441,471,2858,885,0,,673
15:28:29,7671.57,Fox,4857,638,232,92,196,78,25,30,4872,4640,4548,3374,1063,942,285,353,2414,2443,471,2861,887,0,,672
15:28:29,7672.17,Fox,4857,636,236,92,196,77,25,29,4876,4640,4548,3374,1063,942,285,351,2414,2443,471,2862,888,0,,670
15:28:30,7672.77,Fox,4859,635,238,92,193,77,23,31,4878,4640,4548,3376,1063,944,285,350,2415,2444,471,2865,888,0,,669
15:28:30,7673.67,Fox,4859,635,238,88,197,77,23,31,4878,4640,4552,3376,1063,944,285,350,2415,2444,471,2865,888,0,,669
15:28:30,7673.97,Fox,4859,633,238,88,196,76,24,30,4878,4640,4552,3377,1064,944,285,348,2415,2444,471,2867,888,0,,667
15:28:31,7674.87,Fox,4861,631,238,86,197,74,24,29,4878,4640,4554,3377,1064,944,286,345,2417,2444,471,2870,889,0,,665
15:28:31,7675.47,Fox,4861,628,240,86,196,71,25,29,4880,4640,4554,3378,1066,945,285,343,2417,2444,471,2872,890,0,,662
15:28:32,7676.07,Fox,4863,629,238,90,192,74,25,29,4882,4644,4554,3381,1066,945,285,344,2418,2445,471,2873,890,0,,663
15:28:32,7676.67,Fox,4867,630,240,90,192,73,25,29,4886,4646,4556,3381,1066,945,284,346,2419,2448,471,2876,890,0,,664
15:28:32,7677.57,Fox,4867,628,240,88,189,78,24,28,4886,4646,4558,3386,1066,946,282,346,2419,2448,471,2876,892,0,,662
15:28:33,7678.138,Fox,4871,629,240,88,185,80,24,27,4886,4646,4558,3389,1066,946,280,349,2420,2451,471,2878,893,0,,663
15:28:33,7678.668,Fox,4874,624,248,88,185,74,24,25,4894,4646,4558,3389,1066,946,277,347,2422,2452,471,2884,895,0,,658
15:28:33,7679.568,Fox,4874,623,238,96,184,76,24,25,4894,4656,4560,3392,1066,946,276,347,2422,2452,471,2885,895,0,,657
15:28:33,7680.168,Fox,4874,619,236,98,183,73,24,25,4894,4658,4560,3393,1066,946,275,344,2422,2452,471,2889,895,0,,653
15:28:34,7680.74,Fox,4878,623,232,100,179,79,24,25,4894,4662,4562,3399,1066,946,277,346,2424,2454,471,2889,895,0,,657
15:28:34,7681.34,Fox,4880,624,234,102,176,81,24,25,4898,4664,4562,3401,1066,946,276,348,2424,2456,471,2890,895,0,,658
15:28:34,7681.94,Fox,4882,623,234,106,175,79,24,25,4902,4668,4562,3402,1066,946,276,347,2426,2456,471,2893,895,0,,657
15:28:35,7682.541,Fox,4882,621,232,106,177,78,24,24,4902,4670,4564,3402,1066,946,275,346,2426,2456,471,2894,896,0,,655
15:28:35,7682.84,Fox,4882,620,232,106,177,78,24,23,4902,4670,4564,3402,1066,946,275,345,2426,2456,471,2894,897,0,,654
15:28:35,7683.74,Fox,4884,619,234,104,178,76,24,23,4904,4670,4566,3402,1066,946,275,344,2427,2457,471,2897,897,0,,653
15:28:36,7684.34,Fox,4886,619,236,104,173,80,24,22,4906,4670,4566,3406,1066,946,273,346,2427,2459,471,2898,898,0,,653
15:28:36,7684.94,Fox,4888,620,236,104,172,82,24,22,4908,4672,4568,3408,1066,946,272,348,2427,2461,471,2899,898,0,,654
15:28:36,7685.541,Fox,4888,618,234,104,168,86,24,22,4908,4674,4570,3414,1066,946,271,347,2427,2461,471,2901,898,0,,652
15:28:37,7686.141,Fox,4890,620,230,106,170,86,24,22,4908,4678,4572,3414,1066,946,272,348,2428,2462,471,2901,898,0,,654
15:28:37,7686.74,Fox,4896,621,232,104,169,84,24,22,4910,4678,4574,3415,1066,946,269,352,2428,2468,472,2905,898,0,,655
15:28:37,7687.34,Fox,4902,624,236,102,168,86,24,22,4916,4680,4578,3417,1066,946,268,356,2430,2472,473,2907,898,0,,658
15:28:38,7687.94,Fox,4902,621,236,108,167,84,25,21,4922,4686,4578,3418,1067,946,268,353,2430,2472,473,2909,899,0,,655
15:28:38,7688.541,Fox,4908,625,236,108,168,85,25,21,4926,4690,4582,3420,1067,946,273,352,2436,2472,473,2911,899,0,,659
15:28:38,7689.107,Fox,4912,626,238,106,167,87,25,21,4930,4692,4586,3424,1067,946,273,353,2438,2474,473,2914,899,0,,660
15:28:39,7689.707,Fox,4912,623,240,104,169,85,25,20,4932,4692,4588,3424,1067,946,272,351,2438,2474,473,2916,900,0,,657
15:28:39,7690.307,Fox,4914,624,242,104,169,84,25,20,4934,4692,4588,3424,1067,946,271,353,2438,2476,473,2917,900,0,,658
15:28:39,7690.907,Fox,4914,624,240,104,169,86,25,20,4934,4694,4590,3426,1067,946,271,353,2438,2476,473,2917,900,0,,658
15:28:39,7691.465,Fox,4914,623,240,102,169,87,25,20,4934,4694,4592,3428,1067,946,271,352,2438,2476,473,2918,900,0,,657
15:28:40,7692.065,Fox,4916,624,240,104,166,89,25,20,4936,4696,4592,3430,1067,946,270,354,2438,2478,473,2919,900,0,,658
15:28:40,7692.666,Fox,4916,623,238,106,163,89,27,20,4936,4698,4592,3433,1069,946,270,353,2438,2478,473,2920,900,0,,657
15:28:40,7693.266,Fox,4920,621,242,106,151,96,27,19,4940,4698,4592,3444,1069,946,269,352,2440,2480,473,2925,901,0,,655
15:28:41,7693.865,Fox,4920,621,240,106,150,99,27,19,4940,4700,4594,3447,1069,946,269,352,2440,2480,473,2925,901,0,,655
15:28:41,7694.465,Fox,4924,623,240,106,147,100,27,19,4940,4700,4594,3448,1069,946,268,355,2441,2483,473,2927,901,0,,657
15:28:41,7695.065,Fox,4926,620,244,108,138,104,27,19,4946,4702,4594,3456,1069,946,267,353,2442,2484,473,2932,901,0,,654
15:28:41,7695.666,Fox,4926,618,244,108,127,113,27,19,4946,4702,4594,3467,1069,946,267,351,2442,2484,473,2934,901,0,,652
15:28:42,7696.266,Fox,4928,619,240,112,128,114,26,19,4948,4708,4596,3468,1069,946,268,351,2444,2484,473,2935,901,0,,653
15:28:42,7696.865,Fox,4930,618,238,112,130,113,25,18,4948,4710,4598,3468,1069,947,267,351,2445,2485,473,2936,903,0,,652
15:28:42,7697.465,Fox,4934,620,240,110,133,112,25,18,4952,4712,4602,3468,1069,947,267,353,2447,2487,473,2938,903,0,,654
15:28:43,7698.065,Fox,4936,620,238,110,135,111,26,18,4954,4716,4606,3469,1070,947,266,354,2448,2488,473,2940,903,0,,654
15:28:43,7698.666,Fox,4938,619,238,110,136,109,26,18,4956,4718,4608,3469,1070,947,266,353,2449,2489,473,2943,903,0,,653
15:28:43,7699.266,Fox,4940,619,236,116,135,108,26,18,4960,4724,4608,3469,1070,947,267,352,2451,2489,473,2945,903,0,,653
15:28:44,7699.865,Fox,4940,611,234,116,137,102,26,16,4960,4726,4610,3469,1070,947,266,345,2451,2489,473,2951,905,0,,645
15:28:44,7700.465,Fox,4942,610,228,122,138,100,26,16,4962,4734,4612,3470,1070,947,265,345,2452,2490,473,2954,905,0,,644
15:28:44,7701.065,Fox,4942,610,226,122,140,100,26,16,4962,4736,4614,3470,1070,947,265,345,2452,2490,473,2954,905,0,,644
15:28:44,7701.666,Fox,4946,611,228,122,130,103,30,16,4964,4736,4614,3478,1074,947,266,345,2455,2491,473,2957,905,0,,645
15:28:45,7702.266,Fox,4946,610,230,122,129,102,32,15,4966,4736,4614,3479,1076,947,265,345,2455,2491,473,2957,906,0,,644
15:28:45,7702.865,Fox,4948,610,228,120,132,102,32,14,4966,4738,4618,3479,1076,947,263,347,2455,2493,473,2958,907,0,,644
15:28:45,7703.465,Fox,4948,610,226,124,130,103,33,14,4968,4742,4618,3481,1077,947,263,347,2455,2493,473,2958,907,0,,644
15:28:46,7704.065,Fox,4948,610,224,126,123,110,33,14,4968,4744,4618,3488,1077,947,263,347,2455,2493,473,2958,907,0,,644
15:28:46,7704.666,Fox,4948,607,222,126,122,110,33,14,4968,4746,4620,3491,1077,947,262,345,2455,2493,473,2961,907,0,,641
15:28:46,7705.266,Fox,4950,608,222,126,124,109,33,14,4970,4748,4622,3491,1077,947,262,346,2456,2494,473,2962,907,0,,642
15:28:46,7705.865,Fox,4952,603,216,130,128,102,33,14,4972,4756,4626,3491,1077,947,261,342,2457,2495,473,2969,907,0,,637
15:28:47,7706.465,Fox,4952,601,210,134,130,100,33,14,4972,4762,4628,3491,1077,947,260,341,2457,2495,473,2971,907,0,,635
15:28:47,7707.065,Fox,4954,602,212,134,130,99,33,14,4974,4762,4628,3491,1077,947,261,341,2459,2495,473,2972,907,0,,636
15:28:47,7707.666,Fox,4954,601,212,128,136,98,33,14,4974,4762,4634,3491,1077,947,261,340,2459,2495,473,2973,907,0,,635
15:28:48,7708.266,Fox,4956,599,208,130,136,96,33,14,4974,4766,4636,3493,1077,947,262,337,2461,2495,474,2976,907,0,,633
15:28:48,7708.565,Fox,4956,599,208,132,135,97,33,14,4976,4768,4636,3494,1077,947,262,337,2461,2495,474,2976,907,0,,633
15:28:48,7709.166,Fox,4956,599,208,128,139,97,33,14,4976,4768,4640,3494,1077,947,262,337,2461,2495,474,2976,907,0,,633
15:28:48,7710.065,Fox,4956,596,207,130,137,97,33,13,4977,4770,4640,3496,1077,947,262,334,2461,2495,474,2978,908,0,,630
15:28:49,7710.666,Fox,4958,597,207,132,135,98,33,13,4979,4772,4640,3498,1077,947,263,334,2462,2496,474,2979,908,0,,631
15:28:49,7711.266,Fox,4958,596,203,136,131,101,33,13,4979,4776,4640,3502,1077,947,262,334,2462,2496,474,2980,908,0,,630
15:28:49,7711.865,Fox,4960,595,203,136,127,102,33,13,4979,4776,4640,3506,1077,947,261,334,2462,2498,474,2983,908,0,,629
15:28:49,7712.465,Fox,4960,587,201,140,123,98,33,13,4981,4780,4640,3510,1077,947,259,328,2462,2498,475,2990,908,0,,621
15:28:50,7713.065,Fox,4960,585,199,142,123,96,33,13,4981,4782,4640,3510,1077,947,259,326,2462,2498,475,2992,908,0,,619
15:28:50,7713.666,Fox,4960,582,199,142,121,95,33,13,4981,4782,4640,3512,1077,947,259,323,2462,2498,475,2995,908,0,,616
15:28:50,7714.266,Fox,4960,576,199,142,117,93,33,13,4981,4782,4640,3516,1077,947,258,318,2462,2498,475,3001,908,0,,610
15:28:51,7714.865,Fox,4961,568,199,138,121,84,33,13,4981,4782,4644,3516,1077,947,255,313,2463,2498,475,3010,908,0,,602
15:28:51,7715.465,Fox,4961,563,201,136,121,79,35,13,4983,4782,4646,3518,1079,947,255,308,2463,2498,475,3015,908,0,,597
15:28:51,7716.666,Fox,4963,562,203,136,121,76,35,13,4985,4782,4646,3518,1080,947,253,309,2463,2500,475,3018,908,0,,596
15:28:52,7716.965,Fox,4963,562,203,136,119,78,35,13,4985,4782,4646,3520,1080,947,253,309,2463,2500,475,3018,908,0,,596
15:28:52,7717.865,Fox,4963,561,203,126,128,79,35,12,4985,4782,4656,3521,1080,947,252,309,2463,2500,475,3018,909,0,,595
15:28:52,7718.465,Fox,4963,560,203,124,126,82,35,12,4985,4782,4658,3525,1080,947,251,309,2463,2500,475,3019,909,0,,594
15:28:53,7719.065,Fox,4963,560,200,124,130,80,37,12,4986,4786,4662,3525,1082,947,251,309,2463,2500,475,3019,909,0,,594
15:28:53,7719.666,Fox,4965,555,200,122,130,75,37,12,4986,4786,4664,3526,1082,947,251,304,2465,2500,475,3026,909,0,,589
15:28:53,7720.266,Fox,4965,552,202,118,134,72,36,13,4988,4786,4668,3526,1082,948,250,302,2465,2500,475,3029,909,0,,586
15:28:53,7720.865,Fox,4965,552,200,118,132,76,36,13,4988,4788,4670,3530,1082,948,250,302,2465,2500,475,3029,909,0,,586
15:28:54,7721.465,Fox,4967,551,202,118,131,74,36,13,4990,4788,4670,3530,1082,948,249,302,2465,2502,475,3032,909,0,,585
15:28:54,7722.365,Fox,4969,547,200,122,129,70,36,13,4992,4792,4670,3532,1082,948,249,298,2467,2502,475,3038,909,0,,581
15:28:54,7722.965,Fox,4969,544,198,122,129,69,36,13,4992,4794,4672,3534,1082,948,248,296,2467,2502,475,3041,909,0,,578
15:28:55,7723.565,Fox,4971,544,196,122,131,69,35,12,4992,4796,4674,3534,1082,948,248,296,2468,2503,475,3042,910,0,,578
15:28:55,7724.166,Fox,4973,545,196,124,130,69,35,12,4994,4798,4674,3535,1082,948,248,297,2469,2504,475,3043,910,0,,579
15:28:55,7724.766,Fox,4973,545,198,120,132,71,35,12,4996,4798,4678,3537,1082,948,248,297,2469,2504,475,3043,910,0,,579
15:28:55,7725.365,Fox,4975,545,200,118,130,73,35,12,4998,4798,4680,3540,1082,948,247,298,2470,2505,475,3045,910,0,,579
15:28:56,7725.965,Fox,4975,543,198,116,134,71,35,12,4998,4800,4684,3540,1082,948,246,297,2470,2505,475,3047,910,0,,577
15:28:56,7726.565,Fox,4979,544,200,114,136,69,35,13,5002,4802,4688,3540,1083,949,246,298,2472,2507,475,3050,910,0,,578
15:28:56,7727.166,Fox,4981,545,200,110,140,68,35,13,5002,4802,4692,3540,1083,949,245,300,2472,2509,475,3051,910,0,,579
15:28:57,7727.766,Fox,4987,545,202,110,139,64,35,12,5004,4802,4692,3540,1083,949,245,300,2475,2512,475,3056,911,0,,579
15:28:57,7728.365,Fox,4989,546,206,114,137,65,35,12,5012,4806,4692,3542,1083,949,245,301,2475,2514,475,3057,911,0,,580
15:28:57,7728.965,Fox,4995,549,208,116,135,67,34,12,5018,4810,4694,3544,1083,949,246,303,2479,2516,475,3060,911,0,,583
15:28:57,7729.43,Fox,4997,545,208,118,134,62,34,12,5020,4812,4694,3544,1083,949,244,301,2479,2518,476,3065,911,0,,579
15:28:57,7730.03,Fox,5001,542,212,118,131,58,34,12,5024,4812,4694,3546,1083,949,241,301,2480,2521,476,3072,911,0,,576
15:28:58,7730.63,Fox,5005,544,210,120,131,58,33,13,5026,4816,4696,3548,1083,950,242,302,2483,2522,476,3074,911,0,,578
15:28:58,7731.23,Fox,5005,542,212,118,133,56,33,13,5028,4816,4698,3548,1083,950,242,300,2483,2522,476,3076,911,0,,576
15:28:58,7731.53,Fox,5005,541,212,118,133,56,33,12,5028,4816,4698,3548,1083,950,242,299,2483,2522,476,3076,912,0,,575
15:28:59,7732.43,Fox,5007,542,212,116,132,58,33,12,5028,4816,4700,3550,1083,950,242,300,2484,2523,476,3077,912,0,,576
15:28:59,7733.03,Fox,5009,540,210,120,131,56,33,11,5030,4820,4700,3550,1083,950,241,299,2485,2524,476,3080,913,0,,574
15:28:59,7733.33,Fox,5009,540,210,120,133,56,33,11,5032,4822,4702,3550,1083,950,241,299,2485,2524,476,3080,913,0,,574
15:28:59,7734.23,Fox,5009,540,210,120,130,59,33,11,5032,4822,4702,3553,1083,950,241,299,2485,2524,476,3080,913,0,,574
15:28:59,7734.83,Fox,5011,539,212,114,135,57,33,11,5034,4822,4708,3553,1083,950,241,298,2486,2525,476,3083,913,0,,573
15:29:00,7735.43,Fox,5015,542,212,114,134,59,33,11,5036,4824,4710,3555,1083,950,242,300,2488,2527,476,3084,913,0,,576
15:29:00,7736.03,Fox,5015,539,214,112,136,56,33,11,5038,4824,4712,3555,1083,950,242,297,2488,2527,476,3087,913,0,,573
15:29:00,7736.33,Fox,5015,538,214,108,140,56,33,10,5038,4824,4716,3555,1083,950,241,297,2488,2527,476,3087,914,0,,572
15:29:00,7737.23,Fox,5015,537,214,106,141,56,33,10,5038,4824,4718,3556,1083,950,241,296,2488,2527,476,3088,914,0,,571
15:29:01,7737.83,Fox,5015,535,212,102,147,54,33,10,5038,4826,4724,3556,1083,950,241,294,2488,2527,476,3090,914,0,,569
15:29:01,7738.43,Fox,5015,535,212,100,147,54,35,10,5038,4826,4726,3558,1085,950,241,294,2488,2527,476,3090,914,0,,569
15:29:01,7739.03,Fox,5017,535,214,92,154,54,35,9,5040,4826,4734,3558,1085,950,241,294,2489,2528,476,3091,915,0,,569
15:29:01,7739.63,Fox,5019,532,216,90,155,50,35,9,5042,4826,4736,3558,1085,950,241,291,2490,2529,476,3096,915,0,,566
15:29:02,7740.23,Fox,5019,532,214,92,154,51,35,9,5042,4828,4736,3559,1085,950,241,291,2490,2529,476,3096,915,0,,566
15:29:02,7740.83,Fox,5019,532,210,96,154,51,35,9,5042,4832,4736,3559,1085,950,241,291,2490,2529,476,3096,915,0,,566
15:29:02,7741.43,Fox,5019,531,208,96,154,52,35,9,5042,4834,4738,3561,1085,950,241,290,2490,2529,476,3097,915,0,,565
15:29:02,7742.03,Fox,5021,529,206,96,157,49,35,9,5044,4838,4742,3561,1085,950,241,288,2491,2530,476,3101,915,0,,563
15:29:03,7742.63,Fox,5021,529,202,98,159,49,35,9,5044,4842,4744,3561,1085,950,241,288,2491,2530,476,3101,915,0,,563
15:29:03,7743.23,Fox,5021,529,196,102,159,51,35,9,5044,4848,4746,3563,1085,950,241,288,2491,2530,476,3101,915,0,,563
15:29:03,7743.83,Fox,5021,528,196,100,161,51,35,8,5044,4848,4748,3563,1085,950,241,287,2491,2530,476,3101,916,0,,562
15:29:03,7744.43,Fox,5021,528,196,92,167,53,35,8,5044,4848,4756,3565,1085,950,241,287,2491,2530,476,3101,916,0,,562
15:29:04,7745.03,Fox,5021,526,196,86,173,51,35,8,5044,4848,4762,3565,1085,950,240,286,2491,2530,476,3103,916,0,,560
15:29:04,7745.93,Fox,5021,524,194,88,172,50,35,8,5044,4850,4762,3566,1085,950,240,284,2491,2530,476,3105,916,0,,558
15:29:04,7746.53,Fox,5021,522,194,86,172,50,35,8,5044,4850,4764,3568,1085,950,240,282,2491,2530,476,3107,916,0,,556
15:29:04,7747.13,Fox,5023,520,192,86,175,48,35,7,5046,4854,4768,3568,1085,950,239,281,2492,2531,476,3110,917,0,,554
15:29:05,7747.651,Fox,5024,520,192,86,172,50,35,7,5046,4854,4768,3571,1085,950,238,282,2492,2532,476,3111,917,0,,554
15:29:05,7748.25,Fox,5024,519,192,88,172,50,35,6,5048,4856,4768,3571,1085,950,238,281,2492,2532,476,3111,918,0,,553
15:29:05,7748.851,Fox,5024,519,188,90,173,51,34,7,5048,4860,4770,3572,1085,951,238,281,2492,2532,476,3111,918,0,,553
15:29:05,7749.451,Fox,5028,521,188,86,174,51,34,8,5048,4860,4774,3575,1087,952,238,283,2494,2534,476,3113,918,0,,555
15:29:06,7749.75,Fox,5028,521,192,84,176,51,34,8,5052,4860,4776,3575,1087,952,238,283,2494,2534,476,3113,918,0,,555
15:29:06,7750.651,Fox,5028,520,190,82,179,51,34,8,5052,4862,4780,3576,1087,952,237,283,2494,2534,476,3114,918,0,,554
15:29:06,7751.25,Fox,5030,520,188,86,177,51,34,8,5054,4866,4780,3577,1087,952,236,284,2494,2536,476,3116,918,0,,554
15:29:06,7751.851,Fox,5030,519,186,86,179,50,34,8,5054,4868,4782,3577,1087,952,235,284,2494,2536,476,3117,918,0,,553
15:29:07,7752.451,Fox,5030,519,182,90,177,52,34,8,5054,4872,4782,3579,1087,952,235,284,2494,2536,476,3117,918,0,,553
15:29:07,7753.351,Fox,5030,518,182,90,177,51,33,9,5054,4872,4782,3579,1087,953,235,283,2494,2536,476,3118,918,0,,552
15:29:07,7754.25,Fox,5032,519,184,90,176,51,33,9,5056,4872,4782,3579,1087,953,236,283,2496,2536,476,3119,918,0,,553
15:29:08,7754.851,Fox,5034,518,182,94,174,50,33,9,5058,4876,4782,3580,1087,953,233,285,2496,2538,476,3122,918,0,,552
15:29:08,7755.75,Fox,5038,520,184,96,172,47,36,9,5062,4878,4782,3580,1090,953,235,285,2500,2538,476,3124,918,0,,554
15:29:08,7756.651,Fox,5040,520,184,96,171,45,36,10,5062,4878,4782,3580,1091,954,234,286,2500,2540,476,3126,918,0,,554
15:29:09,7757.25,Fox,5040,518,186,94,171,45,36,10,5064,4878,4784,3582,1091,954,234,284,2500,2540,476,3128,918,0,,552
15:29:09,7757.851,Fox,5040,518,184,94,173,45,36,10,5064,4880,4786,3582,1091,954,234,284,2500,2540,476,3128,918,0,,552
15:29:09,7758.451,Fox,5044,520,184,94,165,51,35,11,5064,4880,4786,3588,1091,955,235,285,2503,2541,476,3130,918,0,,554
15:29:09,7759.051,Fox,5044,520,186,94,163,55,35,11,5068,4882,4788,3592,1091,955,235,285,2503,2541,476,3130,918,0,,554
15:29:10,7759.351,Fox,5044,518,182,98,163,53,35,11,5068,4886,4788,3592,1091,955,235,283,2503,2541,476,3132,918,0,,552
15:29:10,7760.25,Fox,5048,518,186,98,159,53,35,11,5072,4886,4788,3594,1091,955,234,284,2505,2543,476,3136,918,0,,552
15:29:10,7760.851,Fox,5050,520,188,94,162,54,35,11,5074,4886,4792,3595,1091,955,235,285,2506,2544,476,3136,918,0,,554
15:29:10,7761.451,Fox,5050,519,180,100,164,53,35,11,5074,4894,4794,3595,1091,955,234,285,2506,2544,476,3137,918,0,,553
15:29:11,7762.051,Fox,5050,518,180,98,164,53,36,11,5074,4894,4796,3597,1092,955,234,284,2506,2544,476,3138,918,0,,552
15:29:11,7762.351,Fox,5050,518,180,96,166,53,36,11,5074,4894,4798,3597,1092,955,234,284,2506,2544,476,3138,918,0,,552
15:29:11,7763.25,Fox,5050,517,180,96,165,51,38,11,5074,4894,4798,3598,1094,955,234,283,2506,2544,476,3139,918,0,,551
15:29:11,7763.851,Fox,5050,516,176,100,163,52,38,11,5074,4898,4798,3600,1094,955,234,282,2506,2544,476,3140,918,0,,550
15:29:12,7764.441,Fox,5052,515,172,102,164,49,39,11,5074,4902,4800,3600,1095,955,232,283,2507,2545,476,3143,918,0,,549
15:29:12,7765.042,Fox,5052,515,174,100,166,49,39,11,5076,4902,4802,3600,1095,955,232,283,2507,2545,476,3143,918,0,,549
15:29:12,7765.642,Fox,5054,513,176,100,162,49,39,11,5078,4902,4802,3603,1095,955,231,282,2508,2546,476,3147,918,0,,547
15:29:12,7766.242,Fox,5054,512,174,102,160,50,39,11,5078,4904,4802,3605,1095,955,231,281,2508,2546,476,3148,918,0,,546
15:29:13,7766.842,Fox,5056,512,172,100,159,53,39,11,5078,4906,4806,3609,1095,955,231,281,2509,2547,476,3150,918,0,,546
15:29:13,7767.441,Fox,5056,511,172,98,163,52,39,11,5080,4908,4810,3609,1095,955,231,280,2509,2547,476,3151,918,0,,545
15:29:13,7768.042,Fox,5058,512,174,96,161,55,39,11,5082,4908,4812,3612,1095,955,230,282,2509,2549,476,3152,918,0,,546
15:29:13,7768.642,Fox,5060,511,176,96,158,55,39,11,5084,4908,4812,3614,1095,955,230,281,2510,2550,476,3155,918,0,,545
15:29:13,7768.941,Fox,5060,511,174,94,160,57,39,11,5084,4910,4816,3616,1095,955,230,281,2510,2550,476,3155,918,0,,545
15:29:14,7769.842,Fox,5064,513,172,100,155,60,39,11,5088,4916,4816,3619,1095,955,230,283,2512,2552,476,3157,918,0,,547
15:29:14,7770.441,Fox,5066,513,168,106,154,59,39,11,5090,4922,4816,3619,1095,955,229,284,2512,2554,476,3159,918,0,,547
15:29:14,7771.342,Fox,5068,514,164,112,153,59,39,11,5092,4928,4816,3619,1095,955,229,285,2513,2555,476,3160,918,0,,548
15:29:15,7771.941,Fox,5070,515,162,110,158,59,39,11,5094,4932,4822,3619,1095,955,229,286,2514,2556,476,3161,918,0,,549
15:29:15,7772.842,Fox,5074,515,162,112,156,57,38,12,5096,4934,4822,3619,1095,956,227,288,2515,2559,476,3165,918,0,,549
15:29:15,7773.441,Fox,5074,511,164,112,156,53,38,12,5098,4934,4822,3619,1095,956,225,286,2515,2559,476,3169,918,0,,545
15:29:15,7774.042,Fox,5076,508,164,110,157,49,38,12,5098,4934,4824,3619,1095,956,225,283,2516,2560,476,3174,918,0,,542
15:29:16,7774.642,Fox,5078,507,166,112,156,47,38,12,5102,4936,4824,3619,1095,956,224,283,2517,2561,476,3177,918,0,,541
15:29:16,7775.242,Fox,5080,508,168,112,154,48,38,12,5104,4936,4824,3621,1095,956,225,283,2519,2561,476,3178,918,0,,542
15:29:16,7775.842,Fox,5080,506,164,114,155,47,38,12,5104,4940,4826,3622,1095,956,225,281,2519,2561,476,3180,918,0,,540
15:29:16,7776.441,Fox,5082,506,166,114,154,46,38,12,5106,4940,4826,3622,1095,956,226,280,2521,2561,476,3182,918,0,,540
15:29:17,7777.342,Fox,5084,504,162,118,153,44,38,11,5106,4944,4826,3622,1095,956,226,278,2523,2561,476,3185,919,0,,538
15:29:17,7777.941,Fox,5086,505,164,120,152,44,38,11,5110,4946,4826,3622,1095,956,225,280,2523,2563,476,3186,919,0,,539
15:29:17,7778.542,Fox,5088,505,164,118,144,50,40,11,5110,4946,4828,3632,1097,956,226,279,2525,2563,476,3188,919,0,,539
15:29:17,7779.142,Fox,5088,503,164,116,146,49,41,11,5112,4948,4832,3634,1098,956,226,277,2525,2563,476,3190,919,0,,537
15:29:18,7779.742,Fox,5088,503,162,116,144,53,41,11,5112,4950,4834,3638,1098,956,226,277,2525,2563,476,3190,919,0,,537
15:29:18,7780.342,Fox,5088,503,158,116,146,55,41,11,5112,4954,4838,3640,1098,956,226,277,2525,2563,476,3190,919,0,,537
15:29:18,7780.941,Fox,5088,500,156,114,148,54,41,11,5112,4956,4842,3642,1098,956,224,276,2525,2563,476,3193,919,0,,534
15:29:18,7781.542,Fox,5090,499,154,110,152,53,41,11,5112,4958,4848,3643,1098,956,223,276,2525,2565,476,3196,919,0,,533
15:29:19,7782.142,Fox,5092,496,154,112,151,49,39,13,5114,4960,4848,3643,1098,958,221,275,2526,2566,476,3201,919,0,,530
15:29:19,7782.441,Fox,5092,496,156,112,151,48,40,13,5116,4960,4848,3643,1099,958,221,275,2526,2566,476,3201,919,0,,530
15:29:19,7783.342,Fox,5094,494,156,114,150,45,40,13,5118,4962,4848,3643,1099,958,221,273,2528,2566,476,3205,919,0,,528
15:29:19,7783.941,Fox,5096,494,156,112,150,45,40,13,5118,4962,4850,3644,1099,958,221,273,2529,2567,476,3207,919,0,,528
15:29:20,7784.542,Fox,5098,495,156,116,149,45,40,13,5122,4966,4850,3645,1099,958,221,274,2530,2568,476,3208,919,0,,529
15:29:20,7785.441,Fox,5100,494,158,112,150,45,40,13,5124,4966,4854,3648,1099,958,221,273,2530,2570,476,3211,919,0,,528
15:29:20,7786.042,Fox,5102,494,156,114,147,47,39,13,5124,4968,4854,3650,1099,958,222,272,2532,2570,476,3213,919,0,,528
15:29:21,7786.642,Fox,5102,494,158,112,148,48,39,13,5126,4968,4856,3651,1099,958,222,272,2532,2570,476,3213,919,0,,528
15:29:21,7787.242,Fox,5102,494,158,108,149,51,39,13,5126,4968,4860,3654,1099,958,222,272,2532,2570,476,3213,919,0,,528
15:29:21,7787.842,Fox,5103,494,156,110,145,54,39,13,5126,4970,4860,3657,1099,958,221,273,2532,2571,476,3214,919,0,,528
15:29:21,7788.441,Fox,5103,494,156,112,145,54,39,13,5128,4972,4860,3657,1099,958,221,273,2532,2571,476,3214,919,0,,528
15:29:22,7789.342,Fox,5105,494,156,110,146,54,38,13,5128,4972,4862,3657,1099,958,221,273,2533,2572,476,3216,919,0,,528
15:29:22,7789.941,Fox,5109,497,156,106,151,54,38,13,5130,4974,4868,3658,1099,958,223,274,2536,2573,476,3217,919,0,,531
15:29:22,7790.534,Fox,5109,496,160,104,153,53,38,13,5134,4974,4870,3658,1099,958,223,273,2536,2573,476,3218,919,0,,530
15:29:22,7791.134,Fox,5111,496,158,104,152,54,38,13,5134,4976,4872,3660,1099,958,223,273,2537,2574,476,3220,919,0,,530
15:29:23,7791.434,Fox,5111,496,160,104,151,55,38,13,5136,4976,4872,3661,1099,958,223,273,2537,2574,476,3220,919,0,,530
15:29:23,7792.334,Fox,5113,496,162,104,150,55,38,12,5138,4976,4872,3661,1099,958,221,275,2537,2576,476,3222,919,0,,530
15:29:23,7792.934,Fox,5117,499,165,101,152,56,38,12,5142,4977,4876,3663,1099,958,223,276,2540,2577,476,3223,919,0,,533
15:29:23,7793.534,Fox,5117,493,163,103,152,50,38,12,5142,4979,4876,3663,1099,958,222,271,2540,2577,476,3229,919,0,,527
15:29:24,7794.134,Fox,5117,487,163,101,152,46,38,12,5142,4979,4878,3665,1099,958,222,265,2540,2577,476,3235,919,0,,521
15:29:24,7794.734,Fox,5123,489,167,103,150,45,38,11,5148,4981,4878,3665,1099,958,222,267,2543,2580,477,3237,920,0,,523
15:29:24,7795.334,Fox,5127,488,169,103,145,45,38,11,5150,4981,4878,3669,1099,958,224,264,2546,2581,477,3242,920,0,,522
15:29:24,7795.934,Fox,5129,487,173,103,143,44,38,11,5154,4981,4878,3671,1099,958,224,263,2547,2582,477,3245,920,0,,521
15:29:25,7796.534,Fox,5137,491,175,101,143,42,38,11,5156,4981,4880,3671,1099,958,226,265,2551,2586,477,3249,920,0,,525
15:29:25,7797.134,Fox,5137,491,181,99,142,45,38,11,5162,4981,4882,3674,1099,958,226,265,2551,2586,477,3249,920,0,,525
15:29:25,7798.034,Fox,5137,491,179,97,141,50,36,13,5162,4983,4886,3679,1099,960,226,265,2551,2586,477,3249,920,0,,525
15:29:25,7798.634,Fox,5137,491,179,97,138,53,36,13,5162,4983,4886,3682,1099,960,226,265,2551,2586,477,3249,920,0,,525
15:29:26,7799.234,Fox,5137,490,177,99,136,54,36,13,5162,4985,4886,3684,1099,960,226,264,2551,2586,477,3250,920,0,,524
15:29:26,7799.834,Fox,5137,490,177,91,137,61,36,13,5162,4985,4894,3691,1099,960,226,264,2551,2586,477,3250,920,0,,524
15:29:26,7800.434,Fox,5139,490,179,91,136,60,36,13,5164,4985,4894,3691,1099,960,227,263,2553,2586,477,3252,920,0,,524
15:29:26,7801.034,Fox,5143,494,183,91,136,60,35,14,5168,4985,4894,3691,1099,961,229,265,2555,2588,477,3252,920,0,,528
15:29:27,7801.634,Fox,5147,495,182,92,136,58,34,14,5168,4986,4894,3691,1099,961,228,267,2556,2591,477,3255,920,0,,529
15:29:27,7802.234,Fox,5147,492,186,88,139,56,34,14,5172,4986,4898,3692,1099,961,227,265,2556,2591,477,3258,920,0,,526
15:29:27,7802.766,Fox,5149,491,184,88,138,56,34,14,5172,4988,4900,3695,1099,961,227,264,2558,2591,477,3261,920,0,,525
15:29:27,7803.366,Fox,5151,490,186,86,138,55,34,14,5174,4988,4902,3697,1099,961,228,262,2560,2591,479,3262,920,0,,524
15:29:27,7803.966,Fox,5151,489,186,88,135,57,34,14,5176,4990,4902,3700,1099,961,228,261,2560,2591,479,3263,920,0,,523
15:29:28,7804.565,Fox,5151,488,186,88,133,57,35,14,5176,4990,4902,3702,1100,961,228,260,2560,2591,479,3264,920,0,,522
15:29:28,7805.166,Fox,5151,488,184,88,128,64,35,14,5176,4992,4904,3709,1100,961,228,260,2560,2591,479,3264,920,0,,522
15:29:28,7805.766,Fox,5159,492,188,86,126,64,35,14,5180,4992,4906,3712,1100,961,231,261,2565,2594,479,3268,920,0,,526
15:29:28,7806.366,Fox,5159,491,190,86,128,63,35,14,5184,4994,4908,3712,1100,961,231,260,2565,2594,479,3269,920,0,,525
15:29:29,7807.266,Fox,5161,490,190,88,126,62,34,15,5186,4996,4908,3714,1100,962,230,260,2566,2595,479,3272,920,0,,524
15:29:29,7807.866,Fox,5161,490,188,88,127,61,36,15,5186,4998,4910,3715,1102,962,230,260,2566,2595,479,3272,920,0,,524
15:29:29,7808.466,Fox,5161,487,188,82,133,59,35,15,5186,4998,4916,3715,1102,962,228,259,2566,2595,479,3275,920,0,,521
15:29:29,7809.065,Fox,5161,487,184,80,137,61,34,16,5186,5002,4922,3717,1102,963,228,259,2566,2595,479,3275,920,0,,521
15:29:30,7809.966,Fox,5161,486,182,76,139,64,34,16,5186,5004,4928,3721,1102,963,227,259,2566,2595,479,3276,920,0,,520
15:29:30,7810.565,Fox,5163,484,178,78,140,64,33,16,5188,5010,4932,3723,1102,963,227,257,2567,2596,479,3280,920,0,,518
15:29:30,7811.166,Fox,5165,484,178,80,138,64,33,16,5190,5012,4932,3725,1102,963,226,258,2568,2597,479,3282,920,0,,518
15:29:30,7811.766,Fox,5167,485,172,84,140,63,32,17,5190,5018,4934,3725,1102,964,226,259,2569,2598,479,3283,920,0,,519
15:29:31,7812.366,Fox,5167,482,172,86,139,62,32,16,5192,5020,4934,3726,1102,964,226,256,2569,2598,479,3285,921,0,,516
15:29:31,7812.966,Fox,5169,483,168,90,139,61,32,16,5192,5024,4934,3726,1102,964,225,258,2569,2600,479,3286,921,0,,517
15:29:31,7813.565,Fox,5169,478,166,92,141,56,31,17,5194,5028,4936,3726,1102,965,223,255,2569,2600,479,3291,921,0,,512
15:29:31,7814.166,Fox,5169,475,166,92,141,53,31,17,5194,5028,4936,3726,1102,965,223,252,2569,2600,479,3294,921,0,,509
15:29:32,7814.766,Fox,5171,474,168,88,144,51,31,17,5196,5028,4940,3726,1102,965,220,254,2569,2602,479,3297,921,0,,508
15:29:32,7815.366,Fox,5173,469,168,90,144,44,31,17,5198,5030,4940,3726,1102,965,219,250,2570,2603,479,3304,921,0,,503
15:29:32,7816.266,Fox,5173,469,166,86,150,44,31,17,5198,5032,4946,3726,1102,965,219,250,2570,2603,479,3304,921,0,,503
15:29:33,7817.163,Fox,5177,472,170,86,149,44,31,17,5202,5032,4946,3726,1102,965,220,252,2572,2605,479,3305,921,0,,506
15:29:33,7817.763,Fox,5179,471,170,86,148,45,30,17,5204,5034,4948,3728,1102,965,221,250,2574,2605,480,3307,921,0,,505
15:29:33,7818.363,Fox,5181,470,168,88,147,46,30,16,5206,5038,4950,3730,1102,965,220,250,2574,2607,480,3309,922,0,,504
15:29:33,7818.963,Fox,5181,469,168,84,151,44,31,16,5206,5038,4954,3730,1103,965,220,249,2574,2607,480,3310,922,0,,503
15:29:33,7819.563,Fox,5185,469,170,82,150,44,31,15,5208,5038,4956,3732,1103,965,221,248,2577,2608,480,3313,923,0,,503
15:29:34,7820.163,Fox,5185,468,172,80,152,44,30,15,5210,5038,4958,3732,1103,965,221,247,2577,2608,480,3314,923,0,,502
15:29:34,7820.763,Fox,5185,463,172,78,154,39,30,15,5210,5038,4960,3732,1103,965,220,243,2577,2608,480,3319,923,0,,497
15:29:34,7821.363,Fox,5185,459,172,78,151,38,30,15,5210,5038,4960,3735,1103,965,218,241,2577,2608,480,3323,923,0,,493
15:29:35,7821.963,Fox,5185,459,170,78,151,40,30,15,5210,5040,4962,3737,1103,965,218,241,2577,2608,480,3323,923,0,,493
15:29:35,7822.263,Fox,5185,459,168,80,149,42,30,15,5210,5042,4962,3739,1103,965,218,241,2577,2608,480,3323,923,0,,493
15:29:35,7823.163,Fox,5187,459,170,76,152,41,30,15,5212,5042,4966,3740,1103,965,219,240,2578,2609,480,3325,923,0,,493
15:29:35,7823.763,Fox,5189,460,170,76,152,40,30,15,5212,5042,4966,3740,1103,965,221,239,2580,2609,480,3326,923,0,,494
15:29:35,7824.357,Fox,5191,461,174,74,153,40,30,15,5216,5042,4968,3740,1103,965,221,240,2581,2610,480,3327,923,0,,495
15:29:36,7824.958,Fox,5195,460,172,76,150,39,30,14,5216,5044,4968,3741,1103,965,219,241,2583,2612,480,3331,924,0,,494
15:29:36,7825.558,Fox,5197,460,176,76,147,38,32,14,5220,5044,4968,3743,1105,965,219,241,2584,2613,480,3333,924,0,,494
15:29:36,7825.857,Fox,5197,460,178,76,147,38,32,14,5222,5044,4968,3743,1105,965,219,241,2584,2613,480,3333,924,0,,494
15:29:36,7826.758,Fox,5199,461,180,74,149,37,32,14,5224,5044,4970,3743,1105,965,219,242,2585,2614,480,3334,924,0,,495
15:29:37,7827.357,Fox,5203,461,182,72,147,37,32,14,5226,5044,4972,3746,1105,965,220,241,2588,2615,480,3338,924,0,,495
15:29:37,7827.958,Fox,5205,461,186,72,143,39,32,14,5230,5044,4972,3748,1105,965,219,242,2589,2616,480,3340,924,0,,495
15:29:37,7828.558,Fox,5209,461,190,70,143,36,33,14,5234,5044,4974,3749,1106,965,218,243,2591,2618,480,3344,924,0,,495
15:29:37,7829.458,Fox,5213,462,192,70,139,37,33,14,5236,5044,4974,3752,1106,965,219,243,2594,2619,480,3347,924,0,,496
15:29:38,7830.058,Fox,5213,462,192,70,141,37,31,16,5238,5046,4976,3752,1106,967,219,243,2594,2619,480,3347,924,0,,496
15:29:38,7830.958,Fox,5217,465,194,72,140,37,31,16,5242,5048,4976,3752,1106,967,219,246,2595,2622,480,3348,924,0,,499
15:29:38,7831.258,Fox,5217,465,194,71,141,37,31,16,5242,5048,4977,3752,1106,967,219,246,2595,2622,480,3348,924,0,,499
15:29:38,7832.04,Fox,5217,464,194,69,139,41,31,15,5242,5048,4979,3756,1106,967,218,246,2595,2622,480,3348,925,0,,498
15:29:38,7832.263,Fox,5217,464,190,73,137,43,31,15,5242,5052,4979,3758,1106,967,218,246,2595,2622,480,3348,925,0,,498
15:29:39,7832.766,Fox,5217,463,190,73,137,43,31,14,5242,5052,4979,3758,1106,967,218,245,2595,2622,480,3348,926,0,,497
15:29:39,7833.507,Fox,5217,461,190,71,139,43,31,12,5242,5052,4981,3758,1106,967,217,244,2595,2622,480,3348,928,0,,495
15:29:39,7834.022,Fox,5218,461,188,73,139,42,31,12,5242,5054,4981,3758,1106,967,217,244,2596,2622,480,3349,928,0,,495
15:29:39,7834.314,Fox,5218,461,190,73,138,43,31,12,5244,5054,4981,3759,1106,967,217,244,2596,2622,480,3349,928,0,,495
15:29:39,7835.214,Fox,5220,460,190,73,137,41,31,12,5244,5054,4981,3759,1106,967,217,243,2598,2622,480,3352,928,0,,494
15:29:39,7835.514,Fox,5220,460,192,73,137,41,30,13,5246,5054,4981,3759,1106,968,217,243,2598,2622,480,3352,928,0,,494
15:29:40,7836.714,Fox,5222,460,194,71,136,42,30,13,5248,5054,4983,3761,1106,968,217,243,2599,2623,480,3354,928,0,,494
15:29:40,7837.014,Fox,5222,460,192,73,136,42,30,13,5248,5056,4983,3761,1106,968,217,243,2599,2623,480,3354,928,0,,494
15:29:40,7837.915,Fox,5222,457,190,73,138,39,30,13,5248,5058,4985,3761,1106,968,214,243,2599,2623,480,3357,928,0,,491
15:29:41,7838.514,Fox,5222,455,186,77,138,38,30,12,5248,5062,4985,3761,1106,968,214,241,2599,2623,480,3358,929,0,,489
15:29:41,7839.114,Fox,5226,456,188,77,136,37,27,15,5250,5062,4985,3761,1106,971,212,244,2600,2626,480,3361,929,0,,490
15:29:41,7839.714,Fox,5226,455,188,79,133,39,26,16,5252,5064,4985,3764,1106,972,211,244,2600,2626,480,3362,929,0,,489
15:29:41,7840.314,Fox,5230,457,190,78,130,41,26,16,5254,5064,4986,3766,1106,972,211,246,2602,2628,480,3364,929,0,,491
15:29:41,7840.915,Fox,5230,456,192,78,127,44,26,15,5256,5064,4986,3769,1106,972,211,245,2602,2628,480,3364,930,0,,490
15:29:42,7841.514,Fox,5232,456,190,80,125,46,26,15,5258,5068,4988,3773,1106,972,210,246,2602,2630,480,3366,930,0,,490
15:29:42,7842.114,Fox,5232,453,190,80,119,51,26,13,5258,5068,4988,3779,1106,972,209,244,2602,2630,480,3367,932,0,,487
15:29:42,7843.014,Fox,5234,454,188,82,121,50,26,13,5260,5072,4990,3779,1106,972,208,246,2602,2632,480,3368,932,0,,488
15:29:43,7843.911,Fox,5234,452,186,82,123,48,26,13,5260,5074,4992,3779,1106,972,206,246,2602,2632,480,3370,932,0,,486
15:29:43,7844.51,Fox,5236,451,186,82,121,47,26,13,5260,5074,4992,3780,1106,972,206,245,2603,2633,481,3372,932,0,,485
15:29:43,7845.11,Fox,5240,452,188,80,121,46,26,13,5262,5074,4994,3780,1106,972,208,244,2607,2633,481,3375,932,0,,486
15:29:43,7845.71,Fox,5240,452,192,78,121,48,26,13,5266,5074,4996,3782,1106,972,208,244,2607,2633,481,3375,932,0,,486
15:29:43,7846.201,Fox,5240,449,192,78,121,45,26,13,5266,5074,4996,3782,1106,972,208,241,2607,2633,481,3378,932,0,,483
15:29:44,7846.801,Fox,5240,448,192,76,121,47,25,13,5266,5074,4998,3784,1106,972,208,240,2607,2633,481,3379,932,0,,482
15:29:44,7847.699,Fox,5240,448,190,74,122,50,25,13,5266,5076,5002,3787,1106,972,208,240,2607,2633,481,3379,932,0,,482
15:29:44,7848.573,Fox,5240,448,188,74,124,50,25,13,5266,5078,5004,3787,1106,972,208,240,2607,2633,481,3379,932,0,,482
15:29:44,7849.172,Fox,5240,443,188,68,130,45,25,13,5266,5078,5010,3787,1106,972,208,235,2607,2633,481,3384,932,0,,477
15:29:45,7849.772,Fox,5242,444,186,68,129,47,25,13,5266,5080,5012,3789,1106,972,208,236,2608,2634,481,3385,932,0,,478
15:29:45,7850.372,Fox,5244,445,190,62,129,52,25,13,5270,5080,5018,3794,1106,972,208,237,2609,2635,481,3386,932,0,,479
15:29:45,7850.972,Fox,5248,446,190,62,130,51,25,12,5272,5082,5020,3795,1106,972,207,239,2611,2637,481,3388,933,0,,480
15:29:45,7851.272,Fox,5248,446,190,60,132,53,25,12,5274,5084,5024,3797,1106,972,207,239,2611,2637,481,3388,933,0,,480
15:29:46,7852.161,Fox,5252,448,192,56,134,53,25,12,5276,5084,5028,3797,1106,972,208,240,2614,2638,481,3390,933,0,,482
15:29:46,7852.461,Fox,5252,448,190,60,134,53,25,12,5278,5088,5028,3797,1106,972,208,240,2614,2638,481,3390,933,0,,482
15:29:46,7853.356,Fox,5256,448,192,62,132,51,24,13,5282,5090,5028,3797,1106,973,208,240,2616,2640,481,3394,933,0,,482
15:29:46,7853.956,Fox,5258,449,192,62,131,53,24,13,5284,5092,5030,3799,1106,973,208,241,2617,2641,481,3395,933,0,,483
15:29:46,7854.552,Fox,5258,449,190,62,132,54,23,14,5284,5094,5032,3800,1106,974,208,241,2617,2641,481,3395,933,0,,483
15:29:47,7855.747,Fox,5258,449,186,66,132,54,23,14,5284,5098,5032,3800,1106,974,208,241,2617,2641,481,3395,933,0,,483
15:29:47,7856.343,Fox,5258,446,186,64,134,51,23,14,5284,5098,5034,3800,1106,974,208,238,2617,2641,481,3398,933,0,,480
15:29:47,7856.937,Fox,5258,444,184,62,136,51,21,16,5284,5100,5038,3802,1106,976,208,236,2617,2641,481,3400,933,0,,478
15:29:47,7857.523,Fox,5258,441,182,64,136,48,21,16,5284,5102,5038,3802,1106,976,207,234,2617,2641,481,3403,933,0,,475
15:29:48,7858.112,Fox,5260,440,180,66,133,48,21,16,5284,5104,5038,3804,1106,976,204,236,2617,2643,481,3406,933,0,,474
15:29:48,7858.712,Fox,5260,438,182,66,130,49,21,16,5286,5104,5038,3807,1106,976,203,235,2617,2643,481,3408,933,0,,472
15:29:48,7859.165,Fox,5262,436,182,68,130,45,21,16,5288,5106,5038,3807,1106,976,202,234,2618,2644,481,3412,933,0,,470
15:29:48,7860.053,Fox,5262,434,182,66,129,47,21,15,5288,5106,5040,3810,1106,976,201,233,2618,2644,481,3413,934,0,,468
15:29:48,7860.646,Fox,5262,434,178,68,129,49,21,15,5288,5110,5042,3812,1106,976,201,233,2618,2644,481,3413,934,0,,468
15:29:49,7861.527,Fox,5262,434,176,70,129,49,21,15,5288,5112,5042,3812,1106,976,201,233,2618,2644,481,3413,934,0,,468
15:29:49,7862.702,Fox,5264,433,176,70,124,50,22,15,5288,5112,5042,3816,1107,976,201,232,2619,2645,481,3416,934,0,,467
15:29:50,7863.292,Fox,5264,433,178,68,124,52,22,15,5290,5112,5044,3818,1107,976,201,232,2619,2645,481,3416,934,0,,467
15:29:50,7863.592,Fox,5264,431,178,68,124,50,22,15,5290,5112,5044,3818,1107,976,201,230,2619,2645,481,3418,934,0,,465
15:29:50,7864.49,Fox,5264,428,176,70,124,47,21,16,5290,5114,5044,3818,1107,977,201,227,2619,2645,481,3421,934,0,,462
15:29:50,7865.383,Fox,5266,429,174,72,121,49,21,16,5290,5116,5044,3820,1107,977,201,228,2620,2646,481,3422,934,0,,463
15:29:51,7865.983,Fox,5268,430,174,74,119,50,21,16,5292,5118,5044,3822,1107,977,200,230,2620,2648,481,3423,934,0,,464
15:29:51,7866.583,Fox,5268,425,176,74,117,47,21,16,5294,5118,5044,3824,1107,977,199,226,2620,2648,481,3428,934,0,,459
15:29:51,7867.173,Fox,5268,425,172,78,117,47,21,16,5294,5122,5044,3824,1107,977,199,226,2620,2648,481,3428,934,0,,459
15:29:51,7867.773,Fox,5269,424,174,78,116,46,21,16,5296,5122,5044,3824,1107,977,199,225,2621,2648,481,3430,934,0,,458
15:29:51,7868.374,Fox,5271,425,174,78,116,47,21,16,5298,5124,5046,3826,1107,977,198,227,2621,2650,481,3431,934,0,,459
15:29:52,7868.974,Fox,5271,425,172,78,112,53,21,16,5298,5126,5048,3832,1107,977,198,227,2621,2650,481,3431,934,0,,459
15:29:52,7869.573,Fox,5273,425,174,78,106,57,21,16,5300,5126,5048,3837,1107,977,198,227,2622,2651,481,3433,934,0,,459
15:29:52,7870.474,Fox,5277,426,178,78,101,59,21,16,5304,5126,5048,3842,1107,977,198,228,2624,2653,481,3436,934,0,,460
15:29:52,7871.073,Fox,5281,428,176,76,102,60,21,16,5304,5128,5052,3844,1107,977,199,229,2627,2654,481,3438,934,0,,462
15:29:53,7871.669,Fox,5283,429,180,76,101,60,21,16,5308,5128,5052,3844,1107,977,199,230,2628,2655,481,3439,934,0,,463
15:29:53,7872.27,Fox,5283,429,180,76,101,62,21,16,5310,5130,5054,3846,1107,977,199,230,2628,2655,481,3439,934,0,,463
15:29:53,7872.87,Fox,5287,431,180,80,101,61,21,15,5314,5134,5054,3846,1107,977,200,231,2630,2657,481,3441,934,0,,465
15:29:54,7873.77,Fox,5289,432,182,80,99,62,21,15,5316,5134,5054,3848,1107,977,202,230,2632,2657,481,3442,934,0,,466
15:29:54,7874.07,Fox,5289,429,180,82,99,59,21,15,5316,5136,5054,3848,1107,977,202,227,2632,2657,481,3445,934,0,,463
15:29:54,7875.27,Fox,5289,426,178,82,99,58,21,15,5316,5138,5056,3850,1107,977,202,224,2632,2657,481,3448,934,0,,460
15:29:54,7875.87,Fox,5289,425,174,84,101,57,19,17,5316,5142,5058,3850,1107,979,202,223,2632,2657,481,3449,934,0,,459
15:29:55,7876.47,Fox,5293,427,178,84,96,60,19,17,5320,5142,5058,3853,1107,979,200,227,2632,2661,481,3451,934,0,,461
15:29:55,7876.77,Fox,5293,427,178,80,99,61,19,17,5320,5142,5062,3854,1107,979,200,227,2632,2661,481,3451,934,0,,461
15:29:55,7877.37,Fox,5293,423,172,86,99,57,19,17,5320,5148,5062,3854,1107,979,198,225,2632,2661,481,3455,934,0,,457
15:29:55,7878.27,Fox,5295,422,170,88,98,57,19,17,5322,5152,5064,3856,1107,979,198,224,2633,2662,481,3458,934,0,,456
15:29:55,7878.868,Fox,5295,422,168,90,97,58,19,17,5322,5154,5064,3857,1107,979,198,224,2633,2662,481,3458,934,0,,456
15:29:56,7879.468,Fox,5295,421,160,98,95,60,19,16,5322,5162,5064,3859,1107,979,197,224,2633,2662,481,3458,935,0,,455
15:29:56,7880.068,Fox,5295,420,160,94,98,60,19,16,5322,5162,5068,3860,1107,979,197,223,2633,2662,481,3459,935,0,,454
15:29:56,7880.962,Fox,5295,416,160,94,96,58,19,16,5322,5162,5068,3862,1107,979,197,219,2633,2662,481,3463,935,0,,450
15:29:56,7881.555,Fox,5297,417,162,90,99,58,19,16,5324,5162,5072,3862,1107,979,197,220,2634,2663,481,3464,935,0,,451
15:29:57,7882.153,Fox,5297,417,162,88,99,60,19,16,5324,5162,5074,3864,1107,979,197,220,2634,2663,481,3464,935,0,,451
15:29:57,7882.45,Fox,5297,415,162,88,99,58,19,16,5324,5162,5074,3864,1107,979,196,219,2634,2663,481,3466,935,0,,449
15:29:57,7883.35,Fox,5299,411,162,90,97,54,19,16,5326,5164,5074,3865,1107,979,196,215,2635,2664,481,3472,935,0,,445
15:29:57,7883.949,Fox,5301,412,158,94,94,56,19,16,5326,5168,5074,3867,1107,979,197,215,2637,2664,481,3473,935,0,,446
15:29:57,7884.517,Fox,5301,409,156,98,94,53,19,16,5328,5172,5074,3867,1107,979,196,213,2637,2664,481,3476,935,0,,443
15:29:58,7885.112,Fox,5305,407,158,98,90,51,19,16,5330,5172,5074,3869,1107,979,192,215,2639,2666,481,3482,935,0,,441
15:29:58,7885.712,Fox,5305,405,158,100,90,49,19,16,5332,5174,5074,3869,1107,979,192,213,2639,2666,481,3484,935,0,,439
15:29:58,7886.312,Fox,5305,402,156,100,92,47,19,15,5332,5176,5076,3869,1107,979,191,211,2639,2666,481,3486,936,0,,436
15:29:58,7886.912,Fox,5305,402,156,98,92,49,17,17,5332,5176,5078,3871,1107,981,191,211,2639,2666,481,3486,936,0,,436
15:29:59,7887.802,Fox,5305,400,156,98,91,48,17,17,5332,5176,5078,3872,1107,981,191,209,2639,2666,481,3488,936,0,,434
15:29:59,7888.388,Fox,5307,401,154,100,92,48,17,17,5334,5180,5080,3872,1107,981,191,210,2640,2667,481,3489,936,0,,435
15:29:59,7888.987,Fox,5307,399,150,104,90,47,18,17,5334,5184,5080,3874,1108,981,191,208,2640,2667,481,3491,936,0,,433
15:29:59,7889.288,Fox,5307,399,150,102,92,47,18,17,5334,5184,5082,3874,1108,981,191,208,2640,2667,481,3491,936,0,,433
15:29:59,7890.167,Fox,5307,398,148,102,93,48,18,16,5334,5186,5084,3875,1108,981,191,207,2640,2667,481,3491,937,0,,432
15:30:00,7890.768,Fox,5307,394,148,102,93,44,18,16,5334,5186,5084,3875,1108,981,191,203,2640,2667,481,3495,937,0,,428
15:30:00,7891.067,Fox,5307,394,148,98,97,44,18,16,5334,5186,5088,3875,1108,981,191,203,2640,2667,481,3495,937,0,,428
15:30:00,7891.967,Fox,5307,392,148,96,98,43,18,16,5334,5186,5090,3876,1108,981,189,203,2640,2667,481,3497,937,0,,426
15:30:00,7892.567,Fox,5307,392,148,94,98,45,18,16,5334,5186,5092,3878,1108,981,189,203,2640,2667,481,3497,937,0,,426
15:30:01,7893.167,Fox,5309,392,146,94,99,44,15,19,5334,5188,5094,3878,1108,984,188,204,2640,2669,481,3499,937,0,,426
15:30:01,7893.768,Fox,5311,391,148,96,96,44,15,19,5338,5190,5094,3880,1108,984,188,203,2641,2670,481,3502,937,0,,425
15:30:01,7894.367,Fox,5315,393,150,92,100,42,14,20,5340,5190,5098,3880,1108,985,189,204,2643,2672,481,3504,937,0,,427
15:30:01,7894.955,Fox,5315,391,150,94,100,40,14,20,5342,5192,5098,3880,1108,985,188,203,2643,2672,481,3506,937,0,,425
15:30:02,7895.555,Fox,5319,394,152,92,102,39,14,20,5344,5192,5100,3880,1108,985,189,205,2645,2674,481,3507,937,0,,428
15:30:02,7896.142,Fox,5321,395,152,92,103,39,14,20,5346,5194,5102,3880,1108,985,190,205,2647,2674,481,3508,937,0,,429
15:30:02,7896.738,Fox,5321,394,154,90,103,40,14,20,5348,5194,5104,3882,1108,985,190,204,2647,2674,481,3509,937,0,,428
15:30:02,7897.614,Fox,5323,393,152,90,104,39,14,19,5348,5196,5106,3882,1108,985,190,203,2648,2675,481,3511,938,0,,427
15:30:02,7898.208,Fox,5323,392,152,92,102,40,14,19,5350,5198,5106,3884,1108,985,189,203,2648,2675,481,3512,938,0,,426
15:30:03,7899.061,Fox,5325,393,152,88,105,40,14,19,5350,5198,5110,3884,1108,985,188,205,2648,2677,481,3513,938,0,,427
15:30:03,7899.621,Fox,5327,391,154,88,105,37,13,19,5352,5198,5110,3884,1108,986,187,204,2648,2679,481,3516,939,0,,425
15:30:03,7900.196,Fox,5327,389,152,90,107,36,13,18,5354,5202,5112,3884,1108,986,187,202,2648,2679,481,3517,940,0,,423
15:30:03,7900.783,Fox,5329,388,152,92,105,36,11,19,5356,5204,5112,3885,1108,988,188,200,2650,2679,481,3519,941,0,,422
15:30:03,7901.083,Fox,5329,387,150,94,105,35,11,19,5356,5206,5112,3885,1108,988,188,199,2650,2679,481,3520,941,0,,421
15:30:04,7901.924,Fox,5329,386,150,94,103,36,11,19,5356,5206,5112,3887,1108,988,187,199,2650,2679,481,3521,941,0,,420
15:30:04,7902.5,Fox,5329,385,146,98,103,35,11,19,5356,5210,5112,3887,1108,988,186,199,2650,2679,481,3522,941,0,,419
15:30:04,7903.362,Fox,5330,384,146,96,102,37,11,18,5356,5210,5114,3889,1108,988,186,198,2651,2679,481,3524,941,0,,418
15:30:04,7903.945,Fox,5330,383,148,94,102,38,11,18,5358,5210,5116,3891,1108,988,185,198,2651,2679,481,3525,941,0,,417
15:30:05,7904.505,Fox,5330,383,148,92,104,38,11,18,5358,5210,5118,3891,1108,988,185,198,2651,2679,481,3525,941,0,,417
15:30:05,7905.638,Fox,5330,383,146,90,106,40,11,18,5358,5212,5122,3893,1108,988,185,198,2651,2679,481,3525,941,0,,417
15:30:05,7906.212,Fox,5330,382,146,90,105,40,11,18,5358,5212,5122,3894,1108,988,184,198,2651,2679,482,3525,941,0,,416
15:30:05,7906.78,Fox,5330,382,144,90,107,40,11,18,5358,5214,5124,3894,1108,988,184,198,2651,2679,482,3525,941,0,,416
15:30:06,7907.349,Fox,5332,380,144,90,107,39,11,17,5360,5216,5126,3895,1108,988,184,196,2652,2680,482,3528,942,0,,414
15:30:06,7908.208,Fox,5332,380,140,94,104,42,11,17,5360,5220,5126,3898,1108,988,184,196,2652,2680,482,3528,942,0,,414
15:30:06,7908.485,Fox,5332,380,138,96,104,42,11,17,5360,5222,5126,3898,1108,988,184,196,2652,2680,482,3528,942,0,,414
15:30:06,7909.355,Fox,5332,380,136,96,104,44,11,17,5360,5224,5128,3900,1108,988,184,196,2652,2680,482,3528,942,0,,414
15:30:07,7909.939,Fox,5332,379,134,98,99,49,11,16,5360,5226,5128,3905,1108,988,183,196,2652,2680,482,3528,943,0,,413
15:30:07,7910.507,Fox,5334,380,132,102,95,52,11,16,5362,5230,5128,3909,1108,988,182,198,2652,2682,482,3529,943,0,,414
15:30:07,7911.102,Fox,5334,380,128,104,95,54,11,16,5362,5234,5130,3911,1108,988,182,198,2652,2682,482,3529,943,0,,414
15:30:07,7911.686,Fox,5334,380,128,100,95,56,13,16,5362,5234,5134,3915,1110,988,182,198,2652,2682,482,3529,943,0,,414
15:30:07,7912.258,Fox,5336,379,124,104,93,55,13,16,5362,5238,5134,3917,1110,988,182,197,2653,2683,482,3532,943,0,,413
15:30:07,7912.546,Fox,5336,379,126,102,93,57,13,16,5364,5238,5136,3919,1110,988,182,197,2653,2683,482,3532,943,0,,413
15:30:08,7913.662,Fox,5336,379,122,104,95,57,13,16,5364,5242,5138,3919,1110,988,182,197,2653,2683,482,3532,943,0,,413
15:30:08,7914.24,Fox,5340,381,124,100,96,58,13,16,5366,5242,5142,3921,1110,988,180,201,2653,2687,482,3534,943,0,,415
15:30:08,7914.818,Fox,5342,382,128,100,95,58,13,16,5370,5242,5142,3922,1110,988,180,202,2654,2688,483,3534,943,0,,416
15:30:08,7915.116,Fox,5342,380,128,100,95,56,13,16,5370,5242,5142,3922,1110,988,178,202,2654,2688,483,3536,943,0,,414
15:30:09,7916.272,Fox,5342,380,128,94,101,56,12,17,5370,5242,5148,3922,1110,989,178,202,2654,2688,483,3536,943,0,,414
15:30:09,7916.818,Fox,5342,380,126,92,104,57,12,17,5370,5244,5152,3923,1110,989,178,202,2654,2688,483,3536,943,0,,414
15:30:09,7917.335,Fox,5342,378,126,90,103,58,12,17,5370,5244,5154,3926,1110,989,178,200,2654,2688,483,3538,943,0,,412
15:30:09,7917.887,Fox,5344,377,126,82,111,55,12,17,5370,5244,5162,3926,1110,989,176,201,2655,2689,483,3541,943,0,,411
15:30:10,7918.47,Fox,5346,378,128,84,111,54,12,17,5374,5246,5162,3926,1110,989,176,202,2656,2690,483,3542,943,0,,412
15:30:10,7919.288,Fox,5348,379,128,86,110,53,13,17,5376,5248,5162,3926,1111,989,176,203,2657,2691,483,3543,943,0,,413
15:30:10,7919.856,Fox,5348,377,128,86,110,51,12,18,5376,5248,5162,3926,1111,990,175,202,2657,2691,483,3545,943,0,,411
15:30:10,7920.144,Fox,5348,376,128,86,110,50,12,18,5376,5248,5162,3926,1111,990,175,201,2657,2691,483,3546,943,0,,410
15:30:10,7920.96,Fox,5348,375,128,86,109,49,13,18,5376,5248,5162,3927,1112,990,175,200,2657,2691,483,3547,943,0,,409
15:30:11,7921.466,Fox,5348,375,128,84,110,50,13,18,5376,5248,5164,3928,1112,990,175,200,2657,2691,483,3547,943,0,,409
15:30:11,7922.056,Fox,5350,374,126,84,114,47,13,18,5378,5252,5168,3928,1112,990,174,200,2657,2693,483,3550,943,0,,408
15:30:11,7922.644,Fox,5352,376,128,84,114,47,13,18,5380,5252,5168,3928,1112,990,175,201,2658,2694,483,3550,943,0,,410
15:30:11,7923.228,Fox,5352,374,124,84,118,45,13,18,5380,5256,5172,3928,1112,990,175,199,2658,2694,483,3552,943,0,,408
15:30:11,7924.094,Fox,5352,368,122,84,118,42,13,17,5380,5258,5174,3930,1112,990,175,193,2658,2694,483,3557,944,0,,402
15:30:12,7924.671,Fox,5352,363,122,82,120,37,13,17,5380,5258,5176,3930,1112,990,174,189,2658,2694,483,3562,944,0,,397
15:30:12,7925.271,Fox,5354,361,124,82,119,34,13,17,5382,5258,5176,3930,1112,990,173,188,2658,2696,483,3566,944,0,,395
15:30:12,7925.827,Fox,5356,361,122,84,118,33,13,17,5382,5260,5176,3930,1112,990,172,189,2659,2697,483,3568,944,0,,395
15:30:12,7926.102,Fox,5356,360,124,84,118,32,13,17,5384,5260,5176,3930,1112,990,172,188,2659,2697,483,3569,944,0,,394
15:30:12,7926.951,Fox,5358,361,126,80,121,32,13,17,5386,5260,5180,3930,1112,990,172,189,2660,2698,483,3570,944,0,,395
15:30:13,7927.526,Fox,5358,361,124,78,125,32,13,17,5386,5262,5184,3930,1112,990,172,189,2660,2698,483,3570,944,0,,395
15:30:13,7928.31,Fox,5360,362,120,80,126,32,13,17,5386,5266,5186,3930,1112,990,171,191,2660,2700,483,3571,944,0,,396
15:30:13,7928.885,Fox,5362,363,124,80,124,33,13,17,5390,5266,5186,3931,1112,990,172,191,2662,2700,483,3572,944,0,,397
15:30:13,7929.446,Fox,5364,363,124,80,121,34,13,17,5390,5266,5186,3933,1112,990,173,190,2664,2700,483,3574,944,0,,397
15:30:13,7929.747,Fox,5364,363,126,80,121,34,13,17,5392,5266,5186,3933,1112,990,173,190,2664,2700,483,3574,944,0,,397
15:30:14,7930.572,Fox,5364,362,126,80,121,33,13,17,5392,5266,5186,3933,1112,990,173,189,2664,2700,483,3575,944,0,,396
15:30:14,7931.383,Fox,5364,359,126,80,117,35,13,16,5392,5266,5186,3937,1112,990,173,186,2664,2700,483,3577,945,0,,393
15:30:14,7931.669,Fox,5364,359,126,78,119,35,13,16,5392,5266,5188,3937,1112,990,173,186,2664,2700,483,3577,945,0,,393
15:30:14,7932.227,Fox,5364,359,126,76,121,35,13,16,5392,5266,5190,3937,1112,990,173,186,2664,2700,483,3577,945,0,,393
15:30:14,7933.019,Fox,5368,361,122,80,117,37,13,16,5392,5270,5190,3939,1112,990,171,190,2664,2704,483,3579,945,0,,395
15:30:15,7933.45,Fox,5368,361,124,80,119,37,13,16,5396,5272,5192,3939,1112,990,171,190,2664,2704,483,3579,945,0,,395
15:30:15,7934.299,Fox,5368,361,122,80,121,37,13,16,5396,5274,5194,3939,1112,990,171,190,2664,2704,483,3579,945,0,,395
15:30:15,7934.818,Fox,5370,361,120,82,120,36,13,16,5396,5276,5194,3939,1112,990,170,191,2664,2706,483,3581,945,0,,395
15:30:15,7935.404,Fox,5376,362,122,84,117,35,13,15,5400,5278,5194,3939,1112,990,170,192,2668,2708,483,3585,946,0,,396
15:30:15,7935.979,Fox,5376,362,122,86,117,37,13,15,5404,5282,5196,3941,1112,990,170,192,2668,2708,483,3585,946,0,,396
15:30:16,7936.84,Fox,5378,363,122,86,116,39,13,15,5406,5284,5198,3943,1112,990,169,194,2668,2710,483,3586,946,0,,397
15:30:16,7937.659,Fox,5378,361,122,86,113,40,13,15,5406,5284,5198,3946,1112,990,168,193,2668,2710,483,3588,946,0,,395
15:30:16,7938.221,Fox,5380,362,124,82,116,40,13,15,5408,5284,5202,3946,1112,990,168,194,2669,2711,483,3589,946,0,,396
15:30:16,7938.755,Fox,5380,362,124,80,116,42,13,15,5408,5284,5204,3948,1112,990,168,194,2669,2711,483,3589,946,0,,396
15:30:17,7939.258,Fox,5382,363,126,80,115,42,13,15,5410,5284,5204,3948,1112,990,168,195,2670,2712,483,3590,946,0,,397
15:30:17,7939.548,Fox,5382,363,126,78,117,42,13,15,5410,5284,5206,3948,1112,990,168,195,2670,2712,483,3590,946,0,,397
15:30:17,7940.363,Fox,5386,365,128,78,113,45,13,14,5412,5284,5206,3951,1112,990,168,197,2672,2714,483,3591,947,0,,399
15:30:17,7940.918,Fox,5386,364,128,76,117,45,13,13,5414,5286,5210,3951,1112,990,168,196,2672,2714,483,3591,948,0,,398
15:30:17,7941.74,Fox,5386,364,126,78,114,48,12,14,5414,5288,5210,3954,1112,991,168,196,2672,2714,483,3591,948,0,,398
15:30:18,7942.841,Fox,5388,365,128,78,112,49,12,14,5416,5288,5210,3955,1112,991,169,196,2674,2714,483,3592,948,0,,399
15:30:18,7943.687,Fox,5390,365,128,78,111,49,12,13,5416,5288,5210,3955,1112,991,169,196,2675,2715,484,3592,949,0,,399
15:30:18,7944.25,Fox,5390,365,130,76,113,48,13,13,5418,5288,5212,3955,1113,991,169,196,2675,2715,484,3592,949,0,,399
15:30:18,7944.823,Fox,5392,363,132,76,113,46,13,11,5420,5288,5212,3955,1113,991,169,194,2676,2716,484,3594,951,0,,397
15:30:19,7945.396,Fox,5392,362,132,72,117,45,11,13,5420,5288,5216,3955,1113,993,169,193,2676,2716,484,3595,951,0,,396
15:30:19,7945.692,Fox,5392,362,130,74,117,45,11,13,5420,5290,5216,3955,1113,993,169,193,2676,2716,484,3595,951,0,,396
15:30:19,7946.541,Fox,5394,363,132,70,120,46,11,12,5422,5290,5220,3956,1113,993,168,195,2676,2718,484,3595,952,0,,397
15:30:19,7947.124,Fox,5396,360,132,68,121,41,12,12,5422,5290,5222,3956,1114,993,166,194,2677,2719,484,3600,952,0,,394
15:30:19,7947.423,Fox,5396,360,134,68,119,43,12,12,5424,5290,5222,3958,1114,993,166,194,2677,2719,484,3600,952,0,,394
15:30:19,7947.865,Fox,5396,359,134,66,121,43,12,11,5424,5290,5224,3958,1114,993,166,193,2677,2719,484,3600,953,0,,393
15:30:20,7948.707,Fox,5398,358,134,64,123,42,12,11,5426,5292,5228,3959,1114,993,167,191,2679,2719,484,3603,953,0,,392
15:30:20,7949.271,Fox,5400,359,132,64,124,42,12,11,5426,5294,5230,3959,1114,993,168,191,2681,2719,484,3604,953,0,,393
15:30:20,7949.571,Fox,5400,359,134,60,126,44,12,11,5428,5294,5234,3961,1114,993,168,191,2681,2719,484,3604,953,0,,393
15:30:21,7950.673,Fox,5400,359,132,60,127,45,12,11,5428,5296,5236,3962,1114,993,168,191,2681,2719,484,3604,953,0,,393
15:30:21,7951.22,Fox,5400,356,130,60,129,43,12,10,5428,5298,5238,3962,1114,993,166,190,2681,2719,484,3606,954,0,,390
15:30:21,7951.496,Fox,5400,356,130,60,126,46,12,10,5428,5298,5238,3965,1114,993,166,190,2681,2719,484,3606,954,0,,390
15:30:21,7952.229,Fox,5402,355,128,58,127,46,12,10,5428,5300,5242,3967,1114,993,165,190,2681,2721,484,3609,954,0,,389
15:30:21,7952.368,Fox,5402,355,130,58,127,46,12,10,5430,5300,5242,3967,1114,993,165,190,2681,2721,484,3609,954,0,,389
15:30:21,7953.188,Fox,5402,353,126,62,126,45,12,10,5430,5304,5242,3968,1114,993,163,190,2681,2721,484,3611,954,0,,387
15:30:22,7953.772,Fox,5406,354,130,62,124,44,13,9,5434,5304,5242,3969,1115,993,165,189,2685,2721,484,3613,955,0,,388
15:30:22,7954.196,Fox,5406,353,126,66,123,44,13,9,5434,5308,5242,3970,1115,993,165,188,2685,2721,484,3614,955,0,,387
15:30:22,7954.76,Fox,5406,352,124,68,121,45,13,9,5434,5310,5242,3972,1115,993,165,187,2685,2721,484,3615,955,0,,386
15:30:22,7955.332,Fox,5408,352,126,66,122,45,13,8,5436,5310,5244,3972,1115,993,164,188,2685,2723,484,3616,956,0,,386
15:30:22,7955.888,Fox,5410,353,122,70,120,46,13,8,5436,5314,5244,3973,1115,993,164,189,2686,2724,484,3617,956,0,,387
15:30:22,7956.448,Fox,5410,351,122,72,119,45,12,9,5438,5316,5244,3974,1115,994,163,188,2686,2724,484,3619,956,0,,385
15:30:23,7956.71,Fox,5410,350,122,70,121,45,12,8,5438,5316,5246,3974,1115,994,162,188,2686,2724,484,3619,957,0,,384
15:30:23,7957.816,Fox,5412,351,124,68,122,45,12,8,5440,5316,5248,3974,1115,994,161,190,2686,2726,484,3620,957,0,,385
15:30:23,7958.367,Fox,5412,348,124,68,122,42,12,8,5440,5316,5248,3974,1115,994,160,188,2686,2726,484,3623,957,0,,382
15:30:23,7958.652,Fox,5412,347,124,68,122,41,12,8,5440,5316,5248,3974,1115,994,160,187,2686,2726,484,3624,957,0,,381
15:30:23,7959.437,Fox,5412,347,120,72,118,45,12,8,5440,5320,5248,3978,1115,994,160,187,2686,2726,484,3624,957,0,,381
15:30:24,7960.45,Fox,5414,348,120,68,120,46,12,8,5440,5320,5252,3979,1115,994,160,188,2687,2727,484,3625,957,0,,382
15:30:24,7961.002,Fox,5414,348,120,70,120,46,12,8,5442,5322,5252,3979,1115,994,160,188,2687,2727,484,3625,957,0,,382
15:30:24,7961.839,Fox,5415,348,122,66,123,46,12,8,5444,5322,5256,3979,1115,994,160,188,2688,2727,484,3626,957,0,,382
15:30:24,7962.373,Fox,5415,347,122,66,123,44,13,8,5444,5322,5256,3979,1116,994,160,187,2688,2727,484,3627,957,0,,381
15:30:24,7962.507,Fox,5415,347,122,64,125,42,15,8,5444,5322,5258,3979,1118,994,160,187,2688,2727,484,3627,957,0,,381
15:30:25,7962.906,Fox,5415,347,122,64,125,42,13,10,5444,5322,5258,3979,1118,996,160,187,2688,2727,484,3627,957,0,,381
15:30:25,7963.4,Fox,5415,346,122,64,123,43,13,10,5444,5322,5258,3981,1118,996,160,186,2688,2727,485,3627,957,0,,380
15:30:25,7964.183,Fox,5415,346,120,64,124,44,13,10,5444,5324,5260,3982,1118,996,160,186,2688,2727,485,3627,957,0,,380
15:30:25,7964.966,Fox,5415,346,120,64,122,46,13,10,5444,5324,5260,3984,1118,996,160,186,2688,2727,485,3627,957,0,,380
15:30:26,7965.964,Fox,5415,344,118,64,122,46,12,11,5444,5326,5262,3986,1118,997,160,184,2688,2727,485,3629,957,0,,378
15:30:26,7966.506,Fox,5417,344,120,60,124,46,12,11,5446,5326,5266,3987,1118,997,159,185,2688,2729,485,3631,957,0,,378
15:30:26,7967.062,Fox,5421,346,122,62,120,48,12,11,5450,5328,5266,3989,1118,997,160,186,2691,2730,485,3633,957,0,,380
15:30:26,7967.63,Fox,5423,344,122,64,119,45,12,11,5452,5330,5266,3989,1118,997,160,184,2693,2730,485,3637,957,0,,378
15:30:26,7968.193,Fox,5423,342,120,66,118,44,12,11,5452,5332,5266,3990,1118,997,160,182,2693,2730,485,3639,957,0,,376
15:30:27,7969.03,Fox,5425,343,122,66,118,43,12,11,5454,5332,5266,3990,1118,997,161,182,2694,2731,485,3640,957,0,,377
15:30:27,7969.62,Fox,5427,343,124,66,117,42,12,11,5456,5332,5266,3990,1118,997,160,183,2694,2733,485,3642,957,0,,377
15:30:27,7969.801,Fox,5427,343,124,66,115,44,12,11,5456,5332,5266,3992,1118,997,160,183,2694,2733,485,3642,957,0,,377
15:30:27,7970.378,Fox,5429,342,126,66,114,43,12,10,5458,5332,5266,3992,1118,997,159,183,2694,2735,485,3644,958,0,,376
15:30:27,7971.048,Fox,5429,341,124,68,114,42,12,10,5458,5334,5266,3992,1118,997,159,182,2694,2735,485,3645,958,0,,375
15:30:28,7971.614,Fox,5435,346,128,64,116,43,12,10,5462,5334,5270,3993,1118,997,159,187,2695,2740,485,3646,958,0,,380
15:30:28,7972.197,Fox,5435,344,130,62,116,43,12,10,5464,5334,5272,3995,1118,997,159,185,2695,2740,485,3648,958,0,,378
15:30:28,7972.479,Fox,5435,344,130,60,118,43,12,10,5464,5334,5274,3995,1118,997,159,185,2695,2740,485,3648,958,0,,378
15:30:28,7973.346,Fox,5435,344,130,58,118,45,12,10,5464,5334,5276,3997,1118,997,159,185,2695,2740,485,3648,958,0,,378
15:30:28,7973.863,Fox,5435,344,130,56,118,47,12,10,5464,5334,5278,3999,1118,997,159,185,2695,2740,485,3648,958,0,,378
15:30:29,7974.415,Fox,5439,346,134,52,120,47,12,10,5468,5334,5282,3999,1118,997,159,187,2697,2742,485,3650,958,0,,380
15:30:29,7974.982,Fox,5439,346,134,50,121,48,12,10,5468,5334,5284,4000,1118,997,159,187,2697,2742,485,3650,958,0,,380
15:30:29,7975.511,Fox,5439,343,134,50,121,45,13,9,5468,5334,5284,4000,1119,997,157,186,2697,2742,485,3652,959,0,,377
15:30:29,7976.352,Fox,5441,343,132,54,116,48,13,9,5470,5338,5284,4004,1119,997,158,185,2699,2742,485,3654,959,0,,377
15:30:29,7976.943,Fox,5445,345,134,56,114,48,13,9,5474,5340,5284,4006,1119,997,160,185,2702,2743,485,3656,959,0,,379
15:30:30,7977.506,Fox,5445,345,132,58,111,51,13,9,5474,5342,5284,4009,1119,997,160,185,2702,2743,485,3656,959,0,,379
15:30:30,7978.357,Fox,5445,345,128,62,104,58,13,9,5474,5346,5284,4016,1119,997,160,185,2702,2743,485,3656,959,0,,379
15:30:30,7979.434,Fox,5447,347,126,62,106,58,13,9,5474,5348,5286,4016,1119,997,160,187,2702,2745,485,3656,959,0,,381
15:30:30,7980,Fox,5449,348,128,62,106,57,13,9,5476,5348,5286,4016,1119,997,160,188,2703,2746,485,3657,959,0,,382
15:30:31,7980.563,Fox,5449,346,128,62,108,55,13,9,5478,5350,5288,4016,1119,997,160,186,2703,2746,485,3659,959,0,,380
15:30:31,7981.113,Fox,5449,345,128,62,108,54,13,9,5478,5350,5288,4016,1119,997,160,185,2703,2746,485,3660,959,0,,379
15:30:31,7982.214,Fox,5449,344,126,64,106,55,13,9,5478,5352,5288,4018,1119,997,159,185,2703,2746,485,3661,959,0,,378
15:30:31,7982.758,Fox,5449,344,124,66,102,59,13,9,5478,5354,5288,4022,1119,997,159,185,2703,2746,485,3661,959,0,,378
15:30:32,7983.533,Fox,5451,343,122,68,98,61,13,8,5478,5356,5288,4025,1119,997,158,185,2704,2747,485,3663,960,0,,377
15:30:32,7984.065,Fox,5453,342,124,66,99,59,13,8,5480,5356,5290,4025,1119,997,158,184,2705,2748,485,3666,960,0,,376
15:30:32,7984.639,Fox,5455,343,128,66,96,61,13,8,5484,5356,5290,4027,1119,997,158,185,2706,2749,485,3667,960,0,,377
15:30:32,7985.173,Fox,5455,342,128,66,95,60,14,8,5484,5356,5290,4028,1120,997,157,185,2706,2749,485,3668,960,0,,376
15:30:32,7985.71,Fox,5455,342,128,66,95,59,15,8,5484,5356,5290,4028,1121,997,157,185,2706,2749,485,3668,960,0,,376
15:30:32,7986.228,Fox,5455,342,126,68,95,59,15,8,5484,5358,5290,4028,1121,997,157,185,2706,2749,485,3668,960,0,,376
15:30:33,7986.999,Fox,5455,341,126,66,97,58,15,8,5484,5358,5292,4028,1121,997,157,184,2706,2749,485,3669,960,0,,375
15:30:33,7987.248,Fox,5455,341,126,64,97,60,15,8,5484,5358,5294,4030,1121,997,157,184,2706,2749,485,3669,960,0,,375
15:30:33,7987.772,Fox,5455,341,126,64,93,64,15,8,5484,5358,5294,4034,1121,997,157,184,2706,2749,485,3669,960,0,,375
15:30:33,7988.796,Fox,5455,339,126,62,94,64,15,7,5484,5358,5296,4035,1121,997,157,182,2706,2749,485,3670,961,0,,373
15:30:33,7989.33,Fox,5461,341,128,62,92,62,15,7,5486,5358,5296,4035,1121,997,155,186,2707,2754,485,3674,961,0,,375
15:30:34,7989.884,Fox,5461,339,130,62,94,60,15,7,5490,5360,5298,4035,1121,997,154,185,2707,2754,485,3676,961,0,,373
15:30:34,7990.448,Fox,5465,342,132,62,93,59,16,7,5492,5360,5298,4035,1122,997,156,186,2710,2755,485,3677,961,0,,376
15:30:34,7990.745,Fox,5465,340,134,60,95,57,16,7,5494,5360,5300,4035,1122,997,156,184,2710,2755,485,3679,961,0,,374
15:30:34,7991.546,Fox,5465,339,134,56,99,56,16,7,5494,5360,5304,4035,1122,997,156,183,2710,2755,485,3680,961,0,,373
15:30:34,7992.12,Fox,5469,341,138,56,96,57,16,7,5498,5360,5304,4036,1122,997,154,187,2710,2759,485,3682,961,0,,375
15:30:35,7992.676,Fox,5469,341,138,52,99,58,16,7,5498,5360,5308,4037,1122,997,154,187,2710,2759,485,3682,961,0,,375
15:30:35,7993.228,Fox,5469,338,136,52,101,55,16,7,5498,5362,5310,4037,1122,997,154,184,2710,2759,485,3685,961,0,,372
15:30:35,7993.721,Fox,5469,337,136,52,100,56,16,6,5498,5362,5310,4038,1122,997,153,184,2710,2759,485,3685,962,0,,371
15:30:35,7994.261,Fox,5469,335,136,48,104,53,17,6,5498,5362,5314,4038,1123,997,152,183,2710,2759,485,3687,962,0,,369
15:30:35,7994.757,Fox,5469,333,136,46,104,53,17,6,5498,5362,5316,4040,1123,997,152,181,2710,2759,485,3689,962,0,,367
15:30:35,7995.306,Fox,5469,328,134,48,104,48,17,6,5498,5364,5316,4040,1123,997,149,179,2710,2759,485,3694,962,0,,362
15:30:36,7996.133,Fox,5471,329,134,48,104,47,17,6,5498,5364,5316,4040,1123,997,150,179,2711,2760,485,3695,962,0,,363
15:30:36,7996.695,Fox,5473,330,136,48,102,48,17,6,5500,5364,5316,4042,1123,997,149,181,2711,2762,485,3696,962,0,,364
15:30:36,7997.266,Fox,5477,331,138,52,98,50,17,5,5506,5368,5316,4044,1123,997,148,183,2712,2765,487,3696,963,0,,365
15:30:36,7997.555,Fox,5477,331,136,50,102,50,17,5,5506,5370,5320,4044,1123,997,148,183,2712,2765,487,3696,963,0,,365
15:30:37,7998.83,Fox,5477,331,136,50,98,54,17,5,5506,5370,5320,4048,1123,997,148,183,2712,2765,487,3696,963,0,,365
15:30:37,7999.62,Fox,5479,331,138,48,98,54,17,5,5508,5370,5322,4050,1123,997,147,184,2713,2766,487,3698,963,0,,365
15:30:37,7999.856,Fox,5479,329,138,48,96,54,16,6,5508,5370,5322,4052,1123,998,147,182,2713,2766,487,3700,963,0,,363
15:30:38,8001.176,Fox,5481,327,134,52,94,52,16,6,5508,5374,5322,4053,1123,998,148,179,2715,2766,487,3704,963,0,,361
15:30:38,8001.44,Fox,5481,327,136,52,93,53,16,6,5510,5374,5322,4054,1123,998,148,179,2715,2766,487,3704,963,0,,361
15:30:38,8001.874,Fox,5481,327,134,54,93,53,16,6,5510,5376,5322,4054,1123,998,148,179,2715,2766,487,3704,963,0,,361
15:30:38,8002.642,Fox,5481,325,134,52,95,51,16,6,5510,5376,5324,4054,1123,998,146,179,2715,2766,487,3706,963,0,,359
15:30:38,8003.149,Fox,5481,324,134,52,95,50,16,6,5510,5376,5324,4054,1123,998,145,179,2715,2766,487,3707,963,0,,358
15:30:39,8004.554,Fox,5481,324,132,52,97,50,16,6,5510,5378,5326,4054,1123,998,145,179,2715,2766,487,3707,963,0,,358
15:30:39,8004.821,Fox,5481,324,132,52,96,51,16,6,5510,5378,5326,4055,1123,998,145,179,2715,2766,487,3707,963,0,,358
15:30:39,8005.517,Fox,5481,320,130,52,97,48,16,6,5510,5380,5328,4056,1123,998,143,177,2715,2766,487,3711,963,0,,354
15:30:39,8006.282,Fox,5481,318,130,50,98,47,16,6,5510,5380,5330,4057,1123,998,142,176,2715,2766,487,3713,963,0,,352
15:30:39,8006.768,Fox,5481,318,130,48,96,51,16,6,5510,5380,5332,4061,1123,998,142,176,2715,2766,487,3713,963,0,,352
15:30:40,8007.244,Fox,5483,317,132,48,96,49,16,5,5512,5380,5332,4061,1123,998,141,176,2715,2768,487,3715,964,0,,351
15:30:40,8007.731,Fox,5485,318,132,48,93,49,18,5,5512,5380,5332,4063,1125,998,142,176,2717,2768,487,3716,964,0,,352
15:30:40,8008.266,Fox,5487,319,134,50,90,51,18,5,5516,5382,5332,4065,1125,998,143,176,2719,2768,487,3717,964,0,,353
15:30:40,8008.791,Fox,5489,320,134,52,89,51,18,5,5518,5384,5332,4065,1125,998,142,178,2719,2770,487,3718,964,0,,354
15:30:40,8009.524,Fox,5489,320,132,52,89,53,18,5,5518,5386,5334,4067,1125,998,142,178,2719,2770,487,3718,964,0,,354
15:30:41,8010.225,Fox,5493,323,136,52,84,57,18,5,5522,5386,5334,4071,1125,998,143,180,2721,2772,487,3719,964,0,,357
15:30:41,8010.752,Fox,5495,323,138,52,84,55,18,5,5524,5386,5334,4071,1125,998,143,180,2722,2773,487,3721,964,0,,357
15:30:41,8011.295,Fox,5495,322,136,54,80,58,18,5,5524,5388,5334,4075,1125,998,143,179,2722,2773,487,3722,964,0,,356
15:30:41,8011.554,Fox,5495,322,134,56,80,58,18,5,5524,5390,5334,4075,1125,998,143,179,2722,2773,487,3722,964,0,,356
15:30:41,8012.602,Fox,5495,321,132,58,77,60,18,5,5524,5392,5334,4078,1125,998,143,178,2722,2773,487,3723,964,0,,355
15:30:42,8013.133,Fox,5496,319,134,58,76,58,18,5,5526,5392,5334,4078,1125,998,143,176,2723,2773,487,3726,964,0,,353
15:30:42,8014.459,Fox,5500,321,136,56,76,58,18,5,5528,5392,5336,4078,1125,998,143,178,2725,2775,488,3727,964,0,,355
15:30:42,8015.007,Fox,5504,321,140,54,77,55,18,5,5532,5392,5338,4078,1125,998,144,177,2728,2776,488,3731,964,0,,355
15:30:42,8015.556,Fox,5506,322,144,52,79,54,18,5,5536,5392,5340,4078,1125,998,145,177,2729,2777,488,3732,964,0,,356
15:30:42,8015.812,Fox,5506,322,140,54,80,55,18,5,5536,5396,5342,4079,1125,998,145,177,2729,2777,488,3732,964,0,,356
15:30:43,8016.828,Fox,5506,322,140,50,84,55,18,5,5536,5396,5346,4079,1125,998,145,177,2729,2777,488,3732,964,0,,356
15:30:43,8017.113,Fox,5506,320,140,50,82,55,18,5,5536,5396,5346,4081,1125,998,144,176,2729,2777,488,3734,964,0,,354
15:30:43,8017.909,Fox,5508,320,138,52,83,54,18,5,5538,5400,5348,4081,1125,998,143,177,2729,2779,488,3736,964,0,,354
15:30:43,8018.435,Fox,5508,318,134,56,82,53,18,5,5538,5404,5348,4082,1125,998,141,177,2729,2779,488,3738,964,0,,352
15:30:44,8018.958,Fox,5510,317,134,54,83,51,18,5,5538,5404,5350,4082,1125,998,142,175,2731,2779,488,3741,964,0,,351
15:30:44,8019.502,Fox,5510,317,134,56,83,51,18,5,5540,5406,5350,4082,1125,998,142,175,2731,2779,488,3741,964,0,,351
15:30:44,8020.04,Fox,5514,318,134,56,82,49,18,5,5540,5406,5350,4082,1125,998,143,175,2734,2780,488,3744,964,0,,352
15:30:44,8020.603,Fox,5514,317,138,54,82,50,18,5,5544,5406,5352,4084,1125,998,142,175,2734,2780,488,3745,964,0,,351
15:30:44,8021.132,Fox,5514,317,136,54,82,52,18,5,5544,5408,5354,4086,1125,998,142,175,2734,2780,488,3745,964,0,,351
15:30:45,8022.144,Fox,5514,317,134,54,81,55,18,5,5544,5410,5356,4089,1125,998,142,175,2734,2780,488,3745,964,0,,351
15:30:45,8023.211,Fox,5514,317,130,58,79,56,19,5,5544,5414,5356,4091,1126,998,142,175,2734,2780,488,3745,964,0,,351
15:30:45,8023.496,Fox,5514,316,130,58,79,55,19,5,5544,5414,5356,4091,1126,998,142,174,2734,2780,488,3746,964,0,,350
15:30:45,8024.55,Fox,5514,315,130,58,77,56,19,5,5544,5414,5356,4093,1126,998,142,173,2734,2780,488,3747,964,0,,349
15:30:45,8024.797,Fox,5514,312,130,56,79,53,19,5,5544,5414,5358,4093,1126,998,141,171,2734,2780,488,3750,964,0,,346
15:30:46,8025.427,Fox,5514,310,128,58,79,51,19,5,5544,5416,5358,4093,1126,998,140,170,2734,2780,488,3752,964,0,,344
15:30:46,8026.471,Fox,5514,308,126,60,77,51,18,6,5544,5418,5358,4095,1126,999,139,169,2734,2780,488,3754,964,0,,342
15:30:46,8027.247,Fox,5514,307,126,60,75,52,18,6,5544,5418,5358,4097,1126,999,139,168,2734,2780,488,3755,964,0,,341
15:30:46,8027.765,Fox,5516,308,124,62,75,51,18,6,5544,5420,5358,4097,1126,999,141,167,2736,2780,488,3756,964,0,,342
15:30:47,8028.293,Fox,5516,305,126,62,75,48,18,6,5546,5420,5358,4097,1126,999,140,165,2736,2780,488,3759,964,0,,339
15:30:47,8028.549,Fox,5516,305,126,60,77,48,18,6,5546,5420,5360,4097,1126,999,140,165,2736,2780,488,3759,964,0,,339
15:30:47,8029.334,Fox,5518,305,124,62,77,46,18,6,5546,5422,5360,4097,1126,999,139,166,2736,2782,488,3761,964,0,,339
15:30:47,8029.867,Fox,5520,304,126,62,76,44,18,6,5548,5422,5360,4097,1126,999,136,168,2736,2784,488,3764,964,0,,338
15:30:47,8030.123,Fox,5520,304,126,64,76,44,18,6,5550,5424,5360,4097,1126,999,136,168,2736,2784,488,3764,964,0,,338
15:30:47,8030.671,Fox,5520,301,126,64,76,41,18,6,5550,5424,5360,4097,1126,999,136,165,2736,2784,488,3767,964,0,,335
15:30:48,8031.64,Fox,5520,301,124,64,76,43,18,6,5550,5426,5362,4099,1126,999,136,165,2736,2784,488,3767,964,0,,335
15:30:48,8032.197,Fox,5526,304,128,66,73,43,18,6,5556,5428,5362,4100,1126,999,135,169,2738,2788,488,3770,964,0,,338
15:30:48,8032.471,Fox,5526,303,128,66,72,44,18,5,5556,5428,5362,4101,1126,999,134,169,2738,2788,488,3770,965,0,,337
15:30:48,8032.976,Fox,5526,301,128,66,71,43,18,5,5556,5428,5362,4102,1126,999,132,169,2738,2788,488,3772,965,0,,335
15:30:48,8033.909,Fox,5528,302,128,64,69,46,18,5,5556,5428,5364,4106,1126,999,131,171,2738,2790,488,3773,965,0,,336
15:30:49,8034.413,Fox,5528,300,130,64,69,44,18,5,5558,5428,5364,4106,1126,999,130,170,2738,2790,488,3775,965,0,,334
15:30:49,8035.154,Fox,5528,300,128,66,66,47,18,5,5558,5430,5364,4109,1126,999,130,170,2738,2790,488,3775,965,0,,334
15:30:49,8035.632,Fox,5528,300,128,62,69,48,18,5,5558,5430,5368,4110,1126,999,130,170,2738,2790,488,3775,965,0,,334
15:30:49,8035.885,Fox,5528,300,128,60,71,48,18,5,5558,5430,5370,4110,1126,999,130,170,2738,2790,488,3775,965,0,,334
15:30:49,8036.531,Fox,5528,297,124,64,71,46,18,4,5558,5434,5370,4110,1126,999,129,168,2738,2790,488,3777,966,0,,331
15:30:50,8036.998,Fox,5530,296,124,64,71,43,18,4,5558,5434,5370,4110,1126,999,130,166,2740,2790,488,3780,966,0,,330
15:30:50,8037.231,Fox,5530,296,126,64,71,43,18,4,5560,5434,5370,4110,1126,999,130,166,2740,2790,488,3780,966,0,,330
15:30:50,8037.969,Fox,5532,295,124,66,70,41,18,4,5560,5436,5370,4110,1126,999,130,165,2741,2791,488,3783,966,0,,329
15:30:50,8038.209,Fox,5532,295,126,66,70,41,18,4,5562,5436,5370,4110,1126,999,130,165,2741,2791,488,3783,966,0,,329
15:30:50,8038.945,Fox,5534,296,124,68,69,41,18,4,5562,5438,5370,4110,1126,999,130,166,2742,2792,488,3784,966,0,,330
15:30:50,8039.429,Fox,5534,296,126,64,73,41,18,4,5564,5438,5374,4110,1126,999,130,166,2742,2792,488,3784,966,0,,330
15:30:50,8039.903,Fox,5534,296,126,64,71,43,18,4,5564,5438,5374,4112,1126,999,130,166,2742,2792,488,3784,966,0,,330
15:30:51,8040.573,Fox,5536,295,126,64,72,41,18,4,5566,5440,5376,4112,1126,999,130,165,2743,2793,488,3787,966,0,,329
15:30:51,8040.789,Fox,5536,295,126,64,71,41,19,4,5566,5440,5376,4113,1127,999,130,165,2743,2793,488,3787,966,0,,329
15:30:51,8042.265,Fox,5536,294,126,64,71,39,20,4,5566,5440,5376,4113,1128,999,130,164,2743,2793,488,3788,966,0,,328
15:30:52,8043.162,Fox,5536,292,126,62,73,37,20,4,5566,5440,5378,4113,1128,999,128,164,2743,2793,488,3790,966,0,,326
15:30:52,8043.649,Fox,5536,292,124,62,75,37,20,4,5566,5442,5380,4113,1128,999,128,164,2743,2793,488,3790,966,0,,326
15:30:52,8044.583,Fox,5536,292,122,64,74,38,20,4,5566,5444,5380,4114,1128,999,128,164,2743,2793,488,3790,966,0,,326
15:30:53,8046.412,Fox,5536,292,122,62,76,38,20,4,5566,5444,5382,4114,1128,999,128,164,2743,2793,488,3790,966,0,,326
15:30:53,8047.076,Fox,5536,291,122,60,78,38,20,3,5566,5444,5384,4114,1128,999,127,164,2743,2793,488,3790,967,0,,325
15:30:53,8047.482,Fox,5536,290,122,60,77,38,20,3,5566,5444,5384,4115,1128,999,127,163,2743,2793,488,3791,967,0,,324
15:30:53,8048.139,Fox,5536,289,122,58,77,38,21,3,5566,5444,5386,4117,1129,999,127,162,2743,2793,488,3792,967,0,,323
15:30:53,8048.308,Fox,5536,288,122,58,77,37,21,3,5566,5444,5386,4117,1129,999,127,161,2743,2793,488,3793,967,0,,322
15:30:54,8048.956,Fox,5536,287,120,60,77,36,19,5,5566,5446,5386,4117,1129,1001,127,160,2743,2793,488,3794,967,0,,321
15:30:54,8049.406,Fox,5538,288,122,60,74,38,19,5,5568,5446,5386,4119,1129,1001,126,162,2743,2795,488,3795,967,0,,322
15:30:54,8049.864,Fox,5538,284,118,60,76,36,19,5,5568,5450,5390,4121,1129,1001,123,161,2743,2795,488,3799,967,0,,318
15:30:54,8050.317,Fox,5538,283,116,62,76,36,19,4,5568,5452,5390,4121,1129,1001,123,160,2743,2795,488,3799,968,0,,317
15:30:54,8050.733,Fox,5538,280,116,60,78,33,19,4,5568,5452,5392,4121,1129,1001,122,158,2743,2795,488,3802,968,0,,314
15:30:54,8051.303,Fox,5538,279,116,60,77,33,19,4,5568,5452,5392,4122,1129,1001,122,157,2743,2795,489,3802,968,0,,313
15:30:54,8051.544,Fox,5538,279,114,62,77,33,19,4,5568,5454,5392,4122,1129,1001,122,157,2743,2795,489,3802,968,0,,313
15:30:55,8052.2,Fox,5540,280,112,64,72,37,19,4,5568,5456,5392,4126,1129,1001,122,158,2744,2796,489,3803,968,0,,314
15:30:55,8052.423,Fox,5540,280,114,64,72,37,19,4,5570,5456,5392,4126,1129,1001,122,158,2744,2796,489,3803,968,0,,314
15:30:55,8053.089,Fox,5540,280,112,66,69,40,19,4,5570,5458,5392,4129,1129,1001,122,158,2744,2796,489,3803,968,0,,314
15:30:55,8053.503,Fox,5540,280,112,66,67,42,19,4,5570,5458,5392,4131,1129,1001,122,158,2744,2796,489,3803,968,0,,314
15:30:55,8054.365,Fox,5542,281,106,68,67,45,19,4,5570,5464,5396,4134,1129,1001,122,159,2745,2797,489,3804,968,0,,315
15:30:56,8054.591,Fox,5542,281,108,68,67,45,19,4,5572,5464,5396,4134,1129,1001,122,159,2745,2797,489,3804,968,0,,315
15:30:56,8055.27,Fox,5544,282,110,68,64,47,19,4,5574,5464,5396,4136,1129,1001,122,160,2746,2798,489,3805,968,0,,316
15:30:56,8055.704,Fox,5546,283,112,68,63,47,19,4,5576,5464,5396,4136,1129,1001,123,160,2748,2798,489,3806,968,0,,317
15:30:56,8056.184,Fox,5548,282,114,66,65,44,19,4,5578,5464,5398,4136,1129,1001,124,158,2750,2798,489,3809,968,0,,316
15:30:56,8056.639,Fox,5550,282,114,60,70,43,18,5,5578,5464,5404,4136,1129,1002,124,158,2751,2799,489,3811,968,0,,316
15:30:56,8056.894,Fox,5550,282,112,64,70,43,18,5,5580,5468,5404,4136,1129,1002,124,158,2751,2799,489,3811,968,0,,316
15:30:57,8057.987,Fox,5550,282,112,62,68,47,18,5,5580,5468,5406,4140,1129,1002,124,158,2751,2799,489,3811,968,0,,316
15:30:57,8058.201,Fox,5550,282,112,62,68,47,17,6,5580,5468,5406,4140,1129,1003,124,158,2751,2799,489,3811,968,0,,316
15:30:57,8058.87,Fox,5550,282,110,64,68,47,17,6,5580,5470,5406,4140,1129,1003,124,158,2751,2799,489,3811,968,0,,316
15:30:57,8059.52,Fox,5550,282,106,66,70,46,18,6,5580,5474,5408,4140,1130,1003,124,158,2751,2799,489,3811,968,0,,316
15:30:57,8059.734,Fox,5550,282,106,66,69,47,18,6,5580,5474,5408,4141,1130,1003,124,158,2751,2799,489,3811,968,0,,316
15:30:57,8060.443,Fox,5552,282,106,64,70,46,18,6,5580,5474,5410,4141,1130,1003,125,157,2753,2799,489,3813,968,0,,316
15:30:58,8060.93,Fox,5554,283,110,64,69,46,18,6,5584,5474,5410,4141,1130,1003,126,157,2755,2799,489,3814,968,0,,317
15:30:58,8061.638,Fox,5554,283,110,60,73,46,18,6,5584,5474,5414,4141,1130,1003,126,157,2755,2799,489,3814,968,0,,317
15:30:58,8062.329,Fox,5554,283,108,62,73,46,18,6,5584,5476,5414,4141,1130,1003,126,157,2755,2799,489,3814,968,0,,317
15:30:58,8063.008,Fox,5554,282,106,64,72,46,18,6,5584,5478,5414,4142,1130,1003,126,156,2755,2799,489,3815,968,0,,316
15:30:58,8063.464,Fox,5554,280,106,64,72,43,19,6,5584,5478,5414,4142,1131,1003,126,154,2755,2799,489,3817,968,0,,314
15:30:59,8063.917,Fox,5554,280,106,62,74,43,19,6,5584,5478,5416,4142,1131,1003,126,154,2755,2799,489,3817,968,0,,314
15:30:59,8064.783,Fox,5554,279,106,62,72,44,19,6,5584,5478,5416,4144,1131,1003,125,154,2755,2799,489,3818,968,0,,313
15:30:59,8065.222,Fox,5554,278,106,60,74,43,19,6,5584,5478,5418,4144,1131,1003,125,153,2755,2799,489,3819,968,0,,312
15:30:59,8065.438,Fox,5554,277,106,60,74,42,19,6,5584,5478,5418,4144,1131,1003,125,152,2755,2799,489,3820,968,0,,311
15:30:59,8065.885,Fox,5554,277,106,58,74,44,19,6,5584,5478,5420,4146,1131,1003,125,152,2755,2799,489,3820,968,0,,311
15:30:59,8066.54,Fox,5554,277,104,60,72,46,19,6,5584,5480,5420,4148,1131,1003,125,152,2755,2799,489,3820,968,0,,311
15:31:00,8066.921,Fox,5558,278,104,62,69,46,19,6,5586,5482,5420,4150,1131,1003,123,155,2755,2803,489,3823,968,0,,312
15:31:00,8067.138,Fox,5558,278,104,64,69,46,19,6,5588,5484,5420,4150,1131,1003,123,155,2755,2803,489,3823,968,0,,312
15:31:00,8067.599,Fox,5558,275,104,62,71,43,19,6,5588,5484,5422,4150,1131,1003,122,153,2755,2803,489,3826,968,0,,309
15:31:00,8068.622,Fox,5558,272,104,60,73,40,19,6,5588,5484,5424,4150,1131,1003,120,152,2755,2803,489,3829,968,0,,306
15:31:00,8069.242,Fox,5558,271,104,60,73,39,19,6,5588,5484,5424,4150,1131,1003,119,152,2755,2803,489,3830,968,0,,305
15:31:01,8069.948,Fox,5560,272,104,58,74,39,19,6,5588,5484,5426,4151,1131,1003,121,151,2757,2803,489,3831,968,0,,306
15:31:01,8070.416,Fox,5560,272,106,58,74,37,21,6,5590,5484,5426,4151,1133,1003,121,151,2757,2803,489,3831,968,0,,306
15:31:01,8070.637,Fox,5560,271,106,56,76,36,21,6,5590,5484,5428,4151,1133,1003,121,150,2757,2803,489,3832,968,0,,305
15:31:01,8072.171,Fox,5562,270,102,62,75,34,21,6,5592,5490,5428,4151,1133,1003,118,152,2757,2805,489,3835,968,0,,304
15:31:02,8073.273,Fox,5562,270,98,66,75,34,21,6,5592,5494,5428,4151,1133,1003,118,152,2757,2805,489,3835,968,0,,304
15:31:02,8073.509,Fox,5562,270,98,64,77,34,21,6,5592,5494,5430,4151,1133,1003,118,152,2757,2805,489,3835,968,0,,304
15:31:02,8074.538,Fox,5564,271,100,64,76,34,21,6,5594,5494,5430,4151,1133,1003,118,153,2758,2806,489,3836,968,0,,305
15:31:02,8074.992,Fox,5564,266,96,64,78,32,21,5,5594,5498,5434,4153,1133,1003,118,148,2758,2806,489,3840,969,0,,300
15:31:02,8075.229,Fox,5564,266,96,64,77,33,21,5,5594,5498,5434,4154,1133,1003,118,148,2758,2806,489,3840,969,0,,300
15:31:03,8075.879,Fox,5566,267,98,64,75,34,21,5,5596,5498,5434,4155,1133,1003,117,150,2758,2808,489,3841,969,0,,301
15:31:03,8076.321,Fox,5566,267,98,62,75,35,22,5,5596,5498,5436,4157,1134,1003,117,150,2758,2808,489,3841,969,0,,301
15:31:03,8076.54,Fox,5566,266,98,62,75,34,22,5,5596,5498,5436,4157,1134,1003,117,149,2758,2808,489,3842,969,0,,300
15:31:03,8077.235,Fox,5566,266,98,60,76,35,22,5,5596,5498,5438,4158,1134,1003,117,149,2758,2808,489,3842,969,0,,300
15:31:03,8077.441,Fox,5566,266,98,60,74,37,22,5,5596,5498,5438,4160,1134,1003,117,149,2758,2808,489,3842,969,0,,300
15:31:04,8079.049,Fox,5568,268,96,60,76,37,22,5,5596,5500,5440,4160,1134,1003,118,150,2759,2809,489,3842,969,0,,302
15:31:04,8079.473,Fox,5570,268,98,62,74,37,22,5,5600,5502,5440,4161,1134,1003,119,149,2761,2809,489,3844,969,0,,302
15:31:04,8079.93,Fox,5570,268,94,66,74,37,22,5,5600,5506,5440,4161,1134,1003,119,149,2761,2809,489,3844,969,0,,302
15:31:04,8081.021,Fox,5572,270,94,66,72,39,22,5,5600,5506,5440,4163,1134,1003,121,149,2763,2809,489,3844,969,0,,304
15:31:04,8081.489,Fox,5572,268,96,66,70,39,21,6,5602,5506,5440,4165,1134,1004,120,148,2763,2809,489,3846,969,0,,302
15:31:05,8081.956,Fox,5572,266,96,64,72,37,21,6,5602,5506,5442,4165,1134,1004,118,148,2763,2809,489,3848,969,0,,300
15:31:05,8082.43,Fox,5574,268,96,66,72,37,21,6,5604,5508,5442,4165,1134,1004,119,149,2764,2810,489,3848,969,0,,302
15:31:05,8083.121,Fox,5574,266,96,64,74,35,21,6,5604,5508,5444,4165,1134,1004,117,149,2764,2810,489,3850,969,0,,300
15:31:05,8083.54,Fox,5574,264,96,64,74,33,21,6,5604,5508,5444,4165,1134,1004,117,147,2764,2810,489,3852,969,0,,298
15:31:05,8083.969,Fox,5574,264,94,66,74,33,21,6,5604,5510,5444,4165,1134,1004,117,147,2764,2810,489,3852,969,0,,298
15:31:05,8084.395,Fox,5574,264,94,66,74,33,20,7,5604,5510,5444,4165,1134,1005,117,147,2764,2810,489,3852,969,0,,298
15:31:06,8085.247,Fox,5574,264,94,66,72,35,20,7,5604,5510,5444,4167,1134,1005,117,147,2764,2810,489,3852,969,0,,298
15:31:06,8086.135,Fox,5576,265,96,66,71,35,20,7,5606,5510,5444,4167,1134,1005,117,148,2765,2811,489,3853,969,0,,299
15:31:06,8086.349,Fox,5576,264,96,66,71,34,20,7,5606,5510,5444,4167,1134,1005,117,147,2765,2811,489,3854,969,0,,298
15:31:07,8087.646,Fox,5578,265,98,64,72,34,20,7,5608,5510,5446,4167,1134,1005,117,148,2766,2812,489,3855,969,0,,299
15:31:07,8088.103,Fox,5578,265,98,60,76,34,20,7,5608,5510,5450,4167,1134,1005,117,148,2766,2812,489,3855,969,0,,299
15:31:07,8088.852,Fox,5578,265,98,58,77,35,20,7,5608,5510,5452,4168,1134,1005,117,148,2766,2812,489,3855,969,0,,299
15:31:07,8089.261,Fox,5578,264,98,58,77,35,20,6,5608,5510,5452,4168,1134,1005,116,148,2766,2812,489,3855,970,0,,298
15:31:07,8090.115,Fox,5578,264,96,58,79,35,20,6,5608,5512,5454,4168,1134,1005,116,148,2766,2812,489,3855,970,0,,298
15:31:08,8090.731,Fox,5578,264,92,60,81,35,20,6,5608,5516,5456,4168,1134,1005,116,148,2766,2812,489,3855,970,0,,298
15:31:08,8091.399,Fox,5578,261,90,62,81,32,19,7,5608,5518,5456,4168,1134,1006,116,145,2766,2812,489,3858,970,0,,295
15:31:08,8091.847,Fox,5578,260,90,60,83,31,19,7,5608,5518,5458,4168,1134,1006,115,145,2766,2812,489,3859,970,0,,294
15:31:08,8092.054,Fox,5578,258,90,60,81,31,19,7,5608,5518,5458,4170,1134,1006,115,143,2766,2812,489,3861,970,0,,292
15:31:08,8092.94,Fox,5578,257,86,58,87,30,19,7,5608,5522,5464,4170,1134,1006,115,142,2766,2812,489,3862,970,0,,291
15:31:09,8093.443,Fox,5578,257,84,60,87,30,19,7,5608,5524,5464,4170,1134,1006,115,142,2766,2812,489,3862,970,0,,291
15:31:09,8094.082,Fox,5578,257,84,60,85,32,19,7,5608,5524,5464,4172,1134,1006,115,142,2766,2812,489,3862,970,0,,291
15:31:09,8094.741,Fox,5580,258,86,60,84,32,19,7,5610,5524,5464,4172,1134,1006,115,143,2767,2813,489,3863,970,0,,292
15:31:09,8095.615,Fox,5580,257,84,58,88,31,19,7,5610,5526,5468,4172,1134,1006,115,142,2767,2813,489,3864,970,0,,291
15:31:09,8096.01,Fox,5582,258,84,58,83,35,19,7,5610,5526,5468,4176,1134,1006,115,143,2768,2814,489,3865,970,0,,292
15:31:10,8096.456,Fox,5582,258,86,58,82,36,19,7,5612,5526,5468,4177,1134,1006,115,143,2768,2814,489,3865,970,0,,292
15:31:10,8097.082,Fox,5582,256,84,60,82,34,19,7,5612,5528,5468,4177,1134,1006,115,141,2768,2814,489,3867,970,0,,290
15:31:10,8097.526,Fox,5584,256,82,62,84,32,19,7,5614,5532,5470,4177,1134,1006,115,141,2768,2816,489,3869,970,0,,290
15:31:10,8097.934,Fox,5584,256,80,60,88,32,19,7,5614,5534,5474,4177,1134,1006,115,141,2768,2816,489,3869,970,0,,290
15:31:10,8098.161,Fox,5584,256,78,62,88,32,19,7,5614,5536,5474,4177,1134,1006,115,141,2768,2816,489,3869,970,0,,290
15:31:10,8098.751,Fox,5588,259,80,62,87,32,19,7,5616,5536,5474,4177,1134,1006,116,143,2770,2818,489,3870,970,0,,293
15:31:10,8099.151,Fox,5590,260,82,62,86,31,20,7,5618,5536,5474,4177,1135,1006,117,143,2772,2818,489,3871,970,0,,294
15:31:11,8099.517,Fox,5592,261,84,62,83,33,19,8,5620,5536,5474,4179,1135,1007,118,143,2774,2818,489,3872,970,0,,295
15:31:11,8099.971,Fox,5592,261,86,62,81,35,19,8,5622,5536,5474,4181,1135,1007,118,143,2774,2818,489,3872,970,0,,295
15:31:11,8100.383,Fox,5592,261,84,64,81,35,17,10,5622,5538,5474,4181,1135,1009,118,143,2774,2818,489,3872,970,0,,295
15:31:11,8100.974,Fox,5592,260,84,62,82,35,17,10,5622,5538,5476,4182,1135,1009,117,143,2774,2818,489,3873,970,0,,294
15:31:11,8101.414,Fox,5592,260,84,60,84,35,17,10,5622,5538,5478,4182,1135,1009,117,143,2774,2818,489,3873,970,0,,294
15:31:11,8101.836,Fox,5592,260,82,62,84,35,17,10,5622,5540,5478,4182,1135,1009,117,143,2774,2818,489,3873,970,0,,294
15:31:12,8102.816,Fox,5592,260,78,66,84,35,17,10,5622,5544,5478,4182,1135,1009,117,143,2774,2818,489,3873,970,0,,294
15:31:12,8103.882,Fox,5594,261,78,66,81,37,17,10,5622,5544,5478,4184,1135,1009,116,145,2774,2820,489,3874,970,0,,295
15:31:12,8104.086,Fox,5594,261,80,66,79,39,17,10,5624,5544,5478,4186,1135,1009,116,145,2774,2820,489,3874,970,0,,295
15:31:12,8104.71,Fox,5594,259,80,66,79,38,17,9,5624,5544,5478,4186,1135,1009,116,143,2774,2820,489,3875,971,0,,293
15:31:12,8104.937,Fox,5594,259,80,64,81,38,17,9,5624,5544,5480,4186,1135,1009,116,143,2774,2820,489,3875,971,0,,293
15:31:13,8105.323,Fox,5594,259,80,62,83,38,17,9,5624,5544,5482,4186,1135,1009,116,143,2774,2820,489,3875,971,0,,293
15:31:13,8105.946,Fox,5598,261,80,60,83,38,17,9,5624,5544,5484,4186,1135,1009,115,146,2775,2823,489,3877,971,0,,295
15:31:13,8106.204,Fox,5598,261,84,60,83,38,17,9,5628,5544,5484,4186,1135,1009,115,146,2775,2823,489,3877,971,0,,295
15:31:13,8107.027,Fox,5598,260,84,60,81,40,17,8,5628,5544,5484,4188,1135,1009,114,146,2775,2823,489,3877,972,0,,294
15:31:13,8107.464,Fox,5600,261,86,60,80,40,17,8,5630,5544,5484,4188,1135,1009,113,148,2775,2825,489,3878,972,0,,295
15:31:13,8107.67,Fox,5600,260,86,60,79,40,17,8,5630,5544,5484,4189,1135,1009,113,147,2775,2825,489,3879,972,0,,294
15:31:14,8108.525,Fox,5600,260,86,60,77,42,17,8,5630,5544,5484,4191,1135,1009,113,147,2775,2825,489,3879,972,0,,294
15:31:14,8109.359,Fox,5600,260,86,60,77,41,18,8,5630,5544,5484,4191,1136,1009,113,147,2775,2825,489,3879,972,0,,294
15:31:14,8110.384,Fox,5600,260,86,58,75,45,18,8,5630,5544,5486,4195,1136,1009,113,147,2775,2825,489,3879,972,0,,294
15:31:14,8110.583,Fox,5600,260,84,56,79,45,18,8,5630,5546,5490,4195,1136,1009,113,147,2775,2825,489,3879,972,0,,294
15:31:15,8111.569,Fox,5602,257,84,54,80,41,18,8,5630,5546,5492,4195,1136,1009,113,144,2776,2826,489,3884,972,0,,291
15:31:15,8111.969,Fox,5602,256,86,52,82,40,18,8,5632,5546,5494,4195,1136,1009,113,143,2776,2826,489,3885,972,0,,290
15:31:15,8112.202,Fox,5602,256,84,54,82,40,18,8,5632,5548,5494,4195,1136,1009,113,143,2776,2826,489,3885,972,0,,290
15:31:15,8112.604,Fox,5602,256,82,56,82,40,18,8,5632,5550,5494,4195,1136,1009,113,143,2776,2826,489,3885,972,0,,290
15:31:15,8113.229,Fox,5602,256,82,52,86,40,17,9,5632,5550,5498,4195,1136,1010,113,143,2776,2826,489,3885,972,0,,290
15:31:16,8114.847,Fox,5602,256,76,58,82,44,17,9,5632,5556,5498,4199,1136,1010,113,143,2776,2826,489,3885,972,0,,290
15:31:16,8115.436,Fox,5602,252,76,58,82,40,17,9,5632,5556,5498,4199,1136,1010,111,141,2776,2826,489,3889,972,0,,286
15:31:16,8116.071,Fox,5604,253,78,58,82,39,17,9,5634,5556,5498,4199,1136,1010,111,142,2777,2827,489,3890,972,0,,287
15:31:16,8116.509,Fox,5608,254,78,58,80,36,19,9,5634,5556,5498,4199,1138,1010,111,143,2779,2829,489,3893,972,0,,288
15:31:16,8116.97,Fox,5608,254,80,60,77,39,19,9,5638,5558,5498,4202,1138,1010,111,143,2779,2829,489,3893,972,0,,288
15:31:17,8117.376,Fox,5608,253,80,58,76,42,19,8,5638,5558,5500,4205,1138,1010,111,142,2779,2829,489,3893,973,0,,287
15:31:17,8118.219,Fox,5608,253,80,52,82,42,19,8,5638,5558,5506,4205,1138,1010,111,142,2779,2829,489,3893,973,0,,287
15:31:17,8118.418,Fox,5608,253,80,52,80,44,19,8,5638,5558,5506,4207,1138,1010,111,142,2779,2829,489,3893,973,0,,287
15:31:17,8119.245,Fox,5610,252,82,52,80,41,19,8,5640,5558,5506,4207,1138,1010,112,140,2781,2829,489,3896,973,0,,286
15:31:17,8119.886,Fox,5612,252,82,54,78,42,19,7,5642,5560,5506,4208,1138,1010,110,142,2781,2831,489,3897,974,0,,286
15:31:18,8120.707,Fox,5612,252,80,54,79,43,19,7,5642,5562,5508,4209,1138,1010,110,142,2781,2831,489,3897,974,0,,286
15:31:18,8121.896,Fox,5612,252,78,56,78,44,19,7,5642,5564,5508,4210,1138,1010,110,142,2781,2831,489,3897,974,0,,286
15:31:18,8122.297,Fox,5612,249,78,56,76,44,19,6,5642,5564,5508,4212,1138,1010,109,140,2781,2831,489,3899,975,0,,283
15:31:18,8122.533,Fox,5612,249,78,54,78,44,18,7,5642,5564,5510,4212,1138,1011,109,140,2781,2831,489,3899,975,0,,283
15:31:18,8123.163,Fox,5612,248,76,56,78,43,17,8,5642,5566,5510,4212,1138,1012,109,139,2781,2831,489,3900,975,0,,282
15:31:19,8123.987,Fox,5612,246,76,56,78,41,17,8,5642,5566,5510,4212,1138,1012,108,138,2781,2831,489,3902,975,0,,280
15:31:19,8124.412,Fox,5612,246,76,56,76,43,17,8,5642,5566,5510,4214,1138,1012,108,138,2781,2831,489,3902,975,0,,280
15:31:19,8125.554,Fox,5612,244,76,56,75,42,17,8,5642,5566,5510,4215,1138,1012,108,136,2781,2831,489,3904,975,0,,278
15:31:20,8126.357,Fox,5612,244,76,56,74,43,17,8,5642,5566,5510,4216,1138,1012,108,136,2781,2831,489,3904,975,0,,278
15:31:20,8127.17,Fox,5616,246,78,56,72,43,17,8,5644,5566,5510,4216,1138,1012,109,137,2784,2832,489,3906,975,0,,280
15:31:20,8127.606,Fox,5616,246,80,56,72,43,16,9,5646,5566,5510,4216,1138,1013,109,137,2784,2832,489,3906,975,0,,280
15:31:20,8128.208,Fox,5616,246,80,54,72,45,16,9,5646,5566,5512,4218,1138,1013,109,137,2784,2832,489,3906,975,0,,280
15:31:20,8128.952,Fox,5616,246,80,52,73,46,16,9,5646,5566,5514,4219,1138,1013,109,137,2784,2832,489,3906,975,0,,280
15:31:21,8129.369,Fox,5616,246,80,50,75,46,16,9,5646,5566,5516,4219,1138,1013,109,137,2784,2832,489,3906,975,0,,280
15:31:21,8129.938,Fox,5616,245,80,48,77,45,16,9,5646,5566,5518,4219,1138,1013,109,136,2784,2832,489,3907,975,0,,279
15:31:21,8130.047,Fox,5616,245,80,48,76,46,16,9,5646,5566,5518,4220,1138,1013,109,136,2784,2832,489,3907,975,0,,279
15:31:21,8130.579,Fox,5616,241,80,48,76,43,16,8,5646,5566,5518,4220,1138,1013,109,132,2784,2832,489,3910,976,0,,275
15:31:21,8131.172,Fox,5616,241,80,44,78,45,15,9,5646,5566,5522,4222,1138,1014,109,132,2784,2832,489,3910,976,0,,275
15:31:21,8131.946,Fox,5616,241,78,44,80,45,15,9,5646,5568,5524,4222,1138,1014,109,132,2784,2832,489,3910,976,0,,275
15:31:21,8132.128,Fox,5616,239,78,44,80,43,15,9,5646,5568,5524,4222,1138,1014,109,130,2784,2832,489,3912,976,0,,273
15:31:22,8132.536,Fox,5616,238,78,44,80,42,15,9,5646,5568,5524,4222,1138,1014,109,129,2784,2832,489,3913,976,0,,272
15:31:22,8133.138,Fox,5616,235,78,44,80,39,15,9,5646,5568,5524,4222,1138,1014,107,128,2784,2832,489,3916,976,0,,269
15:31:22,8134.116,Fox,5616,235,78,42,80,41,15,9,5646,5568,5526,4224,1138,1014,107,128,2784,2832,489,3916,976,0,,269
15:31:22,8134.328,Fox,5616,233,78,42,80,39,15,9,5646,5568,5526,4224,1138,1014,107,126,2784,2832,489,3918,976,0,,267
15:31:22,8135.094,Fox,5618,234,76,44,80,38,15,9,5646,5570,5526,4224,1138,1014,108,126,2786,2832,489,3919,976,0,,268
15:31:23,8135.504,Fox,5618,234,78,42,79,41,15,9,5648,5570,5528,4227,1138,1014,108,126,2786,2832,489,3919,976,0,,268
15:31:23,8135.992,Fox,5618,233,78,38,83,40,15,9,5648,5570,5532,4227,1138,1014,108,125,2786,2832,489,3920,976,0,,267
15:31:23,8136.553,Fox,5620,234,78,34,87,39,15,9,5648,5570,5536,4227,1138,1014,108,126,2787,2833,489,3921,976,0,,268
15:31:23,8136.752,Fox,5620,233,80,34,85,40,15,9,5650,5570,5536,4229,1138,1014,108,125,2787,2833,489,3922,976,0,,267
15:31:23,8137.309,Fox,5624,235,82,36,83,40,15,9,5654,5572,5536,4229,1138,1014,106,129,2787,2837,489,3924,976,0,,269
15:31:23,8137.727,Fox,5626,235,84,36,81,40,15,9,5656,5572,5536,4230,1138,1014,106,129,2788,2838,489,3926,976,0,,269
15:31:24,8138.109,Fox,5626,234,82,38,81,39,15,9,5656,5574,5536,4230,1138,1014,106,128,2788,2838,489,3927,976,0,,268
15:31:24,8138.26,Fox,5626,234,80,40,81,39,15,9,5656,5576,5536,4230,1138,1014,106,128,2788,2838,489,3927,976,0,,268
15:31:24,8138.634,Fox,5626,234,78,42,81,39,15,9,5656,5578,5536,4230,1138,1014,106,128,2788,2838,489,3927,976,0,,268
15:31:24,8139.235,Fox,5626,234,78,40,81,41,15,9,5656,5578,5538,4232,1138,1014,106,128,2788,2838,489,3927,976,0,,268
15:31:24,8139.419,Fox,5626,234,76,42,81,41,15,9,5656,5580,5538,4232,1138,1014,106,128,2788,2838,489,3927,976,0,,268
15:31:24,8140.332,Fox,5628,233,76,40,82,39,15,9,5656,5580,5540,4232,1138,1014,103,130,2788,2840,489,3930,976,0,,267
15:31:24,8140.561,Fox,5628,233,78,40,82,39,15,9,5658,5580,5540,4232,1138,1014,103,130,2788,2840,489,3930,976,0,,267
15:31:25,8141.544,Fox,5630,234,78,36,85,39,15,9,5658,5580,5544,4232,1138,1014,102,132,2788,2842,489,3931,976,0,,268
15:31:25,8141.773,Fox,5630,233,80,36,85,39,15,8,5660,5580,5544,4232,1138,1014,102,131,2788,2842,489,3931,977,0,,267
15:31:25,8142.393,Fox,5632,233,82,36,83,39,15,8,5662,5580,5544,4233,1138,1014,101,132,2788,2844,489,3933,977,0,,267
15:31:25,8142.984,Fox,5634,234,82,36,82,38,16,8,5662,5580,5544,4233,1139,1014,101,133,2789,2845,489,3934,977,0,,268
15:31:25,8143.376,Fox,5634,233,80,40,80,40,16,7,5664,5584,5544,4235,1139,1014,100,133,2789,2845,489,3934,978,0,,267
15:31:26,8143.958,Fox,5634,231,80,40,80,38,16,7,5664,5584,5544,4235,1139,1014,100,131,2789,2845,489,3936,978,0,,265
15:31:26,8144.538,Fox,5634,230,80,40,80,37,16,7,5664,5584,5544,4235,1139,1014,100,130,2789,2845,489,3937,978,0,,264
15:31:26,8145.117,Fox,5634,230,80,40,80,37,14,9,5664,5584,5544,4235,1139,1016,100,130,2789,2845,489,3937,978,0,,264
15:31:26,8146.137,Fox,5638,232,84,40,78,37,14,9,5668,5584,5544,4235,1139,1016,100,132,2791,2847,489,3939,978,0,,266
15:31:27,8147.101,Fox,5638,230,84,40,78,35,14,9,5668,5584,5544,4235,1139,1016,98,132,2791,2847,489,3941,978,0,,264
15:31:27,8148.042,Fox,5638,229,84,40,76,35,16,8,5668,5584,5544,4237,1141,1016,98,131,2791,2847,489,3941,979,0,,263
15:31:27,8148.629,Fox,5640,230,86,40,72,38,16,8,5670,5584,5544,4240,1141,1016,98,132,2792,2848,489,3942,979,0,,264
15:31:27,8149.029,Fox,5640,229,86,38,74,38,16,7,5670,5584,5546,4240,1141,1016,98,131,2792,2848,489,3942,980,0,,263
15:31:27,8149.612,Fox,5640,227,82,42,74,36,16,7,5670,5588,5546,4240,1141,1016,98,129,2792,2848,489,3944,980,0,,261
15:31:28,8150.535,Fox,5640,227,82,40,75,37,16,7,5670,5588,5548,4241,1141,1016,98,129,2792,2848,489,3944,980,0,,261
15:31:28,8151.071,Fox,5640,224,82,38,75,36,16,7,5670,5588,5550,4243,1141,1016,95,129,2792,2848,489,3947,980,0,,258
15:31:28,8152.153,Fox,5640,222,82,38,73,36,16,7,5670,5588,5550,4245,1141,1016,95,127,2792,2848,489,3949,980,0,,256
15:31:28,8152.71,Fox,5640,222,80,40,73,36,16,7,5670,5590,5550,4245,1141,1016,95,127,2792,2848,489,3949,980,0,,256
15:31:29,8153.242,Fox,5642,223,80,34,75,39,16,7,5670,5590,5556,4249,1141,1016,96,127,2793,2849,489,3950,980,0,,257
15:31:29,8153.431,Fox,5642,223,82,34,73,41,16,7,5672,5590,5556,4251,1141,1016,96,127,2793,2849,489,3950,980,0,,257
15:31:29,8154.371,Fox,5644,224,84,34,72,41,16,7,5674,5590,5556,4251,1141,1016,96,128,2794,2850,489,3951,980,0,,258
15:31:29,8154.73,Fox,5644,222,82,36,72,39,16,7,5674,5592,5556,4251,1141,1016,96,126,2794,2850,489,3953,980,0,,256
15:31:29,8155.057,Fox,5644,222,82,34,74,39,16,7,5674,5592,5558,4251,1141,1016,96,126,2794,2850,489,3953,980,0,,256
15:31:30,8155.949,Fox,5644,222,82,34,71,42,16,7,5674,5592,5558,4254,1141,1016,96,126,2794,2850,489,3953,980,0,,256
15:31:30,8156.523,Fox,5646,224,84,34,71,42,16,7,5676,5592,5558,4254,1141,1016,97,127,2795,2851,489,3953,980,0,,258
15:31:30,8157.108,Fox,5646,224,82,36,71,42,16,7,5676,5594,5558,4254,1141,1016,97,127,2795,2851,489,3953,980,0,,258
15:31:30,8157.834,Fox,5646,223,82,36,69,43,16,7,5676,5594,5558,4256,1141,1016,97,126,2795,2851,489,3954,980,0,,257
15:31:30,8158.413,Fox,5646,223,80,36,69,45,16,7,5676,5596,5560,4258,1141,1016,97,126,2795,2851,489,3954,980,0,,257
15:31:30,8158.803,Fox,5646,222,80,36,69,44,16,7,5676,5596,5560,4258,1141,1016,96,126,2795,2851,489,3955,980,0,,256
15:31:31,8159.391,Fox,5650,224,82,34,69,44,16,7,5678,5596,5562,4258,1141,1016,97,127,2798,2852,489,3957,980,0,,258
15:31:31,8159.594,Fox,5650,224,84,34,69,44,16,7,5680,5596,5562,4258,1141,1016,97,127,2798,2852,489,3957,980,0,,258
15:31:31,8160.347,Fox,5650,224,84,32,71,44,15,8,5680,5596,5564,4258,1141,1017,97,127,2798,2852,489,3957,980,0,,258
15:31:31,8161.259,Fox,5650,224,84,32,69,46,15,8,5680,5596,5564,4260,1141,1017,97,127,2798,2852,489,3957,980,0,,258
15:31:31,8161.821,Fox,5650,224,82,32,70,47,15,8,5680,5598,5566,4261,1141,1017,97,127,2798,2852,489,3957,980,0,,258
15:31:32,8161.998,Fox,5650,224,80,34,70,47,15,8,5680,5600,5566,4261,1141,1017,97,127,2798,2852,489,3957,980,0,,258
15:31:32,8162.731,Fox,5650,222,80,34,70,45,15,8,5680,5600,5566,4261,1141,1017,97,125,2798,2852,489,3959,980,0,,256
15:31:32,8163.494,Fox,5652,223,82,34,70,44,15,8,5682,5600,5566,4261,1141,1017,98,125,2800,2852,489,3960,980,0,,257
15:31:32,8163.874,Fox,5652,220,80,36,70,41,15,8,5682,5602,5566,4261,1141,1017,96,124,2800,2852,489,3963,980,0,,254
15:31:33,8164.981,Fox,5654,220,78,38,69,41,14,8,5682,5604,5566,4261,1141,1017,95,125,2801,2853,489,3965,980,0,,254
15:31:33,8165.349,Fox,5654,220,80,38,68,42,14,8,5684,5604,5566,4262,1141,1017,95,125,2801,2853,489,3965,980,0,,254
15:31:33,8166.117,Fox,5654,219,80,38,66,43,14,8,5684,5604,5566,4264,1141,1017,95,124,2801,2853,489,3966,980,0,,253
15:31:33,8166.465,Fox,5654,216,80,38,66,40,14,8,5684,5604,5566,4264,1141,1017,95,121,2801,2853,489,3969,980,0,,250
15:31:33,8167.19,Fox,5656,218,82,38,66,40,14,8,5686,5604,5566,4264,1141,1017,96,122,2802,2854,489,3969,980,0,,252
15:31:33,8167.929,Fox,5656,212,82,38,66,34,14,8,5686,5604,5566,4264,1141,1017,95,117,2802,2854,489,3975,980,0,,246
15:31:34,8168.321,Fox,5660,214,84,38,64,34,14,8,5688,5604,5566,4264,1141,1017,95,119,2804,2856,489,3977,980,0,,248
15:31:34,8168.719,Fox,5664,216,88,40,62,34,14,8,5694,5606,5566,4264,1141,1017,94,122,2805,2859,489,3979,980,0,,250
15:31:34,8169.307,Fox,5668,219,92,40,61,34,14,8,5698,5606,5566,4264,1141,1017,96,123,2808,2860,489,3980,980,0,,253
15:31:34,8170.469,Fox,5668,216,90,40,63,31,14,8,5698,5608,5568,4264,1141,1017,95,121,2808,2860,489,3983,980,0,,250
15:31:35,8171.084,Fox,5668,216,90,40,58,34,16,8,5698,5608,5568,4269,1143,1017,95,121,2808,2860,489,3983,980,0,,250
15:31:35,8172.21,Fox,5668,216,90,40,54,38,16,8,5698,5608,5568,4273,1143,1017,95,121,2808,2860,489,3983,980,0,,250
15:31:35,8172.56,Fox,5670,215,90,40,53,36,16,8,5698,5608,5568,4273,1143,1017,92,123,2808,2862,489,3986,980,0,,249
15:31:35,8172.75,Fox,5670,215,92,40,53,36,16,8,5700,5608,5568,4273,1143,1017,92,123,2808,2862,489,3986,980,0,,249
15:31:35,8173.318,Fox,5672,216,94,40,53,35,16,8,5702,5608,5568,4273,1143,1017,93,123,2809,2863,489,3987,980,0,,250
15:31:35,8173.718,Fox,5672,216,94,38,51,39,16,8,5702,5608,5570,4277,1143,1017,93,123,2809,2863,489,3987,980,0,,250
15:31:36,8174.479,Fox,5674,217,96,38,50,39,16,8,5704,5608,5570,4277,1143,1017,93,124,2810,2864,489,3988,980,0,,251
15:31:36,8175.055,Fox,5676,219,98,38,50,39,16,8,5706,5608,5570,4277,1143,1017,94,125,2811,2865,489,3988,980,0,,253
15:31:36,8175.458,Fox,5678,220,100,38,49,39,16,8,5708,5608,5570,4277,1143,1017,93,127,2811,2867,489,3989,980,0,,254
15:31:36,8175.632,Fox,5678,220,100,36,51,39,16,8,5708,5608,5572,4277,1143,1017,93,127,2811,2867,489,3989,980,0,,254
15:31:36,8176.196,Fox,5680,219,100,36,50,37,16,8,5708,5608,5572,4277,1143,1017,92,127,2811,2869,489,3992,980,0,,253
15:31:36,8176.617,Fox,5680,218,102,34,52,36,16,8,5710,5608,5574,4277,1143,1017,92,126,2811,2869,489,3993,980,0,,252
15:31:36,8176.801,Fox,5680,218,102,32,54,36,16,8,5710,5608,5576,4277,1143,1017,92,126,2811,2869,489,3993,980,0,,252
15:31:37,8177.359,Fox,5680,218,100,32,56,36,16,8,5710,5610,5578,4277,1143,1017,92,126,2811,2869,489,3993,980,0,,252
15:31:37,8178.125,Fox,5680,218,100,30,57,37,15,9,5710,5610,5580,4278,1143,1018,92,126,2811,2869,489,3993,980,0,,252
15:31:37,8178.62,Fox,5680,218,100,30,55,38,16,9,5710,5610,5580,4280,1144,1018,92,126,2811,2869,489,3993,980,0,,252
15:31:37,8178.984,Fox,5684,220,98,32,50,41,16,9,5710,5612,5580,4283,1144,1018,92,128,2813,2871,489,3995,980,0,,254
15:31:37,8179.221,Fox,5684,220,102,32,50,41,16,9,5714,5612,5580,4283,1144,1018,92,128,2813,2871,489,3995,980,0,,254
15:31:37,8179.462,Fox,5684,220,102,32,50,41,15,10,5714,5612,5580,4283,1144,1019,92,128,2813,2871,489,3995,980,0,,254
15:31:38,8180.268,Fox,5684,219,100,34,50,40,15,10,5714,5614,5580,4283,1144,1019,92,127,2813,2871,489,3996,980,0,,253
15:31:38,8181.063,Fox,5684,217,100,34,50,38,15,10,5714,5614,5580,4283,1144,1019,92,125,2813,2871,489,3998,980,0,,251
15:31:38,8181.469,Fox,5684,217,96,38,49,39,15,10,5714,5618,5580,4284,1144,1019,92,125,2813,2871,489,3998,980,0,,251
15:31:38,8181.835,Fox,5684,217,94,38,51,39,15,10,5714,5620,5582,4284,1144,1019,92,125,2813,2871,489,3998,980,0,,251
15:31:38,8182.286,Fox,5684,217,92,38,53,39,15,10,5714,5622,5584,4284,1144,1019,92,125,2813,2871,489,3998,980,0,,251
15:31:38,8182.656,Fox,5686,218,94,38,53,38,15,10,5716,5622,5584,4284,1144,1019,92,126,2814,2872,489,3999,980,0,,252
15:31:40,8185.571,Fox,5686,215,94,38,53,35,15,10,5716,5622,5584,4284,1145,1020,91,124,2814,2872,489,4001,981,0,,249
15:31:40,8185.772,Fox,5686,212,94,38,53,32,15,10,5716,5622,5584,4284,1145,1020,91,121,2814,2872,489,4004,981,0,,246
15:31:40,8186.655,Fox,5686,210,92,40,53,30,15,10,5716,5624,5584,4284,1145,1020,90,120,2814,2872,489,4006,981,0,,244
15:31:40,8186.845,Fox,5686,209,92,40,53,29,15,10,5716,5624,5584,4284,1145,1020,89,120,2814,2872,489,4007,981,0,,243
15:31:40,8187.468,Fox,5686,209,92,40,53,27,17,10,5716,5624,5584,4284,1147,1020,89,120,2814,2872,489,4007,981,0,,243
15:31:40,8188.23,Fox,5686,205,92,36,57,23,17,10,5716,5624,5588,4284,1147,1020,89,116,2814,2872,489,4011,981,0,,239
15:31:41,8188.743,Fox,5686,205,88,40,55,25,17,10,5716,5628,5588,4286,1147,1020,89,116,2814,2872,489,4011,981,0,,239
15:31:41,8189.936,Fox,5686,205,86,42,54,26,17,10,5716,5630,5588,4287,1147,1020,89,116,2814,2872,489,4011,981,0,,239
15:31:41,8190.293,Fox,5686,205,86,42,52,28,17,10,5716,5630,5588,4289,1147,1020,89,116,2814,2872,489,4011,981,0,,239
15:31:41,8191.127,Fox,5688,206,88,40,53,28,17,10,5718,5630,5590,4289,1147,1020,90,116,2816,2872,489,4012,981,0,,240
15:31:42,8191.653,Fox,5688,206,88,40,51,30,17,10,5718,5630,5590,4291,1147,1020,90,116,2816,2872,489,4012,981,0,,240
15:31:42,8192.187,Fox,5688,205,88,40,50,30,17,10,5718,5630,5590,4292,1147,1020,90,115,2816,2872,489,4013,981,0,,239
15:31:42,8192.873,Fox,5688,203,88,40,50,28,17,10,5718,5630,5590,4292,1147,1020,90,113,2816,2872,489,4015,981,0,,237
15:31:42,8193.2,Fox,5688,200,88,38,52,25,17,10,5718,5630,5592,4292,1147,1020,90,110,2816,2872,489,4018,981,0,,234
15:31:43,8194.636,Fox,5688,200,86,40,51,26,17,10,5718,5632,5592,4293,1147,1020,90,110,2816,2872,489,4018,981,0,,234
15:31:43,8195.645,Fox,5690,200,88,38,52,25,17,10,5720,5632,5594,4293,1147,1020,90,110,2817,2873,489,4020,981,0,,234
15:31:43,8196.197,Fox,5690,200,88,38,48,29,17,10,5720,5632,5594,4297,1147,1020,90,110,2817,2873,489,4020,981,0,,234
15:31:43,8196.698,Fox,5690,200,88,38,44,33,16,11,5720,5632,5594,4301,1147,1021,90,110,2817,2873,489,4020,981,0,,234
15:31:43,8197.08,Fox,5690,200,88,36,45,34,16,11,5720,5632,5596,4302,1147,1021,90,110,2817,2873,489,4020,981,0,,234
15:31:44,8197.815,Fox,5692,201,90,36,44,32,18,11,5722,5632,5596,4302,1149,1021,90,111,2818,2874,489,4021,981,0,,235
15:31:44,8198.57,Fox,5692,201,88,38,44,32,18,11,5722,5634,5596,4302,1149,1021,90,111,2818,2874,489,4021,981,0,,235
15:31:44,8199.4,Fox,5692,201,84,42,42,34,18,11,5722,5638,5596,4304,1149,1021,90,111,2818,2874,489,4021,981,0,,235
15:31:44,8200.28,Fox,5694,202,86,40,43,34,18,11,5724,5638,5598,4304,1149,1021,90,112,2819,2875,489,4022,981,0,,236
15:31:45,8200.648,Fox,5694,201,86,38,45,34,17,11,5724,5638,5600,4304,1149,1022,90,111,2819,2875,489,4022,982,0,,235
15:31:45,8200.823,Fox,5694,201,86,38,43,36,17,11,5724,5638,5600,4306,1149,1022,90,111,2819,2875,489,4022,982,0,,235
15:31:45,8201.842,Fox,5694,201,84,40,41,38,17,11,5724,5640,5600,4308,1149,1022,90,111,2819,2875,489,4022,982,0,,235
15:31:45,8202.518,Fox,5694,199,82,40,43,36,17,11,5724,5642,5602,4308,1149,1022,90,109,2819,2875,489,4024,982,0,,233
15:31:46,8203.511,Fox,5696,199,84,38,45,34,17,11,5726,5642,5604,4308,1149,1022,89,110,2820,2876,489,4026,982,0,,233
15:31:46,8204.249,Fox,5698,199,84,38,45,32,17,11,5726,5642,5604,4308,1149,1022,90,109,2821,2877,489,4028,982,0,,233
15:31:46,8204.438,Fox,5698,199,86,38,45,32,17,11,5728,5642,5604,4308,1149,1022,90,109,2821,2877,489,4028,982,0,,233
15:31:46,8205.471,Fox,5698,197,86,38,45,30,17,11,5728,5642,5604,4308,1149,1022,90,107,2821,2877,489,4030,982,0,,231
15:31:46,8205.995,Fox,5698,196,86,38,45,29,17,11,5728,5642,5604,4308,1149,1022,90,106,2821,2877,489,4031,982,0,,230
15:31:47,8207.215,Fox,5698,196,86,36,47,29,17,11,5728,5642,5606,4308,1149,1022,90,106,2821,2877,489,4031,982,0,,230
15:31:47,8207.701,Fox,5698,196,86,36,47,29,15,13,5728,5642,5606,4308,1149,1024,90,106,2821,2877,489,4031,982,0,,230
15:31:47,8208.671,Fox,5698,196,86,34,49,29,15,13,5728,5642,5608,4308,1149,1024,90,106,2821,2877,489,4031,982,0,,230
15:31:47,8209.157,Fox,5698,195,86,34,49,29,14,13,5728,5642,5608,4308,1149,1024,89,106,2821,2877,489,4032,982,0,,229
15:31:48,8209.683,Fox,5698,193,84,36,47,29,14,13,5728,5644,5608,4310,1149,1024,88,105,2821,2877,489,4034,982,0,,227
15:31:48,8209.878,Fox,5698,191,82,38,47,27,14,13,5728,5646,5608,4310,1149,1024,87,104,2821,2877,489,4036,982,0,,225
15:31:48,8210.764,Fox,5700,190,84,38,46,25,14,13,5730,5646,5608,4310,1149,1024,85,105,2821,2879,489,4039,982,0,,224
15:31:48,8211.294,Fox,5700,187,84,38,44,24,14,13,5730,5646,5608,4312,1149,1024,83,104,2821,2879,489,4042,982,0,,221
15:31:48,8211.647,Fox,5700,187,84,38,42,26,14,13,5730,5646,5608,4314,1149,1024,83,104,2821,2879,489,4042,982,0,,221
15:31:49,8213.087,Fox,5700,185,84,38,42,25,14,12,5730,5646,5608,4314,1149,1024,83,102,2821,2879,489,4043,983,0,,219
15:31:49,8213.585,Fox,5700,183,84,38,37,28,14,12,5730,5646,5608,4319,1149,1024,83,100,2821,2879,489,4045,983,0,,217
15:31:49,8213.928,Fox,5700,182,84,38,37,28,14,11,5730,5646,5608,4319,1149,1024,83,99,2821,2879,489,4045,984,0,,216
15:31:49,8214.902,Fox,5700,180,84,38,37,26,14,11,5730,5646,5608,4319,1149,1024,81,99,2821,2879,489,4047,984,0,,214
15:31:50,8215.701,Fox,5700,180,84,36,37,28,14,11,5730,5646,5610,4321,1149,1024,81,99,2821,2879,489,4047,984,0,,214
15:31:50,8216.51,Fox,5704,182,88,36,35,28,14,11,5734,5646,5610,4321,1149,1024,83,99,2825,2879,489,4049,984,0,,216
15:31:50,8216.857,Fox,5705,181,88,36,34,27,14,11,5734,5646,5610,4321,1149,1024,82,99,2825,2880,489,4051,984,0,,215
15:31:50,8217.188,Fox,5705,181,90,34,36,27,14,11,5736,5646,5612,4321,1149,1024,82,99,2825,2880,489,4051,984,0,,215
15:31:50,8217.857,Fox,5705,181,88,36,36,27,14,11,5736,5648,5612,4321,1149,1024,82,99,2825,2880,489,4051,984,0,,215
15:31:51,8218.464,Fox,5705,181,88,34,38,27,14,11,5736,5648,5614,4321,1149,1024,82,99,2825,2880,489,4051,984,0,,215
15:31:51,8218.762,Fox,5705,181,88,34,36,29,14,11,5736,5648,5614,4323,1149,1024,82,99,2825,2880,489,4051,984,0,,215
15:31:51,8219.219,Fox,5705,181,86,36,36,29,14,11,5736,5650,5614,4323,1149,1024,82,99,2825,2880,489,4051,984,0,,215
15:31:51,8219.82,Fox,5705,181,82,38,37,30,14,11,5736,5654,5616,4324,1149,1024,82,99,2825,2880,489,4051,984,0,,215
15:31:51,8219.967,Fox,5705,181,82,36,39,30,14,11,5736,5654,5618,4324,1149,1024,82,99,2825,2880,489,4051,984,0,,215
15:31:51,8220.42,Fox,5705,181,80,36,41,30,14,11,5736,5656,5620,4324,1149,1024,82,99,2825,2880,489,4051,984,0,,215
15:31:51,8220.715,Fox,5705,181,80,34,42,31,14,11,5736,5656,5622,4325,1149,1024,82,99,2825,2880,489,4051,984,0,,215
15:31:52,8221.989,Fox,5705,181,80,34,41,32,14,11,5736,5656,5622,4326,1149,1024,82,99,2825,2880,489,4051,984,0,,215
15:31:52,8223.109,Fox,5705,181,78,36,41,32,14,11,5736,5658,5622,4326,1149,1024,82,99,2825,2880,489,4051,984,0,,215
15:31:52,8224.027,Fox,5705,179,78,36,41,30,14,11,5736,5658,5622,4326,1149,1024,80,99,2825,2880,489,4053,984,0,,213
15:31:52,8224.333,Fox,5705,179,76,38,41,30,14,11,5736,5660,5622,4326,1149,1024,80,99,2825,2880,489,4053,984,0,,213
15:31:53,8224.805,Fox,5705,179,74,40,41,30,14,11,5736,5662,5622,4326,1149,1024,80,99,2825,2880,489,4053,984,0,,213
15:31:53,8225.095,Fox,5705,179,74,38,43,30,14,11,5736,5662,5624,4326,1149,1024,80,99,2825,2880,489,4053,984,0,,213
15:31:53,8225.729,Fox,5705,178,72,40,43,29,14,11,5736,5664,5624,4326,1149,1024,80,98,2825,2880,489,4054,984,0,,212
15:31:53,8226.216,Fox,5705,175,72,40,43,26,14,11,5736,5664,5624,4326,1149,1024,80,95,2825,2880,489,4057,984,0,,209
15:31:53,8227.115,Fox,5705,175,72,36,47,26,14,11,5736,5664,5628,4326,1149,1024,80,95,2825,2880,489,4057,984,0,,209
15:31:54,8228.141,Fox,5705,172,72,36,47,23,14,11,5736,5664,5628,4326,1149,1024,79,93,2825,2880,489,4060,984,0,,206
15:31:54,8228.623,Fox,5705,169,68,38,49,21,14,10,5736,5668,5630,4326,1149,1024,78,91,2825,2880,489,4062,985,0,,203
15:31:54,8229.099,Fox,5707,171,70,38,49,21,14,10,5738,5668,5630,4326,1149,1024,80,91,2827,2880,489,4062,985,0,,205
15:31:54,8229.725,Fox,5709,172,72,38,48,21,14,10,5740,5668,5630,4326,1149,1024,80,92,2828,2881,489,4063,985,0,,206
15:31:54,8230.044,Fox,5709,171,72,38,48,21,14,9,5740,5668,5630,4326,1149,1024,80,91,2828,2881,489,4063,986,0,,205
15:31:54,8230.339,Fox,5709,169,72,38,48,19,14,9,5740,5668,5630,4326,1149,1024,80,89,2828,2881,489,4065,986,0,,203
15:31:55,8230.81,Fox,5709,169,72,38,46,21,14,9,5740,5668,5630,4328,1149,1024,80,89,2828,2881,489,4065,986,0,,203
15:31:55,8231.132,Fox,5709,169,70,40,46,21,14,9,5740,5670,5630,4328,1149,1024,80,89,2828,2881,489,4065,986,0,,203
15:31:55,8232.28,Fox,5709,168,70,40,46,21,14,8,5740,5670,5630,4328,1149,1024,79,89,2828,2881,489,4065,987,0,,202
15:31:55,8232.901,Fox,5711,169,72,38,47,21,14,8,5742,5670,5632,4328,1149,1024,78,91,2828,2883,489,4066,987,0,,203
15:31:55,8233.224,Fox,5711,167,72,38,47,19,14,8,5742,5670,5632,4328,1149,1024,76,91,2828,2883,489,4068,987,0,,201
15:31:56,8234.122,Fox,5711,166,72,38,46,19,14,8,5742,5670,5632,4329,1149,1024,76,90,2828,2883,489,4069,987,0,,200
15:31:56,8235.152,Fox,5711,165,72,38,46,18,14,8,5742,5670,5632,4329,1149,1024,76,89,2828,2883,489,4070,987,0,,199
15:31:56,8236.033,Fox,5711,165,70,40,44,20,14,8,5742,5672,5632,4331,1149,1024,76,89,2828,2883,489,4070,987,0,,199
15:31:57,8236.591,Fox,5711,164,70,40,44,19,13,9,5742,5672,5632,4331,1149,1025,76,88,2828,2883,489,4071,987,0,,198
15:31:57,8236.877,Fox,5711,164,68,42,43,19,14,9,5742,5674,5632,4332,1150,1025,76,88,2828,2883,489,4071,987,0,,198
15:31:57,8237.021,Fox,5711,164,68,40,45,19,14,9,5742,5674,5634,4332,1150,1025,76,88,2828,2883,489,4071,987,0,,198
15:31:57,8237.792,Fox,5711,164,68,36,47,21,14,9,5742,5674,5638,4334,1150,1025,76,88,2828,2883,489,4071,987,0,,198
15:31:57,8238.064,Fox,5711,163,68,36,47,21,14,8,5742,5674,5638,4334,1150,1025,75,88,2828,2883,489,4071,988,0,,197
15:31:57,8238.34,Fox,5711,163,68,36,46,22,14,8,5742,5674,5638,4335,1150,1025,75,88,2828,2883,489,4071,988,0,,197
15:31:58,8239.073,Fox,5711,163,66,38,46,22,14,8,5742,5676,5638,4335,1150,1025,75,88,2828,2883,489,4071,988,0,,197
15:31:58,8240.291,Fox,5711,163,66,36,48,22,14,8,5742,5676,5640,4335,1150,1025,75,88,2828,2883,489,4071,988,0,,197
15:31:58,8240.831,Fox,5711,163,66,34,50,22,14,8,5742,5676,5642,4335,1150,1025,75,88,2828,2883,489,4071,988,0,,197
15:31:58,8241.641,Fox,5711,162,66,34,50,22,14,7,5742,5676,5642,4335,1150,1025,75,87,2828,2883,489,4071,989,0,,196
15:31:59,8242.049,Fox,5711,162,62,38,50,22,14,7,5742,5680,5642,4335,1150,1025,75,87,2828,2883,489,4071,989,0,,196
15:31:59,8242.358,Fox,5711,162,62,38,46,26,14,7,5742,5680,5642,4339,1150,1025,75,87,2828,2883,489,4071,989,0,,196
15:31:59,8244.682,Fox,5713,163,64,38,45,25,15,7,5744,5680,5642,4339,1151,1025,75,88,2829,2884,489,4072,989,0,,197
15:31:59,8244.984,Fox,5713,161,64,38,45,23,15,7,5744,5680,5642,4339,1151,1025,75,86,2829,2884,489,4074,989,0,,195
15:32:00,8245.726,Fox,5715,162,66,38,44,23,15,7,5746,5680,5642,4339,1151,1025,76,86,2831,2884,489,4075,989,0,,196
15:32:00,8246.037,Fox,5715,162,64,40,44,23,15,7,5746,5682,5642,4339,1151,1025,76,86,2831,2884,489,4075,989,0,,196
15:32:00,8246.71,Fox,5715,162,64,40,44,23,14,8,5746,5682,5642,4339,1151,1026,76,86,2831,2884,489,4075,989,0,,196
15:32:00,8247.413,Fox,5717,162,64,40,44,22,14,7,5746,5682,5642,4339,1151,1026,76,86,2832,2885,489,4076,990,0,,196
15:32:00,8247.729,Fox,5717,162,64,42,44,22,14,7,5748,5684,5642,4339,1151,1026,76,86,2832,2885,489,4076,990,0,,196
15:32:01,8248.298,Fox,5717,161,64,40,46,21,14,7,5748,5684,5644,4339,1151,1026,76,85,2832,2885,489,4077,990,0,,195
15:32:01,8248.408,Fox,5717,161,64,38,46,23,14,7,5748,5684,5646,4341,1151,1026,76,85,2832,2885,489,4077,990,0,,195
15:32:01,8248.712,Fox,5717,161,64,38,44,25,14,7,5748,5684,5646,4343,1151,1026,76,85,2832,2885,489,4077,990,0,,195
15:32:01,8249.265,Fox,5719,162,66,38,44,24,14,7,5750,5684,5646,4343,1151,1026,75,87,2832,2887,489,4078,990,0,,196
15:32:01,8249.84,Fox,5721,164,64,40,44,24,14,7,5750,5686,5646,4343,1151,1026,76,88,2833,2888,489,4078,990,0,,198
15:32:01,8249.983,Fox,5721,164,66,40,44,24,14,7,5752,5686,5646,4343,1151,1026,76,88,2833,2888,489,4078,990,0,,198
15:32:01,8250.433,Fox,5721,163,66,40,44,23,14,7,5752,5686,5646,4343,1151,1026,76,87,2833,2888,489,4079,990,0,,197
15:32:01,8251.012,Fox,5721,163,62,44,44,23,14,7,5752,5690,5646,4343,1151,1026,76,87,2833,2888,489,4079,990,0,,197
15:32:02,8251.291,Fox,5721,160,58,48,44,22,14,5,5752,5694,5646,4343,1151,1026,74,86,2833,2888,489,4080,992,0,,194
15:32:02,8251.604,Fox,5721,160,58,48,42,24,14,5,5752,5694,5646,4345,1151,1026,74,86,2833,2888,489,4080,992,0,,194
15:32:02,8252.057,Fox,5723,160,54,52,41,23,14,5,5752,5698,5646,4345,1151,1026,73,87,2834,2889,489,4082,992,0,,194
15:32:02,8252.206,Fox,5723,160,56,52,41,23,14,5,5754,5698,5646,4345,1151,1026,73,87,2834,2889,489,4082,992,0,,194
15:32:02,8252.653,Fox,5723,159,56,52,41,22,14,5,5754,5698,5646,4345,1151,1026,73,86,2834,2889,489,4083,992,0,,193
15:32:02,8253.63,Fox,5723,159,56,52,39,24,14,5,5754,5698,5646,4347,1151,1026,73,86,2834,2889,489,4083,992,0,,193
15:32:02,8253.899,Fox,5723,159,56,52,39,24,12,7,5754,5698,5646,4347,1151,1028,73,86,2834,2889,489,4083,992,0,,193
15:32:03,8255.113,Fox,5725,160,58,52,38,24,12,7,5756,5698,5646,4347,1151,1028,73,87,2835,2890,489,4084,992,0,,194
15:32:03,8255.251,Fox,5725,160,56,54,38,24,12,7,5756,5700,5646,4347,1151,1028,73,87,2835,2890,489,4084,992,0,,194
15:32:03,8255.975,Fox,5725,159,54,56,37,25,12,6,5756,5702,5646,4348,1151,1028,73,86,2835,2890,489,4084,993,0,,193
15:32:03,8256.392,Fox,5725,157,54,54,39,23,12,6,5756,5702,5648,4348,1151,1028,71,86,2835,2890,489,4086,993,0,,191
15:32:03,8256.693,Fox,5725,155,54,54,39,21,12,6,5756,5702,5648,4348,1151,1028,69,86,2835,2890,489,4088,993,0,,189
15:32:03,8256.972,Fox,5725,155,52,56,39,21,12,6,5756,5704,5648,4348,1151,1028,69,86,2835,2890,489,4088,993,0,,189
15:32:04,8257.536,Fox,5725,155,50,58,37,23,12,6,5756,5706,5648,4350,1151,1028,69,86,2835,2890,489,4088,993,0,,189
15:32:04,8257.944,Fox,5725,155,48,58,39,23,12,6,5756,5708,5650,4350,1151,1028,69,86,2835,2890,489,4088,993,0,,189
15:32:04,8258.354,Fox,5725,155,48,54,43,23,12,6,5756,5708,5654,4350,1151,1028,69,86,2835,2890,489,4088,993,0,,189
15:32:04,8258.912,Fox,5725,155,46,54,45,23,12,6,5756,5710,5656,4350,1151,1028,69,86,2835,2890,489,4088,993,0,,189
15:32:05,8260.926,Fox,5725,155,46,54,41,27,12,6,5756,5710,5656,4354,1151,1028,69,86,2835,2890,489,4088,993,0,,189
15:32:05,8261.749,Fox,5725,155,42,56,43,27,12,6,5756,5714,5658,4354,1151,1028,69,86,2835,2890,489,4088,993,0,,189
15:32:05,8262.743,Fox,5725,151,42,54,43,25,12,6,5756,5714,5660,4356,1151,1028,69,82,2835,2890,489,4092,993,0,,185
15:32:06,8263.446,Fox,5725,151,42,52,45,25,12,6,5756,5714,5662,4356,1151,1028,69,82,2835,2890,489,4092,993,0,,185
15:32:06,8263.873,Fox,5725,151,42,52,43,27,12,6,5756,5714,5662,4358,1151,1028,69,82,2835,2890,489,4092,993,0,,185
15:32:06,8264.139,Fox,5725,151,42,50,45,27,12,6,5756,5714,5664,4358,1151,1028,69,82,2835,2890,489,4092,993,0,,185
15:32:06,8265.109,Fox,5725,151,40,52,45,27,12,6,5756,5716,5664,4358,1151,1028,69,82,2835,2890,489,4092,993,0,,185
15:32:06,8265.488,Fox,5725,149,40,52,45,25,12,6,5756,5716,5664,4358,1151,1028,67,82,2835,2890,489,4094,993,0,,183
15:32:07,8267.082,Fox,5725,149,40,48,49,25,12,6,5756,5716,5668,4358,1151,1028,67,82,2835,2890,489,4094,993,0,,183
15:32:07,8267.62,Fox,5725,147,40,48,48,24,12,6,5756,5716,5668,4359,1151,1028,67,80,2835,2890,489,4096,993,0,,181
15:32:07,8267.901,Fox,5727,149,42,48,48,24,12,6,5758,5716,5668,4359,1151,1028,68,81,2836,2891,489,4096,993,0,,183
15:32:08,8269.18,Fox,5727,149,42,48,47,25,12,6,5758,5716,5668,4360,1151,1028,68,81,2836,2891,489,4096,993,0,,183
15:32:08,8269.589,Fox,5727,149,42,46,49,25,12,6,5758,5716,5670,4360,1151,1028,68,81,2836,2891,489,4096,993,0,,183
15:32:08,8269.866,Fox,5727,148,42,46,49,24,12,6,5758,5716,5670,4360,1151,1028,68,80,2836,2891,489,4097,993,0,,182
15:32:08,8271.122,Fox,5727,146,42,46,49,22,12,6,5758,5716,5670,4360,1151,1028,68,78,2836,2891,489,4099,993,0,,180
15:32:09,8272.756,Fox,5729,147,44,46,48,22,12,6,5760,5716,5670,4360,1151,1028,68,79,2837,2892,489,4100,993,0,,181
15:32:09,8273.603,Fox,5729,147,42,48,48,22,12,6,5760,5718,5670,4360,1151,1028,68,79,2837,2892,489,4100,993,0,,181
15:32:09,8274.59,Fox,5729,145,42,46,50,20,12,6,5760,5718,5672,4360,1151,1028,67,78,2837,2892,489,4102,993,0,,179
15:32:09,8274.759,Fox,5729,143,42,46,50,18,12,6,5760,5718,5672,4360,1151,1028,65,78,2837,2892,489,4104,993,0,,177
15:32:10,8275.47,Fox,5729,143,42,44,52,18,12,6,5760,5718,5674,4360,1151,1028,65,78,2837,2892,489,4104,993,0,,177
15:32:10,8276.262,Fox,5729,143,42,44,51,19,12,6,5760,5718,5674,4361,1151,1028,65,78,2837,2892,489,4104,993,0,,177
15:32:10,8276.551,Fox,5729,141,42,44,51,17,12,6,5760,5718,5674,4361,1151,1028,63,78,2837,2892,489,4106,993,0,,175
15:32:10,8277.476,Fox,5729,141,42,42,53,17,12,6,5760,5718,5676,4361,1151,1028,63,78,2837,2892,489,4106,993,0,,175
15:32:10,8277.726,Fox,5729,139,42,42,52,16,12,6,5760,5718,5676,4362,1151,1028,62,77,2837,2892,489,4108,993,0,,173
15:32:11,8278.142,Fox,5729,139,40,44,52,16,12,6,5760,5720,5676,4362,1151,1028,62,77,2837,2892,489,4108,993,0,,173
15:32:11,8279.061,Fox,5729,139,40,44,50,18,12,6,5760,5720,5676,4364,1151,1028,62,77,2837,2892,489,4108,993,0,,173
15:32:11,8280.311,Fox,5729,139,38,44,50,20,11,7,5760,5722,5678,4366,1151,1029,62,77,2837,2892,489,4108,993,0,,173
15:32:11,8280.56,Fox,5729,139,38,42,50,22,11,7,5760,5722,5680,4368,1151,1029,62,77,2837,2892,489,4108,993,0,,173
15:32:11,8280.809,Fox,5729,139,38,42,48,24,11,7,5760,5722,5680,4370,1151,1029,62,77,2837,2892,489,4108,993,0,,173
15:32:12,8281.184,Fox,5729,138,38,42,46,25,11,7,5760,5722,5680,4372,1151,1029,62,76,2837,2892,489,4109,993,0,,172
15:32:12,8282.743,Fox,5729,137,36,44,46,24,11,7,5760,5724,5680,4372,1151,1029,62,75,2837,2892,489,4110,993,0,,171
15:32:13,8284.651,Fox,5731,138,38,42,47,24,11,7,5762,5724,5682,4372,1151,1029,61,77,2837,2894,489,4111,993,0,,172
15:32:13,8285.319,Fox,5731,138,38,42,47,24,9,9,5762,5724,5682,4372,1151,1031,61,77,2837,2894,489,4111,993,0,,172
15:32:13,8285.567,Fox,5731,138,38,42,45,26,9,9,5762,5724,5682,4374,1151,1031,61,77,2837,2894,489,4111,993,0,,172
15:32:13,8285.951,Fox,5733,139,40,42,44,26,9,9,5764,5724,5682,4374,1151,1031,62,77,2839,2894,489,4112,993,0,,173
15:32:13,8286.23,Fox,5733,139,38,42,46,26,9,9,5764,5726,5684,4374,1151,1031,62,77,2839,2894,489,4112,993,0,,173
15:32:14,8287.06,Fox,5735,140,38,44,46,25,9,9,5766,5728,5684,4374,1151,1031,62,78,2840,2895,489,4113,993,0,,174
15:32:14,8287.467,Fox,5737,141,40,44,45,25,9,9,5768,5728,5684,4374,1151,1031,63,78,2842,2895,489,4114,993,0,,175
15:32:14,8287.64,Fox,5737,141,40,44,42,28,9,9,5768,5728,5684,4377,1151,1031,63,78,2842,2895,489,4114,993,0,,175
15:32:14,8288.193,Fox,5737,141,40,42,44,27,10,9,5768,5728,5686,4377,1152,1031,63,78,2842,2895,489,4114,993,0,,175
15:32:14,8288.973,Fox,5737,141,40,42,42,29,10,9,5768,5728,5686,4379,1152,1031,63,78,2842,2895,489,4114,993,0,,175
15:32:14,8289.263,Fox,5737,141,40,40,44,29,10,9,5768,5728,5688,4379,1152,1031,63,78,2842,2895,489,4114,993,0,,175
15:32:14,8289.657,Fox,5737,141,40,34,50,29,10,9,5768,5728,5694,4379,1152,1031,63,78,2842,2895,489,4114,993,0,,175
15:32:15,8289.791,Fox,5737,140,40,34,50,28,10,9,5768,5728,5694,4379,1152,1031,63,77,2842,2895,489,4115,993,0,,174
15:32:15,8290.343,Fox,5737,140,40,30,54,28,10,9,5768,5728,5698,4379,1152,1031,63,77,2842,2895,489,4115,993,0,,174
15:32:15,8291.35,Fox,5737,139,40,30,54,27,10,9,5768,5728,5698,4379,1152,1031,63,76,2842,2895,489,4116,993,0,,173
15:32:15,8292.19,Fox,5741,141,42,30,53,26,10,9,5770,5728,5698,4379,1152,1031,65,76,2846,2895,489,4118,993,0,,175
15:32:15,8292.498,Fox,5741,139,44,30,53,24,10,9,5772,5728,5698,4379,1152,1031,65,74,2846,2895,489,4120,993,0,,173
15:32:16,8293.318,Fox,5741,139,42,32,51,26,10,9,5772,5730,5698,4381,1152,1031,65,74,2846,2895,489,4120,993,0,,173
15:32:16,8293.759,Fox,5741,137,42,30,53,24,10,9,5772,5730,5700,4381,1152,1031,65,72,2846,2895,489,4122,993,0,,171
15:32:16,8294.317,Fox,5741,134,42,28,55,22,10,8,5772,5730,5702,4381,1152,1031,63,71,2846,2895,489,4124,994,0,,168
15:32:16,8294.579,Fox,5741,132,42,28,55,20,10,8,5772,5730,5702,4381,1152,1031,61,71,2846,2895,489,4126,994,0,,166
15:32:16,8295.486,Fox,5741,132,42,26,57,20,10,8,5772,5730,5704,4381,1152,1031,61,71,2846,2895,489,4126,994,0,,166
15:32:17,8296.078,Fox,5741,132,42,24,59,20,10,8,5772,5730,5706,4381,1152,1031,61,71,2846,2895,489,4126,994,0,,166
15:32:17,8296.436,Fox,5741,132,42,22,61,20,10,8,5772,5730,5708,4381,1152,1031,61,71,2846,2895,489,4126,994,0,,166
15:32:17,8297.32,Fox,5741,132,42,20,63,20,10,8,5772,5730,5710,4381,1152,1031,61,71,2846,2895,489,4126,994,0,,166
15:32:17,8297.563,Fox,5741,132,42,20,61,22,10,8,5772,5730,5710,4383,1152,1031,61,71,2846,2895,489,4126,994,0,,166
15:32:17,8298.164,Fox,5741,132,42,20,58,25,10,8,5772,5730,5710,4386,1152,1031,61,71,2846,2895,489,4126,994,0,,166
15:32:18,8299.057,Fox,5741,130,38,24,58,23,10,8,5772,5734,5710,4386,1152,1031,61,69,2846,2895,489,4128,994,0,,164
15:32:18,8299.578,Fox,5741,130,36,26,58,23,10,8,5772,5736,5710,4386,1152,1031,61,69,2846,2895,489,4128,994,0,,164
15:32:18,8300.311,Fox,5743,131,38,22,62,23,10,7,5774,5736,5714,4386,1152,1031,61,70,2847,2896,489,4129,994,0,,165
15:32:18,8300.708,Fox,5743,131,38,22,60,25,10,7,5774,5736,5714,4388,1152,1031,61,70,2847,2896,489,4129,994,0,,165
15:32:18,8301.365,Fox,5743,128,38,22,58,24,10,7,5774,5736,5714,4390,1152,1031,61,67,2847,2896,489,4132,994,0,,162
15:32:19,8302.495,Fox,5743,126,38,22,58,22,10,7,5774,5736,5714,4390,1152,1031,61,65,2847,2896,489,4134,994,0,,160
15:32:19,8303.783,Fox,5745,127,38,20,59,22,10,7,5774,5736,5716,4390,1152,1031,60,67,2847,2898,489,4135,994,0,,161
15:32:19,8303.916,Fox,5745,127,40,20,59,22,10,7,5776,5736,5716,4390,1152,1031,60,67,2847,2898,489,4135,994,0,,161
15:32:19,8304.309,Fox,5745,126,40,20,59,22,10,6,5776,5736,5716,4390,1152,1031,60,66,2847,2898,489,4135,995,0,,160
15:32:20,8306.104,Fox,5746,126,42,20,58,22,10,6,5778,5736,5716,4390,1152,1031,59,67,2847,2899,489,4136,995,0,,160
15:32:20,8306.863,Fox,5748,125,44,20,57,20,10,6,5780,5736,5716,4390,1152,1031,58,67,2848,2900,489,4139,995,0,,159
15:32:20,8307.215,Fox,5748,124,44,20,57,20,10,5,5780,5736,5716,4390,1152,1031,57,67,2848,2900,489,4139,996,0,,158
15:32:21,8308.191,Fox,5748,124,44,20,57,20,8,7,5780,5736,5716,4390,1152,1033,57,67,2848,2900,489,4139,996,0,,158
15:32:21,8308.661,Fox,5748,123,44,20,56,21,8,6,5780,5736,5716,4391,1152,1033,56,67,2848,2900,489,4139,997,0,,157
15:32:21,8310.233,Fox,5752,125,46,20,55,21,7,6,5782,5736,5716,4391,1152,1033,57,68,2851,2901,489,4141,997,0,,159
15:32:21,8310.368,Fox,5752,125,48,20,55,21,7,6,5784,5736,5716,4391,1152,1033,57,68,2851,2901,489,4141,997,0,,159
15:32:22,8311.097,Fox,5752,123,48,20,55,19,7,6,5784,5736,5716,4391,1152,1033,56,67,2851,2901,489,4143,997,0,,157
15:32:22,8311.612,Fox,5752,123,46,22,55,19,7,6,5784,5738,5716,4391,1152,1033,56,67,2851,2901,489,4143,997,0,,157
15:32:22,8312.117,Fox,5752,122,46,20,57,18,7,6,5784,5738,5718,4391,1152,1033,56,66,2851,2901,489,4144,997,0,,156
15:32:22,8312.381,Fox,5752,120,44,22,57,16,7,6,5784,5740,5718,4391,1152,1033,55,65,2851,2901,489,4146,997,0,,154
15:32:23,8314.64,Fox,5752,118,44,22,57,14,7,6,5784,5740,5718,4391,1152,1033,53,65,2851,2901,489,4148,997,0,,152
15:32:23,8315.376,Fox,5752,116,42,24,57,12,7,6,5784,5742,5718,4391,1152,1033,53,63,2851,2901,489,4150,997,0,,150
15:32:23,8315.766,Fox,5754,117,44,24,56,12,7,6,5786,5742,5718,4391,1152,1033,52,65,2851,2903,489,4151,997,0,,151
15:32:23,8316.002,Fox,5754,117,44,24,56,12,6,7,5786,5742,5718,4391,1152,1034,52,65,2851,2903,489,4151,997,0,,151
15:32:23,8316.386,Fox,5754,116,44,24,56,12,6,6,5786,5742,5718,4391,1152,1034,52,64,2851,2903,489,4151,998,0,,150
15:32:24,8316.781,Fox,5756,117,46,22,56,13,6,6,5788,5742,5720,4392,1152,1034,52,65,2852,2904,489,4152,998,0,,151
15:32:24,8318.285,Fox,5756,116,46,22,54,15,6,5,5788,5742,5720,4394,1152,1034,52,64,2852,2904,489,4152,999,0,,150
15:32:24,8318.803,Fox,5756,116,46,20,52,19,6,5,5788,5742,5722,4398,1152,1034,52,64,2852,2904,489,4152,999,0,,150
15:32:24,8319.165,Fox,5756,116,46,20,50,21,6,5,5788,5742,5722,4400,1152,1034,52,64,2852,2904,489,4152,999,0,,150
15:32:25,8321.304,Fox,5756,116,46,18,52,21,6,5,5788,5742,5724,4400,1152,1034,52,64,2852,2904,489,4152,999,0,,150
15:32:25,8322.038,Fox,5756,116,46,18,50,23,6,5,5788,5742,5724,4402,1152,1034,52,64,2852,2904,489,4152,999,0,,150
15:32:25,8322.382,Fox,5756,115,46,18,50,22,6,5,5788,5742,5724,4402,1152,1034,52,63,2852,2904,489,4153,999,0,,149
15:32:26,8322.888,Fox,5756,115,46,18,50,22,5,6,5788,5742,5724,4402,1152,1035,52,63,2852,2904,489,4153,999,0,,149
15:32:26,8323.271,Fox,5756,115,46,18,48,24,5,6,5788,5742,5724,4404,1152,1035,52,63,2852,2904,489,4153,999,0,,149
15:32:26,8323.807,Fox,5756,115,46,18,46,26,5,6,5788,5742,5724,4406,1152,1035,52,63,2852,2904,489,4153,999,0,,149
15:32:26,8324.336,Fox,5758,116,48,18,46,25,5,6,5790,5742,5724,4406,1152,1035,52,64,2853,2905,489,4154,999,0,,150
15:32:26,8324.79,Fox,5758,116,48,16,47,26,5,6,5790,5742,5726,4407,1152,1035,52,64,2853,2905,489,4154,999,0,,150
15:32:26,8324.925,Fox,5758,116,48,16,47,26,4,7,5790,5742,5726,4407,1152,1036,52,64,2853,2905,489,4154,999,0,,150
15:32:26,8325.575,Fox,5760,118,48,14,49,26,4,7,5790,5742,5728,4407,1152,1036,54,64,2855,2905,489,4154,999,0,,152
15:32:26,8325.712,Fox,5760,118,50,14,49,26,4,7,5792,5742,5728,4407,1152,1036,54,64,2855,2905,489,4154,999,0,,152
15:32:27,8326.791,Fox,5762,119,52,14,48,26,4,7,5794,5742,5728,4407,1152,1036,54,65,2856,2906,489,4155,999,0,,153
15:32:27,8327.313,Fox,5764,120,50,16,47,26,4,7,5794,5744,5728,4407,1152,1036,54,66,2857,2907,489,4156,999,0,,154
15:32:27,8327.573,Fox,5764,120,52,16,44,29,4,7,5796,5744,5728,4410,1152,1036,54,66,2857,2907,489,4156,999,0,,154
15:32:27,8327.843,Fox,5766,121,54,16,43,29,4,7,5798,5744,5728,4410,1152,1036,55,66,2859,2907,489,4157,999,0,,155
15:32:27,8328.265,Fox,5766,121,52,18,43,29,4,7,5798,5746,5728,4410,1152,1036,55,66,2859,2907,489,4157,999,0,,155
15:32:28,8328.799,Fox,5768,122,54,18,42,29,4,7,5800,5746,5728,4410,1152,1036,55,67,2860,2908,489,4158,999,0,,156
15:32:28,8329.36,Fox,5770,123,56,18,42,28,4,7,5802,5746,5728,4410,1152,1036,55,68,2861,2909,489,4159,999,0,,157
15:32:28,8330.166,Fox,5770,123,54,20,41,29,4,7,5802,5748,5728,4411,1152,1036,55,68,2861,2909,489,4159,999,0,,157
15:32:28,8330.66,Fox,5770,122,54,20,41,29,4,6,5802,5748,5728,4411,1152,1036,55,67,2861,2909,489,4159,1000,0,,156
15:32:28,8331.455,Fox,5770,121,54,20,41,28,4,6,5802,5748,5728,4411,1152,1036,55,66,2861,2909,489,4160,1000,0,,155
15:32:29,8331.915,Fox,5774,123,54,20,41,28,4,6,5804,5750,5730,4411,1152,1036,55,68,2863,2911,489,4162,1000,0,,157
15:32:29,8332.245,Fox,5776,120,56,20,40,24,4,6,5806,5750,5730,4411,1152,1036,54,66,2863,2913,489,4167,1000,0,,154
15:32:29,8332.55,Fox,5776,118,56,22,40,22,4,6,5808,5752,5730,4411,1152,1036,53,65,2863,2913,489,4169,1000,0,,152
15:32:29,8332.992,Fox,5778,119,58,22,39,22,4,6,5810,5752,5730,4411,1152,1036,53,66,2864,2914,489,4170,1000,0,,153
15:32:30,8335.217,Fox,5778,116,56,24,38,21,3,6,5810,5754,5730,4412,1152,1037,53,63,2864,2914,489,4172,1001,0,,150
15:32:30,8335.91,Fox,5778,116,56,24,37,22,3,6,5810,5754,5730,4413,1152,1037,53,63,2864,2914,489,4172,1001,0,,150
15:32:30,8336.423,Fox,5778,114,56,24,37,20,3,6,5810,5754,5730,4413,1152,1037,53,61,2864,2914,489,4174,1001,0,,148
15:32:30,8336.945,Fox,5778,112,56,24,37,18,3,6,5810,5754,5730,4413,1152,1037,53,59,2864,2914,489,4176,1001,0,,146
15:32:31,8337.698,Fox,5780,112,56,22,40,17,3,6,5812,5756,5734,4413,1152,1037,54,58,2866,2914,489,4178,1001,0,,146
15:32:31,8338.127,Fox,5782,113,58,20,40,18,3,6,5814,5756,5736,4415,1152,1037,55,58,2868,2914,489,4179,1001,0,,147
15:32:32,8340.802,Fox,5782,111,58,20,38,18,3,6,5814,5756,5736,4417,1152,1037,55,56,2868,2914,489,4181,1001,0,,145
15:32:32,8341.066,Fox,5784,112,60,20,36,19,3,6,5816,5756,5736,4418,1152,1037,54,58,2868,2916,489,4182,1001,0,,146
15:32:32,8341.995,Fox,5786,113,62,20,35,19,3,6,5818,5756,5736,4418,1152,1037,54,59,2869,2917,489,4183,1001,0,,147
15:32:33,8343.275,Fox,5786,112,62,20,35,18,3,6,5818,5756,5736,4418,1152,1037,54,58,2869,2917,489,4184,1001,0,,146
15:32:33,8345.012,Fox,5786,112,62,20,33,20,3,6,5818,5756,5736,4420,1152,1037,54,58,2869,2917,489,4184,1001,0,,146
15:32:33,8345.3,Fox,5786,111,62,20,33,20,3,5,5818,5756,5736,4420,1152,1037,54,57,2869,2917,489,4184,1002,0,,145
15:32:33,8345.68,Fox,5786,110,62,20,33,20,3,4,5818,5756,5736,4420,1152,1037,54,56,2869,2917,489,4184,1003,0,,144
15:32:34,8346.669,Fox,5786,110,62,20,31,22,3,4,5818,5756,5736,4422,1152,1037,54,56,2869,2917,489,4184,1003,0,,144
15:32:34,8347.568,Fox,5786,109,62,20,31,21,3,4,5818,5756,5736,4422,1152,1037,54,55,2869,2917,489,4185,1003,0,,143
15:32:34,8348.694,Fox,5786,108,62,20,30,21,3,4,5818,5756,5736,4423,1152,1037,54,54,2869,2917,489,4186,1003,0,,142
15:32:35,8349.775,Fox,5786,108,62,20,29,22,3,4,5818,5756,5736,4424,1152,1037,54,54,2869,2917,489,4186,1003,0,,142
15:32:35,8350.123,Fox,5786,108,62,18,30,23,3,4,5818,5756,5738,4425,1152,1037,54,54,2869,2917,489,4186,1003,0,,142
15:32:35,8350.25,Fox,5786,106,62,18,27,24,3,4,5818,5756,5738,4428,1152,1037,53,53,2869,2917,489,4188,1003,0,,140
15:32:35,8350.532,Fox,5786,106,60,20,27,24,3,4,5818,5758,5738,4428,1152,1037,53,53,2869,2917,489,4188,1003,0,,140
15:32:35,8350.815,Fox,5786,106,60,18,26,27,3,4,5818,5758,5740,4431,1152,1037,53,53,2869,2917,489,4188,1003,0,,140
15:32:36,8353.061,Fox,5786,104,60,18,26,25,3,4,5818,5758,5740,4431,1152,1037,51,53,2869,2917,489,4190,1003,0,,138
15:32:36,8353.312,Fox,5786,103,60,18,26,24,3,4,5818,5758,5740,4431,1152,1037,51,52,2869,2917,489,4191,1003,0,,137
15:32:36,8354.02,Fox,5786,103,60,16,28,24,3,4,5818,5758,5742,4431,1152,1037,51,52,2869,2917,489,4191,1003,0,,137
15:32:36,8354.3,Fox,5786,103,60,16,26,26,3,4,5818,5758,5742,4433,1152,1037,51,52,2869,2917,489,4191,1003,0,,137
15:32:36,8354.871,Fox,5786,103,60,16,25,27,3,4,5818,5758,5742,4434,1152,1037,51,52,2869,2917,489,4191,1003,0,,137
15:32:37,8355.327,Fox,5786,103,58,18,25,27,3,4,5818,5760,5742,4434,1152,1037,51,52,2869,2917,489,4191,1003,0,,137
15:32:37,8356.057,Fox,5786,103,58,18,24,28,3,4,5818,5760,5742,4435,1152,1037,51,52,2869,2917,489,4191,1003,0,,137
15:32:37,8356.535,Fox,5786,103,58,18,23,29,3,4,5818,5760,5742,4436,1152,1037,51,52,2869,2917,489,4191,1003,0,,137
15:32:37,8357.116,Fox,5788,104,58,18,20,31,3,4,5818,5760,5742,4438,1152,1037,50,54,2869,2919,489,4192,1003,0,,138
15:32:37,8357.272,Fox,5788,102,60,18,20,29,3,4,5820,5760,5742,4438,1152,1037,48,54,2869,2919,489,4194,1003,0,,136
15:32:37,8357.857,Fox,5788,102,60,18,18,31,3,4,5820,5760,5742,4440,1152,1037,48,54,2869,2919,489,4194,1003,0,,136
15:32:38,8358.858,Fox,5788,100,60,18,18,29,3,4,5820,5760,5742,4440,1152,1037,47,53,2869,2919,489,4196,1003,0,,134
15:32:38,8359.733,Fox,5790,101,62,18,17,29,3,4,5822,5760,5742,4440,1152,1037,47,54,2870,2920,489,4197,1003,0,,135
15:32:38,8360.73,Fox,5790,100,62,18,15,30,3,4,5822,5760,5742,4442,1152,1037,47,53,2870,2920,489,4198,1003,0,,134
15:32:39,8361.83,Fox,5790,99,62,18,15,29,3,4,5822,5760,5742,4442,1152,1037,47,52,2870,2920,489,4199,1003,0,,133
15:32:39,8362.212,Fox,5790,95,62,18,15,25,3,4,5822,5760,5742,4442,1152,1037,47,48,2870,2920,489,4203,1003,0,,129
15:32:39,8362.76,Fox,5792,96,64,18,14,25,3,4,5824,5760,5742,4442,1152,1037,47,49,2871,2921,489,4204,1003,0,,130
15:32:39,8362.9,Fox,5792,93,64,18,14,22,3,4,5824,5760,5742,4442,1152,1037,45,48,2871,2921,489,4207,1003,0,,127
15:32:40,8364.195,Fox,5792,93,64,18,12,24,3,4,5824,5760,5742,4444,1152,1037,45,48,2871,2921,489,4207,1003,0,,127
15:32:40,8365.693,Fox,5792,93,64,16,14,24,3,4,5824,5760,5744,4444,1152,1037,45,48,2871,2921,489,4207,1003,0,,127
15:32:40,8366.223,Fox,5792,91,64,16,14,22,3,4,5824,5760,5744,4444,1152,1037,45,46,2871,2921,489,4209,1003,0,,125
15:32:40,8366.816,Fox,5792,90,64,14,16,21,3,4,5824,5760,5746,4444,1152,1037,45,45,2871,2921,489,4210,1003,0,,124
15:32:41,8367.22,Fox,5792,90,62,16,16,21,3,4,5824,5762,5746,4444,1152,1037,45,45,2871,2921,489,4210,1003,0,,124
15:32:41,8368.009,Fox,5794,90,64,16,15,20,3,4,5826,5762,5746,4444,1152,1037,44,46,2871,2923,489,4212,1003,0,,124
15:32:41,8368.673,Fox,5794,89,62,16,17,19,3,4,5826,5764,5748,4444,1152,1037,44,45,2871,2923,489,4213,1003,0,,123
15:32:41,8368.931,Fox,5796,88,64,16,16,17,3,4,5828,5764,5748,4444,1152,1037,44,44,2872,2924,489,4216,1003,0,,122
15:32:41,8369.548,Fox,5796,88,62,18,16,17,3,4,5828,5766,5748,4444,1152,1037,44,44,2872,2924,489,4216,1003,0,,122
15:32:42,8370.075,Fox,5796,86,60,20,16,15,3,4,5828,5768,5748,4444,1152,1037,44,42,2872,2924,489,4218,1003,0,,120
15:32:42,8370.337,Fox,5796,86,60,18,18,15,3,4,5828,5768,5750,4444,1152,1037,44,42,2872,2924,489,4218,1003,0,,120
15:32:42,8371.071,Fox,5796,86,60,16,20,15,3,4,5828,5768,5752,4444,1152,1037,44,42,2872,2924,489,4218,1003,0,,120
15:32:42,8372.24,Fox,5796,84,60,16,20,13,3,4,5828,5768,5752,4444,1152,1037,44,40,2872,2924,489,4220,1003,0,,118
15:32:42,8372.578,Fox,5796,84,60,16,19,14,3,4,5828,5768,5752,4445,1152,1037,44,40,2872,2924,489,4220,1003,0,,118
15:32:43,8373.223,Fox,5796,83,60,14,21,14,3,3,5828,5768,5754,4445,1152,1037,44,39,2872,2924,489,4220,1004,0,,117
15:32:43,8374.275,Fox,5796,83,60,14,21,14,2,4,5828,5768,5754,4445,1152,1038,44,39,2872,2924,489,4220,1004,0,,117
15:32:43,8374.833,Fox,5796,83,56,18,21,14,2,4,5828,5772,5754,4445,1152,1038,44,39,2872,2924,489,4220,1004,0,,117
15:32:43,8375.6,Fox,5796,81,56,18,21,12,2,4,5828,5772,5754,4445,1152,1038,43,38,2872,2924,489,4222,1004,0,,115
15:32:44,8376.148,Fox,5796,81,56,16,23,12,2,4,5828,5772,5756,4445,1152,1038,43,38,2872,2924,489,4222,1004,0,,115
15:32:44,8376.367,Fox,5796,80,56,16,23,12,2,3,5828,5772,5756,4445,1152,1038,42,38,2872,2924,489,4222,1005,0,,114
15:32:44,8377.035,Fox,5796,80,56,16,21,14,2,3,5828,5772,5756,4447,1152,1038,42,38,2872,2924,489,4222,1005,0,,114
15:32:44,8378.618,Fox,5796,79,56,16,21,14,2,2,5828,5772,5756,4447,1152,1038,41,38,2872,2924,489,4222,1006,0,,113
15:32:45,8379.318,Fox,5796,79,56,16,20,15,2,2,5828,5772,5756,4448,1152,1038,41,38,2872,2924,489,4222,1006,0,,113
15:32:45,8381.948,Fox,5800,81,60,16,17,16,2,2,5832,5772,5756,4449,1152,1038,40,41,2873,2927,489,4224,1006,0,,115
15:32:45,8382.074,Fox,5800,81,60,16,17,16,1,3,5832,5772,5756,4449,1152,1039,40,41,2873,2927,489,4224,1006,0,,115
15:32:46,8382.807,Fox,5800,81,58,18,17,16,1,3,5832,5774,5756,4449,1152,1039,40,41,2873,2927,489,4224,1006,0,,115
15:32:46,8383.424,Fox,5800,80,58,18,17,15,1,3,5832,5774,5756,4449,1152,1039,39,41,2873,2927,489,4225,1006,0,,114
15:32:46,8384.955,Fox,5800,80,58,18,16,16,1,3,5832,5774,5756,4450,1152,1039,39,41,2873,2927,489,4225,1006,0,,114
15:32:47,8385.892,Fox,5800,80,58,18,15,17,1,3,5832,5774,5756,4451,1152,1039,39,41,2873,2927,489,4225,1006,0,,114
15:32:47,8386.385,Fox,5800,80,56,20,15,17,1,3,5832,5776,5756,4451,1152,1039,39,41,2873,2927,489,4225,1006,0,,114
15:32:47,8387.999,Fox,5800,78,56,20,15,15,1,3,5832,5776,5756,4451,1152,1039,38,40,2873,2927,489,4227,1006,0,,112
15:32:48,8388.606,Fox,5800,78,54,22,15,15,1,3,5832,5778,5756,4451,1152,1039,38,40,2873,2927,489,4227,1006,0,,112
15:32:48,8388.923,Fox,5800,78,54,20,17,15,1,3,5832,5778,5758,4451,1152,1039,38,40,2873,2927,489,4227,1006,0,,112
15:32:48,8389.314,Fox,5800,78,52,22,17,15,1,3,5832,5780,5758,4451,1152,1039,38,40,2873,2927,489,4227,1006,0,,112
15:32:48,8390.195,Fox,5800,77,52,22,17,14,1,3,5832,5780,5758,4451,1152,1039,38,39,2873,2927,489,4228,1006,0,,111
15:32:49,8391.835,Fox,5802,78,54,22,16,14,1,3,5834,5780,5758,4451,1152,1039,38,40,2874,2928,489,4229,1006,0,,112
15:32:49,8392.275,Fox,5802,78,54,22,14,16,1,3,5834,5780,5758,4453,1152,1039,38,40,2874,2928,489,4229,1006,0,,112
15:32:49,8392.571,Fox,5802,77,54,22,14,15,1,3,5834,5780,5758,4453,1152,1039,38,39,2874,2928,489,4230,1006,0,,111
15:32:49,8392.908,Fox,5802,77,50,26,14,15,1,3,5834,5784,5758,4453,1152,1039,38,39,2874,2928,489,4230,1006,0,,111
15:32:49,8393.731,Fox,5802,77,50,24,16,15,1,3,5834,5784,5760,4453,1152,1039,38,39,2874,2928,489,4230,1006,0,,111
15:32:50,8395.895,Fox,5802,76,50,24,16,14,1,3,5834,5784,5760,4453,1152,1039,38,38,2874,2928,489,4231,1006,0,,110
15:32:50,8396.807,Fox,5802,75,50,24,16,13,1,3,5834,5784,5760,4453,1152,1039,38,37,2874,2928,489,4232,1006,0,,109
15:32:51,8398.02,Fox,5802,75,50,24,14,15,1,3,5834,5784,5760,4455,1152,1039,38,37,2874,2928,489,4232,1006,0,,109
15:32:51,8398.214,Fox,5802,75,48,26,14,15,1,3,5834,5786,5760,4455,1152,1039,38,37,2874,2928,489,4232,1006,0,,109
15:32:51,8398.501,Fox,5802,75,48,26,12,17,1,3,5834,5786,5760,4457,1152,1039,38,37,2874,2928,489,4232,1006,0,,109
15:32:51,8399.274,Fox,5802,75,46,28,12,17,1,3,5834,5788,5760,4457,1152,1039,38,37,2874,2928,489,4232,1006,0,,109
15:32:53,8403.139,Fox,5802,73,46,28,12,15,1,3,5834,5788,5760,4457,1152,1039,38,35,2874,2928,489,4234,1006,0,,107
15:32:53,8403.701,Fox,5804,74,48,28,11,15,1,3,5836,5788,5760,4457,1152,1039,38,36,2875,2929,489,4235,1006,0,,108
15:32:53,8403.993,Fox,5805,74,50,28,10,15,1,3,5838,5788,5760,4457,1152,1039,38,36,2876,2929,489,4236,1006,0,,108
15:32:53,8405.632,Fox,5805,74,50,26,12,15,1,3,5838,5788,5762,4457,1152,1039,38,36,2876,2929,489,4236,1006,0,,108
15:32:54,8406.81,Fox,5805,74,48,28,12,15,1,3,5838,5790,5762,4457,1152,1039,38,36,2876,2929,489,4236,1006,0,,108
15:32:54,8407.026,Fox,5805,74,48,26,14,15,1,3,5838,5790,5764,4457,1152,1039,38,36,2876,2929,489,4236,1006,0,,108
15:32:54,8407.717,Fox,5807,75,50,26,13,15,1,3,5840,5790,5764,4457,1152,1039,38,37,2877,2930,489,4237,1006,0,,109
15:32:54,8407.841,Fox,5807,74,50,26,13,15,1,2,5840,5790,5764,4457,1152,1039,38,36,2877,2930,489,4237,1007,0,,108
15:32:54,8408.216,Fox,5807,74,48,26,15,15,1,2,5840,5792,5766,4457,1152,1039,38,36,2877,2930,489,4237,1007,0,,108
15:32:54,8408.462,Fox,5807,74,48,24,17,15,1,2,5840,5792,5768,4457,1152,1039,38,36,2877,2930,489,4237,1007,0,,108
15:32:55,8409.28,Fox,5807,72,46,26,17,13,1,2,5840,5794,5768,4457,1152,1039,36,36,2877,2930,489,4239,1007,0,,106
15:32:55,8409.702,Fox,5807,71,46,26,17,12,1,2,5840,5794,5768,4457,1152,1039,36,35,2877,2930,489,4240,1007,0,,105
15:32:55,8409.949,Fox,5807,71,44,28,17,12,1,2,5840,5796,5768,4457,1152,1039,36,35,2877,2930,489,4240,1007,0,,105
15:32:55,8410.364,Fox,5807,71,42,30,17,12,1,2,5840,5798,5768,4457,1152,1039,36,35,2877,2930,489,4240,1007,0,,105
15:32:55,8410.605,Fox,5807,71,42,30,15,14,1,2,5840,5798,5768,4459,1152,1039,36,35,2877,2930,489,4240,1007,0,,105
15:32:55,8411.333,Fox,5807,71,40,32,14,15,1,2,5840,5800,5768,4460,1152,1039,36,35,2877,2930,489,4240,1007,0,,105
15:32:56,8411.824,Fox,5807,71,38,34,14,15,1,2,5840,5802,5768,4460,1152,1039,36,35,2877,2930,489,4240,1007,0,,105
15:32:56,8412.296,Fox,5807,70,38,34,14,15,1,1,5840,5802,5768,4460,1152,1039,36,34,2877,2930,489,4240,1008,0,,104
15:32:56,8413.308,Fox,5807,70,38,30,18,15,1,1,5840,5802,5772,4460,1152,1039,36,34,2877,2930,489,4240,1008,0,,104
15:32:56,8413.885,Fox,5809,71,40,30,17,15,1,1,5842,5802,5772,4460,1152,1039,36,35,2878,2931,489,4241,1008,0,,105
15:32:56,8414.517,Fox,5809,70,38,32,15,17,1,0,5842,5804,5772,4462,1152,1039,35,35,2878,2931,489,4241,1009,0,,104
15:32:56,8414.616,Fox,5809,70,36,34,15,17,1,0,5842,5806,5772,4462,1152,1039,35,35,2878,2931,489,4241,1009,0,,104
15:32:57,8414.963,Fox,5809,70,34,36,15,17,1,0,5842,5808,5772,4462,1152,1039,35,35,2878,2931,489,4241,1009,0,,104
15:32:57,8415.505,Fox,5809,70,32,38,15,17,1,0,5842,5810,5772,4462,1152,1039,35,35,2878,2931,489,4241,1009,0,,104
15:32:58,8420.254,Fox,5809,70,30,40,15,17,1,0,5842,5812,5772,4462,1152,1039,35,35,2878,2931,489,4241,1009,0,,104
15:32:58,8420.558,Fox,5809,70,28,42,15,17,1,0,5842,5814,5772,4462,1152,1039,35,35,2878,2931,489,4241,1009,0,,104
15:32:59,8421.465,Fox,5809,68,28,40,17,15,1,0,5842,5814,5774,4462,1152,1039,33,35,2878,2931,489,4243,1009,0,,102
15:32:59,8422.036,Fox,5809,67,28,40,17,14,1,0,5842,5814,5774,4462,1152,1039,33,34,2878,2931,489,4244,1009,0,,101
15:32:59,8423.618,Fox,5809,67,26,42,17,14,1,0,5842,5816,5774,4462,1152,1039,33,34,2878,2931,489,4244,1009,0,,101
15:33:00,8424.533,Fox,5809,67,24,44,17,14,1,0,5842,5818,5774,4462,1152,1039,33,34,2878,2931,489,4244,1009,0,,101
15:33:00,8424.9,Fox,5809,67,24,42,19,14,1,0,5842,5818,5776,4462,1152,1039,33,34,2878,2931,489,4244,1009,0,,101
15:33:00,8425.227,Fox,5809,65,24,42,19,12,1,0,5842,5818,5776,4462,1152,1039,33,32,2878,2931,489,4246,1009,0,,99
15:33:00,8425.573,Fox,5809,65,24,42,19,12,0,1,5842,5818,5776,4462,1152,1040,33,32,2878,2931,489,4246,1009,0,,99
15:33:00,8426.194,Fox,5809,65,24,42,18,13,0,1,5842,5818,5776,4463,1152,1040,33,32,2878,2931,489,4246,1009,0,,99
15:33:01,8427.248,Fox,5809,65,24,40,18,15,0,1,5842,5818,5778,4465,1152,1040,33,32,2878,2931,489,4246,1009,0,,99
15:33:01,8427.897,Fox,5809,65,24,38,20,15,0,1,5842,5818,5780,4465,1152,1040,33,32,2878,2931,489,4246,1009,0,,99
15:33:01,8429.07,Fox,5809,65,24,38,19,16,0,1,5842,5818,5780,4466,1152,1040,33,32,2878,2931,489,4246,1009,0,,99
15:33:02,8430.792,Fox,5809,65,24,38,17,18,0,1,5842,5818,5780,4468,1152,1040,33,32,2878,2931,489,4246,1009,0,,99
15:33:02,8431.341,Fox,5809,65,24,34,21,18,0,1,5842,5818,5784,4468,1152,1040,33,32,2878,2931,489,4246,1009,0,,99
15:33:02,8431.431,Fox,5809,65,24,34,20,19,0,1,5842,5818,5784,4469,1152,1040,33,32,2878,2931,489,4246,1009,0,,99
15:33:03,8433.448,Fox,5810,65,26,34,19,19,0,1,5844,5818,5784,4469,1152,1040,33,32,2879,2931,489,4247,1009,0,,99
15:33:03,8433.666,Fox,5810,65,26,34,17,21,0,1,5844,5818,5784,4471,1152,1040,33,32,2879,2931,489,4247,1009,0,,99
15:33:04,8436.794,Fox,5810,65,26,32,18,22,0,1,5844,5818,5786,4472,1152,1040,33,32,2879,2931,489,4247,1009,0,,99
15:33:04,8437.068,Fox,5810,64,26,32,18,21,0,1,5844,5818,5786,4472,1152,1040,33,31,2879,2931,489,4248,1009,0,,98
15:33:04,8437.758,Fox,5810,64,26,30,20,21,0,1,5844,5818,5788,4472,1152,1040,33,31,2879,2931,489,4248,1009,0,,98
15:33:04,8438.029,Fox,5810,62,26,30,20,19,0,1,5844,5818,5788,4472,1152,1040,31,31,2879,2931,489,4250,1009,0,,96
15:33:05,8439.935,Fox,5810,61,24,32,20,18,0,1,5844,5820,5788,4472,1152,1040,31,30,2879,2931,489,4251,1009,0,,95
15:33:05,8441.49,Fox,5810,59,24,32,20,16,0,1,5844,5820,5788,4472,1152,1040,31,28,2879,2931,489,4253,1009,0,,93
15:33:06,8442.271,Fox,5810,58,22,34,20,15,0,1,5844,5822,5788,4472,1152,1040,31,27,2879,2931,489,4254,1009,0,,92
15:33:06,8444.485,Fox,5810,56,22,34,20,13,0,1,5844,5822,5788,4472,1152,1040,30,26,2879,2931,489,4256,1009,0,,90
15:33:07,8445.309,Fox,5810,56,20,34,22,13,0,1,5844,5824,5790,4472,1152,1040,30,26,2879,2931,489,4256,1009,0,,90
15:33:07,8446.759,Fox,5810,56,20,32,24,13,0,1,5844,5824,5792,4472,1152,1040,30,26,2879,2931,489,4256,1009,0,,90
15:33:07,8447.362,Fox,5810,55,20,32,24,12,0,1,5844,5824,5792,4472,1152,1040,30,25,2879,2931,489,4257,1009,0,,89
15:33:08,8447.79,Fox,5810,55,20,30,26,12,0,1,5844,5824,5794,4472,1152,1040,30,25,2879,2931,489,4257,1009,0,,89
15:33:08,8448.505,Fox,5810,55,20,28,28,12,0,1,5844,5824,5796,4472,1152,1040,30,25,2879,2931,489,4257,1009,0,,89
15:33:08,8448.819,Fox,5810,55,20,26,30,12,0,1,5844,5824,5798,4472,1152,1040,30,25,2879,2931,489,4257,1009,0,,89
15:33:08,8449.437,Fox,5810,55,20,26,28,14,0,1,5844,5824,5798,4474,1152,1040,30,25,2879,2931,489,4257,1009,0,,89
15:33:08,8449.866,Fox,5810,55,20,24,30,14,0,1,5844,5824,5800,4474,1152,1040,30,25,2879,2931,489,4257,1009,0,,89
15:33:08,8450.493,Fox,5810,55,18,24,32,14,0,1,5844,5826,5802,4474,1152,1040,30,25,2879,2931,489,4257,1009,0,,89
15:33:09,8451.446,Fox,5810,55,16,26,32,14,0,1,5844,5828,5802,4474,1152,1040,30,25,2879,2931,489,4257,1009,0,,89
15:33:09,8452.861,Fox,5810,55,16,24,34,14,0,1,5844,5828,5804,4474,1152,1040,30,25,2879,2931,489,4257,1009,0,,89
15:33:09,8453.038,Fox,5810,55,16,22,36,14,0,1,5844,5828,5806,4474,1152,1040,30,25,2879,2931,489,4257,1009,0,,89
15:33:09,8453.375,Fox,5810,55,16,20,38,14,0,1,5844,5828,5808,4474,1152,1040,30,25,2879,2931,489,4257,1009,0,,89
15:33:10,8454.014,Fox,5810,55,16,18,40,14,0,1,5844,5828,5810,4474,1152,1040,30,25,2879,2931,489,4257,1009,0,,89
15:33:10,8454.217,Fox,5810,55,16,18,39,15,0,1,5844,5828,5810,4475,1152,1040,30,25,2879,2931,489,4257,1009,0,,89
15:33:11,8458.701,Fox,5810,55,16,16,41,15,0,1,5844,5828,5812,4475,1152,1040,30,25,2879,2931,489,4257,1009,0,,89
15:33:11,8459.133,Fox,5810,55,16,14,43,15,0,1,5844,5828,5814,4475,1152,1040,30,25,2879,2931,489,4257,1009,0,,89
15:33:12,8460.109,Fox,5810,53,16,14,43,13,0,1,5844,5828,5814,4475,1152,1040,29,24,2879,2931,489,4259,1009,0,,87
15:33:12,8462.074,Fox,5810,53,16,12,45,13,0,1,5844,5828,5816,4475,1152,1040,29,24,2879,2931,489,4259,1009,0,,87
15:33:13,8463.04,Fox,5810,53,16,10,47,13,0,1,5844,5828,5818,4475,1152,1040,29,24,2879,2931,489,4259,1009,0,,87
15:33:13,8464.496,Fox,5810,53,12,14,47,13,0,1,5844,5832,5818,4475,1152,1040,29,24,2879,2931,489,4259,1009,0,,87
15:33:13,8464.993,Fox,5810,52,12,14,47,12,0,1,5844,5832,5818,4475,1152,1040,29,23,2879,2931,489,4260,1009,0,,86
15:33:14,8466.189,Fox,5812,53,14,14,44,14,0,1,5846,5832,5818,4477,1152,1040,30,23,2881,2931,489,4261,1009,0,,87
15:33:14,8466.791,Fox,5814,54,16,14,43,14,0,1,5848,5832,5818,4477,1152,1040,31,23,2883,2931,489,4262,1009,0,,88
15:33:14,8467.523,Fox,5814,54,16,14,41,16,0,1,5848,5832,5818,4479,1152,1040,31,23,2883,2931,489,4262,1009,0,,88
15:33:15,8468.57,Fox,5814,54,16,14,40,17,0,1,5848,5832,5818,4480,1152,1040,31,23,2883,2931,489,4262,1009,0,,88
15:33:15,8469.036,Fox,5814,54,16,14,38,19,0,1,5848,5832,5818,4482,1152,1040,31,23,2883,2931,489,4262,1009,0,,88
15:33:16,8473.675,Fox,5814,54,16,14,36,21,0,1,5848,5832,5818,4484,1152,1040,31,23,2883,2931,489,4262,1009,0,,88
15:33:16,8473.897,Fox,5814,54,16,14,34,23,0,1,5848,5832,5818,4486,1152,1040,31,23,2883,2931,489,4262,1009,0,,88
15:33:17,8474.453,Fox,5816,55,16,16,33,23,0,1,5850,5834,5818,4486,1152,1040,32,23,2885,2931,489,4263,1009,0,,89
15:33:17,8476.909,Fox,5816,53,16,16,33,21,0,1,5850,5834,5818,4486,1152,1040,32,21,2885,2931,489,4265,1009,0,,87
15:33:18,8478.287,Fox,5816,51,16,14,35,19,0,1,5850,5834,5820,4486,1152,1040,30,21,2885,2931,489,4267,1009,0,,85
15:33:18,8479.33,Fox,5816,50,16,14,35,18,0,1,5850,5834,5820,4486,1152,1040,30,20,2885,2931,489,4268,1009,0,,84
15:33:18,8479.774,Fox,5816,48,16,14,35,16,0,1,5850,5834,5820,4486,1152,1040,28,20,2885,2931,489,4270,1009,0,,82
15:33:19,8480.717,Fox,5816,48,16,12,37,16,0,1,5850,5834,5822,4486,1152,1040,28,20,2885,2931,489,4270,1009,0,,82
15:33:19,8481.904,Fox,5818,49,16,12,34,18,0,1,5850,5834,5822,4488,1152,1040,29,20,2887,2931,489,4271,1009,0,,83
15:33:19,8482.017,Fox,5818,49,18,12,34,18,0,1,5852,5834,5822,4488,1152,1040,29,20,2887,2931,489,4271,1009,0,,83
15:33:20,8483.53,Fox,5820,50,20,12,33,18,0,1,5854,5834,5822,4488,1152,1040,28,22,2887,2933,489,4272,1009,0,,84
15:33:20,8483.777,Fox,5820,50,20,10,35,18,0,1,5854,5834,5824,4488,1152,1040,28,22,2887,2933,489,4272,1009,0,,84
15:33:20,8484.522,Fox,5820,46,20,10,35,14,0,1,5854,5834,5824,4488,1152,1040,24,22,2887,2933,489,4276,1009,0,,80
15:33:20,8485.413,Fox,5822,47,22,10,32,16,0,1,5856,5834,5824,4490,1152,1040,24,23,2888,2934,489,4277,1009,0,,81
15:33:20,8486.227,Fox,5822,47,20,12,32,16,0,1,5856,5836,5824,4490,1152,1040,24,23,2888,2934,489,4277,1009,0,,81
15:33:21,8486.446,Fox,5822,47,18,14,32,16,0,1,5856,5838,5824,4490,1152,1040,24,23,2888,2934,489,4277,1009,0,,81
15:33:21,8487.605,Fox,5822,47,18,14,30,18,0,1,5856,5838,5824,4492,1152,1040,24,23,2888,2934,489,4277,1009,0,,81
15:33:21,8488.125,Fox,5824,48,20,14,29,18,0,1,5858,5838,5824,4492,1152,1040,24,24,2889,2935,489,4278,1009,0,,82
15:33:21,8488.396,Fox,5824,48,20,14,27,20,0,1,5858,5838,5824,4494,1152,1040,24,24,2889,2935,489,4278,1009,0,,82
15:33:21,8489.01,Fox,5826,49,22,12,28,20,0,1,5860,5838,5826,4494,1152,1040,23,26,2889,2937,489,4279,1009,0,,83
15:33:22,8490.104,Fox,5828,50,24,10,29,20,0,1,5862,5838,5828,4494,1152,1040,23,27,2890,2938,489,4280,1009,0,,84
15:33:22,8490.241,Fox,5828,50,22,12,29,20,0,1,5862,5840,5828,4494,1152,1040,23,27,2890,2938,489,4280,1009,0,,84
15:33:22,8491.726,Fox,5828,50,22,12,28,21,0,1,5862,5840,5828,4495,1152,1040,23,27,2890,2938,489,4280,1009,0,,84
15:33:22,8492.037,Fox,5828,50,22,12,26,22,1,1,5862,5840,5828,4497,1153,1040,23,27,2890,2938,489,4280,1009,0,,84
15:33:23,8492.473,Fox,5830,51,24,12,26,21,1,1,5864,5840,5828,4497,1153,1040,22,29,2890,2940,489,4281,1009,0,,85
15:33:23,8492.578,Fox,5830,49,24,12,26,19,1,1,5864,5840,5828,4497,1153,1040,21,28,2890,2940,489,4283,1009,0,,83
15:33:24,8495.966,Fox,5830,48,24,12,26,19,1,0,5864,5840,5828,4497,1153,1040,20,28,2890,2940,489,4283,1010,0,,82
15:33:24,8496.465,Fox,5830,46,22,14,26,17,1,0,5864,5842,5828,4497,1153,1040,20,26,2890,2940,489,4285,1010,0,,80
15:33:24,8497.234,Fox,5830,46,22,14,24,19,1,0,5864,5842,5828,4499,1153,1040,20,26,2890,2940,489,4285,1010,0,,80
15:33:24,8498.351,Fox,5830,46,22,14,23,20,1,0,5864,5842,5828,4500,1153,1040,20,26,2890,2940,489,4285,1010,0,,80
15:33:25,8498.588,Fox,5830,45,22,14,23,19,1,0,5864,5842,5828,4500,1153,1040,20,25,2890,2940,489,4286,1010,0,,79
15:33:25,8499.26,Fox,5832,46,24,14,22,19,1,0,5866,5842,5828,4500,1153,1040,20,26,2891,2941,489,4287,1010,0,,80
15:33:25,8499.388,Fox,5832,44,24,14,22,17,1,0,5866,5842,5828,4500,1153,1040,19,25,2891,2941,489,4289,1010,0,,78
15:33:26,8501.55,Fox,5834,45,26,14,21,17,1,0,5868,5842,5828,4500,1153,1040,19,26,2892,2942,489,4290,1010,0,,79
15:33:26,8502.713,Fox,5834,44,26,14,21,16,1,0,5868,5842,5828,4500,1153,1040,19,25,2892,2942,489,4291,1010,0,,78
15:33:26,8503.068,Fox,5834,43,26,10,25,15,1,0,5868,5842,5832,4500,1153,1040,18,25,2892,2942,489,4292,1010,0,,77
15:33:27,8505.853,Fox,5834,43,26,10,24,16,1,0,5868,5842,5832,4501,1153,1040,18,25,2892,2942,489,4292,1010,0,,77
15:33:27,8506.955,Fox,5836,44,28,10,23,16,1,0,5870,5842,5832,4501,1153,1040,19,25,2894,2942,489,4293,1010,0,,78
15:33:27,8507.296,Fox,5836,44,28,10,21,18,1,0,5870,5842,5832,4503,1153,1040,19,25,2894,2942,489,4293,1010,0,,78
15:33:28,8508.46,Fox,5836,42,28,10,20,17,1,0,5870,5842,5832,4504,1153,1040,19,23,2894,2942,489,4295,1010,0,,76
15:33:28,8509.006,Fox,5836,42,28,10,19,18,1,0,5870,5842,5832,4505,1153,1040,19,23,2894,2942,489,4295,1010,0,,76
15:33:28,8509.302,Fox,5836,42,28,10,18,19,1,0,5870,5842,5832,4506,1153,1040,19,23,2894,2942,489,4295,1010,0,,76
15:33:28,8509.506,Fox,5836,41,28,10,18,18,1,0,5870,5842,5832,4506,1153,1040,19,22,2894,2942,489,4296,1010,0,,75
15:33:28,8510.313,Fox,5836,41,28,10,17,19,1,0,5870,5842,5832,4507,1153,1040,19,22,2894,2942,489,4296,1010,0,,75
15:33:29,8510.851,Fox,5836,41,28,10,16,20,1,0,5870,5842,5832,4508,1153,1040,19,22,2894,2942,489,4296,1010,0,,75
15:33:29,8512.854,Fox,5836,41,28,8,18,20,1,0,5870,5842,5834,4508,1153,1040,19,22,2894,2942,489,4296,1010,0,,75
15:33:29,8513.375,Fox,5836,41,28,8,17,21,1,0,5870,5842,5834,4509,1153,1040,19,22,2894,2942,489,4296,1010,0,,75
15:33:30,8513.593,Fox,5836,41,28,8,15,23,1,0,5870,5842,5834,4511,1153,1040,19,22,2894,2942,489,4296,1010,0,,75
15:33:30,8513.896,Fox,5836,41,28,8,13,25,1,0,5870,5842,5834,4513,1153,1040,19,22,2894,2942,489,4296,1010,0,,75
15:33:30,8514.545,Fox,5836,41,28,8,11,27,1,0,5870,5842,5834,4515,1153,1040,19,22,2894,2942,489,4296,1010,0,,75
15:33:30,8516.007,Fox,5836,41,26,10,11,27,1,0,5870,5844,5834,4515,1153,1040,19,22,2894,2942,489,4296,1010,0,,75
15:33:31,8516.736,Fox,5836,40,26,10,11,26,1,0,5870,5844,5834,4515,1153,1040,19,21,2894,2942,489,4297,1010,0,,74
15:33:31,8518.109,Fox,5836,38,26,10,11,24,1,0,5870,5844,5834,4515,1153,1040,17,21,2894,2942,489,4299,1010,0,,72
15:33:31,8519.211,Fox,5836,37,26,10,9,25,1,0,5870,5844,5834,4517,1153,1040,17,20,2894,2942,489,4300,1010,0,,71
15:33:32,8519.64,Fox,5836,37,26,10,8,26,1,0,5870,5844,5834,4518,1153,1040,17,20,2894,2942,489,4300,1010,0,,71
15:33:32,8519.953,Fox,5836,36,26,10,8,25,1,0,5870,5844,5834,4518,1153,1040,17,19,2894,2942,489,4301,1010,0,,70
15:33:32,8520.267,Fox,5836,35,26,10,8,24,1,0,5870,5844,5834,4518,1153,1040,16,19,2894,2942,489,4302,1010,0,,69
15:33:32,8521.205,Fox,5836,34,26,10,8,23,1,0,5870,5844,5834,4518,1153,1040,16,18,2894,2942,489,4303,1010,0,,68
15:33:32,8521.81,Fox,5836,33,26,10,8,22,1,0,5870,5844,5834,4518,1153,1040,16,17,2894,2942,489,4304,1010,0,,67
15:33:33,8522.534,Fox,5836,33,26,10,6,24,1,0,5870,5844,5834,4520,1153,1040,16,17,2894,2942,489,4304,1010,0,,67
15:33:33,8523.573,Fox,5838,34,26,10,5,24,1,0,5870,5844,5834,4521,1153,1040,16,18,2895,2943,489,4305,1010,0,,68
15:33:33,8523.675,Fox,5838,34,28,10,5,24,1,0,5872,5844,5834,4521,1153,1040,16,18,2895,2943,489,4305,1010,0,,68
15:33:33,8524.368,Fox,5838,33,28,10,5,23,1,0,5872,5844,5834,4521,1153,1040,16,17,2895,2943,489,4306,1010,0,,67
15:33:33,8524.644,Fox,5838,32,28,8,7,22,1,0,5872,5844,5836,4521,1153,1040,16,16,2895,2943,489,4307,1010,0,,66
15:33:33,8524.828,Fox,5838,30,28,8,7,20,1,0,5872,5844,5836,4521,1153,1040,16,14,2895,2943,489,4309,1010,0,,64
15:33:33,8525.079,Fox,5838,30,28,6,9,20,1,0,5872,5844,5838,4521,1153,1040,16,14,2895,2943,489,4309,1010,0,,64
15:33:34,8525.497,Fox,5838,28,28,6,9,18,1,0,5872,5844,5838,4521,1153,1040,15,13,2895,2943,489,4311,1010,0,,62
15:33:34,8527.353,Fox,5840,29,30,6,8,18,1,0,5874,5844,5838,4521,1153,1040,16,13,2897,2943,489,4312,1010,0,,63
15:33:35,8528.704,Fox,5840,29,30,4,10,18,1,0,5874,5844,5840,4521,1153,1040,16,13,2897,2943,489,4312,1010,0,,63
15:33:35,8529.975,Fox,5840,27,30,4,10,16,1,0,5874,5844,5840,4521,1153,1040,14,13,2897,2943,489,4314,1010,0,,61
15:33:35,8530.36,Fox,5840,26,30,4,10,15,1,0,5874,5844,5840,4521,1153,1040,13,13,2897,2943,489,4315,1010,0,,60
15:33:36,8533.336,Fox,5840,24,30,4,10,13,1,0,5874,5844,5840,4521,1153,1040,13,11,2897,2943,489,4317,1010,0,,58
15:33:36,8534.208,Fox,5840,23,30,4,10,12,1,0,5874,5844,5840,4521,1153,1040,13,10,2897,2943,489,4318,1010,0,,57
15:33:37,8534.945,Fox,5840,23,30,2,12,12,1,0,5874,5844,5842,4521,1153,1040,13,10,2897,2943,489,4318,1010,0,,57
15:33:38,8538.813,Fox,5840,23,30,2,10,14,1,0,5874,5844,5842,4523,1153,1040,13,10,2897,2943,489,4318,1010,0,,57
15:33:38,8540.333,Fox,5842,24,32,2,9,14,1,0,5876,5844,5842,4523,1153,1040,14,10,2899,2943,489,4319,1010,0,,58
15:33:39,8541.289,Fox,5842,24,32,2,7,16,1,0,5876,5844,5842,4525,1153,1040,14,10,2899,2943,489,4319,1010,0,,58
15:33:40,8544.226,Fox,5842,24,32,2,5,18,1,0,5876,5844,5842,4527,1153,1040,14,10,2899,2943,489,4319,1010,0,,58
15:33:41,8548.734,Fox,5842,24,30,4,5,18,1,0,5876,5846,5842,4527,1153,1040,14,10,2899,2943,489,4319,1010,0,,58
15:33:42,8549.335,Fox,5842,24,28,6,5,18,1,0,5876,5848,5842,4527,1153,1040,14,10,2899,2943,489,4319,1010,0,,58
15:33:42,8549.509,Fox,5842,22,28,6,3,18,1,0,5876,5848,5842,4529,1153,1040,14,8,2899,2943,489,4321,1010,0,,56
15:33:42,8550.457,Fox,5842,22,28,6,2,19,1,0,5876,5848,5842,4530,1153,1040,14,8,2899,2943,489,4321,1010,0,,56
15:33:42,8551.248,Fox,5844,23,30,6,2,18,1,0,5878,5848,5842,4530,1153,1040,15,8,2901,2943,489,4322,1010,0,,57
15:33:42,8551.927,Fox,5844,21,30,6,2,16,1,0,5878,5848,5842,4530,1153,1040,14,7,2901,2943,489,4324,1010,0,,55
15:33:43,8554.444,Fox,5844,21,30,4,4,16,1,0,5878,5848,5844,4530,1153,1040,14,7,2901,2943,489,4324,1010,0,,55
15:33:43,8554.942,Fox,5844,20,30,4,4,15,1,0,5878,5848,5844,4530,1153,1040,14,6,2901,2943,489,4325,1010,0,,54
15:33:44,8556.971,Fox,5844,20,28,6,4,15,1,0,5878,5850,5844,4530,1153,1040,14,6,2901,2943,489,4325,1010,0,,54
15:33:45,8559.653,Fox,5846,21,30,6,3,15,1,0,5880,5850,5844,4530,1153,1040,14,7,2902,2944,489,4326,1010,0,,55
15:33:45,8560.205,Fox,5846,19,30,6,3,13,1,0,5880,5850,5844,4530,1153,1040,14,5,2902,2944,489,4328,1010,0,,53
15:33:46,8561.126,Fox,5846,18,30,6,3,12,1,0,5880,5850,5844,4530,1153,1040,14,4,2902,2944,489,4329,1010,0,,52
15:33:46,8563.481,Fox,5846,18,30,6,0,15,1,0,5880,5850,5844,4533,1153,1040,14,4,2902,2944,489,4329,1010,0,,52
15:33:47,8564.522,Fox,5846,18,28,8,0,15,1,0,5880,5852,5844,4533,1153,1040,14,4,2902,2944,489,4329,1010,0,,52
15:33:47,8566.023,Fox,5846,18,26,10,0,15,1,0,5880,5854,5844,4533,1153,1040,14,4,2902,2944,489,4329,1010,0,,52
15:33:48,8567.912,Fox,5846,18,24,12,0,15,1,0,5880,5856,5844,4533,1153,1040,14,4,2902,2944,489,4329,1010,0,,52
15:33:49,8570.588,Fox,5846,18,22,14,0,15,1,0,5880,5858,5844,4533,1153,1040,14,4,2902,2944,489,4329,1010,0,,52
15:33:49,8571.469,Fox,5846,18,20,16,0,15,1,0,5880,5860,5844,4533,1153,1040,14,4,2902,2944,489,4329,1010,0,,52
15:33:49,8572.589,Fox,5846,18,18,18,0,15,1,0,5880,5862,5844,4533,1153,1040,14,4,2902,2944,489,4329,1010,0,,52
15:33:50,8573.372,Fox,5846,18,18,18,-2,17,1,0,5880,5862,5844,4535,1153,1040,14,4,2902,2944,489,4329,1010,0,,52
15:33:50,8574.168,Fox,5846,15,18,18,-2,14,1,0,5880,5862,5844,4535,1153,1040,14,1,2902,2944,489,4332,1010,0,,49
15:33:50,8574.998,Fox,5846,15,16,20,-2,14,1,0,5880,5864,5844,4535,1153,1040,14,1,2902,2944,489,4332,1010,0,,49
15:33:52,8581.086,Fox,5846,15,16,20,-2,13,2,0,5880,5864,5844,4535,1154,1040,14,1,2902,2944,489,4332,1010,0,,49
15:33:52,8581.707,Fox,5846,15,14,22,-2,13,2,0,5880,5866,5844,4535,1154,1040,14,1,2902,2944,489,4332,1010,0,,49
15:33:53,8584.055,Fox,5846,13,12,24,-2,11,2,0,5880,5868,5844,4535,1154,1040,13,0,2902,2944,489,4334,1010,0,,47
15:33:54,8585.19,Fox,5846,13,12,24,-3,12,2,0,5880,5868,5844,4536,1154,1040,13,0,2902,2944,489,4334,1010,0,,47
15:33:54,8585.428,Fox,5846,13,12,24,-5,14,2,0,5880,5868,5844,4538,1154,1040,13,0,2902,2944,489,4334,1010,0,,47
15:33:54,8587.181,Fox,5846,13,12,22,-3,14,2,0,5880,5868,5846,4538,1154,1040,13,0,2902,2944,489,4334,1010,0,,47
15:33:54,8587.797,Fox,5846,13,12,20,-1,14,2,0,5880,5868,5848,4538,1154,1040,13,0,2902,2944,489,4334,1010,0,,47
15:33:55,8589.203,Fox,5846,13,12,20,-3,16,2,0,5880,5868,5848,4540,1154,1040,13,0,2902,2944,489,4334,1010,0,,47
15:33:55,8589.44,Fox,5846,13,10,22,-3,16,2,0,5880,5870,5848,4540,1154,1040,13,0,2902,2944,489,4334,1010,0,,47
15:33:56,8593.483,Fox,5848,14,12,22,-4,16,2,0,5882,5870,5848,4540,1154,1040,12,2,2902,2946,489,4335,1010,0,,48
15:33:57,8595.413,Fox,5848,14,12,20,-3,17,2,0,5882,5870,5850,4541,1154,1040,12,2,2902,2946,489,4335,1010,0,,48
15:33:57,8595.929,Fox,5848,13,12,20,-3,16,2,0,5882,5870,5850,4541,1154,1040,12,1,2902,2946,489,4336,1010,0,,47
15:33:57,8596.218,Fox,5848,12,12,20,-3,15,2,0,5882,5870,5850,4541,1154,1040,11,1,2902,2946,489,4337,1010,0,,46
15:33:58,8599.976,Fox,5848,10,12,20,-3,13,2,0,5882,5870,5850,4541,1154,1040,10,0,2902,2946,489,4339,1010,0,,44
15:33:59,8603.028,Fox,5848,10,12,18,-1,13,2,0,5882,5870,5852,4541,1154,1040,10,0,2902,2946,489,4339,1010,0,,44
15:34:00,8604.543,Fox,5848,10,12,16,1,13,2,0,5882,5870,5854,4541,1154,1040,10,0,2902,2946,489,4339,1010,0,,44
15:34:01,8606.28,Fox,5848,9,10,18,1,12,2,0,5882,5872,5854,4541,1154,1040,10,-1,2902,2946,489,4340,1010,0,,43
15:34:01,8606.436,Fox,5848,9,10,16,3,12,2,0,5882,5872,5856,4541,1154,1040,10,-1,2902,2946,489,4340,1010,0,,43
15:34:02,8609.13,Fox,5848,9,10,14,5,12,2,0,5882,5872,5858,4541,1154,1040,10,-1,2902,2946,489,4340,1010,0,,43
15:34:02,8609.969,Fox,5848,9,8,14,7,12,2,0,5882,5874,5860,4541,1154,1040,10,-1,2902,2946,489,4340,1010,0,,43
15:34:02,8611.088,Fox,5848,9,8,12,9,12,2,0,5882,5874,5862,4541,1154,1040,10,-1,2902,2946,489,4340,1010,0,,43
15:34:03,8613.448,Fox,5848,9,8,10,11,12,2,0,5882,5874,5864,4541,1154,1040,10,-1,2902,2946,489,4340,1010,0,,43
15:34:03,8614.946,Fox,5848,9,8,10,9,14,2,0,5882,5874,5864,4543,1154,1040,10,-1,2902,2946,489,4340,1010,0,,43
15:34:05,8620.212,Fox,5848,9,8,8,11,14,2,0,5882,5874,5866,4543,1154,1040,10,-1,2902,2946,489,4340,1010,0,,43
15:34:06,8622.578,Fox,5848,9,8,6,13,14,2,0,5882,5874,5868,4543,1154,1040,10,-1,2902,2946,489,4340,1010,0,,43
15:34:06,8622.911,Fox,5848,9,6,8,13,14,2,0,5882,5876,5868,4543,1154,1040,10,-1,2902,2946,489,4340,1010,0,,43
15:34:07,8625.836,Fox,5848,8,6,8,13,13,2,0,5882,5876,5868,4543,1154,1040,9,-1,2902,2946,489,4341,1010,0,,42
15:34:08,8627.926,Fox,5848,8,6,6,15,13,2,0,5882,5876,5870,4543,1154,1040,9,-1,2902,2946,489,4341,1010,0,,42
15:34:08,8629.496,Fox,5848,8,6,6,15,13,1,1,5882,5876,5870,4543,1154,1041,9,-1,2902,2946,489,4341,1010,0,,42
15:34:10,8633.743,Fox,5848,8,4,8,15,13,1,1,5882,5878,5870,4543,1154,1041,9,-1,2902,2946,489,4341,1010,0,,42
15:34:13,8642.152,Fox,5848,8,2,10,15,13,1,1,5882,5880,5870,4543,1154,1041,9,-1,2902,2946,489,4341,1010,0,,42
15:34:13,8644.697,Fox,5850,9,4,8,16,13,1,1,5884,5880,5872,4543,1154,1041,10,-1,2904,2946,489,4342,1010,0,,43
15:34:14,8646.703,Fox,5852,10,6,8,15,13,1,1,5886,5880,5872,4543,1154,1041,10,0,2905,2947,489,4343,1010,0,,44
15:34:14,8647.655,Fox,5852,10,6,8,13,15,1,1,5886,5880,5872,4545,1154,1041,10,0,2905,2947,489,4343,1010,0,,44
15:34:15,8648.38,Fox,5852,10,6,6,13,17,1,1,5886,5880,5874,4547,1154,1041,10,0,2905,2947,489,4343,1010,0,,44
15:34:17,8655.181,Fox,5854,11,8,6,12,17,1,1,5888,5880,5874,4547,1154,1041,11,0,2907,2947,489,4344,1010,0,,45
15:34:17,8655.936,Fox,5854,11,8,6,10,19,1,1,5888,5880,5874,4549,1154,1041,11,0,2907,2947,489,4344,1010,0,,45
15:34:18,8658.721,Fox,5854,9,8,6,10,17,1,1,5888,5880,5874,4549,1154,1041,9,0,2907,2947,489,4346,1010,0,,43
15:34:18,8659.413,Fox,5854,7,8,6,10,15,1,1,5888,5880,5874,4549,1154,1041,7,0,2907,2947,489,4348,1010,0,,41
15:34:19,8661.357,Fox,5854,7,8,4,12,15,1,1,5888,5880,5876,4549,1154,1041,7,0,2907,2947,489,4348,1010,0,,41
15:34:20,8663.538,Fox,5854,7,8,4,11,16,1,1,5888,5880,5876,4550,1154,1041,7,0,2907,2947,489,4348,1010,0,,41
15:34:20,8665.052,Fox,5854,7,8,4,9,18,1,1,5888,5880,5876,4552,1154,1041,7,0,2907,2947,489,4348,1010,0,,41
15:34:21,8666.903,Fox,5854,7,8,4,8,19,1,1,5888,5880,5876,4553,1154,1041,7,0,2907,2947,489,4348,1010,0,,41
15:34:21,8667.059,Fox,5854,5,8,4,8,17,1,1,5888,5880,5876,4553,1154,1041,5,0,2907,2947,489,4350,1010,0,,39
15:34:21,8667.968,Fox,5856,6,10,4,8,16,1,1,5890,5880,5876,4553,1154,1041,6,0,2909,2947,489,4351,1010,0,,40
15:34:22,8669.59,Fox,5856,6,10,4,6,18,1,1,5890,5880,5876,4555,1154,1041,6,0,2909,2947,489,4351,1010,0,,40
15:34:22,8670.508,Fox,5856,6,10,4,4,20,1,1,5890,5880,5876,4557,1154,1041,6,0,2909,2947,489,4351,1010,0,,40
15:34:22,8671.566,Fox,5856,6,10,4,3,21,1,1,5890,5880,5876,4558,1154,1041,6,0,2909,2947,489,4351,1010,0,,40
15:34:23,8672.262,Fox,5856,6,10,2,5,21,1,1,5890,5880,5878,4558,1154,1041,6,0,2909,2947,489,4351,1010,0,,40
15:34:23,8673.977,Fox,5856,6,10,2,3,23,1,1,5890,5880,5878,4560,1154,1041,6,0,2909,2947,489,4351,1010,0,,40
15:34:24,8676.027,Fox,5856,6,8,4,3,23,1,1,5890,5882,5878,4560,1154,1041,6,0,2909,2947,489,4351,1010,0,,40
15:34:24,8676.18,Fox,5856,4,8,4,3,21,1,1,5890,5882,5878,4560,1154,1041,6,-2,2909,2947,489,4353,1010,0,,38
15:34:25,8678.057,Fox,5856,3,8,4,3,20,1,1,5890,5882,5878,4560,1154,1041,6,-3,2909,2947,489,4354,1010,0,,37
15:34:25,8678.931,Fox,5856,3,8,4,3,19,2,1,5890,5882,5878,4560,1155,1041,6,-3,2909,2947,489,4354,1010,0,,37
15:34:25,8680.716,Fox,5856,1,8,2,3,19,2,1,5890,5882,5880,4562,1155,1041,5,-4,2909,2947,489,4356,1010,0,,35
15:34:26,8681.722,Fox,5856,-1,8,2,3,17,2,1,5890,5882,5880,4562,1155,1041,5,-6,2909,2947,489,4358,1010,0,,33
15:34:26,8682.789,Fox,5856,-2,8,2,3,16,2,1,5890,5882,5880,4562,1155,1041,5,-7,2909,2947,489,4359,1010,0,,32
15:34:26,8683.024,Fox,5856,-2,8,2,1,18,2,1,5890,5882,5880,4564,1155,1041,5,-7,2909,2947,489,4359,1010,0,,32
15:34:27,8684.811,Fox,5858,-1,10,2,0,18,2,1,5892,5882,5880,4564,1155,1041,6,-7,2911,2947,489,4360,1010,0,,33
15:34:27,8685.152,Fox,5858,-3,10,2,0,16,2,1,5892,5882,5880,4564,1155,1041,6,-9,2911,2947,489,4362,1010,0,,31
15:34:28,8688.44,Fox,5858,-3,10,2,-2,18,2,1,5892,5882,5880,4566,1155,1041,6,-9,2911,2947,489,4362,1010,0,,31
15:34:29,8691.907,Fox,5858,-5,10,2,-2,16,2,1,5892,5882,5880,4566,1155,1041,5,-10,2911,2947,489,4364,1010,0,,29
15:34:30,8694.175,Fox,5858,-6,10,2,-2,15,2,1,5892,5882,5880,4566,1155,1041,4,-10,2911,2947,489,4365,1010,0,,28
15:34:30,8694.354,Fox,5858,-7,10,2,-2,14,2,1,5892,5882,5880,4566,1155,1041,4,-11,2911,2947,489,4366,1010,0,,27
15:34:32,8699.756,Fox,5858,-9,10,2,-2,12,2,1,5892,5882,5880,4566,1155,1041,2,-11,2911,2947,489,4368,1010,0,,25
15:34:34,8705.184,Fox,5858,-9,10,2,-4,14,2,1,5892,5882,5880,4568,1155,1041,2,-11,2911,2947,489,4368,1010,0,,25
15:34:35,8708.451,Fox,5858,-9,10,2,-4,13,3,1,5892,5882,5880,4568,1156,1041,2,-11,2911,2947,489,4368,1010,0,,25
15:34:35,8708.865,Fox,5858,-9,10,2,-5,14,3,1,5892,5882,5880,4569,1156,1041,2,-11,2911,2947,489,4368,1010,0,,25
15:34:37,8714.516,Fox,5858,-9,10,0,-3,14,3,1,5892,5882,5882,4569,1156,1041,2,-11,2911,2947,489,4368,1010,0,,25
15:34:37,8716.564,Fox,5860,-10,12,0,-4,12,3,1,5894,5882,5882,4569,1156,1041,1,-11,2912,2948,489,4371,1010,0,,24
15:34:38,8718.601,Fox,5860,-10,12,0,-4,12,2,2,5894,5882,5882,4569,1156,1042,1,-11,2912,2948,489,4371,1010,0,,24
15:34:39,8720.296,Fox,5860,-11,12,0,-4,11,2,2,5894,5882,5882,4569,1156,1042,0,-11,2912,2948,489,4372,1010,0,,23
15:34:39,8721.809,Fox,5860,-11,12,0,-6,13,2,2,5894,5882,5882,4571,1156,1042,0,-11,2912,2948,489,4372,1010,0,,23
15:34:41,8727.186,Fox,5860,-11,10,2,-6,13,2,2,5894,5884,5882,4571,1156,1042,0,-11,2912,2948,489,4372,1010,0,,23
15:34:42,8729.2,Fox,5860,-11,8,4,-6,13,2,2,5894,5886,5882,4571,1156,1042,0,-11,2912,2948,489,4372,1010,0,,23
15:34:43,8732.772,Fox,5860,-11,8,4,-8,15,2,2,5894,5886,5882,4573,1156,1042,0,-11,2912,2948,489,4372,1010,0,,23
15:34:43,8733.142,Fox,5860,-13,8,4,-8,13,2,2,5894,5886,5882,4573,1156,1042,-2,-11,2912,2948,489,4374,1010,0,,21
15:34:44,8737.666,Fox,5860,-13,6,6,-8,13,2,2,5894,5888,5882,4573,1156,1042,-2,-11,2912,2948,489,4374,1010,0,,21
15:34:45,8739.766,Fox,5860,-14,6,6,-8,13,2,1,5894,5888,5882,4573,1156,1042,-3,-11,2912,2948,489,4374,1011,0,,20
15:34:46,8741.123,Fox,5860,-14,6,6,-9,14,2,1,5894,5888,5882,4574,1156,1042,-3,-11,2912,2948,489,4374,1011,0,,20
15:34:47,8743.97,Fox,5860,-16,6,6,-9,12,2,1,5894,5888,5882,4574,1156,1042,-5,-11,2912,2948,489,4376,1011,0,,18
15:34:48,8748.699,Fox,5860,-17,6,6,-9,12,2,0,5894,5888,5882,4574,1156,1042,-6,-11,2912,2948,489,4376,1012,0,,17
15:34:49,8750.481,Fox,5860,-17,4,8,-9,12,2,0,5894,5890,5882,4574,1156,1042,-6,-11,2912,2948,489,4376,1012,0,,17
15:34:49,8752.264,Fox,5860,-18,4,8,-9,11,2,0,5894,5890,5882,4574,1156,1042,-6,-12,2912,2948,489,4377,1012,0,,16
15:34:54,8765.704,Fox,5860,-18,4,6,-7,11,2,0,5894,5890,5884,4574,1156,1042,-6,-12,2912,2948,489,4377,1012,0,,16
15:34:54,8767.301,Fox,5860,-18,2,8,-7,11,2,0,5894,5892,5884,4574,1156,1042,-6,-12,2912,2948,489,4377,1012,0,,16
15:34:54,8767.718,Fox,5860,-18,2,6,-5,11,2,0,5894,5892,5886,4574,1156,1042,-6,-12,2912,2948,489,4377,1012,0,,16
15:34:57,8774.988,Fox,5860,-18,2,6,-7,13,2,0,5894,5892,5886,4576,1156,1042,-6,-12,2912,2948,489,4377,1012,0,,16
15:34:57,8776.186,Fox,5860,-18,2,4,-5,13,2,0,5894,5892,5888,4576,1156,1042,-6,-12,2912,2948,489,4377,1012,0,,16
15:35:01,8786.146,Fox,5860,-20,2,4,-5,11,2,0,5894,5892,5888,4576,1156,1042,-6,-14,2912,2948,489,4379,1012,0,,14
15:35:02,8788.941,Fox,5860,-20,2,2,-3,11,2,0,5894,5892,5890,4576,1156,1042,-6,-14,2912,2948,489,4379,1012,0,,14
15:35:05,8799.054,Fox,5860,-20,0,4,-3,11,2,0,5894,5894,5890,4576,1156,1042,-6,-14,2912,2948,489,4379,1012,0,,14
15:35:07,8805.337,Fox,5862,-19,2,4,-4,11,2,0,5896,5894,5890,4576,1156,1042,-7,-12,2912,2950,489,4380,1012,0,,15
15:35:07,8805.834,Fox,5862,-19,2,2,-2,11,2,0,5896,5894,5892,4576,1156,1042,-7,-12,2912,2950,489,4380,1012,0,,15
15:35:11,8816.467,Fox,5862,-19,2,2,-2,11,1,1,5896,5894,5892,4576,1156,1043,-7,-12,2912,2950,489,4380,1012,0,,15
15:35:14,8826.194,Fox,5862,-19,2,2,-4,13,1,1,5896,5894,5892,4578,1156,1043,-7,-12,2912,2950,489,4380,1012,0,,15
15:35:15,8828.181,Fox,5862,-19,2,2,-5,14,1,1,5896,5894,5892,4579,1156,1043,-7,-12,2912,2950,489,4380,1012,0,,15
15:35:18,8836.686,Fox,5862,-19,2,2,-7,16,1,1,5896,5894,5892,4581,1156,1043,-7,-12,2912,2950,489,4380,1012,0,,15
15:35:18,8837.034,Fox,5862,-21,2,2,-7,14,1,1,5896,5894,5892,4581,1156,1043,-9,-12,2912,2950,489,4382,1012,0,,13
15:35:18,8837.595,Fox,5862,-21,2,0,-5,14,1,1,5896,5894,5894,4581,1156,1043,-9,-12,2912,2950,489,4382,1012,0,,13
15:35:18,8839.054,Fox,5862,-22,2,0,-5,13,1,1,5896,5894,5894,4581,1156,1043,-9,-13,2912,2950,489,4383,1012,0,,12
15:35:21,8845.927,Fox,5862,-22,2,0,-5,13,0,2,5896,5894,5894,4581,1156,1044,-9,-13,2912,2950,489,4383,1012,0,,12
15:35:21,8847.487,Fox,5862,-24,2,0,-5,11,0,2,5896,5894,5894,4581,1156,1044,-11,-13,2912,2950,489,4385,1012,0,,10
15:35:22,8849.47,Fox,5862,-24,2,0,-7,13,0,2,5896,5894,5894,4583,1156,1044,-11,-13,2912,2950,489,4385,1012,0,,10
15:35:25,8860.283,Fox,5862,-26,2,0,-7,11,0,2,5896,5894,5894,4583,1156,1044,-13,-13,2912,2950,489,4387,1012,0,,8
15:35:27,8866.285,Fox,5862,-26,2,0,-9,13,0,2,5896,5894,5894,4585,1156,1044,-13,-13,2912,2950,489,4387,1012,0,,8
15:35:31,8877.116,Fox,5862,-28,2,0,-9,11,0,2,5896,5894,5894,4585,1156,1044,-15,-13,2912,2950,489,4389,1012,0,,6
15:35:35,8887.886,Fox,5862,-28,0,2,-9,11,0,2,5896,5896,5894,4585,1156,1044,-15,-13,2912,2950,489,4389,1012,0,,6
15:35:37,8896.111,Fox,5862,-29,0,2,-9,11,0,1,5896,5896,5894,4585,1156,1044,-16,-13,2912,2950,489,4389,1013,0,,5
15:35:38,8896.755,Fox,5862,-30,0,2,-9,11,0,0,5896,5896,5894,4585,1156,1044,-17,-13,2912,2950,489,4389,1014,0,,4
15:35:38,8898.107,Fox,5862,-30,0,2,-11,13,0,0,5896,5896,5894,4587,1156,1044,-17,-13,2912,2950,489,4389,1014,0,,4
15:35:42,8908.749,Fox,5862,-31,0,2,-11,12,0,0,5896,5896,5894,4587,1156,1044,-17,-14,2912,2950,489,4390,1014,0,,3
15:35:42,8908.916,Fox,5862,-32,0,2,-11,11,0,0,5896,5896,5894,4587,1156,1044,-18,-14,2912,2950,489,4391,1014,0,,2
15:35:48,8926.347,Fox,5862,-32,0,0,-9,11,0,0,5896,5896,5896,4587,1156,1044,-18,-14,2912,2950,489,4391,1014,0,,2
15:36:08,8986.831,Fox,5862,-32,0,0,-11,13,0,0,5896,5896,5896,4589,1156,1044,-18,-14,2912,2950,489,4391,1014,0,,2
15:36:12,8997.646,Fox,5862,-34,0,0,-11,11,0,0,5896,5896,5896,4589,1156,1044,-18,-16,2912,2950,489,4393,1014,0,,0
,,,,,,,,,,,,,,,,,,,,,,,,,,
,,,,,,,,,,,,,,,,,,,,,,,,,,
,,,,,,,,,,,,,,,,,,,,,,,,,,
,,,,,,,,,,,,,,,,,,,,,,,,,,0
,,,,,,,,,,,,,,,,,,,,,,,,,,12
,,,,,,,,,,,,,,,,,,,,,,,,,6600,34
