System Time:,Simulation Time:,AnimalType:,overall,alive,puppy,juvenile,young_adult,adult,aged_adult,elder,overall_puppy,overall_juvenile,overall_young_adult,overall_adult,overall_aged_adult,overall_elder,female,male,overall_female,overall_male,thirstDeath,hungerDeath,ageDeath,predatorDeath
16:11:23,5.94316,Lion,15,15,0,0,0,0,0,0,0,0,0,0,0,0,8,7,8,7,0,0,0,0
16:11:30,18.97206,Lion,15,15,15,0,0,0,0,0,15,0,0,0,0,0,8,7,8,7,0,0,0,0
16:12:28,135.9685,Lion,15,15,0,15,0,0,0,0,15,15,0,0,0,0,8,7,8,7,0,0,0,0
16:13:46,291.9648,Lion,15,15,0,0,15,0,0,0,15,15,15,0,0,0,8,7,8,7,0,0,0,0
16:14:58,434.9499,Lion,15,15,0,0,0,15,0,0,15,15,15,15,0,0,8,7,8,7,0,0,0,0
16:16:48,655.9844,Lion,15,15,0,0,0,0,15,0,15,15,15,15,15,0,8,7,8,7,0,0,0,0
16:17:14,707.7339,Lion,18,18,0,0,0,0,15,0,15,15,15,15,15,0,10,8,10,8,0,0,0,0
16:17:21,720.7184,Lion,18,18,3,0,0,0,15,0,18,15,15,15,15,0,10,8,10,8,0,0,0,0
16:17:24,726.1768,Lion,21,21,3,0,0,0,15,0,18,15,15,15,15,0,12,9,12,9,0,0,0,0
16:17:30,739.0961,Lion,21,21,6,0,0,0,15,0,21,15,15,15,15,0,12,9,12,9,0,0,0,0
16:18:07,811.718,Lion,24,24,6,0,0,0,15,0,21,15,15,15,15,0,13,11,13,11,0,0,0,0
16:18:14,824.7039,Lion,24,24,9,0,0,0,15,0,24,15,15,15,15,0,13,11,13,11,0,0,0,0
16:18:21,837.6753,Lion,24,24,6,3,0,0,15,0,24,18,15,15,15,0,13,11,13,11,0,0,0,0
16:18:31,856.0635,Lion,24,24,3,6,0,0,15,0,24,21,15,15,15,0,13,11,13,11,0,0,0,0
16:18:33,859.0635,Lion,27,27,3,6,0,0,15,0,24,21,15,15,15,0,15,12,15,12,0,0,0,0
16:18:41,872.0635,Lion,27,27,6,6,0,0,15,0,27,21,15,15,15,0,15,12,15,12,0,0,0,0
16:18:44,877.6635,Lion,30,30,6,6,0,0,15,0,27,21,15,15,15,0,18,12,18,12,0,0,0,0
16:18:53,890.6635,Lion,30,30,9,6,0,0,15,0,30,21,15,15,15,0,18,12,18,12,0,0,0,0
16:19:03,905.6635,Lion,33,33,9,6,0,0,15,0,30,21,15,15,15,0,19,14,19,14,0,0,0,0
16:19:12,918.6635,Lion,33,33,12,6,0,0,15,0,33,21,15,15,15,0,19,14,19,14,0,0,0,0
16:19:29,941.6635,Lion,33,33,9,9,0,0,15,0,33,24,15,15,15,0,19,14,19,14,0,0,0,0
16:19:40,955.6635,Lion,36,36,9,9,0,0,15,0,33,24,15,15,15,0,21,15,21,15,0,0,0,0
16:19:52,968.6635,Lion,36,36,12,9,0,0,15,0,36,24,15,15,15,0,21,15,21,15,0,0,0,0
16:20:03,981.0635,Lion,36,36,12,9,0,0,0,15,36,24,15,15,15,15,21,15,21,15,0,0,0,0
16:20:10,989.0635,Lion,36,36,9,12,0,0,0,15,36,27,15,15,15,15,21,15,21,15,0,0,0,0
16:20:14,993.6635,Lion,36,36,9,9,3,0,0,15,36,27,18,15,15,15,21,15,21,15,0,0,0,0
16:20:17,996.2635,Lion,39,39,9,9,3,0,0,15,36,27,18,15,15,15,23,16,23,16,0,0,0,0
16:20:28,1007.664,Lion,39,39,6,12,3,0,0,15,36,30,18,15,15,15,23,16,23,16,0,0,0,0
16:20:29,1009.264,Lion,39,39,9,12,3,0,0,15,39,30,18,15,15,15,23,16,23,16,0,0,0,0
16:20:31,1011.064,Lion,39,38,9,12,3,0,0,14,39,30,18,15,15,15,22,16,23,16,0,0,1,0
16:20:32,1012.064,Lion,39,38,9,9,6,0,0,14,39,30,21,15,15,15,22,16,23,16,0,0,1,0
16:20:41,1021.064,Lion,39,36,9,9,6,0,0,12,39,30,21,15,15,15,22,14,23,16,0,0,3,0
16:20:55,1035.664,Lion,39,36,6,12,6,0,0,12,39,33,21,15,15,15,22,14,23,16,0,0,3,0
16:21:12,1051.464,Lion,39,35,6,12,6,0,0,11,39,33,21,15,15,15,21,14,23,16,0,0,4,0
16:21:23,1061.664,Lion,39,33,6,12,6,0,0,9,39,33,21,15,15,15,21,12,23,16,0,0,6,0
16:21:34,1071.864,Lion,39,32,6,12,6,0,0,8,39,33,21,15,15,15,20,12,23,16,0,0,7,0
16:21:50,1085.664,Lion,39,32,3,15,6,0,0,8,39,36,21,15,15,15,20,12,23,16,0,0,7,0
16:21:57,1092.264,Lion,39,29,3,15,6,0,0,5,39,36,21,15,15,15,17,12,23,16,0,0,10,0
16:22:04,1097.664,Lion,39,29,3,12,9,0,0,5,39,36,24,15,15,15,17,12,23,16,0,0,10,0
16:22:10,1102.464,Lion,39,28,3,12,9,0,0,4,39,36,24,15,15,15,16,12,23,16,0,0,11,0
16:22:23,1112.664,Lion,39,26,3,12,9,0,0,2,39,36,24,15,15,15,16,10,23,16,0,0,13,0
16:22:41,1126.264,Lion,39,26,0,15,9,0,0,2,39,39,24,15,15,15,16,10,23,16,0,0,13,0
16:22:49,1133.063,Lion,39,24,0,15,9,0,0,0,39,39,24,15,15,15,15,9,23,16,0,0,15,0
16:22:54,1136.664,Lion,39,24,0,15,6,3,0,0,39,39,24,18,15,15,15,9,23,16,0,0,15,0
16:23:05,1145.063,Lion,39,24,0,12,9,3,0,0,39,39,27,18,15,15,15,9,23,16,0,0,15,0
16:23:19,1155.063,Lion,39,24,0,12,6,6,0,0,39,39,27,21,15,15,15,9,23,16,0,0,15,0
16:23:32,1163.664,Lion,39,24,0,9,9,6,0,0,39,39,30,21,15,15,15,9,23,16,0,0,15,0
16:24:11,1191.664,Lion,39,24,0,6,12,6,0,0,39,39,33,21,15,15,15,9,23,16,0,0,15,0
16:25:23,1240.664,Lion,39,24,0,6,9,9,0,0,39,39,33,24,15,15,15,9,23,16,0,0,15,0
16:25:24,1241.664,Lion,39,24,0,3,12,9,0,0,39,39,36,24,15,15,15,9,23,16,0,0,15,0
16:26:33,1282.264,Lion,39,24,0,0,15,9,0,0,39,39,39,24,15,15,15,9,23,16,0,0,15,0
16:26:43,1287.864,Lion,39,24,0,0,12,12,0,0,39,39,39,27,15,15,15,9,23,16,0,0,15,0
16:27:18,1306.464,Lion,39,24,0,0,9,15,0,0,39,39,39,30,15,15,15,9,23,16,0,0,15,0
16:28:17,1334.464,Lion,39,24,0,0,6,18,0,0,39,39,39,33,15,15,15,9,23,16,0,0,15,0
16:29:12,1357.664,Lion,39,24,0,0,6,15,3,0,39,39,39,33,18,15,15,9,23,16,0,0,15,0
16:30:01,1376.064,Lion,39,24,0,0,6,12,6,0,39,39,39,33,21,15,15,9,23,16,0,0,15,0
16:30:24,1384.464,Lion,39,24,0,0,3,15,6,0,39,39,39,36,21,15,15,9,23,16,0,0,15,0
16:32:14,1421.664,Lion,42,27,0,0,3,15,6,0,39,39,39,36,21,15,17,10,25,17,0,0,15,0
16:32:24,1425.064,Lion,42,27,0,0,0,18,6,0,39,39,39,39,21,15,17,10,25,17,0,0,15,0
16:32:57,1434.664,Lion,42,27,3,0,0,18,6,0,42,39,39,39,21,15,17,10,25,17,0,0,15,0
16:34:30,1461.664,Lion,42,27,3,0,0,15,9,0,42,39,39,39,24,15,17,10,25,17,0,0,15,0
16:35:56,1484.664,Lion,45,30,3,0,0,15,9,0,42,39,39,39,24,15,19,11,27,18,0,0,15,0
16:36:49,1497.664,Lion,45,30,6,0,0,15,9,0,45,39,39,39,24,15,19,11,27,18,0,0,15,0
16:37:36,1508.864,Lion,45,30,6,0,0,12,12,0,45,39,39,39,27,15,19,11,27,18,0,0,15,0
16:38:59,1527.464,Lion,45,30,6,0,0,9,15,0,45,39,39,39,30,15,19,11,27,18,0,0,15,0
16:40:52,1551.664,Lion,45,30,3,3,0,9,15,0,45,42,39,39,30,15,19,11,27,18,0,0,15,0
16:41:11,1555.464,Lion,45,30,3,3,0,6,18,0,45,42,39,39,33,15,19,11,27,18,0,0,15,0
16:44:26,1593.664,Lion,48,33,3,3,0,6,18,0,45,42,39,39,33,15,19,14,27,21,0,0,15,0
16:45:15,1603.064,Lion,51,36,3,3,0,6,18,0,45,42,39,39,33,15,19,17,27,24,0,0,15,0
16:45:26,1605.464,Lion,51,36,3,3,0,3,21,0,45,42,39,39,36,15,19,17,27,24,0,0,15,0
16:45:34,1606.664,Lion,51,36,6,3,0,3,21,0,48,42,39,39,36,15,19,17,27,24,0,0,15,0
16:46:17,1614.664,Lion,51,36,3,6,0,3,21,0,48,45,39,39,36,15,19,17,27,24,0,0,15,0
16:46:24,1616.064,Lion,51,36,6,6,0,3,21,0,51,45,39,39,36,15,19,17,27,24,0,0,15,0
16:48:37,1640.264,Lion,54,39,6,6,0,3,21,0,51,45,39,39,36,15,21,18,29,25,0,0,15,0
16:49:08,1646.064,Lion,54,39,6,6,0,0,24,0,51,45,39,39,39,15,21,18,29,25,0,0,15,0
16:49:48,1653.264,Lion,54,39,9,6,0,0,24,0,54,45,39,39,39,15,21,18,29,25,0,0,15,0
16:51:38,1672.864,Lion,57,42,9,6,0,0,24,0,54,45,39,39,39,15,23,19,31,26,0,0,15,0
16:52:34,1682.664,Lion,57,42,9,6,0,0,21,3,54,45,39,39,39,18,23,19,31,26,0,0,15,0
16:52:55,1685.864,Lion,57,42,12,6,0,0,21,3,57,45,39,39,39,18,23,19,31,26,0,0,15,0
16:54:24,1701.064,Lion,57,42,12,6,0,0,18,6,57,45,39,39,39,21,23,19,31,26,0,0,15,0
16:55:05,1707.664,Lion,57,42,12,3,3,0,18,6,57,45,42,39,39,21,23,19,31,26,0,0,15,0
16:55:52,1715.464,Lion,60,45,12,3,3,0,18,6,57,45,42,39,39,21,25,20,33,27,0,0,15,0
16:56:42,1723.664,Lion,60,45,9,6,3,0,18,6,57,48,42,39,39,21,25,20,33,27,0,0,15,0
16:57:12,1728.464,Lion,60,45,12,6,3,0,18,6,60,48,42,39,39,21,25,20,33,27,0,0,15,0
16:57:40,1733.064,Lion,60,45,9,9,3,0,18,6,60,51,42,39,39,21,25,20,33,27,0,0,15,0
16:58:11,1737.864,Lion,63,48,9,9,3,0,18,6,60,51,42,39,39,21,28,20,36,27,0,0,15,0
16:58:54,1744.664,Lion,66,51,9,9,3,0,18,6,60,51,42,39,39,21,31,20,39,27,0,0,15,0
16:59:33,1750.864,Lion,66,51,12,9,3,0,18,6,63,51,42,39,39,21,31,20,39,27,0,0,15,0
16:59:46,1753.064,Lion,66,49,12,9,3,0,18,4,63,51,42,39,39,21,29,20,39,27,0,0,17,0
17:00:16,1757.664,Lion,66,49,15,9,3,0,18,4,66,51,42,39,39,21,29,20,39,27,0,0,17,0
17:01:38,1770.264,Lion,66,49,12,12,3,0,18,4,66,54,42,39,39,21,29,20,39,27,0,0,17,0
17:01:40,1770.664,Lion,66,49,12,9,6,0,18,4,66,54,45,39,39,21,29,20,39,27,0,0,17,0
17:01:58,1773.464,Lion,66,48,12,9,6,0,18,3,66,54,45,39,39,21,29,19,39,27,0,0,18,0
17:02:51,1781.664,Lion,66,47,12,9,6,0,18,2,66,54,45,39,39,21,29,18,39,27,0,0,19,0
17:03:25,1786.664,Lion,66,47,12,9,6,0,15,5,66,54,45,39,39,24,29,18,39,27,0,0,19,0
17:03:29,1787.064,Lion,69,50,12,9,6,0,15,5,66,54,45,39,39,24,30,20,40,29,0,0,19,0
17:04:53,1800.064,Lion,69,50,15,9,6,0,15,5,69,54,45,39,39,24,30,20,40,29,0,0,19,0
17:05:11,1802.864,Lion,69,50,12,12,6,0,15,5,69,57,45,39,39,24,30,20,40,29,0,0,19,0
17:05:19,1804.064,Lion,72,53,12,12,6,0,15,5,69,57,45,39,39,24,31,22,41,31,0,0,19,0
17:05:38,1807.064,Lion,75,56,12,12,6,0,15,5,69,57,45,39,39,24,32,24,42,33,0,0,19,0
17:06:45,1817.064,Lion,75,56,15,12,6,0,15,5,72,57,45,39,39,24,32,24,42,33,0,0,19,0
17:07:05,1820.064,Lion,75,56,18,12,6,0,15,5,75,57,45,39,39,24,32,24,42,33,0,0,19,0
17:07:47,1826.664,Lion,75,55,18,12,6,0,15,4,75,57,45,39,39,24,32,23,42,33,0,0,20,0
17:08:27,1832.664,Lion,75,54,18,12,6,0,15,3,75,57,45,39,39,24,31,23,42,33,0,0,21,0
17:08:35,1833.864,Lion,75,54,18,12,6,0,12,6,75,57,45,39,39,27,31,23,42,33,0,0,21,0
17:08:54,1836.664,Lion,75,53,18,12,6,0,12,5,75,57,45,39,39,27,30,23,42,33,0,0,22,0
17:09:54,1845.464,Lion,75,53,15,15,6,0,12,5,75,60,45,39,39,27,30,23,42,33,0,0,22,0
17:10:03,1846.864,Lion,75,52,15,15,6,0,12,4,75,60,45,39,39,27,30,22,42,33,0,0,23,0
17:10:27,1850.464,Lion,75,52,15,15,3,3,12,4,75,60,45,42,39,27,30,22,42,33,0,0,23,0
17:10:40,1852.464,Lion,75,52,15,15,3,3,9,7,75,60,45,42,39,30,30,22,42,33,0,0,23,0
17:11:56,1863.864,Lion,75,51,15,15,3,3,9,6,75,60,45,42,39,30,29,22,42,33,0,0,24,0
17:12:23,1867.864,Lion,75,51,12,18,3,3,9,6,75,63,45,42,39,30,29,22,42,33,0,0,24,0
17:13:08,1874.664,Lion,75,51,9,21,3,3,9,6,75,66,45,42,39,30,29,22,42,33,0,0,24,0
17:13:41,1879.664,Lion,75,51,9,18,6,3,9,6,75,66,48,42,39,30,29,22,42,33,0,0,24,0
17:13:45,1880.464,Lion,75,51,9,18,6,3,6,9,75,66,48,42,39,33,29,22,42,33,0,0,24,0
17:13:59,1882.464,Lion,75,50,9,18,6,3,6,8,75,66,48,42,39,33,28,22,42,33,0,0,25,0
17:14:42,1889.064,Lion,75,50,9,15,9,3,6,8,75,66,51,42,39,33,28,22,42,33,0,0,25,0
17:15:13,1894.064,Lion,75,48,9,15,9,3,6,6,75,66,51,42,39,33,27,21,42,33,0,0,27,0
17:17:00,1910.864,Lion,75,47,9,15,8,3,6,6,75,66,51,42,39,33,27,20,42,33,1,0,27,0
17:17:16,1913.464,Lion,75,47,9,15,6,5,6,6,75,66,51,44,39,33,27,20,42,33,1,0,27,0
17:17:39,1917.064,Lion,75,47,6,18,6,5,6,6,75,69,51,44,39,33,27,20,42,33,1,0,27,0
17:18:00,1920.464,Lion,78,50,6,18,6,5,6,6,75,69,51,44,39,33,30,20,45,33,1,0,27,0
17:18:13,1922.864,Lion,78,49,6,18,6,5,6,5,75,69,51,44,39,33,29,20,45,33,1,0,28,0
17:18:34,1926.264,Lion,78,49,6,15,9,5,6,5,75,69,54,44,39,33,29,20,45,33,1,0,28,0
17:18:58,1930.464,Lion,78,49,6,15,9,5,3,8,75,69,54,44,39,36,29,20,45,33,1,0,28,0
17:19:16,1933.464,Lion,78,49,9,15,9,5,3,8,78,69,54,44,39,36,29,20,45,33,1,0,28,0
17:19:20,1934.064,Lion,78,49,6,18,9,5,3,8,78,72,54,44,39,36,29,20,45,33,1,0,28,0
17:19:37,1937.064,Lion,78,49,3,21,9,5,3,8,78,75,54,44,39,36,29,20,45,33,1,0,28,0
17:21:11,1953.464,Lion,78,48,3,21,9,5,3,7,78,75,54,44,39,36,28,20,45,33,1,0,29,0
17:21:42,1958.864,Lion,78,48,3,18,12,5,3,7,78,75,57,44,39,36,28,20,45,33,1,0,29,0
17:22:52,1971.264,Lion,78,47,3,18,12,5,0,9,78,75,57,44,39,39,27,20,45,33,1,0,30,0
17:23:33,1978.064,Lion,78,46,3,18,11,5,0,9,78,75,57,44,39,39,27,19,45,33,2,0,30,0
17:25:21,1991.664,Lion,78,45,3,18,11,5,0,8,78,75,57,44,39,39,27,18,45,33,2,0,31,0
17:26:20,1998.664,Lion,81,48,3,18,11,5,0,8,78,75,57,44,39,39,28,20,46,35,2,0,31,0
17:26:43,2001.464,Lion,81,48,3,15,14,5,0,8,78,75,60,44,39,39,28,20,46,35,2,0,31,0
17:28:07,2011.064,Lion,81,47,3,15,14,5,0,7,78,75,60,44,39,39,27,20,46,35,2,0,32,0
17:28:14,2011.664,Lion,81,47,6,15,14,5,0,7,81,75,60,44,39,39,27,20,46,35,2,0,32,0
17:29:38,2021.064,Lion,81,45,6,15,14,5,0,5,81,75,60,44,39,39,26,19,46,35,2,0,34,0
17:29:51,2022.464,Lion,81,44,6,15,12,7,0,4,81,75,60,46,39,39,26,18,46,35,2,0,35,0
17:30:04,2023.864,Lion,81,44,6,12,15,7,0,4,81,75,63,46,39,39,26,18,46,35,2,0,35,0
17:31:01,2030.664,Lion,81,44,6,9,18,7,0,4,81,75,66,46,39,39,26,18,46,35,2,0,35,0
17:31:11,2031.864,Lion,81,44,6,9,15,10,0,4,81,75,66,49,39,39,26,18,46,35,2,0,35,0
17:32:37,2042.264,Lion,84,47,6,9,15,10,0,4,81,75,66,49,39,39,26,21,46,38,2,0,35,0
17:33:44,2050.464,Lion,84,47,3,12,15,10,0,4,81,78,66,49,39,39,26,21,46,38,2,0,35,0
17:34:26,2055.264,Lion,84,47,6,12,15,10,0,4,84,78,66,49,39,39,26,21,46,38,2,0,35,0
17:36:27,2062.063,Lion,84,46,6,12,15,10,0,3,84,78,66,49,39,39,25,21,46,38,2,0,36,0
17:38:31,2069.063,Lion,84,46,6,12,12,13,0,3,84,78,66,52,39,39,25,21,46,38,2,0,36,0
17:39:13,2071.464,Lion,84,46,6,12,12,10,3,3,84,78,66,52,42,39,25,21,46,38,2,0,36,0
17:39:25,2072.264,Lion,84,44,6,12,12,10,3,1,84,78,66,52,42,39,24,20,46,38,2,0,38,0
17:39:37,2073.063,Lion,84,44,6,9,15,10,3,1,84,78,69,52,42,39,24,20,46,38,2,0,38,0
17:42:38,2087.864,Lion,84,43,6,9,15,10,3,0,84,78,69,52,42,39,23,20,46,38,2,0,39,0
17:42:59,2090.063,Lion,84,43,6,6,18,10,3,0,84,78,72,52,42,39,23,20,46,38,2,0,39,0
17:43:27,2093.063,Lion,84,43,6,3,21,10,3,0,84,78,75,52,42,39,23,20,46,38,2,0,39,0
17:44:49,2101.664,Lion,84,43,6,3,18,13,3,0,84,78,75,55,42,39,23,20,46,38,2,0,39,0
17:49:10,2128.664,Lion,84,43,3,6,18,13,3,0,84,81,75,55,42,39,23,20,46,38,2,0,39,0
17:50:05,2134.464,Lion,84,43,3,6,18,11,5,0,84,81,75,55,44,39,23,20,46,38,2,0,39,0
17:51:07,2144.264,Lion,84,43,3,6,15,14,5,0,84,81,75,58,44,39,23,20,46,38,2,0,39,0
17:52:59,2166.664,Lion,84,43,3,6,12,17,5,0,84,81,75,61,44,39,23,20,46,38,2,0,39,0
17:53:26,2172.264,Lion,84,43,0,9,12,17,5,0,84,84,75,61,44,39,23,20,46,38,2,0,39,0
17:53:31,2173.464,Lion,84,43,0,9,9,20,5,0,84,84,75,64,44,39,23,20,46,38,2,0,39,0
17:54:33,2186.264,Lion,87,46,0,9,9,20,5,0,84,84,75,64,44,39,24,22,47,40,2,0,39,0
17:55:29,2197.864,Lion,90,49,0,9,9,20,5,0,84,84,75,64,44,39,24,25,47,43,2,0,39,0
17:55:35,2199.264,Lion,90,49,3,9,9,20,5,0,87,84,75,64,44,39,24,25,47,43,2,0,39,0
17:56:09,2206.464,Lion,90,49,3,6,12,20,5,0,87,84,78,64,44,39,24,25,47,43,2,0,39,0
17:56:31,2210.864,Lion,90,49,6,6,12,20,5,0,90,84,78,64,44,39,24,25,47,43,2,0,39,0
17:56:53,2215.864,Lion,90,49,6,6,9,23,5,0,90,84,78,67,44,39,24,25,47,43,2,0,39,0
17:58:13,2232.864,Lion,90,49,6,6,6,26,5,0,90,84,78,70,44,39,24,25,47,43,2,0,39,0
17:58:27,2235.864,Lion,90,49,6,6,3,29,5,0,90,84,78,73,44,39,24,25,47,43,2,0,39,0
17:59:03,2243.464,Lion,90,49,6,6,3,27,7,0,90,84,78,73,46,39,24,25,47,43,2,0,39,0
17:59:48,2252.864,Lion,90,49,6,6,3,24,10,0,90,84,78,73,49,39,24,25,47,43,2,0,39,0
18:01:07,2269.264,Lion,93,52,6,6,3,24,10,0,90,84,78,73,49,39,26,26,49,44,2,0,39,0
18:02:11,2282.264,Lion,93,52,9,6,3,24,10,0,93,84,78,73,49,39,26,26,49,44,2,0,39,0
18:02:22,2284.664,Lion,93,52,9,3,6,24,10,0,93,84,81,73,49,39,26,26,49,44,2,0,39,0
18:02:47,2290.063,Lion,93,52,9,3,6,21,13,0,93,84,81,73,52,39,26,26,49,44,2,0,39,0
18:03:04,2293.464,Lion,96,55,9,3,6,21,13,0,93,84,81,73,52,39,28,27,51,45,2,0,39,0
18:04:08,2306.464,Lion,96,55,12,3,6,21,13,0,96,84,81,73,52,39,28,27,51,45,2,0,39,0
18:04:55,2316.264,Lion,96,55,9,6,6,21,13,0,96,87,81,73,52,39,28,27,51,45,2,0,39,0
18:05:25,2322.664,Lion,96,55,9,6,6,18,16,0,96,87,81,73,55,39,28,27,51,45,2,0,39,0
18:05:51,2327.864,Lion,96,55,6,9,6,18,16,0,96,90,81,73,55,39,28,27,51,45,2,0,39,0
18:05:52,2328.264,Lion,96,55,6,6,9,18,16,0,96,90,84,73,55,39,28,27,51,45,2,0,39,0
18:07:33,2349.264,Lion,96,55,6,6,6,21,16,0,96,90,84,76,55,39,28,27,51,45,2,0,39,0
18:08:53,2365.264,Lion,96,55,6,6,6,18,19,0,96,90,84,76,58,39,28,27,51,45,2,0,39,0
18:10:21,2383.264,Lion,99,58,6,6,6,18,19,0,96,90,84,76,58,39,30,28,53,46,2,0,39,0
18:10:41,2387.664,Lion,99,58,6,6,6,15,22,0,96,90,84,76,61,39,30,28,53,46,2,0,39,0
18:11:08,2393.464,Lion,99,57,6,6,5,15,22,0,96,90,84,76,61,39,30,27,53,46,3,0,39,0
18:11:12,2394.464,Lion,99,57,6,6,5,12,25,0,96,90,84,76,64,39,30,27,53,46,3,0,39,0
18:11:21,2396.464,Lion,99,57,9,6,5,12,22,3,99,90,84,76,64,42,30,27,53,46,3,0,39,0
18:11:35,2399.264,Lion,99,57,6,9,5,12,22,3,99,93,84,76,64,42,30,27,53,46,3,0,39,0
18:13:27,2423.464,Lion,99,57,3,12,5,12,22,3,99,96,84,76,64,42,30,27,53,46,3,0,39,0
18:13:33,2425.063,Lion,99,56,3,12,4,12,22,3,99,96,84,76,64,42,30,26,53,46,3,1,39,0
18:13:44,2427.464,Lion,99,56,3,12,2,14,22,3,99,96,84,78,64,42,30,26,53,46,3,1,39,0
18:13:51,2428.864,Lion,102,59,3,12,2,14,22,3,99,96,84,78,64,42,31,28,54,48,3,1,39,0
18:14:05,2431.864,Lion,102,58,3,12,2,13,22,3,99,96,84,78,64,42,30,28,54,48,4,1,39,0
18:14:29,2436.864,Lion,102,58,3,12,2,10,25,3,99,96,84,78,67,42,30,28,54,48,4,1,39,0
18:14:52,2441.864,Lion,102,58,6,12,2,10,25,3,102,96,84,78,67,42,30,28,54,48,4,1,39,0
18:15:46,2453.864,Lion,102,58,6,12,2,7,28,3,102,96,84,78,70,42,30,28,54,48,4,1,39,0
18:16:00,2456.864,Lion,102,58,6,12,2,4,31,3,102,96,84,78,73,42,30,28,54,48,4,1,39,0
18:16:12,2459.464,Lion,102,58,6,12,2,4,29,5,102,96,84,78,73,44,30,28,54,48,4,1,39,0
18:17:07,2471.063,Lion,102,58,6,12,0,6,29,5,102,96,84,80,73,44,30,28,54,48,4,1,39,0
18:17:12,2472.264,Lion,102,58,6,9,3,6,29,5,102,96,87,80,73,44,30,28,54,48,4,1,39,0
18:18:06,2483.864,Lion,102,58,6,6,6,6,29,5,102,96,90,80,73,44,30,28,54,48,4,1,39,0
18:18:21,2487.264,Lion,102,57,6,6,6,6,29,4,102,96,90,80,73,44,30,27,54,48,4,1,40,0
18:20:21,2513.264,Lion,102,57,3,9,6,6,29,4,102,99,90,80,73,44,30,27,54,48,4,1,40,0
18:20:24,2513.864,Lion,105,60,3,9,6,6,29,4,102,99,90,80,73,44,31,29,55,50,4,1,40,0
18:21:15,2525.063,Lion,108,63,3,9,6,6,29,4,102,99,90,80,73,44,32,31,56,52,4,1,40,0
18:21:24,2526.864,Lion,108,63,6,9,6,6,29,4,105,99,90,80,73,44,32,31,56,52,4,1,40,0
18:21:29,2528.063,Lion,108,62,6,9,6,6,29,3,105,99,90,80,73,44,31,31,56,52,4,1,41,0
18:22:16,2538.264,Lion,108,61,9,9,6,6,29,2,108,99,90,80,73,44,30,31,56,52,4,1,42,0
18:22:23,2539.464,Lion,111,64,9,9,6,6,29,2,108,99,90,80,73,44,31,33,57,54,4,1,42,0
18:23:21,2552.464,Lion,111,64,12,9,6,6,29,2,111,99,90,80,73,44,31,33,57,54,4,1,42,0
18:23:34,2555.264,Lion,111,64,12,6,9,6,29,2,111,99,93,80,73,44,31,33,57,54,4,1,42,0
18:23:50,2558.864,Lion,111,64,9,9,9,6,29,2,111,102,93,80,73,44,31,33,57,54,4,1,42,0
18:24:34,2568.464,Lion,111,64,9,9,9,6,27,4,111,102,93,80,73,46,31,33,57,54,4,1,42,0
18:24:42,2570.264,Lion,111,64,9,9,9,3,30,4,111,102,93,80,76,46,31,33,57,54,4,1,42,0
18:25:16,2577.864,Lion,111,64,9,9,9,3,27,7,111,102,93,80,76,49,31,33,57,54,4,1,42,0
18:25:23,2579.464,Lion,111,64,9,6,12,3,27,7,111,102,96,80,76,49,31,33,57,54,4,1,42,0
18:25:29,2580.864,Lion,111,63,9,6,12,3,27,6,111,102,96,80,76,49,30,33,57,54,4,1,43,0
18:26:12,2590.464,Lion,114,66,9,6,12,3,27,6,111,102,96,80,76,49,31,35,58,56,4,1,43,0
18:26:59,2601.264,Lion,114,65,9,6,12,3,27,5,111,102,96,80,76,49,30,35,58,56,4,1,44,0
18:27:09,2603.464,Lion,114,65,12,6,12,3,27,5,114,102,96,80,76,49,30,35,58,56,4,1,44,0
18:27:57,2615.063,Lion,114,65,12,6,9,6,24,8,114,102,96,83,76,52,30,35,58,56,4,1,44,0
18:28:45,2626.664,Lion,114,65,12,6,6,9,24,8,114,102,96,86,76,52,30,35,58,56,4,1,44,0
18:29:32,2638.063,Lion,114,64,12,6,6,9,24,7,114,102,96,86,76,52,30,34,58,56,4,1,45,0
18:29:35,2638.864,Lion,114,63,12,6,6,9,24,6,114,102,96,86,76,52,30,33,58,56,4,1,46,0
18:29:55,2643.864,Lion,114,63,9,9,6,9,24,6,114,105,96,86,76,52,30,33,58,56,4,1,46,0
18:30:10,2647.664,Lion,114,63,9,9,6,9,21,9,114,105,96,86,76,55,30,33,58,56,4,1,46,0
18:30:13,2648.464,Lion,114,62,9,9,6,8,22,8,114,105,96,86,77,55,30,32,58,56,4,1,47,0
18:30:39,2655.063,Lion,114,62,6,12,6,8,22,8,114,108,96,86,77,55,30,32,58,56,4,1,47,0
18:30:56,2659.464,Lion,114,61,6,12,5,8,22,8,114,108,96,86,77,55,29,32,58,56,5,1,47,0
18:31:18,2664.864,Lion,114,60,6,12,4,8,22,8,114,108,96,86,77,55,29,31,58,56,6,1,47,0
18:31:29,2667.664,Lion,114,59,6,12,4,8,22,7,114,108,96,86,77,55,28,31,58,56,6,1,48,0
18:31:37,2669.464,Lion,114,59,3,12,7,8,22,7,114,111,99,86,77,55,28,31,58,56,6,1,48,0
18:32:42,2685.464,Lion,114,58,3,12,7,8,22,6,114,111,99,86,77,55,28,30,58,56,6,1,49,0
18:33:02,2690.264,Lion,114,58,3,12,7,8,19,9,114,111,99,86,77,58,28,30,58,56,6,1,49,0
18:33:10,2692.063,Lion,114,58,3,12,7,6,21,9,114,111,99,86,79,58,28,30,58,56,6,1,49,0
18:33:27,2695.864,Lion,117,61,3,12,7,6,21,9,114,111,99,86,79,58,30,31,60,57,6,1,49,0
18:33:35,2698.063,Lion,117,61,3,12,5,8,21,9,114,111,99,88,79,58,30,31,60,57,6,1,49,0
18:33:52,2702.063,Lion,120,64,3,12,5,8,21,9,114,111,99,88,79,58,30,34,60,60,6,1,49,0
18:34:03,2704.864,Lion,123,67,3,12,5,8,21,9,114,111,99,88,79,58,32,35,62,61,6,1,49,0
18:34:07,2705.864,Lion,126,70,3,12,5,8,21,9,114,111,99,88,79,58,35,35,65,61,6,1,49,0
18:34:19,2708.864,Lion,126,70,6,12,5,8,21,9,117,111,99,88,79,58,35,35,65,61,6,1,49,0
18:34:34,2712.664,Lion,126,70,6,12,5,8,18,12,117,111,99,88,79,61,35,35,65,61,6,1,49,0
18:34:44,2715.063,Lion,126,70,9,9,8,8,18,12,120,111,102,88,79,61,35,35,65,61,6,1,49,0
18:34:47,2716.063,Lion,126,69,9,9,8,8,18,11,120,111,102,88,79,61,34,35,65,61,6,1,50,0
18:34:55,2717.864,Lion,126,69,12,9,8,8,18,11,123,111,102,88,79,61,34,35,65,61,6,1,50,0
18:34:59,2718.864,Lion,129,72,15,9,8,8,18,11,126,111,102,88,79,61,34,38,65,64,6,1,50,0
18:35:01,2719.464,Lion,129,72,15,9,8,8,15,14,126,111,102,88,79,64,34,38,65,64,6,1,50,0
18:35:05,2720.464,Lion,129,71,12,12,8,8,15,13,126,114,102,88,79,64,34,37,65,64,6,1,51,0
18:35:11,2722.264,Lion,129,71,12,12,6,10,15,13,126,114,102,90,79,64,34,37,65,64,6,1,51,0
18:35:23,2725.264,Lion,132,74,12,12,6,10,15,13,126,114,102,90,79,64,34,40,65,67,6,1,51,0
18:35:42,2730.063,Lion,135,77,12,12,6,10,15,13,126,114,102,90,79,64,36,41,67,68,6,1,51,0
18:35:48,2731.664,Lion,135,77,15,12,6,10,15,13,129,114,102,90,79,64,36,41,67,68,6,1,51,0
18:36:09,2737.063,Lion,138,80,15,12,6,10,15,13,129,114,102,90,79,64,38,42,69,69,6,1,51,0
18:36:14,2738.264,Lion,138,80,18,12,6,10,15,13,132,114,102,90,79,64,38,42,69,69,6,1,51,0
18:36:32,2743.063,Lion,138,80,21,12,6,10,15,13,135,114,102,90,79,64,38,42,69,69,6,1,51,0
18:36:53,2748.664,Lion,138,78,21,12,6,10,15,11,135,114,102,90,79,64,37,41,69,69,6,1,53,0
18:36:59,2750.063,Lion,138,78,24,12,6,10,15,11,138,114,102,90,79,64,37,41,69,69,6,1,53,0
18:37:45,2761.864,Lion,138,78,24,12,6,10,12,14,138,114,102,90,79,67,37,41,69,69,6,1,53,0
18:38:02,2766.264,Lion,138,77,24,12,5,10,12,14,138,114,102,90,79,67,36,41,69,69,6,2,53,0
18:38:05,2767.063,Lion,138,76,24,12,5,10,12,13,138,114,102,90,79,67,35,41,69,69,6,2,54,0
18:38:14,2769.464,Lion,138,75,24,12,5,10,12,12,138,114,102,90,79,67,34,41,69,69,6,2,55,0
18:38:19,2770.864,Lion,138,73,24,12,5,10,12,10,138,114,102,90,79,67,33,40,69,69,6,2,57,0
18:38:27,2772.864,Lion,138,72,24,12,5,10,12,9,138,114,102,90,79,67,32,40,69,69,6,2,58,0
18:38:49,2778.864,Lion,138,72,24,12,5,10,9,12,138,114,102,90,79,70,32,40,69,69,6,2,58,0
18:39:01,2781.864,Lion,138,72,24,12,5,10,6,15,138,114,102,90,79,73,32,40,69,69,6,2,58,0
18:39:39,2791.264,Lion,141,74,24,12,5,10,6,14,138,114,102,90,79,73,33,41,70,71,6,2,59,0
18:39:41,2791.864,Lion,141,73,24,12,5,10,6,13,138,114,102,90,79,73,32,41,70,71,6,2,60,0
18:40:09,2798.864,Lion,141,72,24,12,5,10,6,12,138,114,102,90,79,73,32,40,70,71,6,2,61,0
18:40:13,2800.063,Lion,141,71,24,9,8,10,6,11,138,114,105,90,79,73,31,40,70,71,6,2,62,0
18:40:27,2803.464,Lion,141,70,24,9,8,10,6,10,138,114,105,90,79,73,30,40,70,71,6,2,63,0
18:40:30,2804.063,Lion,141,70,27,9,8,10,6,10,141,114,105,90,79,73,30,40,70,71,6,2,63,0
18:40:56,2811.063,Lion,141,70,27,6,11,10,6,10,141,114,108,90,79,73,30,40,70,71,6,2,63,0
18:41:00,2812.063,Lion,141,70,27,6,9,12,6,10,141,114,108,92,79,73,30,40,70,71,6,2,63,0
18:41:36,2821.864,Lion,141,69,27,6,9,12,6,9,141,114,108,92,79,73,29,40,70,71,6,2,64,0
18:41:49,2825.464,Lion,141,69,27,3,12,12,6,9,141,114,111,92,79,73,29,40,70,71,6,2,64,0
18:41:51,2825.864,Lion,141,69,24,6,12,12,6,9,141,117,111,92,79,73,29,40,70,71,6,2,64,0
18:42:14,2832.063,Lion,141,69,21,9,12,12,6,9,141,120,111,92,79,73,29,40,70,71,6,2,64,0
18:42:25,2835.063,Lion,144,72,18,12,12,12,6,9,141,123,111,92,79,73,31,41,72,72,6,2,64,0
18:42:28,2836.063,Lion,144,71,15,15,11,9,9,9,141,126,111,92,82,73,30,41,72,72,7,2,64,0
18:42:58,2844.264,Lion,144,70,15,15,11,9,9,8,141,126,111,92,82,73,29,41,72,72,7,2,65,0
18:43:10,2847.664,Lion,144,70,15,15,11,6,12,8,141,126,111,92,85,73,29,41,72,72,7,2,65,0
18:43:12,2848.063,Lion,144,70,18,15,11,6,12,8,144,126,111,92,85,73,29,41,72,72,7,2,65,0
18:43:14,2848.664,Lion,144,70,15,18,11,6,12,8,144,129,111,92,85,73,29,41,72,72,7,2,65,0
18:43:27,2852.264,Lion,144,69,15,18,11,6,12,7,144,129,111,92,85,73,28,41,72,72,7,2,66,0
18:43:38,2855.264,Lion,144,69,12,21,11,6,12,7,144,132,111,92,85,73,28,41,72,72,7,2,66,0
18:43:46,2857.664,Lion,144,69,12,21,9,8,12,7,144,132,111,94,85,73,28,41,72,72,7,2,66,0
18:43:55,2860.063,Lion,144,69,9,24,9,8,12,7,144,135,111,94,85,73,28,41,72,72,7,2,66,0
18:44:21,2867.063,Lion,144,69,6,27,9,8,12,7,144,138,111,94,85,73,28,41,72,72,7,2,66,0
18:44:30,2869.664,Lion,144,68,6,27,9,8,12,6,144,138,111,94,85,73,28,40,72,72,7,2,67,0
18:44:56,2876.464,Lion,144,68,6,24,12,8,12,6,144,138,114,94,85,73,28,40,72,72,7,2,67,0
18:45:20,2883.264,Lion,144,67,6,24,12,8,12,5,144,138,114,94,85,73,28,39,72,72,7,2,68,0
18:45:41,2888.864,Lion,144,66,6,24,11,8,12,5,144,138,114,94,85,73,28,38,72,72,7,3,68,0
18:45:46,2890.063,Lion,144,65,6,24,11,8,12,4,144,138,114,94,85,73,27,38,72,72,7,3,69,0
18:45:57,2893.063,Lion,144,64,6,24,11,8,12,3,144,138,114,94,85,73,27,37,72,72,7,3,70,0
18:46:04,2895.264,Lion,144,64,6,24,11,8,9,6,144,138,114,94,85,76,27,37,72,72,7,3,70,0
18:46:35,2903.664,Lion,144,63,6,24,11,8,9,5,144,138,114,94,85,76,27,36,72,72,7,3,71,0
18:47:23,2917.264,Lion,144,62,6,24,10,8,9,5,144,138,114,94,85,76,27,35,72,72,8,3,71,0
18:47:29,2919.063,Lion,144,62,6,24,10,6,11,5,144,138,114,94,87,76,27,35,72,72,8,3,71,0
18:47:36,2921.063,Lion,144,62,3,27,10,6,11,5,144,141,114,94,87,76,27,35,72,72,8,3,71,0
18:48:14,2932.664,Lion,144,61,3,27,10,6,11,4,144,141,114,94,87,76,26,35,72,72,8,3,72,0
18:48:49,2942.664,Lion,144,61,3,27,8,8,11,4,144,141,114,96,87,76,26,35,72,72,8,3,72,0
18:48:51,2943.264,Lion,144,61,3,27,8,6,13,4,144,141,114,96,89,76,26,35,72,72,8,3,72,0
18:48:53,2944.063,Lion,144,60,3,27,8,6,13,3,144,141,114,96,89,76,26,34,72,72,8,3,73,0
18:48:57,2945.264,Lion,144,59,3,27,8,6,13,2,144,141,114,96,89,76,25,34,72,72,8,3,74,0
18:49:25,2953.264,Lion,147,62,3,27,8,6,13,2,144,141,114,96,89,76,27,35,74,73,8,3,74,0
18:49:26,2953.864,Lion,147,62,3,27,6,8,13,2,144,141,114,98,89,76,27,35,74,73,8,3,74,0
18:49:31,2955.464,Lion,147,61,3,27,6,8,13,1,144,141,114,98,89,76,26,35,74,73,8,3,75,0
18:50:04,2965.063,Lion,147,61,0,30,6,8,13,1,144,144,114,98,89,76,26,35,74,73,8,3,75,0
18:50:08,2966.264,Lion,147,61,3,30,6,8,13,1,147,144,114,98,89,76,26,35,74,73,8,3,75,0
18:50:14,2968.264,Lion,147,61,3,30,3,11,13,1,147,144,114,101,89,76,26,35,74,73,8,3,75,0
18:50:31,2973.464,Lion,147,61,3,30,3,11,12,2,147,144,114,101,89,77,26,35,74,73,8,3,75,0
18:50:40,2975.864,Lion,150,64,3,30,3,11,12,2,147,144,114,101,89,77,28,36,76,74,8,3,75,0
18:50:42,2976.664,Lion,153,67,3,30,3,11,12,2,147,144,114,101,89,77,30,37,78,75,8,3,75,0
18:50:58,2981.864,Lion,153,67,3,27,6,11,12,2,147,144,117,101,89,77,30,37,78,75,8,3,75,0
18:51:19,2988.063,Lion,153,67,3,24,9,11,12,2,147,144,120,101,89,77,30,37,78,75,8,3,75,0
18:51:22,2988.864,Lion,153,67,6,24,9,11,12,2,150,144,120,101,89,77,30,37,78,75,8,3,75,0
18:51:24,2989.664,Lion,153,67,9,24,9,11,12,2,153,144,120,101,89,77,30,37,78,75,8,3,75,0
18:51:29,2990.864,Lion,153,67,9,21,12,11,12,2,153,144,123,101,89,77,30,37,78,75,8,3,75,0
18:51:32,2991.864,Lion,153,67,9,18,15,11,12,2,153,144,126,101,89,77,30,37,78,75,8,3,75,0
18:51:48,2996.264,Lion,153,66,9,18,15,11,12,1,153,144,126,101,89,77,29,37,78,75,8,3,76,0
18:52:06,3001.063,Lion,153,65,9,18,14,11,12,1,153,144,126,101,89,77,29,36,78,75,8,4,76,0
18:52:19,3004.664,Lion,153,65,9,15,17,11,12,1,153,144,129,101,89,77,29,36,78,75,8,4,76,0
18:52:41,3011.264,Lion,153,65,9,12,20,11,12,1,153,144,132,101,89,77,29,36,78,75,8,4,76,0
18:52:46,3012.664,Lion,156,68,9,12,20,11,12,1,153,144,132,101,89,77,31,37,80,76,8,4,76,0
18:52:48,3013.464,Lion,156,67,9,12,20,11,12,0,153,144,132,101,89,77,31,36,80,76,8,4,77,0
18:52:57,3016.063,Lion,156,67,9,9,23,11,12,0,153,144,135,101,89,77,31,36,80,76,8,4,77,0
18:53:00,3017.063,Lion,156,67,9,9,23,11,10,2,153,144,135,101,89,79,31,36,80,76,8,4,77,0
18:53:07,3019.264,Lion,156,67,9,9,21,13,10,2,153,144,135,103,89,79,31,36,80,76,8,4,77,0
18:53:21,3023.063,Lion,156,67,9,6,24,13,10,2,153,144,138,103,89,79,31,36,80,76,8,4,77,0
18:53:31,3025.664,Lion,156,67,12,6,24,13,10,2,156,144,138,103,89,79,31,36,80,76,8,4,77,0
18:53:55,3033.063,Lion,156,67,12,6,24,11,12,2,156,144,138,103,91,79,31,36,80,76,8,4,77,0
18:56:26,3077.264,Lion,156,66,12,3,27,11,12,1,156,144,141,103,91,79,31,35,80,76,8,4,78,0
18:56:31,3078.664,Lion,156,66,12,3,27,9,14,1,156,144,141,103,93,79,31,35,80,76,8,4,78,0
18:56:47,3083.264,Lion,156,66,9,6,27,9,14,1,156,147,141,103,93,79,31,35,80,76,8,4,78,0
18:58:05,3105.864,Lion,156,66,6,9,27,9,14,1,156,150,141,103,93,79,31,35,80,76,8,4,78,0
18:58:08,3106.664,Lion,156,66,3,12,27,9,14,1,156,153,141,103,93,79,31,35,80,76,8,4,78,0
18:58:48,3118.664,Lion,156,65,3,12,26,9,14,1,156,153,141,103,93,79,30,35,80,76,9,4,78,0
18:58:56,3121.063,Lion,156,65,3,9,29,9,14,1,156,153,144,103,93,79,30,35,80,76,9,4,78,0
18:59:06,3124.264,Lion,156,64,3,9,28,9,14,1,156,153,144,103,93,79,30,34,80,76,10,4,78,0
18:59:07,3124.664,Lion,156,64,3,9,25,12,14,1,156,153,144,106,93,79,30,34,80,76,10,4,78,0
18:59:28,3130.864,Lion,156,64,3,9,22,15,14,1,156,153,144,109,93,79,30,34,80,76,10,4,78,0
18:59:37,3133.664,Lion,156,64,3,9,19,18,14,1,156,153,144,112,93,79,30,34,80,76,10,4,78,0
18:59:40,3134.664,Lion,156,64,3,9,17,20,14,1,156,153,144,114,93,79,30,34,80,76,10,4,78,0
19:00:08,3142.664,Lion,156,64,0,12,17,20,14,1,156,156,144,114,93,79,30,34,80,76,10,4,78,0
19:00:11,3143.664,Lion,159,67,0,12,17,20,14,1,156,156,144,114,93,79,32,35,82,77,10,4,78,0
19:00:23,3147.464,Lion,159,67,0,12,14,23,14,1,156,156,144,117,93,79,32,35,82,77,10,4,78,0
19:00:45,3154.063,Lion,159,67,0,12,11,26,14,1,156,156,144,120,93,79,32,35,82,77,10,4,78,0
19:00:54,3156.664,Lion,159,67,3,12,11,26,14,1,159,156,144,120,93,79,32,35,82,77,10,4,78,0
19:01:01,3158.864,Lion,159,66,3,12,9,28,14,0,159,156,144,122,93,79,32,34,82,77,10,4,79,0
19:01:07,3161.063,Lion,159,66,3,12,9,28,11,3,159,156,144,122,93,82,32,34,82,77,10,4,79,0
19:01:16,3163.664,Lion,159,66,3,12,9,26,13,3,159,156,144,122,95,82,32,34,82,77,10,4,79,0
19:01:23,3165.864,Lion,159,66,3,12,6,29,13,3,159,156,144,125,95,82,32,34,82,77,10,4,79,0
19:01:44,3172.664,Lion,159,66,3,12,6,29,10,6,159,156,144,125,95,85,32,34,82,77,10,4,79,0
19:01:51,3174.864,Lion,159,66,3,12,6,27,12,6,159,156,144,125,97,85,32,34,82,77,10,4,79,0
19:02:36,3189.264,Lion,159,66,3,12,6,24,15,6,159,156,144,125,100,85,32,34,82,77,10,4,79,0
19:04:13,3219.864,Lion,159,66,3,12,3,27,15,6,159,156,144,128,100,85,32,34,82,77,10,4,79,0
19:04:18,3221.264,Lion,159,65,3,12,3,27,15,5,159,156,144,128,100,85,32,33,82,77,10,4,80,0
19:04:56,3232.864,Lion,159,64,3,12,3,27,15,4,159,156,144,128,100,85,32,32,82,77,10,4,81,0
19:05:19,3239.264,Lion,159,64,3,9,6,27,15,4,159,156,147,128,100,85,32,32,82,77,10,4,81,0
19:05:22,3240.264,Lion,159,64,3,9,6,25,17,4,159,156,147,128,102,85,32,32,82,77,10,4,81,0
19:05:34,3244.063,Lion,159,64,3,9,6,25,15,6,159,156,147,128,102,87,32,32,82,77,10,4,81,0
19:06:33,3262.063,Lion,159,63,3,6,9,25,15,5,159,156,150,128,102,87,31,32,82,77,10,4,82,0
19:06:35,3262.664,Lion,159,63,3,3,12,25,15,5,159,156,153,128,102,87,31,32,82,77,10,4,82,0
19:06:39,3263.864,Lion,159,63,3,3,9,28,15,5,159,156,153,131,102,87,31,32,82,77,10,4,82,0
19:06:53,3268.264,Lion,159,63,3,3,9,28,13,7,159,156,153,131,102,89,31,32,82,77,10,4,82,0
19:07:10,3273.664,Lion,159,63,0,6,9,28,13,7,159,159,153,131,102,89,31,32,82,77,10,4,82,0
19:07:42,3284.063,Lion,159,62,0,6,9,28,13,6,159,159,153,131,102,89,30,32,82,77,10,4,83,0
19:08:28,3298.664,Lion,159,62,0,3,12,28,13,6,159,159,156,131,102,89,30,32,82,77,10,4,83,0
19:08:45,3304.264,Lion,159,61,0,3,12,28,13,5,159,159,156,131,102,89,30,31,82,77,10,4,84,0
19:09:44,3323.264,Lion,159,60,0,3,12,28,13,4,159,159,156,131,102,89,30,30,82,77,10,4,85,0
19:09:49,3324.664,Lion,159,59,0,3,12,28,13,3,159,159,156,131,102,89,29,30,82,77,10,4,86,0
19:10:01,3328.464,Lion,159,58,0,3,12,28,13,2,159,159,156,131,102,89,28,30,82,77,10,4,87,0
19:10:13,3331.864,Lion,162,61,0,3,12,28,13,2,159,159,156,131,102,89,30,31,84,78,10,4,87,0
19:10:55,3345.063,Lion,162,60,3,3,12,28,13,1,162,159,156,131,102,89,30,30,84,78,10,4,88,0
19:10:57,3345.664,Lion,162,60,3,3,12,25,16,1,162,159,156,131,105,89,30,30,84,78,10,4,88,0
19:11:18,3351.864,Lion,162,60,3,3,12,22,19,1,162,159,156,131,108,89,30,30,84,78,10,4,88,0
19:11:27,3354.664,Lion,162,60,3,3,12,19,22,1,162,159,156,131,111,89,30,30,84,78,10,4,88,0
19:11:30,3355.664,Lion,162,60,3,3,12,17,24,1,162,159,156,131,113,89,30,30,84,78,10,4,88,0
19:11:38,3358.063,Lion,162,60,3,3,12,17,22,3,162,159,156,131,113,91,30,30,84,78,10,4,88,0
19:12:11,3368.464,Lion,162,60,3,3,12,14,25,3,162,159,156,131,116,91,30,30,84,78,10,4,88,0
19:12:32,3375.063,Lion,162,60,3,3,12,11,28,3,162,159,156,131,119,91,30,30,84,78,10,4,88,0
19:12:47,3379.864,Lion,162,60,3,3,12,9,30,3,162,159,156,131,121,91,30,30,84,78,10,4,88,0
19:12:54,3382.063,Lion,162,60,3,3,9,12,30,3,162,159,156,134,121,91,30,30,84,78,10,4,88,0
19:12:58,3383.464,Lion,162,59,3,3,9,11,30,3,162,159,156,134,121,91,30,29,84,78,11,4,88,0
19:13:09,3386.864,Lion,162,59,3,3,9,8,33,3,162,159,156,134,124,91,30,29,84,78,11,4,88,0
19:13:23,3391.264,Lion,165,62,3,3,9,8,33,3,162,159,156,134,124,91,31,31,85,80,11,4,88,0
19:14:03,3403.664,Lion,165,62,3,3,9,8,31,5,162,159,156,134,124,93,31,31,85,80,11,4,88,0
19:14:05,3404.264,Lion,165,62,6,3,9,8,31,5,165,159,156,134,124,93,31,31,85,80,11,4,88,0
19:14:06,3404.664,Lion,165,62,6,3,6,11,31,5,165,159,156,137,124,93,31,31,85,80,11,4,88,0
19:14:09,3405.464,Lion,165,62,6,3,3,14,31,5,165,159,156,140,124,93,31,31,85,80,11,4,88,0
19:14:17,3408.063,Lion,165,61,6,3,3,14,31,4,165,159,156,140,124,93,31,30,85,80,11,4,89,0
19:15:25,3429.664,Lion,165,61,6,0,6,14,31,4,165,159,159,140,124,93,31,30,85,80,11,4,89,0
19:15:56,3439.664,Lion,168,64,6,0,6,14,31,4,165,159,159,140,124,93,32,32,86,82,11,4,89,0
19:15:59,3440.864,Lion,168,64,6,0,6,11,34,4,165,159,159,140,127,93,32,32,86,82,11,4,89,0
19:16:01,3441.464,Lion,168,64,6,0,3,14,34,4,165,159,159,143,127,93,32,32,86,82,11,4,89,0
19:16:36,3452.664,Lion,168,64,9,0,3,14,34,4,168,159,159,143,127,93,32,32,86,82,11,4,89,0
19:16:57,3459.664,Lion,171,67,9,0,3,14,34,4,168,159,159,143,127,93,35,32,89,82,11,4,89,0
19:17:04,3461.864,Lion,171,67,6,3,3,14,34,4,168,162,159,143,127,93,35,32,89,82,11,4,89,0
19:17:27,3469.264,Lion,171,66,6,3,3,14,34,3,168,162,159,143,127,93,34,32,89,82,11,4,90,0
19:17:39,3472.664,Lion,171,66,9,3,3,14,34,3,171,162,159,143,127,93,34,32,89,82,11,4,90,0
19:18:16,3484.864,Lion,171,66,9,3,3,11,37,3,171,162,159,143,130,93,34,32,89,82,11,4,90,0
19:18:19,3485.864,Lion,174,69,9,3,3,11,37,3,171,162,159,143,130,93,36,33,91,83,11,4,90,0
19:18:28,3488.664,Lion,174,69,9,3,3,11,35,5,171,162,159,143,130,95,36,33,91,83,11,4,90,0
19:18:37,3491.664,Lion,174,68,9,3,3,11,35,4,171,162,159,143,130,95,36,32,91,83,11,4,91,0
19:19:00,3498.864,Lion,174,68,12,3,3,11,35,4,174,162,159,143,130,95,36,32,91,83,11,4,91,0
19:19:03,3499.864,Lion,174,68,12,3,3,11,33,6,174,162,159,143,130,97,36,32,91,83,11,4,91,0
19:19:19,3504.664,Lion,177,71,12,3,3,11,33,6,174,162,159,143,130,97,36,35,91,86,11,4,91,0
19:19:27,3507.264,Lion,180,74,12,3,3,11,33,6,174,162,159,143,130,97,38,36,93,87,11,4,91,0
19:19:41,3511.664,Lion,183,77,12,3,3,11,33,6,174,162,159,143,130,97,39,38,94,89,11,4,91,0
19:19:49,3514.264,Lion,183,77,12,3,3,11,30,9,174,162,159,143,130,100,39,38,94,89,11,4,91,0
19:20:00,3517.664,Lion,183,77,15,3,3,11,30,9,177,162,159,143,130,100,39,38,94,89,11,4,91,0
19:20:08,3520.264,Lion,183,77,18,3,3,11,30,9,180,162,159,143,130,100,39,38,94,89,11,4,91,0
19:20:12,3521.264,Lion,183,77,15,6,3,11,30,9,180,165,159,143,130,100,39,38,94,89,11,4,91,0
19:20:24,3524.664,Lion,183,77,18,6,3,11,30,9,183,165,159,143,130,100,39,38,94,89,11,4,91,0
19:20:56,3534.264,Lion,186,80,18,6,3,11,30,9,183,165,159,143,130,100,40,40,95,91,11,4,91,0
19:21:08,3538.063,Lion,189,83,18,6,3,11,30,9,183,165,159,143,130,100,42,41,97,92,11,4,91,0
19:21:32,3545.464,Lion,189,82,18,6,3,11,30,8,183,165,159,143,130,100,42,40,97,92,11,4,92,0
19:21:38,3547.264,Lion,189,82,21,6,3,11,30,8,186,165,159,143,130,100,42,40,97,92,11,4,92,0
19:21:42,3548.264,Lion,192,85,21,6,3,11,30,8,186,165,159,143,130,100,42,43,97,95,11,4,92,0
19:21:51,3551.063,Lion,192,85,24,6,3,11,30,8,189,165,159,143,130,100,42,43,97,95,11,4,92,0
19:22:25,3561.264,Lion,192,85,27,6,3,11,30,8,192,165,159,143,130,100,42,43,97,95,11,4,92,0
19:22:37,3565.264,Lion,192,85,27,6,3,11,28,10,192,165,159,143,130,102,42,43,97,95,11,4,92,0
19:22:39,3565.864,Lion,192,84,27,6,3,11,28,9,192,165,159,143,130,102,42,42,97,95,11,4,93,0
19:22:53,3569.664,Lion,192,84,24,9,3,11,28,9,192,168,159,143,130,102,42,42,97,95,11,4,93,0
19:22:54,3570.264,Lion,192,83,24,9,3,11,28,8,192,168,159,143,130,102,41,42,97,95,11,4,94,0
19:23:02,3572.464,Lion,192,83,24,9,0,14,28,8,192,168,159,146,130,102,41,42,97,95,11,4,94,0
19:23:29,3580.464,Lion,192,82,24,9,0,14,28,7,192,168,159,146,130,102,41,41,97,95,11,4,95,0
19:24:02,3589.664,Lion,192,82,21,12,0,14,28,7,192,171,159,146,130,102,41,41,97,95,11,4,95,0
19:24:19,3594.864,Lion,192,81,21,12,0,14,28,6,192,171,159,146,130,102,40,41,97,95,11,4,96,0
19:24:36,3599.864,Lion,192,80,21,12,0,14,28,5,192,171,159,146,130,102,39,41,97,95,11,4,97,0
19:24:47,3603.063,Lion,192,80,21,12,0,12,30,5,192,171,159,146,132,102,39,41,97,95,11,4,97,0
19:25:31,3615.864,Lion,192,80,18,15,0,12,30,5,192,174,159,146,132,102,39,41,97,95,11,4,97,0
19:25:37,3617.864,Lion,192,80,18,12,3,12,30,5,192,174,162,146,132,102,39,41,97,95,11,4,97,0
19:25:55,3622.864,Lion,195,83,18,12,3,12,30,5,192,174,162,146,132,102,40,43,98,97,11,4,97,0
19:26:04,3625.664,Lion,195,83,18,12,3,9,33,5,192,174,162,146,135,102,40,43,98,97,11,4,97,0
19:26:07,3626.464,Lion,195,83,18,12,3,6,36,5,192,174,162,146,138,102,40,43,98,97,11,4,97,0
19:26:35,3634.664,Lion,195,83,15,15,3,6,36,5,192,177,162,146,138,102,40,43,98,97,11,4,97,0
19:26:40,3635.864,Lion,195,83,18,15,3,6,36,5,195,177,162,146,138,102,40,43,98,97,11,4,97,0
19:26:44,3637.264,Lion,195,83,15,18,3,6,36,5,195,180,162,146,138,102,40,43,98,97,11,4,97,0
19:26:59,3641.664,Lion,195,83,12,21,3,6,36,5,195,183,162,146,138,102,40,43,98,97,11,4,97,0
19:27:12,3645.864,Lion,195,81,12,21,3,6,36,3,195,183,162,146,138,102,40,41,98,97,11,4,99,0
19:27:46,3656.063,Lion,195,80,12,21,3,6,36,2,195,183,162,146,138,102,40,40,98,97,11,4,100,0
19:28:07,3662.464,Lion,195,80,12,21,3,3,39,2,195,183,162,146,141,102,40,40,98,97,11,4,100,0
19:28:11,3663.464,Lion,195,79,12,21,3,3,38,2,195,183,162,146,141,102,39,40,98,97,11,5,100,0
19:28:14,3664.264,Lion,195,79,9,24,3,3,38,2,195,186,162,146,141,102,39,40,98,97,11,5,100,0
19:28:26,3668.063,Lion,195,79,6,27,3,3,38,2,195,189,162,146,141,102,39,40,98,97,11,5,100,0
19:28:35,3670.664,Lion,195,79,6,27,3,3,35,5,195,189,162,146,141,105,39,40,98,97,11,5,100,0
19:28:49,3674.664,Lion,198,82,6,27,3,3,35,5,195,189,162,146,141,105,40,42,99,99,11,5,100,0
19:28:54,3676.464,Lion,198,81,6,27,3,3,35,4,195,189,162,146,141,105,39,42,99,99,11,5,101,0
19:28:56,3676.864,Lion,198,81,6,27,3,3,32,7,195,189,162,146,141,108,39,42,99,99,11,5,101,0
19:28:57,3677.264,Lion,198,81,6,24,6,3,32,7,195,189,165,146,141,108,39,42,99,99,11,5,101,0
19:28:59,3677.664,Lion,201,84,6,24,6,3,32,7,195,189,165,146,141,108,40,44,100,101,11,5,101,0
19:29:01,3678.264,Lion,201,84,3,27,6,3,32,7,195,192,165,146,141,108,40,44,100,101,11,5,101,0
19:29:05,3679.664,Lion,201,84,3,27,6,3,29,10,195,192,165,146,141,111,40,44,100,101,11,5,101,0
19:29:09,3680.664,Lion,204,87,3,27,6,3,27,12,195,192,165,146,141,113,43,44,103,101,11,5,101,0
19:29:11,3681.464,Lion,204,86,3,27,6,3,27,11,195,192,165,146,141,113,43,43,103,101,11,5,102,0
19:29:33,3687.664,Lion,204,86,6,27,6,3,27,11,198,192,165,146,141,113,43,43,103,101,11,5,102,0
19:29:43,3690.664,Lion,204,86,9,27,6,3,27,11,201,192,165,146,141,113,43,43,103,101,11,5,102,0
19:29:53,3693.664,Lion,204,86,12,27,6,3,24,14,204,192,165,146,141,116,43,43,103,101,11,5,102,0
19:30:13,3700.063,Lion,204,86,12,27,6,3,21,17,204,192,165,146,141,119,43,43,103,101,11,5,102,0
19:30:30,3704.864,Lion,204,86,12,27,6,3,19,19,204,192,165,146,141,121,43,43,103,101,11,5,102,0
19:30:49,3710.664,Lion,204,85,12,27,6,3,19,18,204,192,165,146,141,121,42,43,103,101,11,5,103,0
19:30:54,3711.864,Lion,204,85,12,27,6,3,16,21,204,192,165,146,141,124,42,43,103,101,11,5,103,0
19:31:23,3720.664,Lion,204,84,12,27,6,3,16,20,204,192,165,146,141,124,41,43,103,101,11,5,104,0
19:31:32,3723.464,Lion,204,83,12,27,6,3,16,19,204,192,165,146,141,124,41,42,103,101,11,5,105,0
19:31:35,3724.063,Lion,207,86,12,27,6,3,16,19,204,192,165,146,141,124,42,44,104,103,11,5,105,0
19:31:40,3725.664,Lion,207,86,12,24,9,3,16,19,204,192,168,146,141,124,42,44,104,103,11,5,105,0
19:31:57,3730.864,Lion,207,84,12,24,9,3,16,17,204,192,168,146,141,124,41,43,104,103,11,5,107,0
19:32:18,3737.063,Lion,207,84,15,24,9,3,16,17,207,192,168,146,141,124,41,43,104,103,11,5,107,0
19:32:33,3741.464,Lion,210,87,15,24,9,3,16,17,207,192,168,146,141,124,42,45,105,105,11,5,107,0
19:32:46,3745.664,Lion,210,87,15,21,12,3,16,17,207,192,171,146,141,124,42,45,105,105,11,5,107,0
19:33:05,3751.063,Lion,210,86,15,21,12,3,16,16,207,192,171,146,141,124,41,45,105,105,11,5,108,0
19:33:11,3752.864,Lion,210,86,12,24,12,3,16,16,207,195,171,146,141,124,41,45,105,105,11,5,108,0
19:33:17,3754.464,Lion,210,86,15,24,12,3,16,16,210,195,171,146,141,124,41,45,105,105,11,5,108,0
19:33:22,3755.864,Lion,213,89,15,24,12,3,16,16,210,195,171,146,141,124,43,46,107,106,11,5,108,0
19:33:29,3757.864,Lion,216,92,15,24,12,3,16,16,210,195,171,146,141,124,44,48,108,108,11,5,108,0
19:33:38,3760.664,Lion,216,92,15,24,9,6,16,16,210,195,171,149,141,124,44,48,108,108,11,5,108,0
19:34:00,3765.864,Lion,216,92,15,24,9,6,13,19,210,195,171,149,141,127,44,48,108,108,11,5,108,0
19:34:13,3768.864,Lion,216,92,18,24,9,6,13,19,213,195,171,149,141,127,44,48,108,108,11,5,108,0
19:34:21,3770.864,Lion,216,92,21,24,9,6,13,19,216,195,171,149,141,127,44,48,108,108,11,5,108,0
19:34:24,3771.864,Lion,216,92,21,21,12,6,13,19,216,195,174,149,141,127,44,48,108,108,11,5,108,0
19:34:37,3775.264,Lion,216,91,21,21,12,6,13,18,216,195,174,149,141,127,43,48,108,108,11,5,109,0
19:34:47,3777.864,Lion,216,90,21,21,12,6,13,17,216,195,174,149,141,127,43,47,108,108,11,5,110,0
19:34:58,3780.664,Lion,216,89,21,21,12,6,13,16,216,195,174,149,141,127,42,47,108,108,11,5,111,0
19:35:24,3786.264,Lion,219,92,21,21,12,6,13,16,216,195,174,149,141,127,42,50,108,111,11,5,111,0
19:35:45,3790.864,Lion,219,90,21,18,15,6,13,14,216,195,177,149,141,127,42,48,108,111,11,5,113,0
19:35:56,3793.464,Lion,219,90,21,15,18,3,16,14,216,195,180,149,144,127,42,48,108,111,11,5,113,0
19:36:00,3794.464,Lion,219,89,21,15,18,3,16,13,216,195,180,149,144,127,42,47,108,111,11,5,114,0
19:36:14,3797.664,Lion,219,89,21,12,21,3,16,13,216,195,183,149,144,127,42,47,108,111,11,5,114,0
19:36:21,3799.264,Lion,219,89,24,12,21,3,16,13,219,195,183,149,144,127,42,47,108,111,11,5,114,0
19:36:35,3802.664,Lion,219,88,24,12,21,3,16,12,219,195,183,149,144,127,41,47,108,111,11,5,115,0
19:36:44,3804.664,Lion,219,87,21,15,21,3,16,11,219,198,183,149,144,127,41,46,108,111,11,5,116,0
19:36:57,3807.664,Lion,219,87,18,18,21,3,16,11,219,201,183,149,144,127,41,46,108,111,11,5,116,0
19:37:06,3809.864,Lion,219,87,18,18,21,3,13,14,219,201,183,149,144,130,41,46,108,111,11,5,116,0
19:37:10,3810.664,Lion,219,87,15,21,21,3,13,14,219,204,183,149,144,130,41,46,108,111,11,5,116,0
19:37:21,3813.063,Lion,222,90,15,21,21,3,13,14,219,204,183,149,144,130,42,48,109,113,11,5,116,0
19:37:48,3819.464,Lion,222,89,15,21,20,3,13,14,219,204,183,149,144,130,42,47,109,113,12,5,116,0
19:37:51,3820.264,Lion,222,89,15,18,21,5,13,14,219,204,186,151,144,130,42,47,109,113,12,5,116,0
19:37:56,3821.464,Lion,222,88,15,18,21,5,13,13,219,204,186,151,144,130,41,47,109,113,12,5,117,0
19:38:08,3824.063,Lion,222,88,15,15,24,5,13,13,219,204,189,151,144,130,41,47,109,113,12,5,117,0
19:38:17,3826.063,Lion,222,88,18,15,24,5,13,13,222,204,189,151,144,130,41,47,109,113,12,5,117,0
19:38:47,3833.264,Lion,222,87,18,15,24,5,13,12,222,204,189,151,144,130,40,47,109,113,12,5,118,0
19:38:51,3834.264,Lion,222,87,18,12,27,5,13,12,222,204,192,151,144,130,40,47,109,113,12,5,118,0
19:39:09,3839.063,Lion,222,86,18,12,27,5,13,11,222,204,192,151,144,130,40,46,109,113,12,5,119,0
19:39:38,3846.464,Lion,222,84,18,12,27,5,13,9,222,204,192,151,144,130,40,44,109,113,12,5,121,0
19:39:43,3847.464,Lion,225,87,18,12,27,5,13,9,222,204,192,151,144,130,41,46,110,115,12,5,121,0
19:40:07,3853.664,Lion,225,86,18,12,27,5,13,8,222,204,192,151,144,130,41,45,110,115,12,5,122,0
19:40:10,3854.063,Lion,225,86,15,15,27,5,13,8,222,207,192,151,144,130,41,45,110,115,12,5,122,0
19:40:34,3859.464,Lion,225,85,15,15,27,5,13,7,222,207,192,151,144,130,41,44,110,115,12,5,123,0
19:40:39,3860.464,Lion,225,85,18,15,27,5,13,7,225,207,192,151,144,130,41,44,110,115,12,5,123,0
19:41:11,3868.464,Lion,225,85,18,15,24,8,13,7,225,207,192,154,144,130,41,44,110,115,12,5,123,0
19:41:23,3871.464,Lion,225,85,15,18,24,8,13,7,225,210,192,154,144,130,41,44,110,115,12,5,123,0
19:42:22,3885.864,Lion,225,85,12,21,24,8,13,7,225,213,192,154,144,130,41,44,110,115,12,5,123,0
19:42:29,3887.864,Lion,225,85,9,24,24,8,13,7,225,216,192,154,144,130,41,44,110,115,12,5,123,0
19:42:31,3888.464,Lion,225,85,9,24,21,11,13,7,225,216,192,157,144,130,41,44,110,115,12,5,123,0
19:42:54,3892.764,Lion,225,84,9,24,21,11,13,6,225,216,192,157,144,130,41,43,110,115,12,5,124,0
19:43:27,3897.364,Lion,225,83,9,24,21,11,13,5,225,216,192,157,144,130,40,43,110,115,12,5,125,0
19:44:05,3902.864,Lion,225,82,9,24,21,11,13,4,225,216,192,157,144,130,40,42,110,115,12,5,126,0
19:44:25,3905.764,Lion,225,81,9,24,20,11,13,4,225,216,192,157,144,130,40,41,110,115,13,5,126,0
19:44:45,3908.764,Lion,225,80,9,21,23,10,13,4,225,216,195,157,144,130,40,40,110,115,14,5,126,0
19:45:16,3913.464,Lion,225,79,9,21,22,10,13,4,225,216,195,157,144,130,39,40,110,115,15,5,126,0
19:45:24,3914.664,Lion,225,79,9,21,19,13,13,4,225,216,195,160,144,130,39,40,110,115,15,5,126,0
19:45:33,3915.964,Lion,225,78,9,21,18,13,13,4,225,216,195,160,144,130,39,39,110,115,16,5,126,0
19:45:35,3916.164,Lion,225,78,6,24,18,13,13,4,225,219,195,160,144,130,39,39,110,115,16,5,126,0
19:45:47,3917.764,Lion,225,77,6,24,18,13,13,3,225,219,195,160,144,130,38,39,110,115,16,5,127,0
19:46:34,3924.764,Lion,228,80,6,24,18,13,13,3,225,219,195,160,144,130,40,40,112,116,16,5,127,0
19:46:55,3928.063,Lion,228,80,6,24,18,13,11,5,225,219,195,160,144,132,40,40,112,116,16,5,127,0
19:47:01,3928.964,Lion,228,79,6,24,17,13,11,5,225,219,195,160,144,132,40,39,112,116,16,6,127,0
19:47:13,3930.764,Lion,228,78,6,24,17,13,11,4,225,219,195,160,144,132,39,39,112,116,16,6,128,0
19:47:30,3933.464,Lion,228,78,6,24,15,15,11,4,225,219,195,162,144,132,39,39,112,116,16,6,128,0
19:47:47,3936.063,Lion,228,78,6,24,13,17,11,4,225,219,195,164,144,132,39,39,112,116,16,6,128,0
19:47:58,3937.664,Lion,228,78,9,24,13,17,11,4,228,219,195,164,144,132,39,39,112,116,16,6,128,0
19:48:16,3940.464,Lion,228,78,9,24,11,19,11,4,228,219,195,166,144,132,39,39,112,116,16,6,128,0
19:48:32,3942.964,Lion,228,78,6,27,11,19,11,4,228,222,195,166,144,132,39,39,112,116,16,6,128,0
19:49:22,3950.664,Lion,228,78,6,27,11,19,8,7,228,222,195,166,144,135,39,39,112,116,16,6,128,0
19:49:24,3950.964,Lion,228,77,6,27,11,19,8,6,228,222,195,166,144,135,38,39,112,116,16,6,129,0
19:49:27,3951.464,Lion,228,77,6,27,11,19,5,9,228,222,195,166,144,138,38,39,112,116,16,6,129,0
19:50:29,3960.464,Lion,228,77,6,24,14,19,5,9,228,222,198,166,144,138,38,39,112,116,16,6,129,0
19:50:47,3963.063,Lion,228,77,6,24,12,21,5,9,228,222,198,168,144,138,38,39,112,116,16,6,129,0
19:50:50,3963.464,Lion,228,77,6,21,15,21,5,9,228,222,201,168,144,138,38,39,112,116,16,6,129,0
19:51:10,3966.464,Lion,228,77,6,18,18,21,5,9,228,222,204,168,144,138,38,39,112,116,16,6,129,0
19:51:12,3966.864,Lion,228,77,6,18,15,24,5,9,228,222,204,171,144,138,38,39,112,116,16,6,129,0
19:51:15,3967.164,Lion,231,80,6,18,15,24,5,9,228,222,204,171,144,138,39,41,113,118,16,6,129,0
19:52:06,3975.063,Lion,231,79,6,18,15,23,5,9,228,222,204,171,144,138,38,41,113,118,16,7,129,0
19:52:20,3977.063,Lion,231,79,6,18,12,26,5,9,228,222,204,174,144,138,38,41,113,118,16,7,129,0
19:52:22,3977.364,Lion,231,79,3,21,12,26,5,9,228,225,204,174,144,138,38,41,113,118,16,7,129,0
19:52:29,3978.563,Lion,231,78,3,21,12,26,5,8,228,225,204,174,144,138,37,41,113,118,16,7,130,0
19:52:40,3980.063,Lion,231,78,6,21,12,26,5,8,231,225,204,174,144,138,37,41,113,118,16,7,130,0
19:52:51,3981.764,Lion,231,77,6,21,12,23,8,7,231,225,204,174,147,138,37,40,113,118,16,7,131,0
19:53:44,3987.464,Lion,231,77,6,21,12,23,6,9,231,225,204,174,147,140,37,40,113,118,16,7,131,0
19:54:16,3991.364,Lion,231,76,6,21,12,23,6,8,231,225,204,174,147,140,37,39,113,118,16,7,132,0
19:56:49,4009.864,Lion,231,76,6,18,15,23,6,8,231,225,207,174,147,140,37,39,113,118,16,7,132,0
19:59:19,4027.264,Lion,231,76,6,15,18,23,6,8,231,225,210,174,147,140,37,39,113,118,16,7,132,0
19:59:59,4032.264,Lion,231,75,6,15,18,23,6,7,231,225,210,174,147,140,36,39,113,118,16,7,133,0
20:00:45,4037.964,Lion,231,74,6,15,18,23,6,6,231,225,210,174,147,140,35,39,113,118,16,7,134,0
20:00:57,4039.164,Lion,231,73,6,15,18,23,6,5,231,225,210,174,147,140,34,39,113,118,16,7,135,0
20:01:07,4040.264,Lion,234,76,6,15,18,23,6,5,231,225,210,174,147,140,37,39,116,118,16,7,135,0
20:01:15,4041.164,Lion,234,76,6,15,18,21,8,5,231,225,210,174,149,140,37,39,116,118,16,7,135,0
20:01:19,4041.664,Lion,234,76,6,12,21,21,8,5,231,225,213,174,149,140,37,39,116,118,16,7,135,0
20:01:37,4043.664,Lion,234,76,6,9,24,21,8,5,231,225,216,174,149,140,37,39,116,118,16,7,135,0
20:02:17,4048.063,Lion,234,75,6,9,24,21,8,4,231,225,216,174,149,140,37,38,116,118,16,7,136,0
20:02:48,4051.664,Lion,234,74,6,9,21,24,8,3,231,225,216,177,149,140,36,38,116,118,16,7,137,0
20:03:00,4053.164,Lion,234,74,9,9,21,24,8,3,234,225,216,177,149,140,36,38,116,118,16,7,137,0
20:03:13,4054.764,Lion,234,74,6,12,21,24,8,3,234,228,216,177,149,140,36,38,116,118,16,7,137,0
20:05:36,4071.864,Lion,234,73,6,12,21,24,8,2,234,228,216,177,149,140,35,38,116,118,16,7,138,0
20:05:38,4072.063,Lion,234,73,6,9,24,24,8,2,234,228,219,177,149,140,35,38,116,118,16,7,138,0
20:07:37,4088.464,Lion,237,76,6,9,24,24,8,2,234,228,219,177,149,140,37,39,118,119,16,7,138,0
20:07:44,4089.563,Lion,237,76,6,9,24,22,10,2,234,228,219,177,151,140,37,39,118,119,16,7,138,0
20:08:01,4092.164,Lion,237,75,6,9,23,22,10,2,234,228,219,177,151,140,36,39,118,119,16,8,138,0
20:08:06,4092.864,Lion,237,74,6,9,23,22,10,1,234,228,219,177,151,140,35,39,118,119,16,8,139,0
20:08:36,4097.164,Lion,237,74,3,12,23,22,10,1,234,231,219,177,151,140,35,39,118,119,16,8,139,0
20:08:47,4098.864,Lion,237,74,3,9,26,22,10,1,234,231,222,177,151,140,35,39,118,119,16,8,139,0
20:09:05,4101.364,Lion,237,74,6,9,26,22,10,1,237,231,222,177,151,140,35,39,118,119,16,8,139,0
20:09:19,4103.463,Lion,237,74,6,9,23,25,10,1,237,231,222,180,151,140,35,39,118,119,16,8,139,0
20:09:41,4106.463,Lion,237,74,6,9,20,28,10,1,237,231,222,183,151,140,35,39,118,119,16,8,139,0
20:10:02,4109.563,Lion,237,74,6,9,18,27,13,1,237,231,222,185,154,140,35,39,118,119,16,8,139,0
20:11:07,4118.563,Lion,237,74,6,9,18,27,10,4,237,231,222,185,154,143,35,39,118,119,16,8,139,0
20:12:55,4133.264,Lion,237,74,6,6,21,27,10,4,237,231,225,185,154,143,35,39,118,119,16,8,139,0
20:13:15,4135.764,Lion,237,74,6,6,21,25,12,4,237,231,225,185,156,143,35,39,118,119,16,8,139,0
20:14:05,4142.563,Lion,237,73,6,6,21,25,12,3,237,231,225,185,156,143,35,38,118,119,16,8,140,0
20:15:16,4152.864,Lion,237,73,6,6,18,28,12,3,237,231,225,188,156,143,35,38,118,119,16,8,140,0
20:15:27,4154.563,Lion,237,73,6,6,18,26,14,3,237,231,225,188,158,143,35,38,118,119,16,8,140,0
20:15:37,4155.864,Lion,240,76,6,6,18,26,14,3,237,231,225,188,158,143,35,41,118,122,16,8,140,0
20:15:46,4157.164,Lion,240,76,6,6,18,24,16,3,237,231,225,188,160,143,35,41,118,122,16,8,140,0
20:16:18,4161.563,Lion,240,76,6,6,18,22,18,3,237,231,225,188,162,143,35,41,118,122,16,8,140,0
20:17:10,4168.764,Lion,240,76,9,6,18,22,18,3,240,231,225,188,162,143,35,41,118,122,16,8,140,0
20:17:24,4170.264,Lion,240,76,6,9,15,25,18,3,240,234,225,191,162,143,35,41,118,122,16,8,140,0
20:17:36,4171.764,Lion,243,79,6,9,15,25,18,3,240,234,225,191,162,143,36,43,119,124,16,8,140,0
20:18:36,4180.264,Lion,243,78,6,9,14,25,18,3,240,234,225,191,162,143,36,42,119,124,17,8,140,0
20:18:41,4180.963,Lion,243,77,6,9,13,25,18,3,240,234,225,191,162,143,35,42,119,124,18,8,140,0
20:19:14,4184.164,Lion,243,77,6,9,13,23,20,3,240,234,225,191,164,143,35,42,119,124,18,8,140,0
20:19:20,4184.664,Lion,243,77,9,9,11,25,20,3,243,234,225,193,164,143,35,42,119,124,18,8,140,0
20:19:39,4186.664,Lion,243,77,9,9,8,28,20,3,243,234,225,196,164,143,35,42,119,124,18,8,140,0
20:19:52,4187.963,Lion,243,77,9,9,8,25,23,3,243,234,225,196,167,143,35,42,119,124,18,8,140,0
20:20:11,4189.764,Lion,246,80,9,9,8,25,23,3,243,234,225,196,167,143,38,42,122,124,18,8,140,0
20:21:35,4198.164,Lion,246,80,9,9,8,22,26,3,243,234,225,196,170,143,38,42,122,124,18,8,140,0
20:21:48,4199.463,Lion,246,79,9,9,7,22,26,3,243,234,225,196,170,143,38,41,122,124,19,8,140,0
20:22:21,4202.664,Lion,246,79,12,9,7,22,26,3,246,234,225,196,170,143,38,41,122,124,19,8,140,0
20:23:32,4210.664,Lion,246,79,12,6,10,22,26,3,246,234,228,196,170,143,38,41,122,124,19,8,140,0
20:24:05,4215.063,Lion,246,79,12,6,9,23,26,3,246,234,228,197,170,143,38,41,122,124,19,8,140,0
20:24:31,4218.463,Lion,246,79,9,9,9,23,26,3,246,237,228,197,170,143,38,41,122,124,19,8,140,0
20:24:39,4219.563,Lion,246,78,9,9,9,23,26,2,246,237,228,197,170,143,37,41,122,124,19,8,141,0
20:24:55,4221.563,Lion,246,77,9,9,9,22,26,2,246,237,228,197,170,143,37,40,122,124,20,8,141,0
20:25:20,4224.864,Lion,249,80,9,9,9,22,26,2,246,237,228,197,170,143,38,42,123,126,20,8,141,0
20:25:54,4229.164,Lion,252,83,9,9,9,22,26,2,246,237,228,197,170,143,38,45,123,129,20,8,141,0
20:27:02,4237.764,Lion,252,83,12,9,9,22,26,2,249,237,228,197,170,143,38,45,123,129,20,8,141,0
20:27:33,4241.864,Lion,252,83,12,9,6,25,26,2,249,237,228,200,170,143,38,45,123,129,20,8,141,0
20:27:35,4242.063,Lion,252,83,15,9,6,25,26,2,252,237,228,200,170,143,38,45,123,129,20,8,141,0
20:27:39,4242.563,Lion,255,86,15,9,6,25,26,2,252,237,228,200,170,143,38,48,123,132,20,8,141,0
20:28:58,4252.764,Lion,258,89,15,9,6,25,26,2,252,237,228,200,170,143,39,50,124,134,20,8,141,0
20:29:00,4253.063,Lion,258,89,15,6,9,25,26,2,252,237,231,200,170,143,39,50,124,134,20,8,141,0
20:29:20,4255.463,Lion,258,89,18,6,9,25,26,2,255,237,231,200,170,143,39,50,124,134,20,8,141,0
20:30:25,4263.664,Lion,261,92,18,6,9,25,26,2,255,237,231,200,170,143,39,53,124,137,20,8,141,0
20:30:42,4265.664,Lion,261,92,21,6,9,25,26,2,258,237,231,200,170,143,39,53,124,137,20,8,141,0
20:31:36,4272.264,Lion,264,95,21,6,9,25,26,2,258,237,231,200,170,143,40,55,125,139,20,8,141,0
20:31:40,4272.764,Lion,264,95,21,6,9,22,29,2,258,237,231,200,173,143,40,55,125,139,20,8,141,0
20:32:08,4276.264,Lion,264,95,21,6,6,25,29,2,258,237,231,203,173,143,40,55,125,139,20,8,141,0
20:32:11,4276.563,Lion,264,95,24,6,6,25,29,2,261,237,231,203,173,143,40,55,125,139,20,8,141,0
20:32:22,4277.864,Lion,267,98,24,6,6,25,29,2,261,237,231,203,173,143,43,55,128,139,20,8,141,0
20:32:41,4280.164,Lion,267,97,24,6,6,25,29,1,261,237,231,203,173,143,43,54,128,139,20,8,142,0
20:33:24,4285.164,Lion,267,97,27,6,6,25,29,1,264,237,231,203,173,143,43,54,128,139,20,8,142,0
20:33:30,4285.864,Lion,267,97,24,9,6,25,29,1,264,240,231,203,173,143,43,54,128,139,20,8,142,0
20:34:07,4290.264,Lion,267,96,24,9,6,25,29,0,264,240,231,203,173,143,42,54,128,139,20,8,143,0
20:34:11,4290.764,Lion,267,96,27,9,6,25,29,0,267,240,231,203,173,143,42,54,128,139,20,8,143,0
20:35:43,4301.764,Lion,267,96,24,12,6,25,29,0,267,243,231,203,173,143,42,54,128,139,20,8,143,0
20:36:24,4306.764,Lion,267,96,24,12,6,25,26,3,267,243,231,203,173,146,42,54,128,139,20,8,143,0
20:38:14,4319.764,Lion,267,96,21,15,6,25,26,3,267,246,231,203,173,146,42,54,128,139,20,8,143,0
20:38:52,4324.563,Lion,267,96,21,15,6,22,29,3,267,246,231,203,176,146,42,54,128,139,20,8,143,0
20:39:05,4326.164,Lion,267,96,21,12,9,22,29,3,267,246,234,203,176,146,42,54,128,139,20,8,143,0
20:39:16,4327.563,Lion,267,96,21,12,9,19,32,3,267,246,234,203,179,146,42,54,128,139,20,8,143,0
20:39:40,4330.563,Lion,267,96,21,12,9,17,34,3,267,246,234,203,181,146,42,54,128,139,20,8,143,0
20:40:06,4333.864,Lion,270,99,21,12,9,17,34,3,267,246,234,203,181,146,43,56,129,141,20,8,143,0
20:41:31,4344.664,Lion,270,98,21,12,8,17,34,3,267,246,234,203,181,146,43,55,129,141,21,8,143,0
20:41:50,4346.764,Lion,270,98,24,12,8,17,34,3,270,246,234,203,181,146,43,55,129,141,21,8,143,0
20:42:45,4353.664,Lion,270,98,24,12,6,19,34,3,270,246,234,205,181,146,43,55,129,141,21,8,143,0
20:42:55,4354.864,Lion,270,98,21,15,6,19,34,3,270,249,234,205,181,146,43,55,129,141,21,8,143,0
20:43:29,4359.164,Lion,270,98,18,18,6,19,34,3,270,252,234,205,181,146,43,55,129,141,21,8,143,0
20:44:25,4366.264,Lion,270,98,18,18,6,19,32,5,270,252,234,205,181,148,43,55,129,141,21,8,143,0
20:44:34,4367.364,Lion,270,97,18,18,6,19,32,4,270,252,234,205,181,148,42,55,129,141,21,8,144,0
20:45:15,4372.563,Lion,270,97,15,21,6,19,32,4,270,255,234,205,181,148,42,55,129,141,21,8,144,0
20:45:26,4373.963,Lion,270,97,15,21,6,16,35,4,270,255,234,205,184,148,42,55,129,141,21,8,144,0
20:45:29,4374.364,Lion,270,97,15,18,9,16,35,4,270,255,237,205,184,148,42,55,129,141,21,8,144,0
20:46:17,4380.463,Lion,273,99,15,18,8,16,35,4,270,255,237,205,184,148,41,58,129,144,21,9,144,0
20:46:34,4382.764,Lion,273,99,12,21,8,16,35,4,270,258,237,205,184,148,41,58,129,144,21,9,144,0
20:47:38,4391.364,Lion,273,99,12,21,8,13,38,4,270,258,237,205,187,148,41,58,129,144,21,9,144,0
20:47:54,4393.364,Lion,273,99,15,21,8,13,38,4,273,258,237,205,187,148,41,58,129,144,21,9,144,0
20:47:56,4393.664,Lion,273,99,12,24,8,13,38,4,273,261,237,205,187,148,41,58,129,144,21,9,144,0
20:48:14,4396.063,Lion,273,99,12,24,6,15,38,4,273,261,237,207,187,148,41,58,129,144,21,9,144,0
20:48:31,4398.364,Lion,273,98,12,24,6,14,38,4,273,261,237,207,187,148,41,57,129,144,21,10,144,0
20:48:40,4399.563,Lion,276,101,12,24,6,14,38,4,273,261,237,207,187,148,42,59,130,146,21,10,144,0
20:49:00,4402.264,Lion,276,101,9,27,6,14,38,4,273,264,237,207,187,148,42,59,130,146,21,10,144,0
20:49:26,4405.764,Lion,276,101,9,27,6,12,40,4,273,264,237,207,189,148,42,59,130,146,21,10,144,0
20:49:43,4407.864,Lion,276,101,6,30,6,9,43,4,273,267,237,207,192,148,42,59,130,146,21,10,144,0
20:50:18,4412.463,Lion,276,101,9,30,6,9,43,4,276,267,237,207,192,148,42,59,130,146,21,10,144,0
20:50:34,4414.664,Lion,276,101,9,30,6,9,41,6,276,267,237,207,192,150,42,59,130,146,21,10,144,0
20:50:59,4417.864,Lion,276,99,9,30,6,9,41,4,276,267,237,207,192,150,41,58,130,146,21,10,146,0
20:52:10,4426.864,Lion,279,102,9,30,6,9,41,4,276,267,237,207,192,150,42,60,131,148,21,10,146,0
20:53:13,4434.664,Lion,279,102,9,30,6,9,38,7,276,267,237,207,192,153,42,60,131,148,21,10,146,0
20:53:26,4436.463,Lion,279,101,9,30,5,9,38,7,276,267,237,207,192,153,41,60,131,148,21,11,146,0
20:53:54,4439.764,Lion,279,101,12,30,5,9,38,7,279,267,237,207,192,153,41,60,131,148,21,11,146,0
20:54:09,4441.764,Lion,279,101,12,27,8,9,38,7,279,267,240,207,192,153,41,60,131,148,21,11,146,0
20:55:45,4453.963,Lion,282,104,12,27,8,9,38,7,279,267,240,207,192,153,41,63,131,151,21,11,146,0
20:56:13,4457.664,Lion,282,104,12,24,11,9,38,7,279,267,243,207,192,153,41,63,131,151,21,11,146,0
20:56:29,4459.563,Lion,285,107,12,24,11,9,38,7,279,267,243,207,192,153,43,64,133,152,21,11,146,0
20:56:38,4460.864,Lion,285,107,12,24,11,9,36,9,279,267,243,207,192,155,43,64,133,152,21,11,146,0
20:56:55,4462.963,Lion,285,107,12,24,11,6,39,9,279,267,243,207,195,155,43,64,133,152,21,11,146,0
20:57:03,4463.864,Lion,285,107,9,27,11,6,39,9,279,270,243,207,195,155,43,64,133,152,21,11,146,0
20:57:26,4466.864,Lion,285,107,12,27,11,6,39,9,282,270,243,207,195,155,43,64,133,152,21,11,146,0
20:57:29,4467.264,Lion,285,106,12,27,11,6,39,8,282,270,243,207,195,155,42,64,133,152,21,11,147,0
20:57:43,4469.164,Lion,285,106,12,27,9,8,39,8,282,270,243,209,195,155,42,64,133,152,21,11,147,0
20:58:09,4472.463,Lion,285,106,15,27,9,8,39,8,285,270,243,209,195,155,42,64,133,152,21,11,147,0
20:58:34,4475.664,Lion,285,106,15,24,12,8,39,8,285,270,246,209,195,155,42,64,133,152,21,11,147,0
20:59:06,4479.664,Lion,285,106,15,24,12,8,37,10,285,270,246,209,195,157,42,64,133,152,21,11,147,0
20:59:17,4481.063,Lion,285,105,15,24,12,8,37,9,285,270,246,209,195,157,42,63,133,152,21,11,148,0
20:59:27,4482.264,Lion,285,105,15,24,12,8,35,11,285,270,246,209,195,159,42,63,133,152,21,11,148,0
21:00:02,4486.664,Lion,285,105,15,24,12,8,33,13,285,270,246,209,195,161,42,63,133,152,21,11,148,0
21:00:49,4492.364,Lion,285,104,15,24,12,8,33,12,285,270,246,209,195,161,42,62,133,152,21,11,149,0
21:01:01,4493.764,Lion,288,107,15,24,12,8,33,12,285,270,246,209,195,161,42,65,133,155,21,11,149,0
21:01:10,4494.864,Lion,291,110,15,24,12,8,33,12,285,270,246,209,195,161,44,66,135,156,21,11,149,0
21:01:14,4495.463,Lion,291,109,15,24,12,8,33,11,285,270,246,209,195,161,44,65,135,156,21,11,150,0
21:01:30,4497.364,Lion,291,109,15,24,12,5,36,11,285,270,246,209,198,161,44,65,135,156,21,11,150,0
21:01:50,4499.864,Lion,291,108,15,24,12,5,36,10,285,270,246,209,198,161,44,64,135,156,21,11,151,0
21:02:18,4502.963,Lion,294,111,15,24,12,5,36,10,285,270,246,209,198,161,46,65,137,157,21,11,151,0
21:02:39,4505.563,Lion,294,110,15,24,12,5,36,9,285,270,246,209,198,161,45,65,137,157,21,11,152,0
21:02:49,4506.664,Lion,294,110,18,24,12,5,36,9,288,270,246,209,198,161,45,65,137,157,21,11,152,0
21:02:58,4507.764,Lion,294,110,21,24,12,5,36,9,291,270,246,209,198,161,45,65,137,157,21,11,152,0
21:03:10,4509.264,Lion,294,110,21,24,12,5,34,11,291,270,246,209,198,163,45,65,137,157,21,11,152,0
21:03:21,4510.463,Lion,294,110,18,27,12,5,34,11,291,273,246,209,198,163,45,65,137,157,21,11,152,0
21:03:23,4510.764,Lion,294,110,18,24,15,5,34,11,291,273,249,209,198,163,45,65,137,157,21,11,152,0
21:03:34,4511.963,Lion,297,113,18,24,15,5,34,11,291,273,249,209,198,163,47,66,139,158,21,11,152,0
21:03:42,4513.063,Lion,297,113,18,24,15,5,31,14,291,273,249,209,198,166,47,66,139,158,21,11,152,0
21:04:00,4515.063,Lion,297,113,18,21,18,5,31,14,291,273,252,209,198,166,47,66,139,158,21,11,152,0
21:04:07,4515.864,Lion,297,113,21,21,18,5,31,14,294,273,252,209,198,166,47,66,139,158,21,11,152,0
21:04:20,4517.364,Lion,297,113,21,21,15,8,31,14,294,273,252,212,198,166,47,66,139,158,21,11,152,0
21:04:23,4517.764,Lion,297,112,21,21,15,8,31,13,294,273,252,212,198,166,47,65,139,158,21,11,153,0
21:04:44,4520.063,Lion,297,111,21,21,15,8,31,12,294,273,252,212,198,166,47,64,139,158,21,11,154,0
21:05:12,4523.264,Lion,297,111,21,21,15,8,28,15,294,273,252,212,198,169,47,64,139,158,21,11,154,0
21:05:27,4524.864,Lion,297,111,24,21,15,8,28,15,297,273,252,212,198,169,47,64,139,158,21,11,154,0
21:05:32,4525.563,Lion,297,110,24,21,15,8,28,14,297,273,252,212,198,169,46,64,139,158,21,11,155,0
21:05:58,4528.463,Lion,297,110,24,18,18,8,28,14,297,273,255,212,198,169,46,64,139,158,21,11,155,0
21:06:08,4529.563,Lion,297,110,21,21,18,8,28,14,297,276,255,212,198,169,46,64,139,158,21,11,155,0
21:06:25,4531.563,Lion,300,113,21,21,18,8,28,14,297,276,255,212,198,169,47,66,140,160,21,11,155,0
21:07:26,4538.664,Lion,300,113,21,18,21,8,28,14,297,276,258,212,198,169,47,66,140,160,21,11,155,0
21:07:51,4541.664,Lion,300,112,21,18,21,8,28,13,297,276,258,212,198,169,46,66,140,160,21,11,156,0
21:08:15,4544.463,Lion,300,112,24,18,21,8,28,13,300,276,258,212,198,169,46,66,140,160,21,11,156,0
21:08:38,4547.264,Lion,300,111,24,18,21,8,28,12,300,276,258,212,198,169,46,65,140,160,21,11,157,0
21:08:57,4549.563,Lion,300,111,24,15,24,8,28,12,300,276,261,212,198,169,46,65,140,160,21,11,157,0
21:09:57,4556.864,Lion,300,111,21,18,24,8,28,12,300,279,261,212,198,169,46,65,140,160,21,11,157,0
21:10:01,4557.364,Lion,300,110,21,18,24,8,28,11,300,279,261,212,198,169,45,65,140,160,21,11,158,0
21:10:07,4558.164,Lion,300,110,21,15,27,8,28,11,300,279,264,212,198,169,45,65,140,160,21,11,158,0
21:10:38,4561.864,Lion,300,109,21,15,26,8,28,11,300,279,264,212,198,169,44,65,140,160,22,11,158,0
21:10:53,4563.764,Lion,300,109,21,12,29,8,28,11,300,279,267,212,198,169,44,65,140,160,22,11,158,0
21:12:26,4574.764,Lion,300,109,21,12,29,6,30,11,300,279,267,212,200,169,44,65,140,160,22,11,158,0
21:12:37,4576.063,Lion,300,108,21,12,29,6,30,10,300,279,267,212,200,169,43,65,140,160,22,11,159,0
21:13:44,4583.963,Lion,300,108,18,15,29,6,30,10,300,282,267,212,200,169,43,65,140,160,22,11,159,0
21:13:50,4584.764,Lion,300,108,18,15,26,9,30,10,300,282,267,215,200,169,43,65,140,160,22,11,159,0
21:14:30,4589.563,Lion,300,108,15,18,26,9,30,10,300,285,267,215,200,169,43,65,140,160,22,11,159,0
21:15:07,4593.963,Lion,300,106,15,18,26,9,30,8,300,285,267,215,200,169,43,63,140,160,22,11,161,0
21:15:39,4597.864,Lion,300,106,15,18,26,9,27,11,300,285,267,215,200,172,43,63,140,160,22,11,161,0
21:15:59,4600.164,Lion,300,105,15,18,26,9,27,10,300,285,267,215,200,172,43,62,140,160,22,11,162,0
21:16:03,4600.664,Lion,300,105,15,18,24,11,27,10,300,285,267,217,200,172,43,62,140,160,22,11,162,0
21:16:26,4603.463,Lion,300,104,15,18,24,11,27,9,300,285,267,217,200,172,42,62,140,160,22,11,163,0
21:16:30,4603.963,Lion,300,103,15,18,24,11,27,8,300,285,267,217,200,172,41,62,140,160,22,11,164,0
21:16:50,4606.364,Lion,300,102,15,18,24,11,27,7,300,285,267,217,200,172,40,62,140,160,22,11,165,0
21:17:00,4607.563,Lion,303,105,15,18,24,11,27,7,300,285,267,217,200,172,41,64,141,162,22,11,165,0
21:17:03,4607.963,Lion,303,104,15,18,24,11,27,6,300,285,267,217,200,172,41,63,141,162,22,11,166,0
21:17:54,4614.164,Lion,303,102,15,18,24,11,27,4,300,285,267,217,200,172,41,61,141,162,22,11,168,0
21:18:01,4614.963,Lion,306,105,15,18,24,11,27,4,300,285,267,217,200,172,41,64,141,165,22,11,168,0
21:18:18,4617.164,Lion,306,105,15,18,24,10,28,4,300,285,267,217,201,172,41,64,141,165,22,11,168,0
21:18:25,4618.063,Lion,306,104,15,18,24,10,28,3,300,285,267,217,201,172,41,63,141,165,22,11,169,0
21:18:30,4618.664,Lion,306,104,15,18,21,13,28,3,300,285,267,220,201,172,41,63,141,165,22,11,169,0
21:18:39,4619.764,Lion,306,104,15,15,24,13,28,3,300,285,270,220,201,172,41,63,141,165,22,11,169,0
21:18:45,4620.463,Lion,306,104,18,15,24,13,28,3,303,285,270,220,201,172,41,63,141,165,22,11,169,0
21:18:59,4622.164,Lion,309,107,18,15,24,13,28,3,303,285,270,220,201,172,41,66,141,168,22,11,169,0
21:19:12,4623.764,Lion,309,107,15,18,24,13,28,3,303,288,270,220,201,172,41,66,141,168,22,11,169,0
21:19:21,4624.864,Lion,309,107,12,21,24,13,28,3,303,291,270,220,201,172,41,66,141,168,22,11,169,0
21:19:46,4627.864,Lion,309,107,15,21,24,13,28,3,306,291,270,220,201,172,41,66,141,168,22,11,169,0
21:20:29,4632.963,Lion,309,107,12,24,24,13,28,3,306,294,270,220,201,172,41,66,141,168,22,11,169,0
21:20:47,4635.063,Lion,309,107,15,24,24,13,28,3,309,294,270,220,201,172,41,66,141,168,22,11,169,0
21:21:44,4641.963,Lion,309,107,12,27,24,13,28,3,309,297,270,220,201,172,41,66,141,168,22,11,169,0
21:22:37,4648.364,Lion,309,106,12,27,24,13,28,2,309,297,270,220,201,172,40,66,141,168,22,11,170,0
21:22:48,4649.563,Lion,309,106,12,27,24,13,25,5,309,297,270,220,201,175,40,66,141,168,22,11,170,0
21:22:57,4650.664,Lion,309,105,12,27,24,13,25,4,309,297,270,220,201,175,39,66,141,168,22,11,171,0
21:23:13,4652.563,Lion,309,105,12,27,24,13,22,7,309,297,270,220,201,178,39,66,141,168,22,11,171,0
21:23:23,4653.764,Lion,309,105,12,27,21,16,22,7,309,297,270,223,201,178,39,66,141,168,22,11,171,0
21:23:38,4655.563,Lion,309,105,12,27,21,16,20,9,309,297,270,223,201,180,39,66,141,168,22,11,171,0
21:23:59,4658.063,Lion,309,105,12,27,18,19,20,9,309,297,270,226,201,180,39,66,141,168,22,11,171,0
21:24:29,4661.563,Lion,309,105,9,30,18,19,20,9,309,300,270,226,201,180,39,66,141,168,22,11,171,0
21:24:38,4662.664,Lion,309,104,9,30,18,19,20,8,309,300,270,226,201,180,38,66,141,168,22,11,172,0
21:25:09,4666.364,Lion,309,104,9,27,21,19,20,8,309,300,273,226,201,180,38,66,141,168,22,11,172,0
21:25:52,4671.463,Lion,309,104,9,27,18,22,20,8,309,300,273,229,201,180,38,66,141,168,22,11,172,0
21:27:08,4680.563,Lion,309,102,9,27,16,22,20,8,309,300,273,229,201,180,36,66,141,168,24,11,172,0
21:27:17,4681.664,Lion,309,102,9,27,13,25,20,8,309,300,273,232,201,180,36,66,141,168,24,11,172,0
21:27:29,4682.864,Lion,309,101,9,27,13,25,20,7,309,300,273,232,201,180,36,65,141,168,24,11,173,0
21:27:44,4684.664,Lion,309,100,9,27,12,25,20,7,309,300,273,232,201,180,36,64,141,168,25,11,173,0
21:27:51,4685.463,Lion,309,100,9,24,15,25,20,7,309,300,276,232,201,180,36,64,141,168,25,11,173,0
21:28:37,4690.264,Lion,309,100,9,24,15,23,22,7,309,300,276,232,203,180,36,64,141,168,25,11,173,0
21:28:57,4692.563,Lion,309,100,9,24,13,25,22,7,309,300,276,234,203,180,36,64,141,168,25,11,173,0
21:29:53,4698.963,Lion,309,100,9,24,13,25,19,10,309,300,276,234,203,183,36,64,141,168,25,11,173,0
21:30:23,4701.164,Lion,309,100,9,24,10,28,19,10,309,300,276,237,203,183,36,64,141,168,25,11,173,0
21:30:55,4704.963,Lion,309,99,9,24,10,28,19,9,309,300,276,237,203,183,35,64,141,168,25,11,174,0
21:31:10,4706.764,Lion,309,99,9,24,9,29,19,9,309,300,276,238,203,183,35,64,141,168,25,11,174,0
21:31:39,4710.164,Lion,309,97,9,24,9,29,19,7,309,300,276,238,203,183,34,63,141,168,25,11,176,0
21:32:00,4712.764,Lion,309,97,9,21,12,29,19,7,309,300,279,238,203,183,34,63,141,168,25,11,176,0
21:32:32,4716.364,Lion,309,97,9,21,12,29,16,10,309,300,279,238,203,186,34,63,141,168,25,11,176,0
21:34:35,4730.764,Lion,309,97,9,21,12,29,14,12,309,300,279,238,203,188,34,63,141,168,25,11,176,0
21:34:53,4732.764,Lion,309,97,9,21,12,29,11,15,309,300,279,238,203,191,34,63,141,168,25,11,176,0
21:35:37,4737.563,Lion,309,97,6,24,12,29,11,15,309,303,279,238,203,191,34,63,141,168,25,11,176,0
21:35:44,4738.463,Lion,309,97,6,24,12,26,14,15,309,303,279,238,206,191,34,63,141,168,25,11,176,0
21:35:52,4739.364,Lion,309,96,6,24,12,26,14,14,309,303,279,238,206,191,34,62,141,168,25,11,177,0
21:35:57,4739.864,Lion,309,96,6,21,15,26,14,14,309,303,282,238,206,191,34,62,141,168,25,11,177,0
21:36:43,4744.963,Lion,309,96,3,24,15,26,14,14,309,306,282,238,206,191,34,62,141,168,25,11,177,0
21:36:47,4745.463,Lion,309,96,3,21,18,26,14,14,309,306,285,238,206,191,34,62,141,168,25,11,177,0
21:37:20,4749.063,Lion,309,95,3,21,18,25,14,14,309,306,285,238,206,191,33,62,141,168,26,11,177,0
21:37:51,4752.164,Lion,309,95,0,24,18,25,14,14,309,309,285,238,206,191,33,62,141,168,26,11,177,0
21:37:58,4752.963,Lion,309,94,0,24,18,25,14,13,309,309,285,238,206,191,33,61,141,168,26,11,178,0
21:38:55,4758.664,Lion,312,97,0,24,18,25,14,13,309,309,285,238,206,191,36,61,144,168,26,11,178,0
21:38:56,4758.864,Lion,312,96,0,24,17,25,14,13,309,309,285,238,206,191,36,60,144,168,27,11,178,0
21:39:26,4761.963,Lion,312,95,0,24,16,25,14,13,309,309,285,238,206,191,36,59,144,168,28,11,178,0
21:39:33,4762.764,Lion,312,95,0,24,15,26,14,13,309,309,285,239,206,191,36,59,144,168,28,11,178,0
21:40:37,4769.664,Lion,312,94,0,24,15,26,14,12,309,309,285,239,206,191,35,59,144,168,28,11,179,0
21:40:51,4771.164,Lion,312,93,0,24,15,26,14,11,309,309,285,239,206,191,34,59,144,168,28,11,180,0
21:40:56,4771.563,Lion,312,93,3,24,15,26,14,11,312,309,285,239,206,191,34,59,144,168,28,11,180,0
21:42:10,4779.664,Lion,312,93,3,21,18,26,14,11,312,309,288,239,206,191,34,59,144,168,28,11,180,0
21:42:20,4780.864,Lion,312,92,3,18,21,26,14,10,312,309,291,239,206,191,34,58,144,168,28,11,181,0
21:42:44,4783.264,Lion,312,91,3,18,21,26,14,9,312,309,291,239,206,191,34,57,144,168,28,11,182,0
21:42:57,4784.563,Lion,315,94,3,18,21,26,14,9,312,309,291,239,206,191,36,58,146,169,28,11,182,0
21:43:28,4787.963,Lion,315,94,3,18,21,26,11,12,312,309,291,239,206,194,36,58,146,169,28,11,182,0
21:43:37,4788.864,Lion,315,94,3,15,24,26,11,12,312,309,294,239,206,194,36,58,146,169,28,11,182,0
21:44:25,4793.963,Lion,315,93,3,15,24,26,11,11,312,309,294,239,206,194,36,57,146,169,28,11,183,0
21:44:54,4797.164,Lion,315,92,3,15,24,26,11,10,312,309,294,239,206,194,35,57,146,169,28,11,184,0
21:44:58,4797.463,Lion,315,92,6,15,24,26,11,10,315,309,294,239,206,194,35,57,146,169,28,11,184,0
21:45:01,4797.864,Lion,315,92,6,12,27,26,11,10,315,309,297,239,206,194,35,57,146,169,28,11,184,0
21:45:13,4799.063,Lion,318,95,6,12,27,26,11,10,315,309,297,239,206,194,36,59,147,171,28,11,184,0
21:45:43,4802.264,Lion,321,98,6,12,27,26,11,10,315,309,297,239,206,194,37,61,148,173,28,11,184,0
21:46:16,4805.864,Lion,321,98,6,12,27,23,14,10,315,309,297,239,209,194,37,61,148,173,28,11,184,0
21:46:48,4809.364,Lion,321,98,6,12,24,26,14,10,315,309,297,242,209,194,37,61,148,173,28,11,184,0
21:47:13,4811.963,Lion,321,98,9,12,24,26,14,10,318,309,297,242,209,194,37,61,148,173,28,11,184,0
21:47:44,4815.164,Lion,321,98,12,12,24,26,14,10,321,309,297,242,209,194,37,61,148,173,28,11,184,0
21:48:03,4817.164,Lion,321,96,12,12,24,26,14,8,321,309,297,242,209,194,35,61,148,173,28,11,186,0
21:48:06,4817.463,Lion,321,96,12,9,27,26,14,8,321,309,300,242,209,194,35,61,148,173,28,11,186,0
21:48:46,4821.764,Lion,321,95,12,9,27,24,16,7,321,309,300,242,211,194,35,60,148,173,28,11,187,0
21:48:51,4822.364,Lion,321,95,12,9,27,24,13,10,321,309,300,242,211,197,35,60,148,173,28,11,187,0
21:49:47,4828.463,Lion,321,95,12,9,24,27,13,10,321,309,300,245,211,197,35,60,148,173,28,11,187,0
21:50:22,4832.264,Lion,324,98,12,9,24,27,13,10,321,309,300,245,211,197,38,60,151,173,28,11,187,0
21:50:34,4833.764,Lion,324,97,12,9,24,27,13,9,321,309,300,245,211,197,37,60,151,173,28,11,188,0
21:51:29,4839.764,Lion,324,97,12,9,24,24,16,9,321,309,300,245,214,197,37,60,151,173,28,11,188,0
21:51:34,4840.364,Lion,324,96,12,9,24,24,16,8,321,309,300,245,214,197,37,59,151,173,28,11,189,0
21:52:18,4845.164,Lion,324,96,15,9,24,24,16,8,324,309,300,245,214,197,37,59,151,173,28,11,189,0
21:53:54,4855.764,Lion,324,96,15,9,21,27,16,8,324,309,300,248,214,197,37,59,151,173,28,11,189,0
21:54:13,4857.764,Lion,324,95,15,9,21,27,16,7,324,309,300,248,214,197,37,58,151,173,28,11,190,0
21:54:21,4858.664,Lion,324,94,15,9,21,27,16,6,324,309,300,248,214,197,36,58,151,173,28,11,191,0
21:55:46,4867.864,Lion,324,93,15,9,21,27,16,5,324,309,300,248,214,197,36,57,151,173,28,11,192,0
21:56:30,4872.364,Lion,324,92,15,9,20,27,16,5,324,309,300,248,214,197,35,57,151,173,28,12,192,0
21:56:53,4874.864,Lion,324,92,15,9,20,24,19,5,324,309,300,248,217,197,35,57,151,173,28,12,192,0
21:57:29,4878.864,Lion,324,91,15,9,20,24,19,4,324,309,300,248,217,197,35,56,151,173,28,12,193,0
21:57:32,4879.164,Lion,324,91,15,9,20,21,22,4,324,309,300,248,220,197,35,56,151,173,28,12,193,0
21:58:06,4882.864,Lion,324,91,15,9,17,24,22,4,324,309,300,251,220,197,35,56,151,173,28,12,193,0
21:58:58,4888.463,Lion,324,91,15,9,15,26,22,4,324,309,300,253,220,197,35,56,151,173,28,12,193,0
21:59:00,4888.664,Lion,324,91,12,12,15,26,22,4,324,312,300,253,220,197,35,56,151,173,28,12,193,0
21:59:02,4888.963,Lion,324,90,12,12,15,26,22,3,324,312,300,253,220,197,35,55,151,173,28,12,194,0
21:59:35,4892.563,Lion,324,90,12,12,15,23,25,3,324,312,300,253,223,197,35,55,151,173,28,12,194,0
21:59:43,4893.463,Lion,324,90,12,9,18,23,25,3,324,312,303,253,223,197,35,55,151,173,28,12,194,0
22:00:19,4897.264,Lion,327,93,12,9,18,23,25,3,324,312,303,253,223,197,37,56,153,174,28,12,194,0
22:00:27,4898.264,Lion,327,92,12,9,17,23,25,3,324,312,303,253,223,197,37,55,153,174,28,13,194,0
22:00:41,4899.764,Lion,327,92,12,9,17,23,23,5,324,312,303,253,223,199,37,55,153,174,28,13,194,0
22:00:52,4900.864,Lion,327,92,12,6,20,23,23,5,324,312,306,253,223,199,37,55,153,174,28,13,194,0
22:01:09,4902.764,Lion,327,92,12,6,20,20,26,5,324,312,306,253,226,199,37,55,153,174,28,13,194,0
22:01:58,4908.063,Lion,327,92,12,3,23,20,26,5,324,312,309,253,226,199,37,55,153,174,28,13,194,0
22:02:19,4910.164,Lion,327,92,15,3,23,20,26,5,327,312,309,253,226,199,37,55,153,174,28,13,194,0
22:02:46,4913.264,Lion,327,91,15,3,23,20,26,4,327,312,309,253,226,199,37,54,153,174,28,13,195,0
22:02:50,4913.664,Lion,327,91,15,3,23,18,28,4,327,312,309,253,228,199,37,54,153,174,28,13,195,0
22:02:58,4914.563,Lion,327,91,12,6,23,18,28,4,327,315,309,253,228,199,37,54,153,174,28,13,195,0
22:04:08,4922.264,Lion,327,91,12,6,23,15,31,4,327,315,309,253,231,199,37,54,153,174,28,13,195,0
22:04:11,4922.664,Lion,327,91,12,6,20,18,31,4,327,315,309,256,231,199,37,54,153,174,28,13,195,0
22:04:17,4923.364,Lion,327,90,12,6,20,18,31,3,327,315,309,256,231,199,37,53,153,174,28,13,196,0
22:04:21,4923.764,Lion,327,90,12,6,17,21,31,3,327,315,309,259,231,199,37,53,153,174,28,13,196,0
22:05:01,4928.164,Lion,330,93,12,6,17,21,31,3,327,315,309,259,231,199,37,56,153,177,28,13,196,0
22:05:09,4929.063,Lion,330,93,9,9,17,21,31,3,327,318,309,259,231,199,37,56,153,177,28,13,196,0
22:05:34,4931.864,Lion,330,93,9,9,14,24,31,3,327,318,309,262,231,199,37,56,153,177,28,13,196,0
22:05:38,4932.264,Lion,330,93,6,12,14,24,31,3,327,321,309,262,231,199,37,56,153,177,28,13,196,0
22:06:49,4940.164,Lion,330,92,6,12,14,24,31,2,327,321,309,262,231,199,36,56,153,177,28,13,197,0
22:06:56,4940.864,Lion,330,92,6,12,11,27,31,2,327,321,309,265,231,199,36,56,153,177,28,13,197,0
22:06:59,4941.063,Lion,330,92,9,12,11,27,31,2,330,321,309,265,231,199,36,56,153,177,28,13,197,0
22:07:08,4942.164,Lion,330,92,9,12,11,27,30,3,330,321,309,265,231,200,36,56,153,177,28,13,197,0
22:07:53,4946.963,Lion,330,91,9,12,10,27,30,3,330,321,309,265,231,200,36,55,153,177,29,13,197,0
22:08:56,4953.364,Lion,333,94,9,12,10,27,30,3,330,321,309,265,231,200,38,56,155,178,29,13,197,0
22:09:46,4958.563,Lion,333,93,9,12,10,26,30,3,330,321,309,265,231,200,38,55,155,178,30,13,197,0
22:10:04,4960.463,Lion,333,93,9,12,8,28,30,3,330,321,309,267,231,200,38,55,155,178,30,13,197,0
22:10:22,4962.264,Lion,333,93,6,15,8,28,30,3,330,324,309,267,231,200,38,55,155,178,30,13,197,0
22:10:36,4963.764,Lion,333,92,6,15,8,28,30,2,330,324,309,267,231,200,37,55,155,178,30,13,198,0
22:11:00,4966.264,Lion,333,92,9,15,8,28,30,2,333,324,309,267,231,200,37,55,155,178,30,13,198,0
22:11:24,4968.764,Lion,336,95,9,15,8,28,30,2,333,324,309,267,231,200,40,55,158,178,30,13,198,0
22:11:30,4969.463,Lion,336,94,9,15,8,27,30,2,333,324,309,267,231,200,39,55,158,178,30,14,198,0
22:11:37,4970.063,Lion,339,97,9,15,8,27,30,2,333,324,309,267,231,200,40,57,159,180,30,14,198,0
22:11:40,4970.463,Lion,339,96,9,15,8,27,30,1,333,324,309,267,231,200,39,57,159,180,30,14,199,0
22:13:30,4981.664,Lion,339,96,12,15,8,27,30,1,336,324,309,267,231,200,39,57,159,180,30,14,199,0
22:13:43,4982.963,Lion,339,96,15,15,8,27,30,1,339,324,309,267,231,200,39,57,159,180,30,14,199,0
22:13:51,4983.864,Lion,339,96,15,15,8,26,31,1,339,324,309,267,232,200,39,57,159,180,30,14,199,0
22:19:09,5015.264,Lion,339,96,15,15,8,26,29,3,339,324,309,267,232,202,39,57,159,180,30,14,199,0
22:21:11,5027.264,Lion,339,96,12,18,8,26,29,3,339,327,309,267,232,202,39,57,159,180,30,14,199,0
22:21:43,5030.463,Lion,339,96,12,18,8,23,32,3,339,327,309,267,235,202,39,57,159,180,30,14,199,0
22:22:43,5036.463,Lion,339,96,12,18,6,25,32,3,339,327,309,269,235,202,39,57,159,180,30,14,199,0
22:23:58,5043.864,Lion,339,96,12,18,3,28,32,3,339,327,309,272,235,202,39,57,159,180,30,14,199,0
22:24:05,5044.563,Lion,339,96,12,15,6,28,32,3,339,327,312,272,235,202,39,57,159,180,30,14,199,0
22:24:55,5049.563,Lion,339,96,12,15,6,25,35,3,339,327,312,272,238,202,39,57,159,180,30,14,199,0
22:25:11,5051.063,Lion,339,96,12,15,3,28,35,3,339,327,312,275,238,202,39,57,159,180,30,14,199,0
22:26:24,5058.164,Lion,339,96,9,18,3,28,35,3,339,330,312,275,238,202,39,57,159,180,30,14,199,0
22:27:17,5063.463,Lion,339,96,9,18,3,28,32,6,339,330,312,275,238,205,39,57,159,180,30,14,199,0
22:28:27,5070.463,Lion,339,96,9,15,6,28,32,6,339,330,315,275,238,205,39,57,159,180,30,14,199,0
22:29:31,5076.864,Lion,339,96,9,15,6,25,35,6,339,330,315,275,241,205,39,57,159,180,30,14,199,0
22:30:36,5083.364,Lion,339,96,6,18,6,25,35,6,339,333,315,275,241,205,39,57,159,180,30,14,199,0
22:30:38,5083.563,Lion,339,95,6,18,6,25,35,5,339,333,315,275,241,205,39,56,159,180,30,14,200,0
22:30:52,5084.963,Lion,339,95,6,15,9,25,35,5,339,333,318,275,241,205,39,56,159,180,30,14,200,0
22:31:23,5088.164,Lion,339,95,6,12,12,25,35,5,339,333,321,275,241,205,39,56,159,180,30,14,200,0
22:32:28,5094.463,Lion,342,98,6,12,12,25,35,5,339,333,321,275,241,205,40,58,160,182,30,14,200,0
22:33:13,5098.764,Lion,342,98,3,15,12,25,35,5,339,336,321,275,241,205,40,58,160,182,30,14,200,0
22:33:26,5100.063,Lion,342,98,0,18,12,25,35,5,339,339,321,275,241,205,40,58,160,182,30,14,200,0
22:34:07,5103.963,Lion,342,98,0,18,12,22,38,5,339,339,321,275,244,205,40,58,160,182,30,14,200,0
22:34:13,5104.463,Lion,345,101,0,18,12,22,38,5,339,339,321,275,244,205,43,58,163,182,30,14,200,0
22:34:29,5106.164,Lion,345,100,0,18,12,22,38,4,339,339,321,275,244,205,42,58,163,182,30,14,201,0
22:34:42,5107.364,Lion,345,100,3,18,12,22,38,4,342,339,321,275,244,205,42,58,163,182,30,14,201,0
22:35:04,5109.563,Lion,345,100,3,18,12,20,40,4,342,339,321,275,246,205,42,58,163,182,30,14,201,0
22:36:25,5117.364,Lion,345,100,6,18,12,20,40,4,345,339,321,275,246,205,42,58,163,182,30,14,201,0
22:36:32,5118.164,Lion,345,100,6,15,15,20,40,4,345,339,324,275,246,205,42,58,163,182,30,14,201,0
22:38:42,5130.864,Lion,345,100,6,15,15,20,37,7,345,339,324,275,246,208,42,58,163,182,30,14,201,0
22:40:52,5143.764,Lion,345,100,6,15,15,18,39,7,345,339,324,275,248,208,42,58,163,182,30,14,201,0
22:41:04,5144.864,Lion,345,100,6,15,15,15,42,7,345,339,324,275,251,208,42,58,163,182,30,14,201,0
22:41:23,5146.764,Lion,345,100,6,15,15,15,40,9,345,339,324,275,251,210,42,58,163,182,30,14,201,0
22:42:26,5152.963,Lion,345,100,6,15,15,13,42,9,345,339,324,275,253,210,42,58,163,182,30,14,201,0
22:43:58,5161.963,Lion,348,103,6,15,15,10,45,9,345,339,324,275,256,210,44,59,165,183,30,14,201,0
22:44:27,5164.764,Lion,348,103,6,15,15,10,42,12,345,339,324,275,256,213,44,59,165,183,30,14,201,0
22:45:05,5168.463,Lion,348,102,6,15,14,10,42,12,345,339,324,275,256,213,43,59,165,183,31,14,201,0
22:45:21,5169.864,Lion,351,105,6,15,14,10,42,12,345,339,324,275,256,213,44,61,166,185,31,14,201,0
22:45:34,5171.264,Lion,351,104,6,15,14,10,42,11,345,339,324,275,256,213,44,60,166,185,31,14,202,0
22:45:38,5171.563,Lion,354,107,6,15,14,10,42,11,345,339,324,275,256,213,46,61,168,186,31,14,202,0
22:46:12,5174.764,Lion,354,107,9,15,14,10,42,11,348,339,324,275,256,213,46,61,168,186,31,14,202,0
22:46:39,5177.463,Lion,354,106,9,15,13,10,42,11,348,339,324,275,256,213,45,61,168,186,32,14,202,0
22:47:19,5181.364,Lion,354,105,9,15,13,10,42,10,348,339,324,275,256,213,45,60,168,186,32,14,203,0
22:47:21,5181.563,Lion,354,105,9,15,13,8,44,10,348,339,324,275,258,213,45,60,168,186,32,14,203,0
22:47:34,5182.764,Lion,354,105,12,15,13,8,44,10,351,339,324,275,258,213,45,60,168,186,32,14,203,0
22:47:37,5183.164,Lion,354,105,12,12,16,8,44,10,351,339,327,275,258,213,45,60,168,186,32,14,203,0
22:47:52,5184.463,Lion,354,105,15,12,16,8,44,10,354,339,327,275,258,213,45,60,168,186,32,14,203,0
22:48:23,5187.563,Lion,354,105,15,12,14,10,44,10,354,339,327,277,258,213,45,60,168,186,32,14,203,0
22:49:42,5194.764,Lion,354,104,15,12,14,10,44,9,354,339,327,277,258,213,44,60,168,186,32,14,204,0
22:50:02,5196.563,Lion,357,107,15,12,14,10,44,9,354,339,327,277,258,213,45,62,169,188,32,14,204,0
22:50:37,5199.864,Lion,357,107,15,12,14,10,41,12,354,339,327,277,258,216,45,62,169,188,32,14,204,0
22:51:24,5204.164,Lion,357,107,15,12,14,10,38,15,354,339,327,277,258,219,45,62,169,188,32,14,204,0
22:51:34,5205.164,Lion,357,106,15,12,14,10,38,14,354,339,327,277,258,219,44,62,169,188,32,14,205,0
22:51:56,5207.164,Lion,360,108,15,12,14,10,38,13,354,339,327,277,258,219,44,64,170,190,32,14,206,0
22:52:21,5209.463,Lion,360,108,18,12,14,10,38,13,357,339,327,277,258,219,44,64,170,190,32,14,206,0
22:53:05,5213.463,Lion,360,108,18,12,11,13,38,13,357,339,327,280,258,219,44,64,170,190,32,14,206,0
22:53:12,5214.063,Lion,360,108,18,9,14,13,38,13,357,339,330,280,258,219,44,64,170,190,32,14,206,0
22:53:27,5215.264,Lion,360,107,18,9,14,13,38,12,357,339,330,280,258,219,43,64,170,190,32,14,207,0
22:53:55,5217.563,Lion,360,107,18,9,14,13,35,15,357,339,330,280,258,222,43,64,170,190,32,14,207,0
22:54:23,5219.963,Lion,360,107,21,9,14,13,35,15,360,339,330,280,258,222,43,64,170,190,32,14,207,0
22:54:43,5221.764,Lion,360,106,21,9,14,13,35,14,360,339,330,280,258,222,43,63,170,190,32,14,208,0
22:55:14,5224.463,Lion,360,106,18,12,14,13,35,14,360,342,330,280,258,222,43,63,170,190,32,14,208,0
22:55:50,5227.764,Lion,360,106,18,12,14,13,32,17,360,342,330,280,258,225,43,63,170,190,32,14,208,0
22:55:53,5227.963,Lion,360,106,18,12,12,15,32,17,360,342,330,282,258,225,43,63,170,190,32,14,208,0
22:56:31,5231.164,Lion,360,106,18,12,9,18,32,17,360,342,330,285,258,225,43,63,170,190,32,14,208,0
22:57:11,5234.463,Lion,360,106,15,15,9,18,32,17,360,345,330,285,258,225,43,63,170,190,32,14,208,0
22:57:18,5235.164,Lion,360,105,15,15,9,18,32,16,360,345,330,285,258,225,42,63,170,190,32,14,209,0
22:58:00,5238.664,Lion,360,105,15,15,9,18,30,18,360,345,330,285,258,227,42,63,170,190,32,14,209,0
22:58:12,5239.264,Lion,360,105,15,12,12,18,30,18,360,345,333,285,258,227,42,63,170,190,32,14,209,0
22:59:26,5245.264,Lion,360,104,15,12,12,18,30,17,360,345,333,285,258,227,42,62,170,190,32,14,210,0
22:59:49,5247.264,Lion,360,104,15,12,12,18,27,20,360,345,333,285,258,230,42,62,170,190,32,14,210,0
22:59:55,5247.864,Lion,360,103,15,12,12,18,27,19,360,345,333,285,258,230,42,61,170,190,32,14,211,0
23:00:24,5250.364,Lion,360,101,15,12,12,18,27,17,360,345,333,285,258,230,41,60,170,190,32,14,213,0
23:00:50,5252.463,Lion,363,104,15,12,12,18,27,17,360,345,333,285,258,230,42,62,171,192,32,14,213,0
23:01:14,5254.664,Lion,363,104,15,9,15,18,27,17,360,345,336,285,258,230,42,62,171,192,32,14,213,0
23:01:29,5255.963,Lion,363,104,15,6,18,18,27,17,360,345,339,285,258,230,42,62,171,192,32,14,213,0
23:01:48,5257.563,Lion,363,104,15,6,18,16,29,17,360,345,339,285,260,230,42,62,171,192,32,14,213,0
23:01:53,5257.963,Lion,363,103,15,6,18,16,29,16,360,345,339,285,260,230,42,61,171,192,32,14,214,0
23:02:24,5260.463,Lion,363,102,15,6,18,16,29,15,360,345,339,285,260,230,42,60,171,192,32,14,215,0
23:02:34,5261.164,Lion,363,102,15,6,15,19,29,15,360,345,339,288,260,230,42,60,171,192,32,14,215,0
23:03:25,5264.963,Lion,363,102,15,6,15,16,32,15,360,345,339,288,263,230,42,60,171,192,32,14,215,0
23:03:32,5265.364,Lion,363,102,18,6,15,16,32,15,363,345,339,288,263,230,42,60,171,192,32,14,215,0
23:03:36,5265.764,Lion,363,101,18,6,15,16,32,14,363,345,339,288,263,230,41,60,171,192,32,14,216,0
23:04:06,5267.963,Lion,363,99,18,6,15,16,32,12,363,345,339,288,263,230,41,58,171,192,32,14,218,0
23:04:56,5272.164,Lion,363,99,18,6,15,13,35,12,363,345,339,288,266,230,41,58,171,192,32,14,218,0
23:08:18,5284.963,Lion,363,98,18,6,15,13,35,11,363,345,339,288,266,230,41,57,171,192,32,14,219,0
23:10:37,5291.864,Lion,363,98,15,9,15,13,35,11,363,348,339,288,266,230,41,57,171,192,32,14,219,0
23:13:25,5299.864,Lion,363,98,12,12,15,13,35,11,363,351,339,288,266,230,41,57,171,192,32,14,219,0
23:14:08,5301.563,Lion,363,98,9,15,15,13,35,11,363,354,339,288,266,230,41,57,171,192,32,14,219,0
23:15:07,5304.963,Lion,363,97,9,15,14,13,35,11,363,354,339,288,266,230,41,56,171,192,33,14,219,0
23:16:03,5307.864,Lion,363,96,9,15,14,13,35,10,363,354,339,288,266,230,40,56,171,192,33,14,220,0
23:16:11,5308.563,Lion,363,94,9,15,14,13,35,8,363,354,339,288,266,230,40,54,171,192,33,14,222,0
23:16:14,5308.864,Lion,363,94,9,15,14,13,34,9,363,354,339,288,266,231,40,54,171,192,33,14,222,0
23:19:04,5317.963,Lion,363,93,9,15,14,13,34,8,363,354,339,288,266,231,40,53,171,192,33,14,223,0
23:21:47,5326.164,Lion,363,93,9,15,11,16,34,8,363,354,339,291,266,231,40,53,171,192,33,14,223,0
23:21:54,5326.563,Lion,363,93,6,18,11,16,34,8,363,357,339,291,266,231,40,53,171,192,33,14,223,0
23:23:12,5330.364,Lion,366,96,6,18,11,16,34,8,363,357,339,291,266,231,40,56,171,195,33,14,223,0
23:25:09,5335.463,Lion,366,94,6,18,11,16,34,6,363,357,339,291,266,231,40,54,171,195,33,14,225,0
23:25:46,5337.063,Lion,366,94,3,21,11,16,34,6,363,360,339,291,266,231,40,54,171,195,33,14,225,0
23:26:22,5338.864,Lion,366,92,3,21,11,16,34,4,363,360,339,291,266,231,39,53,171,195,33,14,227,0
23:26:34,5339.664,Lion,366,91,3,21,11,16,34,3,363,360,339,291,266,231,39,52,171,195,33,14,228,0
23:27:13,5343.264,Lion,366,91,6,21,11,16,34,3,366,360,339,291,266,231,39,52,171,195,33,14,228,0
23:29:12,5355.463,Lion,366,91,6,21,11,16,31,6,366,360,339,291,266,234,39,52,171,195,33,14,228,0
23:29:27,5357.063,Lion,366,91,6,21,9,18,31,6,366,360,339,293,266,234,39,52,171,195,33,14,228,0
23:29:50,5359.364,Lion,369,94,6,21,9,18,31,6,366,360,339,293,266,234,41,53,173,196,33,14,228,0
23:30:43,5365.164,Lion,369,93,6,21,8,18,31,6,366,360,339,293,266,234,40,53,173,196,34,14,228,0
23:31:14,5368.463,Lion,369,92,6,21,8,18,31,5,366,360,339,293,266,234,40,52,173,196,34,14,229,0
23:31:49,5372.264,Lion,369,92,9,21,8,18,31,5,369,360,339,293,266,234,40,52,173,196,34,14,229,0
23:32:10,5374.563,Lion,369,92,9,21,8,18,28,8,369,360,339,293,266,237,40,52,173,196,34,14,229,0
23:33:04,5380.364,Lion,369,92,9,18,11,18,28,8,369,360,342,293,266,237,40,52,173,196,34,14,229,0
23:33:21,5382.264,Lion,369,92,9,18,8,21,28,8,369,360,342,296,266,237,40,52,173,196,34,14,229,0
23:33:23,5382.463,Lion,369,92,6,21,8,21,28,8,369,363,342,296,266,237,40,52,173,196,34,14,229,0
23:34:36,5390.364,Lion,369,92,6,18,11,21,28,8,369,363,345,296,266,237,40,52,173,196,34,14,229,0
23:35:38,5396.864,Lion,369,91,6,18,10,21,28,8,369,363,345,296,266,237,39,52,173,196,35,14,229,0
23:35:46,5397.664,Lion,369,91,6,18,8,23,28,8,369,363,345,298,266,237,39,52,173,196,35,14,229,0
23:35:58,5398.963,Lion,369,91,6,18,6,25,28,8,369,363,345,300,266,237,39,52,173,196,35,14,229,0
23:36:11,5400.264,Lion,369,90,6,18,6,25,28,7,369,363,345,300,266,237,39,51,173,196,35,14,230,0
23:36:26,5401.864,Lion,369,90,6,18,6,25,25,10,369,363,345,300,266,240,39,51,173,196,35,14,230,0
23:36:36,5402.764,Lion,372,93,6,18,6,25,25,10,369,363,345,300,266,240,41,52,175,197,35,14,230,0
23:37:33,5408.664,Lion,372,93,6,18,6,23,27,10,369,363,345,300,268,240,41,52,175,197,35,14,230,0
23:38:40,5415.664,Lion,372,93,9,18,6,23,27,10,372,363,345,300,268,240,41,52,175,197,35,14,230,0
23:38:43,5416.063,Lion,372,92,9,18,6,23,27,9,372,363,345,300,268,240,41,51,175,197,35,14,231,0
23:40:50,5428.963,Lion,372,92,9,18,6,23,24,12,372,363,345,300,268,243,41,51,175,197,35,14,231,0
23:41:46,5434.563,Lion,372,92,9,18,6,20,25,14,372,363,345,300,271,245,41,51,175,197,35,14,231,0
23:43:42,5446.364,Lion,372,91,9,18,6,20,25,13,372,363,345,300,271,245,41,50,175,197,35,14,232,0
23:43:56,5447.764,Lion,372,91,9,15,9,20,25,13,372,363,348,300,271,245,41,50,175,197,35,14,232,0
23:44:09,5449.063,Lion,372,91,9,15,9,18,27,13,372,363,348,300,273,245,41,50,175,197,35,14,232,0
23:44:41,5452.264,Lion,372,91,9,15,9,15,30,13,372,363,348,300,276,245,41,50,175,197,35,14,232,0
23:45:13,5455.364,Lion,372,90,9,15,9,15,30,12,372,363,348,300,276,245,40,50,175,197,35,14,233,0
23:45:17,5455.764,Lion,372,90,9,12,12,15,30,12,372,363,351,300,276,245,40,50,175,197,35,14,233,0
23:45:29,5456.963,Lion,372,89,9,12,11,15,30,12,372,363,351,300,276,245,40,49,175,197,36,14,233,0
23:45:34,5457.463,Lion,372,89,9,9,14,15,30,12,372,363,354,300,276,245,40,49,175,197,36,14,233,0
23:46:04,5460.364,Lion,372,89,6,12,14,15,30,12,372,366,354,300,276,245,40,49,175,197,36,14,233,0
23:47:08,5466.563,Lion,372,88,6,12,14,15,30,11,372,366,354,300,276,245,40,48,175,197,36,14,234,0
23:47:31,5468.764,Lion,372,88,6,12,14,15,28,13,372,366,354,300,276,247,40,48,175,197,36,14,234,0
23:47:42,5469.864,Lion,372,88,6,12,14,15,25,16,372,366,354,300,276,250,40,48,175,197,36,14,234,0
23:49:06,5477.963,Lion,375,91,6,12,14,15,23,18,372,366,354,300,276,252,41,50,176,199,36,14,234,0
23:49:22,5479.463,Lion,375,90,6,12,14,15,23,17,372,366,354,300,276,252,41,49,176,199,36,14,235,0
23:49:51,5482.264,Lion,375,90,6,12,14,12,26,17,372,366,354,300,279,252,41,49,176,199,36,14,235,0
23:49:54,5482.463,Lion,375,90,6,9,17,12,26,17,372,366,357,300,279,252,41,49,176,199,36,14,235,0
23:50:42,5486.963,Lion,375,90,6,9,17,12,23,20,372,366,357,300,279,255,41,49,176,199,36,14,235,0
23:51:08,5489.364,Lion,375,90,3,12,17,12,23,20,372,369,357,300,279,255,41,49,176,199,36,14,235,0
23:51:23,5490.764,Lion,375,90,6,12,17,12,23,20,375,369,357,300,279,255,41,49,176,199,36,14,235,0
23:51:46,5492.963,Lion,375,90,6,9,20,12,23,20,375,369,360,300,279,255,41,49,176,199,36,14,235,0
23:52:07,5494.864,Lion,378,93,6,9,20,12,23,20,375,369,360,300,279,255,43,50,178,200,36,14,235,0
23:52:15,5495.764,Lion,378,92,6,9,20,12,23,19,375,369,360,300,279,255,43,49,178,200,36,14,236,0
23:53:08,5500.764,Lion,378,91,6,9,20,12,23,18,375,369,360,300,279,255,42,49,178,200,36,14,237,0
23:53:59,5505.364,Lion,381,94,6,9,20,12,23,18,375,369,360,300,279,255,43,51,179,202,36,14,237,0
23:54:10,5506.563,Lion,384,97,6,9,20,12,21,20,375,369,360,300,279,257,46,51,182,202,36,14,237,0
23:54:24,5507.764,Lion,384,97,9,9,20,12,21,20,378,369,360,300,279,257,46,51,182,202,36,14,237,0
23:54:25,5507.963,Lion,384,96,9,9,19,12,21,20,378,369,360,300,279,257,45,51,182,202,36,15,237,0
23:54:45,5509.764,Lion,384,95,9,9,19,12,21,19,378,369,360,300,279,257,45,50,182,202,36,15,238,0
23:55:21,5512.963,Lion,384,94,9,9,19,12,21,18,378,369,360,300,279,257,44,50,182,202,36,15,239,0
23:56:19,5518.264,Lion,384,94,12,9,19,12,21,18,381,369,360,300,279,257,44,50,182,202,36,15,239,0
23:56:32,5519.364,Lion,384,94,15,9,19,12,21,18,384,369,360,300,279,257,44,50,182,202,36,15,239,0
23:57:15,5523.364,Lion,384,94,15,9,17,14,21,18,384,369,360,302,279,257,44,50,182,202,36,15,239,0
23:57:39,5525.463,Lion,384,92,15,9,17,14,21,16,384,369,360,302,279,257,43,49,182,202,36,15,241,0
23:58:34,5530.463,Lion,384,90,15,9,17,14,21,14,384,369,360,302,279,257,42,48,182,202,36,15,243,0
23:59:00,5532.764,Lion,384,90,12,12,17,14,21,14,384,372,360,302,279,257,42,48,182,202,36,15,243,0
23:59:06,5533.364,Lion,384,90,12,12,15,16,21,14,384,372,360,304,279,257,42,48,182,202,36,15,243,0
23:59:15,5534.063,Lion,387,93,12,12,15,16,21,14,384,372,360,304,279,257,43,50,183,204,36,15,243,0
23:59:52,5537.463,Lion,387,92,12,12,15,16,21,13,384,372,360,304,279,257,43,49,183,204,36,15,244,0
0:00:03,5538.364,Lion,387,92,12,9,18,16,21,13,384,372,363,304,279,257,43,49,183,204,36,15,244,0
0:00:57,5543.264,Lion,390,95,12,9,18,16,21,13,384,372,363,304,279,257,45,50,185,205,36,15,244,0
0:01:37,5546.963,Lion,390,94,15,9,18,16,21,12,387,372,363,304,279,257,45,49,185,205,36,15,245,0
0:01:39,5547.264,Lion,390,94,15,9,18,13,24,12,387,372,363,304,282,257,45,49,185,205,36,15,245,0
0:03:16,5556.164,Lion,390,94,18,9,18,13,24,12,390,372,363,304,282,257,45,49,185,205,36,15,245,0
0:06:19,5573.463,Lion,393,97,18,9,18,13,24,12,390,372,363,304,282,257,47,50,187,206,36,15,245,0
0:06:51,5576.563,Lion,393,96,18,9,18,13,24,11,390,372,363,304,282,257,47,49,187,206,36,15,246,0
0:07:09,5578.164,Lion,393,96,18,9,18,11,26,11,390,372,363,304,284,257,47,49,187,206,36,15,246,0
0:07:18,5578.963,Lion,393,95,18,9,18,11,26,10,390,372,363,304,284,257,47,48,187,206,36,15,247,0
0:07:27,5579.864,Lion,393,94,18,9,18,11,26,9,390,372,363,304,284,257,47,47,187,206,36,15,248,0
0:07:34,5580.463,Lion,393,93,18,9,18,11,26,8,390,372,363,304,284,257,47,46,187,206,36,15,249,0
0:07:56,5582.563,Lion,393,93,18,9,18,11,24,10,390,372,363,304,284,259,47,46,187,206,36,15,249,0
0:08:39,5586.364,Lion,393,93,21,9,18,11,24,10,393,372,363,304,284,259,47,46,187,206,36,15,249,0
0:09:17,5589.963,Lion,393,92,21,9,18,11,21,12,393,372,363,304,284,262,47,45,187,206,36,15,250,0
0:09:26,5590.764,Lion,393,92,21,9,15,14,21,12,393,372,363,307,284,262,47,45,187,206,36,15,250,0
0:09:44,5592.364,Lion,396,95,21,9,15,14,21,12,393,372,363,307,284,262,49,46,189,207,36,15,250,0
0:09:58,5593.764,Lion,396,94,21,9,15,14,21,11,393,372,363,307,284,262,49,45,189,207,36,15,251,0
0:10:36,5597.164,Lion,396,94,21,9,15,14,18,14,393,372,363,307,284,265,49,45,189,207,36,15,251,0
0:10:46,5598.063,Lion,396,93,21,9,15,14,18,13,393,372,363,307,284,265,48,45,189,207,36,15,252,0
0:10:54,5598.764,Lion,396,93,21,9,12,17,18,13,393,372,363,310,284,265,48,45,189,207,36,15,252,0
0:11:13,5600.463,Lion,396,93,21,9,9,20,18,13,393,372,363,313,284,265,48,45,189,207,36,15,252,0
0:11:44,5603.364,Lion,396,93,21,9,9,17,21,13,393,372,363,313,287,265,48,45,189,207,36,15,252,0
0:12:06,5605.264,Lion,396,93,24,9,9,17,21,13,396,372,363,313,287,265,48,45,189,207,36,15,252,0
0:12:34,5607.864,Lion,396,93,21,12,9,17,21,13,396,375,363,313,287,265,48,45,189,207,36,15,252,0
0:12:37,5608.164,Lion,396,92,21,12,9,17,21,12,396,375,363,313,287,265,47,45,189,207,36,15,253,0
0:13:01,5610.264,Lion,399,95,21,12,9,17,21,12,396,375,363,313,287,265,48,47,190,209,36,15,253,0
0:13:11,5611.264,Lion,399,94,21,12,9,17,21,11,396,375,363,313,287,265,47,47,190,209,36,15,254,0
0:14:06,5616.264,Lion,399,94,21,9,12,17,21,11,396,375,366,313,287,265,47,47,190,209,36,15,254,0
0:14:33,5618.764,Lion,399,94,21,9,12,15,23,11,396,375,366,313,289,265,47,47,190,209,36,15,254,0
0:14:47,5620.063,Lion,399,94,21,9,12,13,25,11,396,375,366,313,291,265,47,47,190,209,36,15,254,0
0:15:23,5623.164,Lion,399,94,24,9,12,13,25,11,399,375,366,313,291,265,47,47,190,209,36,15,254,0
0:15:32,5624.063,Lion,399,93,24,9,12,13,25,10,399,375,366,313,291,265,47,46,190,209,36,15,255,0
0:15:41,5624.864,Lion,399,93,21,12,12,13,25,10,399,378,366,313,291,265,47,46,190,209,36,15,255,0
0:15:47,5625.463,Lion,399,93,21,12,9,16,25,10,399,378,366,316,291,265,47,46,190,209,36,15,255,0
0:17:38,5635.364,Lion,399,93,18,15,9,16,25,10,399,381,366,316,291,265,47,46,190,209,36,15,255,0
0:17:44,5635.963,Lion,399,93,18,15,6,19,25,10,399,381,366,319,291,265,47,46,190,209,36,15,255,0
0:17:50,5636.463,Lion,399,93,15,18,6,19,25,10,399,384,366,319,291,265,47,46,190,209,36,15,255,0
0:19:29,5645.264,Lion,399,93,15,15,9,19,25,10,399,384,369,319,291,265,47,46,190,209,36,15,255,0
0:20:17,5649.664,Lion,399,92,15,15,9,19,25,9,399,384,369,319,291,265,46,46,190,209,36,15,256,0
0:20:27,5650.563,Lion,399,91,15,15,9,19,25,8,399,384,369,319,291,265,46,45,190,209,36,15,257,0
0:22:16,5660.264,Lion,402,94,15,15,9,19,25,8,399,384,369,319,291,265,47,47,191,211,36,15,257,0
0:22:58,5664.063,Lion,402,94,12,18,9,19,25,8,399,387,369,319,291,265,47,47,191,211,36,15,257,0
0:23:03,5664.463,Lion,405,97,12,18,9,19,25,8,399,387,369,319,291,265,50,47,194,211,36,15,257,0
0:23:13,5665.364,Lion,408,100,12,18,9,19,25,8,399,387,369,319,291,265,51,49,195,213,36,15,257,0
0:23:43,5668.164,Lion,408,99,12,18,9,19,25,7,399,387,369,319,291,265,50,49,195,213,36,15,258,0
0:24:12,5670.764,Lion,408,98,12,18,9,19,25,6,399,387,369,319,291,265,50,48,195,213,36,15,259,0
0:24:40,5673.264,Lion,408,98,12,21,9,19,25,6,402,390,369,319,291,265,50,48,195,213,36,15,259,0
0:25:27,5677.364,Lion,408,98,15,21,9,19,25,6,405,390,369,319,291,265,50,48,195,213,36,15,259,0
0:25:37,5678.264,Lion,408,98,18,21,9,19,25,6,408,390,369,319,291,265,50,48,195,213,36,15,259,0
0:26:11,5681.364,Lion,408,98,18,21,6,22,25,6,408,390,369,322,291,265,50,48,195,213,36,15,259,0
0:26:15,5681.664,Lion,411,101,18,21,6,22,25,6,408,390,369,322,291,265,53,48,198,213,36,15,259,0
0:27:35,5688.664,Lion,411,101,18,18,9,22,25,6,408,390,372,322,291,265,53,48,198,213,36,15,259,0
0:28:02,5690.963,Lion,411,100,18,18,9,22,25,5,408,390,372,322,291,265,53,47,198,213,36,15,260,0
0:28:47,5694.563,Lion,411,100,21,18,9,22,25,5,411,390,372,322,291,265,53,47,198,213,36,15,260,0
0:29:30,5698.164,Lion,411,99,21,18,9,22,25,4,411,390,372,322,291,265,53,46,198,213,36,15,261,0
0:30:38,5703.463,Lion,411,99,18,21,9,22,25,4,411,393,372,322,291,265,53,46,198,213,36,15,261,0
0:32:52,5713.864,Lion,411,98,18,21,9,22,25,3,411,393,372,322,291,265,53,45,198,213,36,15,262,0
0:34:45,5722.364,Lion,411,98,15,24,9,22,25,3,411,396,372,322,291,265,53,45,198,213,36,15,262,0
0:35:05,5723.963,Lion,411,97,15,24,9,22,25,2,411,396,372,322,291,265,52,45,198,213,36,15,263,0
0:36:03,5728.463,Lion,411,96,15,24,9,22,25,1,411,396,372,322,291,265,52,44,198,213,36,15,264,0
0:37:10,5733.664,Lion,411,96,15,24,9,22,23,3,411,396,372,322,291,267,52,44,198,213,36,15,264,0
0:38:34,5740.264,Lion,411,96,12,27,9,22,23,3,411,399,372,322,291,267,52,44,198,213,36,15,264,0
0:39:28,5744.463,Lion,411,96,12,27,9,20,25,3,411,399,372,322,293,267,52,44,198,213,36,15,264,0
0:41:37,5754.463,Lion,411,96,12,27,9,18,27,3,411,399,372,322,295,267,52,44,198,213,36,15,264,0
0:42:38,5759.264,Lion,411,96,12,27,6,21,27,3,411,399,372,325,295,267,52,44,198,213,36,15,264,0
0:42:42,5759.563,Lion,411,96,12,27,6,21,24,6,411,399,372,325,295,270,52,44,198,213,36,15,264,0
0:43:35,5763.764,Lion,411,96,12,24,9,21,24,6,411,399,375,325,295,270,52,44,198,213,36,15,264,0
0:44:49,5769.664,Lion,411,95,12,24,9,21,24,5,411,399,375,325,295,270,52,43,198,213,36,15,265,0
0:45:44,5774.063,Lion,411,95,12,24,9,21,22,7,411,399,375,325,295,272,52,43,198,213,36,15,265,0
0:46:24,5777.264,Lion,411,95,12,24,9,21,19,10,411,399,375,325,295,275,52,43,198,213,36,15,265,0
0:47:08,5780.764,Lion,411,95,12,21,12,21,19,10,411,399,378,325,295,275,52,43,198,213,36,15,265,0
0:47:41,5783.364,Lion,411,94,12,21,11,21,19,10,411,399,378,325,295,275,52,42,198,213,37,15,265,0
0:47:46,5783.664,Lion,414,97,12,21,11,21,19,10,411,399,378,325,295,275,55,42,201,213,37,15,265,0
0:48:33,5787.364,Lion,414,96,12,21,11,21,19,9,411,399,378,325,295,275,55,41,201,213,37,15,266,0
0:48:45,5788.264,Lion,414,96,12,21,8,24,19,9,411,399,378,328,295,275,55,41,201,213,37,15,266,0
0:49:11,5790.264,Lion,414,96,9,24,8,24,19,9,411,402,378,328,295,275,55,41,201,213,37,15,266,0
0:49:23,5791.264,Lion,414,96,9,21,11,24,19,9,411,402,381,328,295,275,55,41,201,213,37,15,266,0
0:49:37,5792.364,Lion,414,96,9,18,14,24,19,9,411,402,384,328,295,275,55,41,201,213,37,15,266,0
0:50:05,5794.463,Lion,414,96,6,21,14,24,19,9,411,405,384,328,295,275,55,41,201,213,37,15,266,0
0:50:16,5795.364,Lion,414,96,3,24,14,24,19,9,411,408,384,328,295,275,55,41,201,213,37,15,266,0
0:50:32,5796.563,Lion,414,96,6,24,14,24,19,9,414,408,384,328,295,275,55,41,201,213,37,15,266,0
0:52:45,5807.264,Lion,414,96,6,24,14,24,16,12,414,408,384,328,295,278,55,41,201,213,37,15,266,0
0:53:42,5811.664,Lion,414,96,3,27,14,24,16,12,414,411,384,328,295,278,55,41,201,213,37,15,266,0
0:53:43,5811.864,Lion,414,96,3,27,14,21,19,12,414,411,384,328,298,278,55,41,201,213,37,15,266,0
0:54:50,5816.963,Lion,414,95,3,27,13,21,19,12,414,411,384,328,298,278,55,40,201,213,37,16,266,0
0:55:05,5818.063,Lion,417,98,3,27,13,21,19,12,414,411,384,328,298,278,57,41,203,214,37,16,266,0
0:55:30,5819.963,Lion,417,98,3,24,16,18,22,12,414,411,387,328,301,278,57,41,203,214,37,16,266,0
0:55:51,5821.563,Lion,417,98,3,24,16,15,25,12,414,411,387,328,304,278,57,41,203,214,37,16,266,0
0:57:15,5827.764,Lion,417,97,3,24,16,15,25,11,414,411,387,328,304,278,56,41,203,214,37,16,267,0
0:57:34,5829.164,Lion,417,97,3,21,19,15,25,11,414,411,390,328,304,278,56,41,203,214,37,16,267,0
0:57:37,5829.463,Lion,417,96,3,21,19,15,25,10,414,411,390,328,304,278,56,40,203,214,37,16,268,0
0:57:58,5830.963,Lion,417,96,6,21,19,15,25,10,417,411,390,328,304,278,56,40,203,214,37,16,268,0
0:58:07,5831.664,Lion,417,96,6,21,17,17,25,10,417,411,390,330,304,278,56,40,203,214,37,16,268,0
0:59:10,5836.364,Lion,420,99,6,21,17,17,25,10,417,411,390,330,304,278,58,41,205,215,37,16,268,0
1:00:02,5840.364,Lion,420,98,6,21,17,17,25,9,417,411,390,330,304,278,57,41,205,215,37,16,269,0
1:01:00,5844.764,Lion,420,97,6,21,17,17,25,8,417,411,390,330,304,278,56,41,205,215,37,16,270,0
1:01:24,5846.563,Lion,420,97,6,21,17,14,28,8,417,411,390,330,307,278,56,41,205,215,37,16,270,0
1:02:00,5849.264,Lion,420,97,9,21,17,14,28,8,420,411,390,330,307,278,56,41,205,215,37,16,270,0
1:02:15,5850.463,Lion,420,96,9,21,17,14,28,7,420,411,390,330,307,278,55,41,205,215,37,16,271,0
1:03:41,5857.063,Lion,420,96,9,21,17,11,31,7,420,411,390,330,310,278,55,41,205,215,37,16,271,0
1:03:51,5857.764,Lion,420,95,9,21,17,11,31,6,420,411,390,330,310,278,54,41,205,215,37,16,272,0
1:04:14,5859.364,Lion,420,95,9,18,20,11,31,6,420,411,393,330,310,278,54,41,205,215,37,16,272,0
1:05:59,5867.864,Lion,420,94,9,18,20,11,31,5,420,411,393,330,310,278,53,41,205,215,37,16,273,0
1:06:44,5871.463,Lion,423,97,9,18,20,11,31,5,420,411,393,330,310,278,55,42,207,216,37,16,273,0
1:06:53,5872.264,Lion,423,97,9,18,20,11,28,8,420,411,393,330,310,281,55,42,207,216,37,16,273,0
1:07:27,5875.063,Lion,423,96,9,18,20,11,28,7,420,411,393,330,310,281,55,41,207,216,37,16,274,0
1:08:06,5878.264,Lion,423,96,9,15,23,11,28,7,420,411,396,330,310,281,55,41,207,216,37,16,274,0
1:09:26,5884.364,Lion,423,96,12,15,23,11,28,7,423,411,396,330,310,281,55,41,207,216,37,16,274,0
1:11:41,5893.864,Lion,426,99,12,15,23,11,28,7,423,411,396,330,310,281,57,42,209,217,37,16,274,0
1:12:00,5895.264,Lion,426,98,12,15,23,11,28,6,423,411,396,330,310,281,56,42,209,217,37,16,275,0
1:12:14,5896.164,Lion,426,98,12,12,26,11,28,6,423,411,399,330,310,281,56,42,209,217,37,16,275,0
1:14:27,5902.463,Lion,426,98,12,12,26,8,31,6,423,411,399,330,313,281,56,42,209,217,37,16,275,0
1:14:38,5903.164,Lion,426,98,12,12,26,8,29,8,423,411,399,330,313,283,56,42,209,217,37,16,275,0
1:15:14,5905.364,Lion,426,97,12,12,26,8,29,7,423,411,399,330,313,283,56,41,209,217,37,16,276,0
1:15:36,5906.764,Lion,426,97,15,12,24,10,29,7,426,411,399,332,313,283,56,41,209,217,37,16,276,0
1:16:58,5912.364,Lion,426,96,15,12,23,10,29,7,426,411,399,332,313,283,55,41,209,217,38,16,276,0
1:17:03,5912.664,Lion,426,95,15,12,23,10,29,6,426,411,399,332,313,283,55,40,209,217,38,16,277,0
1:17:18,5913.764,Lion,426,93,12,15,21,10,29,6,426,414,399,332,313,283,55,38,209,217,40,16,277,0
1:19:30,5923.364,Lion,426,92,12,15,21,10,29,5,426,414,399,332,313,283,55,37,209,217,40,16,278,0
1:19:35,5923.764,Lion,426,92,12,15,18,13,29,5,426,414,399,335,313,283,55,37,209,217,40,16,278,0
1:20:40,5928.463,Lion,426,91,12,15,18,13,26,7,426,414,399,335,313,286,54,37,209,217,40,16,279,0
1:22:01,5934.264,Lion,426,91,12,15,17,14,26,7,426,414,399,336,313,286,54,37,209,217,40,16,279,0
1:22:16,5935.364,Lion,426,91,12,15,14,17,26,7,426,414,399,339,313,286,54,37,209,217,40,16,279,0
1:22:32,5936.364,Lion,429,94,12,15,14,17,26,7,426,414,399,339,313,286,55,39,210,219,40,16,279,0
1:23:00,5938.364,Lion,432,97,12,15,14,17,26,7,426,414,399,339,313,286,58,39,213,219,40,16,279,0
1:23:33,5940.764,Lion,432,96,12,15,13,17,26,7,426,414,399,339,313,286,58,38,213,219,40,17,279,0
1:24:16,5943.764,Lion,432,96,12,15,13,17,24,9,426,414,399,339,313,288,58,38,213,219,40,17,279,0
1:24:35,5945.063,Lion,432,96,12,15,13,17,22,11,426,414,399,339,313,290,58,38,213,219,40,17,279,0
1:24:52,5946.164,Lion,432,96,12,12,16,17,22,11,426,414,402,339,313,290,58,38,213,219,40,17,279,0
1:25:21,5948.063,Lion,432,96,9,15,16,17,22,11,426,417,402,339,313,290,58,38,213,219,40,17,279,0
1:25:28,5948.563,Lion,432,95,9,15,16,17,22,10,426,417,402,339,313,290,57,38,213,219,40,17,280,0
1:25:39,5949.264,Lion,432,95,12,15,16,17,22,10,429,417,402,339,313,290,57,38,213,219,40,17,280,0
1:25:54,5950.364,Lion,432,95,12,12,19,17,22,10,429,417,405,339,313,290,57,38,213,219,40,17,280,0
1:26:09,5951.264,Lion,432,95,15,9,22,17,22,10,432,417,408,339,313,290,57,38,213,219,40,17,280,0
1:27:50,5958.063,Lion,435,98,15,9,22,17,22,10,432,417,408,339,313,290,60,38,216,219,40,17,280,0
1:28:59,5962.764,Lion,435,97,15,9,22,16,22,10,432,417,408,339,313,290,59,38,216,219,41,17,280,0
1:29:02,5962.963,Lion,435,97,15,9,20,18,22,10,432,417,408,341,313,290,59,38,216,219,41,17,280,0
1:29:05,5963.164,Lion,435,96,15,9,20,18,22,9,432,417,408,341,313,290,58,38,216,219,41,17,281,0
1:29:34,5965.063,Lion,435,95,15,9,19,18,22,9,432,417,408,341,313,290,57,38,216,219,41,18,281,0
1:29:54,5966.364,Lion,435,95,12,12,19,18,22,9,432,420,408,341,313,290,57,38,216,219,41,18,281,0
1:30:03,5966.864,Lion,438,98,12,12,19,18,22,9,432,420,408,341,313,290,59,39,218,220,41,18,281,0
1:30:12,5967.563,Lion,438,98,12,9,22,18,22,9,432,420,411,341,313,290,59,39,218,220,41,18,281,0
1:31:05,5970.963,Lion,438,98,15,9,22,18,22,9,435,420,411,341,313,290,59,39,218,220,41,18,281,0
1:31:22,5972.164,Lion,438,98,15,9,20,20,22,9,435,420,411,343,313,290,59,39,218,220,41,18,281,0
1:33:21,5979.764,Lion,438,98,18,9,20,20,22,9,438,420,411,343,313,290,59,39,218,220,41,18,281,0
1:33:28,5980.364,Lion,438,98,18,9,20,17,25,9,438,420,411,343,316,290,59,39,218,220,41,18,281,0
1:35:45,5989.364,Lion,438,97,18,9,20,17,25,8,438,420,411,343,316,290,59,38,218,220,41,18,282,0
1:36:59,5994.264,Lion,438,96,18,9,20,17,25,7,438,420,411,343,316,290,58,38,218,220,41,18,283,0
1:38:00,5998.264,Lion,441,99,18,9,20,17,25,7,438,420,411,343,316,290,61,38,221,220,41,18,283,0
1:38:49,6001.463,Lion,441,99,15,12,20,17,25,7,438,423,411,343,316,290,61,38,221,220,41,18,283,0
1:39:02,6002.364,Lion,441,99,15,12,18,19,25,7,438,423,411,345,316,290,61,38,221,220,41,18,283,0
1:40:12,6006.864,Lion,444,102,15,12,18,19,25,7,438,423,411,345,316,290,62,40,222,222,41,18,283,0
1:40:45,6009.164,Lion,444,101,15,12,18,19,25,6,438,423,411,345,316,290,61,40,222,222,41,18,284,0
1:40:48,6009.364,Lion,444,101,15,12,18,16,28,6,438,423,411,345,319,290,61,40,222,222,41,18,284,0
1:41:17,6011.164,Lion,444,101,18,12,18,16,28,6,441,423,411,345,319,290,61,40,222,222,41,18,284,0
1:41:34,6012.364,Lion,444,100,18,12,17,16,28,6,441,423,411,345,319,290,61,39,222,222,42,18,284,0
1:42:26,6015.764,Lion,444,98,18,12,17,16,28,4,441,423,411,345,319,290,61,37,222,222,42,18,286,0
1:42:49,6017.264,Lion,444,97,18,12,16,16,28,4,441,423,411,345,319,290,60,37,222,222,42,19,286,0
1:43:29,6019.764,Lion,444,97,21,12,16,16,28,4,444,423,411,345,319,290,60,37,222,222,42,19,286,0
1:43:51,6021.264,Lion,444,97,21,12,13,19,28,4,444,423,411,348,319,290,60,37,222,222,42,19,286,0
1:44:32,6023.864,Lion,444,96,18,15,13,19,28,3,444,426,411,348,319,290,59,37,222,222,42,19,287,0
1:48:30,6039.164,Lion,444,96,18,15,11,21,28,3,444,426,411,350,319,290,59,37,222,222,42,19,287,0
1:49:54,6044.563,Lion,444,95,18,15,11,21,28,2,444,426,411,350,319,290,59,36,222,222,42,19,288,0
1:52:02,6052.764,Lion,444,95,18,15,11,19,30,2,444,426,411,350,321,290,59,36,222,222,42,19,288,0
1:55:08,6064.563,Lion,447,98,18,15,11,19,30,2,444,426,411,350,321,290,60,38,223,224,42,19,288,0
1:55:36,6066.364,Lion,447,98,15,18,11,19,30,2,444,429,411,350,321,290,60,38,223,224,42,19,288,0
1:56:08,6068.364,Lion,447,98,12,21,11,19,30,2,444,432,411,350,321,290,60,38,223,224,42,19,288,0
1:56:27,6069.563,Lion,447,98,12,18,14,19,28,4,444,432,414,350,321,292,60,38,223,224,42,19,288,0
1:58:36,6077.463,Lion,447,98,15,18,14,19,28,4,447,432,414,350,321,292,60,38,223,224,42,19,288,0
1:59:07,6079.463,Lion,447,98,15,18,14,19,26,6,447,432,414,350,321,294,60,38,223,224,42,19,288,0
1:59:42,6081.664,Lion,447,97,15,18,13,19,26,6,447,432,414,350,321,294,60,37,223,224,43,19,288,0
2:01:24,6088.063,Lion,447,97,12,21,13,19,26,6,447,435,414,350,321,294,60,37,223,224,43,19,288,0
2:01:40,6089.164,Lion,447,97,12,21,11,21,26,6,447,435,414,352,321,294,60,37,223,224,43,19,288,0
2:02:48,6093.364,Lion,447,97,12,21,8,24,26,6,447,435,414,355,321,294,60,37,223,224,43,19,288,0
2:03:02,6094.264,Lion,447,97,12,21,6,26,26,6,447,435,414,357,321,294,60,37,223,224,43,19,288,0
2:03:45,6096.864,Lion,447,97,9,24,6,26,26,6,447,438,414,357,321,294,60,37,223,224,43,19,288,0
2:04:31,6099.764,Lion,447,96,9,24,6,26,26,5,447,438,414,357,321,294,60,36,223,224,43,19,289,0
2:05:39,6103.963,Lion,447,96,9,21,9,26,26,5,447,438,417,357,321,294,60,36,223,224,43,19,289,0
2:07:05,6109.164,Lion,450,99,9,21,9,26,26,5,447,438,417,357,321,294,61,38,224,226,43,19,289,0
2:07:27,6110.563,Lion,450,99,9,21,6,29,26,5,447,438,417,360,321,294,61,38,224,226,43,19,289,0
2:08:48,6115.463,Lion,450,98,9,21,6,29,26,4,447,438,417,360,321,294,60,38,224,226,43,19,290,0
2:10:07,6120.264,Lion,450,97,9,21,6,29,26,3,447,438,417,360,321,294,60,37,224,226,43,19,291,0
2:10:38,6122.063,Lion,450,97,12,21,6,29,26,3,450,438,417,360,321,294,60,37,224,226,43,19,291,0
2:10:40,6122.264,Lion,450,97,12,18,9,29,26,3,450,438,420,360,321,294,60,37,224,226,43,19,291,0
2:12:14,6127.864,Lion,450,97,12,18,9,27,28,3,450,438,420,360,323,294,60,37,224,226,43,19,291,0
2:12:22,6128.264,Lion,450,97,9,21,9,27,28,3,450,441,420,360,323,294,60,37,224,226,43,19,291,0
2:12:29,6128.664,Lion,453,100,9,21,9,27,28,3,450,441,420,360,323,294,62,38,226,227,43,19,291,0
2:14:49,6136.864,Lion,453,100,6,24,9,27,25,6,450,444,420,360,323,297,62,38,226,227,43,19,291,0
2:16:11,6141.563,Lion,453,100,9,24,9,27,25,6,453,444,420,360,323,297,62,38,226,227,43,19,291,0
2:17:06,6144.864,Lion,453,100,9,24,9,24,25,9,453,444,420,360,326,300,62,38,226,227,43,19,291,0
2:17:36,6146.563,Lion,453,100,9,24,9,24,22,12,453,444,420,360,326,303,62,38,226,227,43,19,291,0
2:20:13,6155.364,Lion,453,100,9,24,9,23,23,12,453,444,420,360,327,303,62,38,226,227,43,19,291,0
2:20:33,6156.463,Lion,453,100,9,24,9,21,25,12,453,444,420,360,329,303,62,38,226,227,43,19,291,0
2:20:51,6157.364,Lion,453,100,9,21,12,21,25,12,453,444,423,360,329,303,62,38,226,227,43,19,291,0
2:22:11,6162.063,Lion,456,103,9,21,12,21,25,12,453,444,423,360,329,303,64,39,228,228,43,19,291,0
2:22:44,6164.063,Lion,459,106,9,21,12,21,25,12,453,444,423,360,329,303,64,42,228,231,43,19,291,0
2:24:29,6170.463,Lion,459,105,9,21,12,21,25,11,453,444,423,360,329,303,63,42,228,231,43,19,292,0
2:24:47,6171.563,Lion,459,105,9,21,12,21,22,14,453,444,423,360,329,306,63,42,228,231,43,19,292,0
2:25:46,6174.963,Lion,459,105,12,21,12,21,22,14,456,444,423,360,329,306,63,42,228,231,43,19,292,0
2:26:20,6176.963,Lion,459,105,15,21,12,21,22,14,459,444,423,360,329,306,63,42,228,231,43,19,292,0
2:27:07,6179.764,Lion,459,105,15,18,15,21,22,14,459,444,426,360,329,306,63,42,228,231,43,19,292,0
2:27:46,6182.063,Lion,459,105,15,18,15,21,19,17,459,444,426,360,329,309,63,42,228,231,43,19,292,0
2:28:20,6184.063,Lion,459,105,15,18,15,19,21,17,459,444,426,360,331,309,63,42,228,231,43,19,292,0
2:28:41,6185.264,Lion,459,104,15,18,15,19,21,16,459,444,426,360,331,309,63,41,228,231,43,19,293,0
2:30:15,6190.563,Lion,459,103,15,18,15,19,21,15,459,444,426,360,331,309,62,41,228,231,43,19,294,0
2:31:11,6193.264,Lion,459,103,15,18,15,17,23,15,459,444,426,360,333,309,62,41,228,231,43,19,294,0
2:31:40,6194.563,Lion,459,103,12,21,15,17,23,15,459,447,426,360,333,309,62,41,228,231,43,19,294,0
2:35:58,6206.664,Lion,462,106,12,21,15,17,23,15,459,447,426,360,333,309,62,44,228,234,43,19,294,0
2:38:02,6212.563,Lion,462,106,12,21,12,20,23,15,459,447,426,363,333,309,62,44,228,234,43,19,294,0
2:39:36,6217.264,Lion,462,105,12,21,12,20,23,14,459,447,426,363,333,309,61,44,228,234,43,19,295,0
2:40:17,6219.563,Lion,462,105,15,21,12,20,23,14,462,447,426,363,333,309,61,44,228,234,43,19,295,0
2:40:34,6220.563,Lion,465,108,15,21,12,20,23,14,462,447,426,363,333,309,63,45,230,235,43,19,295,0
2:41:01,6222.264,Lion,465,108,15,18,15,20,23,14,462,447,429,363,333,309,63,45,230,235,43,19,295,0
2:41:21,6223.463,Lion,465,108,15,18,15,18,25,14,462,447,429,363,335,309,63,45,230,235,43,19,295,0
2:41:35,6224.264,Lion,465,108,15,15,18,18,25,14,462,447,432,363,335,309,63,45,230,235,43,19,295,0
2:42:29,6227.463,Lion,465,108,15,15,18,18,22,17,462,447,432,363,335,312,63,45,230,235,43,19,295,0
2:43:25,6230.563,Lion,468,111,15,15,18,18,22,17,462,447,432,363,335,312,65,46,232,236,43,19,295,0
2:43:58,6232.563,Lion,468,110,15,15,18,18,22,16,462,447,432,363,335,312,65,45,232,236,43,19,296,0
2:44:15,6233.463,Lion,468,110,18,15,18,18,22,16,465,447,432,363,335,312,65,45,232,236,43,19,296,0
2:44:53,6235.764,Lion,468,109,18,15,18,18,22,15,465,447,432,363,335,312,65,44,232,236,43,19,297,0
2:45:52,6239.164,Lion,468,109,15,18,18,18,22,15,465,450,432,363,335,312,65,44,232,236,43,19,297,0
2:46:24,6241.063,Lion,468,108,15,18,18,18,22,14,465,450,432,363,335,312,64,44,232,236,43,19,298,0
2:46:46,6242.364,Lion,468,108,15,18,18,15,25,14,465,450,432,363,338,312,64,44,232,236,43,19,298,0
2:47:06,6243.463,Lion,468,108,18,18,18,15,25,14,468,450,432,363,338,312,64,44,232,236,43,19,298,0
2:47:13,6243.963,Lion,468,108,18,15,21,15,25,14,468,450,435,363,338,312,64,44,232,236,43,19,298,0
2:47:46,6245.864,Lion,468,107,18,15,21,15,25,13,468,450,435,363,338,312,63,44,232,236,43,19,299,0
2:48:05,6246.963,Lion,468,107,18,15,18,18,25,13,468,450,435,366,338,312,63,44,232,236,43,19,299,0
2:48:55,6249.463,Lion,471,109,18,15,18,17,25,13,468,450,435,366,338,312,64,45,233,238,43,20,299,0
2:50:01,6252.764,Lion,471,109,18,12,21,17,25,13,468,450,438,366,338,312,64,45,233,238,43,20,299,0
2:50:25,6253.963,Lion,474,112,18,12,21,17,25,13,468,450,438,366,338,312,65,47,234,240,43,20,299,0
2:51:38,6257.664,Lion,477,115,18,12,21,17,25,13,468,450,438,366,338,312,66,49,235,242,43,20,299,0
2:51:44,6258.063,Lion,477,114,18,12,21,17,25,12,468,450,438,366,338,312,65,49,235,242,43,20,300,0
2:51:57,6258.664,Lion,477,113,15,15,20,17,25,12,468,453,438,366,338,312,64,49,235,242,43,21,300,0
2:52:27,6260.264,Lion,477,113,15,15,20,15,27,12,468,453,438,366,340,312,64,49,235,242,43,21,300,0
2:53:09,6262.264,Lion,477,113,18,15,20,15,27,12,471,453,438,366,340,312,64,49,235,242,43,21,300,0
2:54:06,6265.264,Lion,477,113,18,15,17,18,27,12,471,453,438,369,340,312,64,49,235,242,43,21,300,0
2:54:15,6265.764,Lion,477,112,18,15,16,18,27,12,471,453,438,369,340,312,63,49,235,242,43,22,300,0
2:54:39,6266.864,Lion,477,112,21,15,16,18,27,12,474,453,438,369,340,312,63,49,235,242,43,22,300,0
2:55:51,6270.563,Lion,477,112,24,15,16,18,27,12,477,453,438,369,340,312,63,49,235,242,43,22,300,0
2:56:17,6271.864,Lion,480,115,24,15,16,18,27,12,477,453,438,369,340,312,63,52,235,245,43,22,300,0
2:56:37,6272.963,Lion,480,114,24,15,16,18,27,11,477,453,438,369,340,312,62,52,235,245,43,22,301,0
2:58:16,6277.864,Lion,480,113,24,15,16,18,27,10,477,453,438,369,340,312,61,52,235,245,43,22,302,0
2:58:24,6278.264,Lion,480,112,24,15,16,18,27,9,477,453,438,369,340,312,60,52,235,245,43,22,303,0
3:00:23,6282.664,Lion,480,111,24,15,16,18,27,8,477,453,438,369,340,312,60,51,235,245,43,22,304,0
3:01:13,6284.164,Lion,480,111,24,12,19,18,27,8,477,453,441,369,340,312,60,51,235,245,43,22,304,0
3:01:34,6284.764,Lion,480,111,27,12,19,18,27,8,480,453,441,369,340,312,60,51,235,245,43,22,304,0
3:03:27,6288.063,Lion,480,110,27,12,19,18,27,7,480,453,441,369,340,312,60,50,235,245,43,22,305,0
3:05:10,6292.063,Lion,480,110,24,15,19,18,27,7,480,456,441,369,340,312,60,50,235,245,43,22,305,0
3:05:25,6292.764,Lion,480,109,24,12,22,18,27,6,480,456,444,369,340,312,60,49,235,245,43,22,306,0
3:05:56,6294.063,Lion,480,109,21,15,22,18,27,6,480,459,444,369,340,312,60,49,235,245,43,22,306,0
3:07:30,6298.463,Lion,480,108,21,15,22,18,27,5,480,459,444,369,340,312,60,48,235,245,43,22,307,0
3:08:12,6300.364,Lion,480,108,21,15,20,20,27,5,480,459,444,371,340,312,60,48,235,245,43,22,307,0
3:10:00,6305.364,Lion,480,108,21,15,20,20,24,8,480,459,444,371,340,315,60,48,235,245,43,22,307,0
3:11:03,6308.164,Lion,480,107,21,15,20,20,24,7,480,459,444,371,340,315,60,47,235,245,43,22,308,0
3:11:50,6310.264,Lion,480,107,21,15,20,19,25,7,480,459,444,371,341,315,60,47,235,245,43,22,308,0
3:12:59,6313.364,Lion,480,106,21,15,20,19,25,6,480,459,444,371,341,315,60,46,235,245,43,22,309,0
3:13:24,6314.463,Lion,480,106,21,15,20,16,28,6,480,459,444,371,344,315,60,46,235,245,43,22,309,0
3:13:44,6315.364,Lion,480,106,21,15,20,14,30,6,480,459,444,371,346,315,60,46,235,245,43,22,309,0
3:13:57,6315.864,Lion,483,109,21,15,20,14,30,6,480,459,444,371,346,315,61,48,236,247,43,22,309,0
3:16:28,6322.764,Lion,483,109,21,15,18,16,30,6,480,459,444,373,346,315,61,48,236,247,43,22,309,0
3:16:37,6323.063,Lion,483,108,21,15,18,16,30,5,480,459,444,373,346,315,60,48,236,247,43,22,310,0
3:19:22,6328.764,Lion,483,108,24,15,18,16,30,5,483,459,444,373,346,315,60,48,236,247,43,22,310,0
3:20:03,6330.463,Lion,486,111,24,15,18,16,30,5,483,459,444,373,346,315,61,50,237,249,43,22,310,0
3:20:28,6331.664,Lion,486,111,24,15,18,13,33,5,483,459,444,373,349,315,61,50,237,249,43,22,310,0
3:21:28,6334.364,Lion,486,111,24,15,18,13,30,8,483,459,444,373,349,318,61,50,237,249,43,22,310,0
3:22:22,6336.664,Lion,486,111,21,18,18,13,30,8,483,462,444,373,349,318,61,50,237,249,43,22,310,0
3:24:52,6343.364,Lion,486,111,24,18,18,13,30,8,486,462,444,373,349,318,61,50,237,249,43,22,310,0
3:27:29,6350.563,Lion,486,111,21,18,21,13,30,8,486,465,447,373,349,318,61,50,237,249,43,22,310,0
3:28:58,6354.563,Lion,486,110,21,18,21,13,30,7,486,465,447,373,349,318,60,50,237,249,43,22,311,0
3:30:33,6358.764,Lion,486,109,21,18,21,13,30,6,486,465,447,373,349,318,59,50,237,249,43,22,312,0
3:31:15,6360.563,Lion,486,109,18,21,21,13,30,6,486,468,447,373,349,318,59,50,237,249,43,22,312,0
3:33:01,6365.264,Lion,486,109,18,21,18,16,30,6,486,468,447,376,349,318,59,50,237,249,43,22,312,0
3:33:23,6366.164,Lion,489,112,18,21,18,16,30,6,486,468,447,376,349,318,59,53,237,252,43,22,312,0
3:33:49,6367.364,Lion,489,111,18,21,14,19,30,6,486,468,447,379,349,318,58,53,237,252,43,23,312,0
3:34:41,6369.563,Lion,492,114,18,21,14,19,30,6,486,468,447,379,349,318,59,55,238,254,43,23,312,0
3:35:11,6370.864,Lion,495,117,18,21,14,19,30,6,486,468,447,379,349,318,61,56,240,255,43,23,312,0
3:37:52,6377.764,Lion,495,117,18,21,14,19,28,8,486,468,447,379,349,320,61,56,240,255,43,23,312,0
3:38:25,6379.063,Lion,495,116,21,21,14,19,28,7,489,468,447,379,349,320,61,55,240,255,43,23,313,0
3:38:32,6379.364,Lion,495,116,18,24,14,19,28,7,489,471,447,379,349,320,61,55,240,255,43,23,313,0
3:39:22,6381.364,Lion,498,119,18,24,14,19,28,7,489,471,447,379,349,320,61,58,240,258,43,23,313,0
3:39:49,6382.463,Lion,498,119,21,24,14,19,28,7,492,471,447,379,349,320,61,58,240,258,43,23,313,0
3:40:21,6383.764,Lion,498,119,24,24,14,19,28,7,495,471,447,379,349,320,61,58,240,258,43,23,313,0
3:40:26,6383.963,Lion,498,119,21,27,14,19,28,7,495,474,447,379,349,320,61,58,240,258,43,23,313,0
3:41:43,6386.963,Lion,498,119,21,27,11,22,28,7,495,474,447,382,349,320,61,58,240,258,43,23,313,0
3:42:07,6387.664,Lion,498,119,18,30,11,22,28,7,495,477,447,382,349,320,61,58,240,258,43,23,313,0
3:44:37,6394.264,Lion,498,119,21,30,11,22,28,7,498,477,447,382,349,320,61,58,240,258,43,23,313,0
3:44:51,6395.063,Lion,498,119,21,27,14,22,28,7,498,477,450,382,349,320,61,58,240,258,43,23,313,0
3:45:04,6395.764,Lion,498,119,21,27,11,25,28,7,498,477,450,385,349,320,61,58,240,258,43,23,313,0
3:45:13,6396.264,Lion,498,118,21,27,11,25,28,6,498,477,450,385,349,320,61,57,240,258,43,23,314,0
3:46:40,6400.864,Lion,501,121,21,27,11,25,28,6,498,477,450,385,349,320,62,59,241,260,43,23,314,0
3:46:58,6401.864,Lion,501,121,18,30,11,25,28,6,498,480,450,385,349,320,62,59,241,260,43,23,314,0
3:48:24,6406.364,Lion,501,120,18,30,11,25,28,5,498,480,450,385,349,320,62,58,241,260,43,23,315,0
3:48:31,6406.764,Lion,501,119,18,30,10,25,28,5,498,480,450,385,349,320,61,58,241,260,44,23,315,0
3:50:48,6413.764,Lion,501,119,21,30,10,25,28,5,501,480,450,385,349,320,61,58,241,260,44,23,315,0
3:51:03,6414.563,Lion,501,119,21,27,13,25,28,5,501,480,453,385,349,320,61,58,241,260,44,23,315,0
3:52:14,6418.164,Lion,501,117,21,27,13,25,28,3,501,480,453,385,349,320,59,58,241,260,44,23,317,0
3:55:01,6426.563,Lion,504,119,21,27,13,25,28,2,501,480,453,385,349,320,61,58,243,261,44,23,318,0
3:55:12,6427.164,Lion,504,119,21,27,11,27,28,2,501,480,453,387,349,320,61,58,243,261,44,23,318,0
3:56:12,6430.164,Lion,504,118,21,27,11,26,28,2,501,480,453,387,349,320,60,58,243,261,45,23,318,0
3:57:23,6433.664,Lion,504,118,21,27,11,23,31,2,501,480,453,387,352,320,60,58,243,261,45,23,318,0
3:57:58,6435.364,Lion,504,117,21,27,11,23,31,1,501,480,453,387,352,320,60,57,243,261,45,23,319,0
3:58:06,6435.764,Lion,504,117,21,27,9,25,31,1,501,480,453,389,352,320,60,57,243,261,45,23,319,0
3:59:21,6439.364,Lion,504,117,24,27,9,25,31,1,504,480,453,389,352,320,60,57,243,261,45,23,319,0
4:01:22,6445.463,Lion,504,116,24,27,9,25,31,0,504,480,453,389,352,320,59,57,243,261,45,23,320,0
4:01:32,6445.864,Lion,504,116,21,30,9,25,31,0,504,483,453,389,352,320,59,57,243,261,45,23,320,0
4:02:13,6447.963,Lion,504,116,21,27,12,25,31,0,504,483,456,389,352,320,59,57,243,261,45,23,320,0
4:02:54,6449.963,Lion,504,116,21,24,15,25,31,0,504,483,459,389,352,320,59,57,243,261,45,23,320,0
4:03:53,6452.864,Lion,507,119,21,24,15,25,29,2,504,483,459,389,352,322,61,58,245,262,45,23,320,0
4:06:30,6460.463,Lion,507,119,18,27,15,25,29,2,504,486,459,389,352,322,61,58,245,262,45,23,320,0
4:08:20,6465.664,Lion,507,119,21,27,15,25,29,2,507,486,459,389,352,322,61,58,245,262,45,23,320,0
4:09:10,6468.063,Lion,507,119,21,27,15,22,32,2,507,486,459,389,355,322,61,58,245,262,45,23,320,0
4:09:51,6469.963,Lion,510,122,21,27,15,22,29,5,507,486,459,389,355,325,61,61,245,265,45,23,320,0
4:13:19,6479.764,Lion,510,121,21,27,14,22,29,5,507,486,459,389,355,325,61,60,245,265,45,24,320,0
4:13:32,6480.364,Lion,510,121,21,27,14,22,28,6,507,486,459,389,355,326,61,60,245,265,45,24,320,0
4:13:57,6481.463,Lion,510,121,21,27,14,22,26,8,507,486,459,389,355,328,61,60,245,265,45,24,320,0
4:14:31,6482.864,Lion,510,121,24,27,14,22,26,8,510,486,459,389,355,328,61,60,245,265,45,24,320,0
4:15:53,6486.364,Lion,510,121,24,27,14,19,29,8,510,486,459,389,358,328,61,60,245,265,45,24,320,0
4:16:28,6487.963,Lion,513,124,24,27,14,19,29,8,510,486,459,389,358,328,62,62,246,267,45,24,320,0
4:18:04,6492.563,Lion,513,124,24,24,17,19,29,8,510,486,462,389,358,328,62,62,246,267,45,24,320,0
4:18:10,6492.764,Lion,516,127,24,24,17,19,29,8,510,486,462,389,358,328,63,64,247,269,45,24,320,0
4:18:14,6492.963,Lion,519,130,24,24,17,19,29,8,510,486,462,389,358,328,64,66,248,271,45,24,320,0
4:18:18,6493.264,Lion,519,129,24,24,17,19,29,7,510,486,462,389,358,328,63,66,248,271,45,24,321,0
4:18:23,6493.463,Lion,519,129,24,24,14,22,29,7,510,486,462,392,358,328,63,66,248,271,45,24,321,0
4:19:21,6496.164,Lion,519,129,21,27,14,22,29,7,510,489,462,392,358,328,63,66,248,271,45,24,321,0
4:20:34,6499.563,Lion,519,129,18,30,14,22,29,7,510,492,462,392,358,328,63,66,248,271,45,24,321,0
4:20:46,6500.164,Lion,519,128,18,30,14,22,29,6,510,492,462,392,358,328,62,66,248,271,45,24,322,0
4:21:03,6500.864,Lion,519,128,18,33,14,22,29,6,513,495,462,392,358,328,62,66,248,271,45,24,322,0
4:22:49,6505.664,Lion,519,128,21,33,14,22,29,6,516,495,462,392,358,328,62,66,248,271,45,24,322,0
4:22:54,6505.864,Lion,519,128,24,33,14,22,29,6,519,495,462,392,358,328,62,66,248,271,45,24,322,0
4:23:06,6506.463,Lion,519,128,24,30,17,22,29,6,519,495,465,392,358,328,62,66,248,271,45,24,322,0
4:24:02,6509.063,Lion,519,128,24,30,17,22,27,8,519,495,465,392,358,330,62,66,248,271,45,24,322,0
4:24:55,6511.364,Lion,519,128,21,33,17,22,27,8,519,498,465,392,358,330,62,66,248,271,45,24,322,0
4:25:02,6511.764,Lion,519,127,21,33,17,22,27,7,519,498,465,392,358,330,61,66,248,271,45,24,323,0
4:26:45,6516.463,Lion,519,127,21,30,20,22,27,7,519,498,468,392,358,330,61,66,248,271,45,24,323,0
4:27:25,6518.264,Lion,519,127,21,30,20,22,25,9,519,498,468,392,358,332,61,66,248,271,45,24,323,0
4:28:35,6521.463,Lion,519,127,21,30,20,20,27,9,519,498,468,392,360,332,61,66,248,271,45,24,323,0
4:30:04,6525.463,Lion,519,126,21,30,19,20,27,9,519,498,468,392,360,332,61,65,248,271,45,25,323,0
4:31:29,6529.264,Lion,519,125,21,30,19,20,27,8,519,498,468,392,360,332,60,65,248,271,45,25,324,0
4:32:08,6530.864,Lion,519,125,18,33,19,20,27,8,519,501,468,392,360,332,60,65,248,271,45,25,324,0
4:33:31,6534.463,Lion,522,127,18,33,19,19,27,8,519,501,468,392,360,332,62,65,251,271,45,26,324,0
4:33:51,6535.264,Lion,522,127,18,30,22,19,27,8,519,501,471,392,360,332,62,65,251,271,45,26,324,0
4:34:57,6538.063,Lion,522,127,18,30,20,21,27,8,519,501,471,394,360,332,62,65,251,271,45,26,324,0
4:35:41,6539.864,Lion,522,127,18,27,23,21,27,8,519,501,474,394,360,332,62,65,251,271,45,26,324,0
4:37:06,6543.563,Lion,522,127,18,24,26,21,27,8,519,501,477,394,360,332,62,65,251,271,45,26,324,0
4:37:12,6543.864,Lion,522,127,18,24,26,19,29,8,519,501,477,394,362,332,62,65,251,271,45,26,324,0
4:38:26,6547.264,Lion,522,127,21,24,26,19,29,8,522,501,477,394,362,332,62,65,251,271,45,26,324,0
4:38:50,6548.463,Lion,522,127,21,24,26,19,27,10,522,501,477,394,362,334,62,65,251,271,45,26,324,0
4:39:46,6551.063,Lion,522,126,21,24,26,19,27,9,522,501,477,394,362,334,61,65,251,271,45,26,325,0
4:40:09,6552.164,Lion,522,125,21,24,26,19,27,8,522,501,477,394,362,334,60,65,251,271,45,26,326,0
4:40:39,6553.463,Lion,525,128,21,24,26,19,27,8,522,501,477,394,362,334,62,66,253,272,45,26,326,0
4:41:45,6556.563,Lion,528,131,18,27,26,19,27,8,522,504,477,394,362,334,64,67,255,273,45,26,326,0
4:42:04,6557.563,Lion,528,131,18,27,24,21,27,8,522,504,477,396,362,334,64,67,255,273,45,26,326,0
4:42:09,6557.764,Lion,528,131,18,24,27,21,27,8,522,504,480,396,362,334,64,67,255,273,45,26,326,0
4:45:16,6566.364,Lion,528,131,21,24,27,21,27,8,525,504,480,396,362,334,64,67,255,273,45,26,326,0
4:45:36,6567.364,Lion,528,131,21,24,27,21,24,11,525,504,480,396,362,337,64,67,255,273,45,26,326,0
4:46:24,6569.463,Lion,528,131,24,24,27,21,24,11,528,504,480,396,362,337,64,67,255,273,45,26,326,0
4:46:52,6570.864,Lion,528,130,24,24,27,21,24,10,528,504,480,396,362,337,63,67,255,273,45,26,327,0
4:47:10,6571.563,Lion,531,133,24,24,27,21,24,10,528,504,480,396,362,337,64,69,256,275,45,26,327,0
4:50:34,6580.963,Lion,531,132,24,24,27,21,24,9,528,504,480,396,362,337,64,68,256,275,45,26,328,0
4:51:15,6582.764,Lion,531,132,21,27,27,21,24,9,528,507,480,396,362,337,64,68,256,275,45,26,328,0
4:51:55,6584.463,Lion,531,132,24,27,27,21,24,9,531,507,480,396,362,337,64,68,256,275,45,26,328,0
4:52:12,6585.264,Lion,531,132,24,27,27,21,22,11,531,507,480,396,362,339,64,68,256,275,45,26,328,0
4:52:39,6586.364,Lion,531,132,24,27,27,18,25,11,531,507,480,396,365,339,64,68,256,275,45,26,328,0
4:53:25,6588.364,Lion,531,132,24,27,27,15,28,11,531,507,480,396,368,339,64,68,256,275,45,26,328,0
4:54:25,6590.963,Lion,531,132,24,27,24,18,28,11,531,507,480,399,368,339,64,68,256,275,45,26,328,0
4:55:12,6592.963,Lion,531,132,24,27,21,21,28,11,531,507,480,402,368,339,64,68,256,275,45,26,328,0
4:57:33,6599.063,Lion,531,131,24,27,21,21,28,10,531,507,480,402,368,339,63,68,256,275,45,26,329,0
4:57:55,6599.963,Lion,531,130,21,30,21,21,28,9,531,510,480,402,368,339,63,67,256,275,45,26,330,0
4:58:36,6601.764,Lion,531,130,21,27,24,21,28,9,531,510,483,402,368,339,63,67,256,275,45,26,330,0
4:59:25,6603.764,Lion,534,133,21,27,24,21,28,9,531,510,483,402,368,339,64,69,257,277,45,26,330,0
5:01:05,6608.063,Lion,534,133,21,27,24,19,30,9,531,510,483,402,370,339,64,69,257,277,45,26,330,0
5:04:32,6616.364,Lion,534,133,21,24,27,19,30,9,531,510,486,402,370,339,64,69,257,277,45,26,330,0
5:04:42,6616.664,Lion,534,133,24,24,27,19,30,9,534,510,486,402,370,339,64,69,257,277,45,26,330,0
5:04:45,6616.864,Lion,534,133,24,24,27,16,33,9,534,510,486,402,373,339,64,69,257,277,45,26,330,0
5:05:10,6617.963,Lion,534,133,21,27,27,16,33,9,534,513,486,402,373,339,64,69,257,277,45,26,330,0
5:06:56,6622.764,Lion,534,133,18,30,27,16,33,9,534,516,486,402,373,339,64,69,257,277,45,26,330,0
5:07:00,6622.963,Lion,534,133,15,33,27,16,33,9,534,519,486,402,373,339,64,69,257,277,45,26,330,0
5:11:32,6635.264,Lion,534,133,15,33,27,16,32,10,534,519,486,402,373,340,64,69,257,277,45,26,330,0
5:11:39,6635.563,Lion,534,133,15,33,24,19,32,10,534,519,486,405,373,340,64,69,257,277,45,26,330,0
5:12:36,6638.063,Lion,534,131,15,33,24,19,32,8,534,519,486,405,373,340,63,68,257,277,45,26,332,0
5:13:08,6639.463,Lion,534,130,15,33,24,19,29,10,534,519,486,405,373,343,63,67,257,277,45,26,333,0
5:13:29,6640.364,Lion,534,130,15,33,24,19,27,12,534,519,486,405,373,345,63,67,257,277,45,26,333,0
5:14:51,6643.764,Lion,537,133,15,33,24,19,27,12,534,519,486,405,373,345,64,69,258,279,45,26,333,0
5:15:12,6644.664,Lion,540,136,15,33,24,19,27,12,534,519,486,405,373,345,66,70,260,280,45,26,333,0
5:15:26,6645.264,Lion,543,139,15,33,24,19,27,12,534,519,486,405,373,345,67,72,261,282,45,26,333,0
5:16:33,6648.264,Lion,543,139,15,33,24,18,28,12,534,519,486,405,374,345,67,72,261,282,45,26,333,0
5:17:01,6649.463,Lion,543,139,15,33,21,21,28,12,534,519,486,408,374,345,67,72,261,282,45,26,333,0
5:18:01,6652.063,Lion,543,139,15,30,24,21,28,12,534,519,489,408,374,345,67,72,261,282,45,26,333,0
5:19:06,6654.864,Lion,543,138,15,30,24,21,28,11,534,519,489,408,374,345,67,71,261,282,45,26,334,0
5:19:20,6655.463,Lion,543,138,15,27,27,21,28,11,534,519,492,408,374,345,67,71,261,282,45,26,334,0
5:19:50,6656.764,Lion,543,138,18,24,30,21,25,14,537,519,495,408,374,348,67,71,261,282,45,26,334,0
5:19:52,6656.864,Lion,543,138,18,24,30,19,27,14,537,519,495,408,376,348,67,71,261,282,45,26,334,0
5:20:10,6657.563,Lion,543,138,21,24,30,19,27,14,540,519,495,408,376,348,67,71,261,282,45,26,334,0
5:20:24,6658.164,Lion,543,138,24,24,30,19,27,14,543,519,495,408,376,348,67,71,261,282,45,26,334,0
5:20:52,6659.463,Lion,543,138,24,24,27,22,27,14,543,519,495,411,376,348,67,71,261,282,45,26,334,0
5:22:52,6664.364,Lion,543,138,21,27,27,22,27,14,543,522,495,411,376,348,67,71,261,282,45,26,334,0
5:24:03,6667.264,Lion,543,138,21,24,30,22,27,14,543,522,498,411,376,348,67,71,261,282,45,26,334,0
5:25:05,6669.764,Lion,543,137,21,24,30,22,27,13,543,522,498,411,376,348,67,70,261,282,45,26,335,0
5:26:13,6672.463,Lion,543,136,21,24,29,22,27,13,543,522,498,411,376,348,67,69,261,282,46,26,335,0
5:27:24,6675.264,Lion,543,135,21,24,29,21,27,13,543,522,498,411,376,348,67,68,261,282,47,26,335,0
5:28:47,6678.264,Lion,543,135,21,24,26,24,27,13,543,522,498,414,376,348,67,68,261,282,47,26,335,0
5:29:03,6678.963,Lion,543,134,21,24,25,24,27,13,543,522,498,414,376,348,66,68,261,282,48,26,335,0
5:29:23,6679.864,Lion,543,133,21,24,24,24,27,13,543,522,498,414,376,348,65,68,261,282,49,26,335,0
5:29:59,6681.364,Lion,546,136,21,24,24,24,27,13,543,522,498,414,376,348,68,68,264,282,49,26,335,0
5:30:33,6682.864,Lion,546,136,21,24,22,26,27,13,543,522,498,416,376,348,68,68,264,282,49,26,335,0
5:30:48,6683.463,Lion,546,136,18,27,22,26,27,13,543,525,498,416,376,348,68,68,264,282,49,26,335,0
5:32:02,6686.563,Lion,546,136,15,30,21,27,27,13,543,528,498,417,376,348,68,68,264,282,49,26,335,0
5:32:06,6686.764,Lion,546,136,15,27,24,27,27,13,543,528,501,417,376,348,68,68,264,282,49,26,335,0
5:32:17,6687.164,Lion,549,139,15,27,24,27,27,13,543,528,501,417,376,348,68,71,264,285,49,26,335,0
5:33:21,6689.864,Lion,549,138,15,27,24,27,27,12,543,528,501,417,376,348,67,71,264,285,49,26,336,0
5:33:45,6690.864,Lion,549,137,15,27,24,27,27,11,543,528,501,417,376,348,67,70,264,285,49,26,337,0
5:35:09,6694.264,Lion,549,137,18,27,24,27,27,11,546,528,501,417,376,348,67,70,264,285,49,26,337,0
5:35:58,6696.364,Lion,549,136,18,27,24,27,27,10,546,528,501,417,376,348,66,70,264,285,49,26,338,0
5:36:53,6698.563,Lion,552,139,18,27,24,27,27,10,546,528,501,417,376,348,68,71,266,286,49,26,338,0
5:37:29,6700.063,Lion,552,139,21,27,24,27,27,10,549,528,501,417,376,348,68,71,266,286,49,26,338,0
5:37:44,6700.764,Lion,552,139,21,27,21,30,27,10,549,528,501,420,376,348,68,71,266,286,49,26,338,0
5:37:49,6700.963,Lion,552,138,21,27,21,30,27,9,549,528,501,420,376,348,68,70,266,286,49,26,339,0
5:38:05,6701.563,Lion,552,138,18,30,21,30,27,9,549,531,501,420,376,348,68,70,266,286,49,26,339,0
5:39:18,6704.463,Lion,555,141,18,30,21,30,27,9,549,531,501,420,376,348,71,70,269,286,49,26,339,0
5:42:08,6711.463,Lion,555,141,21,30,21,30,27,9,552,531,501,420,376,348,71,70,269,286,49,26,339,0
5:42:28,6712.364,Lion,555,141,21,27,24,30,27,9,552,531,504,420,376,348,71,70,269,286,49,26,339,0
5:43:18,6714.364,Lion,558,144,21,27,24,30,27,9,552,531,504,420,376,348,74,70,272,286,49,26,339,0
5:43:21,6714.563,Lion,558,144,21,27,24,27,30,9,552,531,504,420,379,348,74,70,272,286,49,26,339,0
5:44:30,6717.364,Lion,558,144,24,27,24,27,30,9,555,531,504,420,379,348,74,70,272,286,49,26,339,0
5:45:40,6720.264,Lion,558,143,24,27,24,27,30,8,555,531,504,420,379,348,73,70,272,286,49,26,340,0
5:48:30,6727.264,Lion,558,143,27,27,24,27,30,8,558,531,504,420,379,348,73,70,272,286,49,26,340,0
5:51:21,6733.764,Lion,558,143,24,30,24,27,30,8,558,534,504,420,379,348,73,70,272,286,49,26,340,0
5:52:31,6736.764,Lion,558,142,24,30,24,27,30,7,558,534,504,420,379,348,73,69,272,286,49,26,341,0
5:52:48,6737.463,Lion,558,141,24,30,24,27,30,6,558,534,504,420,379,348,72,69,272,286,49,26,342,0
5:53:17,6738.664,Lion,558,141,24,27,27,27,30,6,558,534,507,420,379,348,72,69,272,286,49,26,342,0
5:53:26,6739.063,Lion,558,140,24,27,27,27,30,5,558,534,507,420,379,348,71,69,272,286,49,26,343,0
5:54:39,6741.963,Lion,561,143,24,27,27,27,30,5,558,534,507,420,379,348,72,71,273,288,49,26,343,0
5:55:46,6744.764,Lion,561,143,24,27,24,30,30,5,558,534,507,423,379,348,72,71,273,288,49,26,343,0
5:58:32,6751.463,Lion,561,142,24,27,23,30,30,5,558,534,507,423,379,348,72,70,273,288,50,26,343,0
5:59:59,6754.864,Lion,561,142,27,27,23,30,30,5,561,534,507,423,379,348,72,70,273,288,50,26,343,0
6:00:22,6755.864,Lion,561,142,27,24,26,30,30,5,561,534,510,423,379,348,72,70,273,288,50,26,343,0
6:01:08,6757.664,Lion,561,141,27,24,26,30,30,4,561,534,510,423,379,348,71,70,273,288,50,26,344,0
6:01:33,6758.664,Lion,561,141,27,24,26,30,27,7,561,534,510,423,379,351,71,70,273,288,50,26,344,0
6:01:46,6759.164,Lion,561,141,27,24,26,28,29,7,561,534,510,423,381,351,71,70,273,288,50,26,344,0
6:01:51,6759.364,Lion,561,141,27,24,24,30,29,7,561,534,510,425,381,351,71,70,273,288,50,26,344,0
6:03:27,6763.063,Lion,564,144,27,24,24,30,29,7,561,534,510,425,381,351,73,71,275,289,50,26,344,0
6:05:08,6767.164,Lion,564,143,27,24,23,30,29,7,561,534,510,425,381,351,73,70,275,289,51,26,344,0
6:05:23,6767.764,Lion,564,142,27,24,23,30,29,6,561,534,510,425,381,351,72,70,275,289,51,26,345,0
6:06:41,6770.764,Lion,564,141,27,24,23,30,29,5,561,534,510,425,381,351,71,70,275,289,51,26,346,0
6:08:02,6773.864,Lion,564,141,24,24,26,30,29,5,561,537,513,425,381,351,71,70,275,289,51,26,346,0
6:08:24,6774.664,Lion,564,141,21,27,26,30,29,5,561,540,513,425,381,351,71,70,275,289,51,26,346,0
6:08:40,6775.264,Lion,564,141,18,30,26,30,29,5,561,543,513,425,381,351,71,70,275,289,51,26,346,0
6:08:59,6775.963,Lion,564,141,21,30,26,30,29,5,564,543,513,425,381,351,71,70,275,289,51,26,346,0
6:10:08,6778.664,Lion,564,141,21,27,29,28,31,5,564,543,516,425,383,351,71,70,275,289,51,26,346,0
6:10:13,6778.864,Lion,564,141,21,24,32,28,31,5,564,543,519,425,383,351,71,70,275,289,51,26,346,0
6:13:45,6786.864,Lion,567,144,21,24,32,28,31,5,564,543,519,425,383,351,71,73,275,292,51,26,346,0
6:14:42,6788.963,Lion,567,143,21,24,32,28,31,4,564,543,519,425,383,351,70,73,275,292,51,26,347,0
6:15:38,6791.264,Lion,567,142,21,24,31,28,31,4,564,543,519,425,383,351,69,73,275,292,52,26,347,0
6:16:22,6793.063,Lion,567,142,21,24,31,28,28,7,564,543,519,425,383,354,69,73,275,292,52,26,347,0
6:17:13,6795.063,Lion,567,142,21,24,29,30,28,7,564,543,519,427,383,354,69,73,275,292,52,26,347,0
6:17:58,6796.864,Lion,567,141,21,24,29,30,28,6,564,543,519,427,383,354,68,73,275,292,52,26,348,0
6:18:38,6798.463,Lion,567,141,21,24,27,32,28,6,564,543,519,429,383,354,68,73,275,292,52,26,348,0
6:18:53,6798.963,Lion,570,144,21,24,27,32,28,6,564,543,519,429,383,354,68,76,275,295,52,26,348,0
6:19:13,6799.764,Lion,570,144,24,24,24,35,28,6,567,543,519,432,383,354,68,76,275,295,52,26,348,0
6:23:30,6810.264,Lion,570,144,24,24,21,38,28,6,567,543,519,435,383,354,68,76,275,295,52,26,348,0
6:23:58,6811.364,Lion,570,144,21,27,21,38,25,9,567,546,519,435,383,357,68,76,275,295,52,26,348,0
6:24:12,6811.864,Lion,570,144,24,27,21,38,25,9,570,546,519,435,383,357,68,76,275,295,52,26,348,0
6:24:14,6812.063,Lion,570,144,24,27,21,35,28,9,570,546,519,435,386,357,68,76,275,295,52,26,348,0
6:25:04,6814.063,Lion,570,144,24,27,21,32,31,9,570,546,519,435,389,357,68,76,275,295,52,26,348,0
6:25:36,6815.364,Lion,570,143,24,27,21,31,31,9,570,546,519,435,389,357,67,76,275,295,52,27,348,0
6:26:22,6817.164,Lion,570,143,21,30,21,31,31,9,570,549,519,435,389,357,67,76,275,295,52,27,348,0
6:27:13,6819.264,Lion,570,142,21,30,21,31,31,8,570,549,519,435,389,357,66,76,275,295,52,27,349,0
6:27:38,6820.264,Lion,570,142,21,27,24,31,31,8,570,549,522,435,389,357,66,76,275,295,52,27,349,0
6:31:09,6828.563,Lion,570,142,18,30,24,31,31,8,570,552,522,435,389,357,66,76,275,295,52,27,349,0
6:31:28,6829.364,Lion,570,141,18,30,24,31,31,7,570,552,522,435,389,357,65,76,275,295,52,27,350,0
6:31:38,6829.764,Lion,570,141,18,30,21,34,31,7,570,552,522,438,389,357,65,76,275,295,52,27,350,0
6:33:35,6834.463,Lion,570,141,15,33,21,34,31,7,570,555,522,438,389,357,65,76,275,295,52,27,350,0
6:35:32,6839.364,Lion,570,141,15,30,24,34,31,7,570,555,525,438,389,357,65,76,275,295,52,27,350,0
6:36:47,6842.463,Lion,570,141,15,27,27,34,31,7,570,555,528,438,389,357,65,76,275,295,52,27,350,0
6:37:15,6843.563,Lion,570,139,15,27,27,34,31,5,570,555,528,438,389,357,63,76,275,295,52,27,352,0
6:37:37,6844.364,Lion,570,139,12,30,27,34,31,5,570,558,528,438,389,357,63,76,275,295,52,27,352,0
6:38:32,6846.463,Lion,570,139,12,30,27,34,29,7,570,558,528,438,389,359,63,76,275,295,52,27,352,0
6:38:42,6846.764,Lion,573,142,12,30,27,34,29,7,570,558,528,438,389,359,64,78,276,297,52,27,352,0
6:40:25,6850.764,Lion,576,145,12,30,27,34,29,7,570,558,528,438,389,359,65,80,277,299,52,27,352,0
6:41:40,6853.664,Lion,576,144,12,30,27,34,29,6,570,558,528,438,389,359,65,79,277,299,52,27,353,0
6:42:26,6855.364,Lion,576,144,12,30,24,37,29,6,570,558,528,441,389,359,65,79,277,299,52,27,353,0
6:43:02,6856.664,Lion,576,144,12,30,24,34,32,6,570,558,528,441,392,359,65,79,277,299,52,27,353,0
6:43:24,6857.463,Lion,576,144,12,27,27,34,32,6,570,558,531,441,392,359,65,79,277,299,52,27,353,0
6:44:24,6859.664,Lion,576,144,15,27,27,34,32,6,573,558,531,441,392,359,65,79,277,299,52,27,353,0
6:46:16,6863.664,Lion,576,144,18,27,27,34,32,6,576,558,531,441,392,359,65,79,277,299,52,27,353,0
6:48:23,6868.864,Lion,576,144,18,27,27,34,30,8,576,558,531,441,392,361,65,79,277,299,52,27,353,0
6:49:06,6870.563,Lion,576,144,18,27,27,32,32,8,576,558,531,441,394,361,65,79,277,299,52,27,353,0
6:49:18,6870.963,Lion,579,147,18,27,27,32,32,8,576,558,531,441,394,361,66,81,278,301,52,27,353,0
6:49:38,6871.764,Lion,582,149,18,27,27,32,32,7,576,558,531,441,394,361,67,82,280,302,52,27,354,0
6:49:42,6871.963,Lion,582,149,15,30,27,32,32,7,576,561,531,441,394,361,67,82,280,302,52,27,354,0
6:50:13,6873.164,Lion,585,152,15,30,27,32,32,7,576,561,531,441,394,361,68,84,281,304,52,27,354,0
6:53:19,6880.563,Lion,585,152,15,30,27,29,35,7,576,561,531,441,397,361,68,84,281,304,52,27,354,0
6:53:48,6881.664,Lion,585,152,15,30,24,32,35,7,576,561,531,444,397,361,68,84,281,304,52,27,354,0
6:54:47,6883.864,Lion,585,152,18,30,24,32,35,7,579,561,531,444,397,361,68,84,281,304,52,27,354,0
6:55:07,6884.664,Lion,585,152,21,30,24,32,35,7,582,561,531,444,397,361,68,84,281,304,52,27,354,0
6:55:42,6886.063,Lion,585,152,24,30,24,32,35,7,585,561,531,444,397,361,68,84,281,304,52,27,354,0
6:57:09,6889.664,Lion,585,152,24,27,27,32,35,7,585,561,534,444,397,361,68,84,281,304,52,27,354,0
6:58:34,6893.063,Lion,585,152,21,30,27,32,35,7,585,564,534,444,397,361,68,84,281,304,52,27,354,0
7:00:10,6896.964,Lion,585,151,21,30,27,32,35,6,585,564,534,444,397,361,67,84,281,304,52,27,355,0
7:00:58,6898.864,Lion,585,151,21,30,24,35,35,6,585,564,534,447,397,361,67,84,281,304,52,27,355,0
7:01:10,6899.364,Lion,585,151,21,30,24,32,38,6,585,564,534,447,400,361,67,84,281,304,52,27,355,0
7:03:11,6903.964,Lion,585,151,21,30,24,30,40,6,585,564,534,447,402,361,67,84,281,304,52,27,355,0
7:04:48,6907.664,Lion,585,151,21,30,24,29,41,6,585,564,534,447,403,361,67,84,281,304,52,27,355,0
7:05:58,6910.364,Lion,585,150,21,30,23,29,41,6,585,564,534,447,403,361,67,83,281,304,53,27,355,0
7:06:23,6911.364,Lion,585,150,21,30,23,29,38,9,585,564,534,447,403,364,67,83,281,304,53,27,355,0
7:07:16,6913.364,Lion,585,150,21,30,23,29,35,12,585,564,534,447,403,367,67,83,281,304,53,27,355,0
7:07:24,6913.563,Lion,588,153,21,30,23,29,35,12,585,564,534,447,403,367,70,83,284,304,53,27,355,0
7:08:50,6916.864,Lion,588,153,18,33,20,32,35,12,585,567,534,450,403,367,70,83,284,304,53,27,355,0
7:10:57,6921.664,Lion,588,153,18,33,18,34,35,12,585,567,534,452,403,367,70,83,284,304,53,27,355,0
7:11:03,6921.864,Lion,588,153,18,33,15,34,38,12,585,567,534,455,406,367,70,83,284,304,53,27,355,0
7:11:19,6922.464,Lion,588,152,18,33,15,34,38,11,585,567,534,455,406,367,69,83,284,304,53,27,356,0
7:13:02,6926.464,Lion,588,152,21,33,15,34,38,11,588,567,534,455,406,367,69,83,284,304,53,27,356,0
7:14:05,6928.964,Lion,588,152,18,36,15,34,38,11,588,570,534,455,406,367,69,83,284,304,53,27,356,0
7:14:14,6929.264,Lion,591,155,18,36,15,34,38,11,588,570,534,455,406,367,69,86,284,307,53,27,356,0
7:14:17,6929.464,Lion,591,154,18,36,15,34,38,10,588,570,534,455,406,367,69,85,284,307,53,27,357,0
7:14:22,6929.664,Lion,591,154,18,33,18,34,38,10,588,570,537,455,406,367,69,85,284,307,53,27,357,0
7:14:45,6930.563,Lion,591,154,18,30,21,34,38,10,588,570,540,455,406,367,69,85,284,307,53,27,357,0
7:15:01,6931.164,Lion,591,154,18,27,24,34,38,10,588,570,543,455,406,367,69,85,284,307,53,27,357,0
7:15:26,6932.164,Lion,591,153,18,27,23,34,38,10,588,570,543,455,406,367,68,85,284,307,53,28,357,0
7:15:49,6933.063,Lion,591,153,18,27,23,34,36,12,588,570,543,455,406,369,68,85,284,307,53,28,357,0
7:19:27,6941.864,Lion,591,153,18,27,23,34,33,15,588,570,543,455,406,372,68,85,284,307,53,28,357,0
7:19:37,6942.164,Lion,591,153,21,27,23,34,33,15,591,570,543,455,406,372,68,85,284,307,53,28,357,0
7:20:14,6943.664,Lion,591,152,21,27,23,34,33,14,591,570,543,455,406,372,67,85,284,307,53,28,358,0
7:28:40,6963.264,Lion,591,152,21,27,21,36,33,14,591,570,543,457,406,372,67,85,284,307,53,28,358,0
7:29:49,6965.864,Lion,591,152,21,27,21,33,36,14,591,570,543,457,409,372,67,85,284,307,53,28,358,0
7:30:27,6967.264,Lion,591,152,21,24,24,33,36,14,591,570,546,457,409,372,67,85,284,307,53,28,358,0
7:32:56,6973.063,Lion,591,152,21,21,27,33,36,14,591,570,549,457,409,372,67,85,284,307,53,28,358,0
7:33:01,6973.264,Lion,591,152,21,21,27,33,35,15,591,570,549,457,409,373,67,85,284,307,53,28,358,0
7:34:34,6976.764,Lion,591,152,18,24,27,33,35,15,591,573,549,457,409,373,67,85,284,307,53,28,358,0
7:35:00,6977.764,Lion,591,151,18,24,27,33,35,14,591,573,549,457,409,373,67,84,284,307,53,28,359,0
7:36:19,6980.464,Lion,591,151,18,24,27,31,37,14,591,573,549,457,411,373,67,84,284,307,53,28,359,0
7:36:31,6980.764,Lion,591,151,15,27,27,31,37,14,591,576,549,457,411,373,67,84,284,307,53,28,359,0
7:37:03,6981.864,Lion,591,151,15,27,27,31,35,16,591,576,549,457,411,375,67,84,284,307,53,28,359,0
7:37:17,6982.364,Lion,591,151,15,27,24,34,35,16,591,576,549,460,411,375,67,84,284,307,53,28,359,0
7:37:34,6983.063,Lion,591,150,15,27,24,34,35,15,591,576,549,460,411,375,67,83,284,307,53,28,360,0
7:37:58,6983.964,Lion,594,153,15,27,24,34,35,15,591,576,549,460,411,375,69,84,286,308,53,28,360,0
7:38:08,6984.464,Lion,594,153,15,24,27,34,35,15,591,576,552,460,411,375,69,84,286,308,53,28,360,0
7:38:33,6985.464,Lion,594,153,15,24,24,37,35,15,591,576,552,463,411,375,69,84,286,308,53,28,360,0
7:40:02,6988.864,Lion,597,156,15,24,24,37,35,15,591,576,552,463,411,375,71,85,288,309,53,28,360,0
7:40:40,6990.364,Lion,597,156,15,21,27,37,35,15,591,576,555,463,411,375,71,85,288,309,53,28,360,0
7:42:17,6994.164,Lion,597,155,15,21,27,37,35,14,591,576,555,463,411,375,70,85,288,309,53,28,361,0
7:43:31,6996.864,Lion,597,155,18,21,27,37,35,14,594,576,555,463,411,375,70,85,288,309,53,28,361,0
7:44:56,7000.264,Lion,597,154,18,18,30,37,35,13,594,576,558,463,411,375,69,85,288,309,53,28,362,0
7:45:00,7000.464,Lion,597,154,18,18,27,40,35,13,594,576,558,466,411,375,69,85,288,309,53,28,362,0
7:45:14,7000.964,Lion,597,154,15,21,27,40,35,13,594,579,558,466,411,375,69,85,288,309,53,28,362,0
7:45:35,7001.764,Lion,597,154,15,24,27,40,35,13,597,582,558,466,411,375,69,85,288,309,53,28,362,0
7:46:09,7003.164,Lion,597,154,12,27,27,40,35,13,597,585,558,466,411,375,69,85,288,309,53,28,362,0
7:50:12,7012.563,Lion,597,153,12,27,27,40,35,12,597,585,558,466,411,375,68,85,288,309,53,28,363,0
7:50:40,7013.664,Lion,597,152,12,27,27,40,35,11,597,585,558,466,411,375,67,85,288,309,53,28,364,0
7:51:44,7016.164,Lion,597,152,12,27,27,38,37,11,597,585,558,466,413,375,67,85,288,309,53,28,364,0
7:53:15,7019.563,Lion,597,152,12,27,27,36,39,11,597,585,558,466,415,375,67,85,288,309,53,28,364,0
7:53:51,7020.864,Lion,597,152,12,27,27,34,41,11,597,585,558,466,417,375,67,85,288,309,53,28,364,0
7:54:01,7021.164,Lion,600,155,12,27,27,34,41,11,597,585,558,466,417,375,68,87,289,311,53,28,364,0
7:54:33,7022.464,Lion,600,154,12,27,27,34,41,10,597,585,558,466,417,375,68,86,289,311,53,28,365,0
7:54:39,7022.664,Lion,600,153,12,27,27,34,41,9,597,585,558,466,417,375,68,85,289,311,53,28,366,0
7:54:52,7023.063,Lion,603,156,12,27,27,34,41,9,597,585,558,466,417,375,70,86,291,312,53,28,366,0
7:57:02,7027.864,Lion,603,156,12,24,30,34,41,9,597,585,561,466,417,375,70,86,291,312,53,28,366,0
7:58:49,7031.364,Lion,603,156,12,24,30,31,44,9,597,585,561,466,420,375,70,86,291,312,53,28,366,0
7:59:15,7032.364,Lion,603,154,12,24,30,31,44,7,597,585,561,466,420,375,70,84,291,312,53,28,368,0
7:59:23,7032.664,Lion,603,154,12,24,27,34,44,7,597,585,561,469,420,375,70,84,291,312,53,28,368,0
8:00:02,7034.063,Lion,603,154,15,24,27,34,44,7,600,585,561,469,420,375,70,84,291,312,53,28,368,0
8:00:43,7035.964,Lion,603,154,18,24,27,34,44,7,603,585,561,469,420,375,70,84,291,312,53,28,368,0
8:00:45,7036.164,Lion,603,153,18,24,26,34,44,7,603,585,561,469,420,375,70,83,291,312,54,28,368,0
