System Time:,Simulation Time:,AnimalType:,overall,alive,puppy,juvenile,young_adult,adult,aged_adult,elder,overall_puppy,overall_juvenile,overall_young_adult,overall_adult,overall_aged_adult,overall_elder,female,male,overall_female,overall_male,thirstDeath,hungerDeath,ageDeath,predatorDeath
19:03:59,3.340582,Fox,18,18,18,0,0,0,0,0,18,0,0,0,0,0,8,10,8,10,0,0,0,0
19:04:26,85.65182,Fox,18,18,0,18,0,0,0,0,18,18,0,0,0,0,8,10,8,10,0,0,0,0
19:04:39,124.1868,Fox,18,18,0,0,18,0,0,0,18,18,18,0,0,0,8,10,8,10,0,0,0,0
19:04:51,160.288,Fox,20,20,2,0,18,0,0,0,20,18,18,0,0,0,9,11,9,11,0,0,0,0
19:04:52,161.9995,Fox,22,22,4,0,18,0,0,0,22,18,18,0,0,0,10,12,10,12,0,0,0,0
19:04:59,184.6812,Fox,22,22,4,0,0,18,0,0,22,18,18,18,0,0,10,12,10,12,0,0,0,0
19:05:05,201.1194,Fox,24,24,6,0,0,18,0,0,24,18,18,18,0,0,10,14,10,14,0,0,0,0
19:05:10,218.0181,Fox,26,26,8,0,0,18,0,0,26,18,18,18,0,0,12,14,12,14,0,0,0,0
19:05:17,237.4857,Fox,28,27,10,0,0,17,0,0,28,18,18,18,0,0,13,14,14,14,0,1,0,0
19:05:17,238.1397,Fox,30,29,12,0,0,17,0,0,30,18,18,18,0,0,14,15,15,15,0,1,0,0
19:05:18,242.7915,Fox,30,29,10,2,0,17,0,0,30,20,18,18,0,0,14,15,15,15,0,1,0,0
19:05:19,244.4895,Fox,30,29,8,4,0,17,0,0,30,22,18,18,0,0,14,15,15,15,0,1,0,0
19:05:21,250.1016,Fox,32,31,10,4,0,17,0,0,32,22,18,18,0,0,15,16,16,16,0,1,0,0
19:05:29,274.3496,Fox,34,33,12,4,0,17,0,0,34,22,18,18,0,0,16,17,17,17,0,1,0,0
19:05:30,277.9589,Fox,36,35,14,4,0,17,0,0,36,22,18,18,0,0,16,19,17,19,0,1,0,0
19:05:30,278.1541,Fox,36,35,14,4,0,0,17,0,36,22,18,18,17,0,16,19,17,19,0,1,0,0
19:05:31,281.2826,Fox,36,35,14,2,2,0,17,0,36,22,20,18,17,0,16,19,17,19,0,1,0,0
19:05:32,283.0391,Fox,36,35,14,0,4,0,17,0,36,22,22,18,17,0,16,19,17,19,0,1,0,0
19:05:32,283.6589,Fox,36,35,12,2,4,0,17,0,36,24,22,18,17,0,16,19,17,19,0,1,0,0
19:05:38,300.5154,Fox,36,35,10,4,4,0,17,0,36,26,22,18,17,0,16,19,17,19,0,1,0,0
19:05:41,311.3361,Fox,36,34,10,4,4,0,16,0,36,26,22,18,17,0,15,19,17,19,0,2,0,0
19:05:42,312.1825,Fox,38,36,12,4,4,0,16,0,38,26,22,18,17,0,16,20,18,20,0,2,0,0
19:05:43,316.0696,Fox,40,37,14,4,3,0,16,0,40,26,22,18,17,0,17,20,20,20,0,3,0,0
19:05:43,317.8923,Fox,42,38,16,4,2,0,16,0,42,26,22,18,17,0,17,21,21,21,0,4,0,0
19:05:44,320.0524,Fox,42,38,14,6,2,0,16,0,42,28,22,18,17,0,17,21,21,21,0,4,0,0
19:05:44,320.6714,Fox,42,38,12,8,2,0,16,0,42,30,22,18,17,0,17,21,21,21,0,4,0,0
19:05:45,322.1388,Fox,42,38,12,6,4,0,16,0,42,30,24,18,17,0,17,21,21,21,0,4,0,0
19:05:48,332.6018,Fox,42,38,10,8,4,0,16,0,42,32,24,18,17,0,17,21,21,21,0,4,0,0
19:05:51,339.0406,Fox,42,38,10,6,6,0,16,0,42,32,26,18,17,0,17,21,21,21,0,4,0,0
19:05:51,340.8236,Fox,44,40,12,6,6,0,16,0,44,32,26,18,17,0,19,21,23,21,0,4,0,0
19:05:51,341.7901,Fox,44,40,12,6,5,1,16,0,44,32,26,19,17,0,19,21,23,21,0,4,0,0
19:05:52,343.5595,Fox,44,40,12,6,4,2,16,0,44,32,26,20,17,0,19,21,23,21,0,4,0,0
19:05:53,347.636,Fox,46,42,14,6,4,2,16,0,46,32,26,20,17,0,20,22,24,22,0,4,0,0
19:05:56,356.8743,Fox,46,42,12,8,4,2,16,0,46,34,26,20,17,0,20,22,24,22,0,4,0,0
19:05:57,358.5048,Fox,46,42,12,6,6,2,16,0,46,34,28,20,17,0,20,22,24,22,0,4,0,0
19:05:57,359.2264,Fox,46,42,12,4,8,2,16,0,46,34,30,20,17,0,20,22,24,22,0,4,0,0
19:05:58,360.4962,Fox,46,42,10,6,8,2,16,0,46,36,30,20,17,0,20,22,24,22,0,4,0,0
19:06:01,371.1073,Fox,46,42,10,4,10,2,16,0,46,36,32,20,17,0,20,22,24,22,0,4,0,0
19:06:05,382.66,Fox,46,42,10,4,8,4,16,0,46,36,32,22,17,0,20,22,24,22,0,4,0,0
19:06:09,393.2434,Fox,46,41,10,4,8,3,16,0,46,36,32,22,17,0,20,21,24,22,0,5,0,0
19:06:09,394.7736,Fox,46,41,8,6,8,3,16,0,46,38,32,22,17,0,20,21,24,22,0,5,0,0
19:06:09,395.382,Fox,46,41,8,4,10,3,16,0,46,38,34,22,17,0,20,21,24,22,0,5,0,0
19:06:09,395.9561,Fox,48,43,10,4,10,3,16,0,48,38,34,22,17,0,20,23,24,24,0,5,0,0
19:06:10,398.3118,Fox,48,42,10,4,10,3,15,0,48,38,34,22,17,0,20,22,24,24,0,6,0,0
19:06:10,398.5918,Fox,50,44,10,6,10,3,15,0,50,40,34,22,17,0,20,24,24,26,0,6,0,0
19:06:10,398.9731,Fox,50,44,10,4,12,3,15,0,50,40,36,22,17,0,20,24,24,26,0,6,0,0
19:06:11,399.541,Fox,50,44,10,4,10,5,15,0,50,40,36,24,17,0,20,24,24,26,0,6,0,0
19:06:11,400.4453,Fox,50,44,8,6,10,5,15,0,50,42,36,24,17,0,20,24,24,26,0,6,0,0
19:06:12,404.3529,Fox,52,46,10,6,10,5,15,0,52,42,36,24,17,0,21,25,25,27,0,6,0,0
19:06:13,407.4598,Fox,54,47,12,6,9,5,15,0,54,42,36,24,17,0,21,26,26,28,0,7,0,0
19:06:16,415.6759,Fox,54,47,12,6,9,5,0,15,54,42,36,24,17,15,21,26,26,28,0,7,0,0
19:06:17,419.0487,Fox,54,47,12,6,7,7,0,15,54,42,36,26,17,15,21,26,26,28,0,7,0,0
19:06:17,419.665,Fox,54,47,12,6,5,9,0,15,54,42,36,28,17,15,21,26,26,28,0,7,0,0
19:06:19,423.4002,Fox,56,49,10,8,5,9,0,15,54,44,36,28,17,15,22,27,27,29,0,7,0,0
19:06:19,423.4949,Fox,56,49,12,8,5,9,0,15,56,44,36,28,17,15,22,27,27,29,0,7,0,0
19:06:19,425.6885,Fox,56,46,12,8,5,9,0,12,56,44,36,28,17,15,22,24,27,29,0,7,3,0
19:06:21,430.1431,Fox,56,46,10,10,5,9,0,12,56,46,36,28,17,15,22,24,27,29,0,7,3,0
19:06:21,430.3164,Fox,56,45,10,10,5,8,0,12,56,46,36,28,17,15,22,23,27,29,0,8,3,0
19:06:21,431.6129,Fox,56,45,10,10,4,9,0,12,56,46,36,29,17,15,22,23,27,29,0,8,3,0
19:06:22,432.97,Fox,58,47,12,10,4,9,0,12,58,46,36,29,17,15,22,25,27,31,0,8,3,0
19:06:22,433.2539,Fox,58,47,12,8,6,9,0,12,58,46,38,29,17,15,22,25,27,31,0,8,3,0
19:06:23,435.335,Fox,58,47,12,8,6,8,1,12,58,46,38,29,18,15,22,25,27,31,0,8,3,0
19:06:23,435.7039,Fox,58,46,12,8,6,8,1,11,58,46,38,29,18,15,22,24,27,31,0,8,4,0
19:06:23,437.0912,Fox,58,46,12,6,8,7,2,11,58,46,40,29,19,15,22,24,27,31,0,8,4,0
19:06:24,438.9191,Fox,58,46,12,4,10,7,2,11,58,46,42,29,19,15,22,24,27,31,0,8,4,0
19:06:25,442.2482,Fox,58,45,12,4,10,6,2,11,58,46,42,29,19,15,22,23,27,31,0,9,4,0
19:06:26,445.092,Fox,60,47,14,4,10,6,2,11,60,46,42,29,19,15,24,23,29,31,0,9,4,0
19:06:26,445.2946,Fox,62,49,16,4,10,6,2,11,62,46,42,29,19,15,25,24,30,32,0,9,4,0
19:06:26,445.7611,Fox,62,48,16,4,10,6,2,10,62,46,42,29,19,15,25,23,30,32,0,9,5,0
19:06:29,453.4282,Fox,62,47,16,4,10,6,1,10,62,46,42,29,19,15,25,22,30,32,0,10,5,0
19:06:29,453.8131,Fox,62,46,16,4,10,5,1,10,62,46,42,29,19,15,24,22,30,32,0,11,5,0
19:06:29,455.8611,Fox,62,44,16,4,8,7,1,8,62,46,42,31,19,15,23,21,30,32,0,11,7,0
19:06:31,459.5139,Fox,62,44,16,4,6,9,1,8,62,46,42,33,19,15,23,21,30,32,0,11,7,0
19:06:31,461.9689,Fox,62,44,16,2,8,9,1,8,62,46,44,33,19,15,23,21,30,32,0,11,7,0
19:06:33,465.8113,Fox,62,39,16,2,8,9,1,3,62,46,44,33,19,15,20,19,30,32,0,11,12,0
19:06:34,468.7968,Fox,64,40,16,0,9,9,1,3,62,46,46,33,19,15,20,20,31,33,0,12,12,0
19:06:34,468.9033,Fox,64,40,18,0,9,9,1,3,64,46,46,33,19,15,20,20,31,33,0,12,12,0
19:06:36,475.1838,Fox,66,41,20,0,8,9,1,3,66,46,46,33,19,15,20,21,32,34,0,13,12,0
19:06:36,475.83,Fox,66,40,20,0,8,9,1,2,66,46,46,33,19,15,20,20,32,34,0,13,13,0
19:06:36,476.2112,Fox,66,40,20,0,8,8,2,2,66,46,46,33,20,15,20,20,32,34,0,13,13,0
19:06:37,478.5081,Fox,66,40,18,2,8,8,2,2,66,48,46,33,20,15,20,20,32,34,0,13,13,0
19:06:38,481.1508,Fox,66,40,16,4,8,8,2,2,66,50,46,33,20,15,20,20,32,34,0,13,13,0
19:06:39,485.8989,Fox,66,39,16,4,8,8,2,1,66,50,46,33,20,15,19,20,32,34,0,13,14,0
19:06:40,486.8826,Fox,66,39,14,6,8,8,2,1,66,52,46,33,20,15,19,20,32,34,0,13,14,0
19:06:41,489.9957,Fox,66,39,12,8,8,8,2,1,66,54,46,33,20,15,19,20,32,34,0,13,14,0
19:06:42,493.0448,Fox,66,39,12,8,8,6,4,1,66,54,46,33,22,15,19,20,32,34,0,13,14,0
19:06:42,493.6936,Fox,66,39,12,8,7,7,4,1,66,54,46,34,22,15,19,20,32,34,0,13,14,0
19:06:43,495.9091,Fox,66,38,12,8,7,7,4,0,66,54,46,34,22,15,18,20,32,34,0,13,15,0
19:06:43,497.5636,Fox,66,38,12,8,5,9,4,0,66,54,46,36,22,15,18,20,32,34,0,13,15,0
19:06:44,499.42,Fox,66,38,12,8,4,10,4,0,66,54,46,37,22,15,18,20,32,34,0,13,15,0
19:06:46,504.3185,Fox,66,37,12,8,4,9,4,0,66,54,46,37,22,15,18,19,32,34,0,14,15,0
19:06:46,506.0454,Fox,66,37,10,10,4,9,4,0,66,56,46,37,22,15,18,19,32,34,0,14,15,0
19:06:46,506.6933,Fox,68,39,12,10,4,9,4,0,68,56,46,37,22,15,20,19,34,34,0,14,15,0
19:06:48,510.0548,Fox,68,38,12,10,4,8,4,0,68,56,46,37,22,15,20,18,34,34,0,15,15,0
19:06:48,512.4935,Fox,68,38,12,10,4,7,5,0,68,56,46,37,23,15,20,18,34,34,0,15,15,0
19:06:49,513.2104,Fox,68,38,12,10,4,6,6,0,68,56,46,37,24,15,20,18,34,34,0,15,15,0
19:06:49,515.3553,Fox,68,38,10,12,4,6,6,0,68,58,46,37,24,15,20,18,34,34,0,15,15,0
19:06:50,517.0301,Fox,68,38,10,10,6,6,6,0,68,58,48,37,24,15,20,18,34,34,0,15,15,0
19:06:51,519.6581,Fox,68,38,10,8,8,6,6,0,68,58,50,37,24,15,20,18,34,34,0,15,15,0
19:06:52,522.365,Fox,68,38,10,8,6,8,6,0,68,58,50,39,24,15,20,18,34,34,0,15,15,0
19:06:53,525.378,Fox,68,38,10,6,8,8,6,0,68,58,52,39,24,15,20,18,34,34,0,15,15,0
19:06:53,527.6049,Fox,68,38,8,8,8,8,6,0,68,60,52,39,24,15,20,18,34,34,0,15,15,0
19:06:53,527.7972,Fox,68,38,6,10,8,8,6,0,68,62,52,39,24,15,20,18,34,34,0,15,15,0
19:06:54,528.4973,Fox,68,38,6,8,10,8,6,0,68,62,54,39,24,15,20,18,34,34,0,15,15,0
19:06:54,529.2053,Fox,68,38,6,8,8,10,6,0,68,62,54,41,24,15,20,18,34,34,0,15,15,0
19:06:55,532.96,Fox,68,36,6,8,8,8,6,0,68,62,54,41,24,15,18,18,34,34,0,17,15,0
19:06:57,539.7692,Fox,68,35,6,8,8,7,6,0,68,62,54,41,24,15,18,17,34,34,0,18,15,0
19:06:59,544.5661,Fox,68,35,6,6,10,7,6,0,68,62,56,41,24,15,18,17,34,34,0,18,15,0
19:07:01,549.4,Fox,68,35,6,6,10,5,8,0,68,62,56,41,26,15,18,17,34,34,0,18,15,0
19:07:01,551.4637,Fox,68,35,4,8,10,5,8,0,68,64,56,41,26,15,18,17,34,34,0,18,15,0
19:07:02,553.0142,Fox,68,35,4,8,10,3,10,0,68,64,56,41,28,15,18,17,34,34,0,18,15,0
19:07:02,553.8553,Fox,68,35,4,6,12,3,10,0,68,64,58,41,28,15,18,17,34,34,0,18,15,0
19:07:03,557.8174,Fox,68,35,2,8,12,3,10,0,68,66,58,41,28,15,18,17,34,34,0,18,15,0
19:07:06,566.0963,Fox,68,35,2,6,14,3,10,0,68,66,60,41,28,15,18,17,34,34,0,18,15,0
19:07:06,566.346,Fox,68,35,2,4,16,3,10,0,68,66,62,41,28,15,18,17,34,34,0,18,15,0
19:07:09,574.4957,Fox,68,35,2,4,16,3,9,1,68,66,62,41,28,16,18,17,34,34,0,18,15,0
19:07:09,574.7984,Fox,70,37,4,4,16,3,9,1,70,66,62,41,28,16,18,19,34,36,0,18,15,0
19:07:10,577.4565,Fox,70,37,4,4,14,5,9,1,70,66,62,43,28,16,18,19,34,36,0,18,15,0
19:07:11,580.1116,Fox,70,37,4,4,12,7,9,1,70,66,62,45,28,16,18,19,34,36,0,18,15,0
19:07:11,581.0864,Fox,72,38,6,4,11,7,9,1,72,66,62,45,28,16,19,19,36,36,0,19,15,0
19:07:13,585.7939,Fox,74,40,8,4,11,7,9,1,74,66,62,45,28,16,21,19,38,36,0,19,15,0
19:07:13,585.8935,Fox,74,40,8,4,9,9,9,1,74,66,62,47,28,16,21,19,38,36,0,19,15,0
19:07:14,588.1111,Fox,74,38,8,4,9,7,9,1,74,66,62,47,28,16,21,17,38,36,0,21,15,0
19:07:14,588.9802,Fox,74,38,8,4,7,9,9,1,74,66,62,49,28,16,21,17,38,36,0,21,15,0
19:07:14,589.4777,Fox,74,38,6,6,7,9,9,1,74,68,62,49,28,16,21,17,38,36,0,21,15,0
19:07:14,589.9344,Fox,74,38,6,4,9,9,9,1,74,68,64,49,28,16,21,17,38,36,0,21,15,0
19:07:15,590.6997,Fox,74,36,6,4,9,7,9,1,74,68,64,49,28,16,21,15,38,36,0,23,15,0
19:07:15,591.1409,Fox,74,36,6,4,9,5,11,1,74,68,64,49,30,16,21,15,38,36,0,23,15,0
19:07:16,593.8508,Fox,76,37,8,4,9,4,11,1,76,68,64,49,30,16,20,17,38,38,0,24,15,0
19:07:16,596.1652,Fox,76,37,8,2,11,4,11,1,76,68,66,49,30,16,20,17,38,38,0,24,15,0
19:07:17,599.5438,Fox,76,36,8,2,11,3,11,1,76,68,66,49,30,16,20,16,38,38,0,25,15,0
19:07:19,603.1414,Fox,78,37,10,2,10,3,11,1,78,68,66,49,30,16,20,17,39,39,0,26,15,0
19:07:19,605.0447,Fox,78,37,10,2,9,4,11,1,78,68,66,50,30,16,20,17,39,39,0,26,15,0
19:07:22,613.633,Fox,78,37,10,2,9,4,10,2,78,68,66,50,30,17,20,17,39,39,0,26,15,0
19:07:22,614.3835,Fox,78,37,10,2,7,6,10,2,78,68,66,52,30,17,20,17,39,39,0,26,15,0
19:07:23,615.6362,Fox,78,36,10,2,7,5,10,2,78,68,66,52,30,17,20,16,39,39,0,27,15,0
19:07:25,622.6394,Fox,78,36,10,2,7,4,11,2,78,68,66,52,31,17,20,16,39,39,0,27,15,0
19:07:26,624.6945,Fox,78,35,10,2,7,4,11,1,78,68,66,52,31,17,20,15,39,39,0,27,16,0
19:07:26,624.9258,Fox,78,34,10,2,7,3,11,1,78,68,66,52,31,17,20,14,39,39,0,28,16,0
19:07:27,626.6476,Fox,78,34,10,2,5,5,11,1,78,68,66,54,31,17,20,14,39,39,0,28,16,0
19:07:27,626.8008,Fox,78,34,10,2,4,6,11,1,78,68,66,55,31,17,20,14,39,39,0,28,16,0
19:07:27,627.7295,Fox,78,34,10,0,6,6,11,1,78,68,68,55,31,17,20,14,39,39,0,28,16,0
19:07:28,630.507,Fox,78,34,10,0,6,6,9,3,78,68,68,55,31,19,20,14,39,39,0,28,16,0
19:07:30,637.23,Fox,78,33,10,0,6,5,9,3,78,68,68,55,31,19,19,14,39,39,1,28,16,0
19:07:30,637.389,Fox,78,32,10,0,6,4,9,3,78,68,68,55,31,19,19,13,39,39,1,29,16,0
19:07:32,643.8427,Fox,78,31,10,0,6,4,9,2,78,68,68,55,31,19,19,12,39,39,1,29,17,0
19:07:34,649.9782,Fox,78,31,10,0,6,4,8,3,78,68,68,55,31,20,19,12,39,39,1,29,17,0
19:07:34,650.4317,Fox,78,31,10,0,4,6,8,3,78,68,68,57,31,20,19,12,39,39,1,29,17,0
19:07:35,650.667,Fox,78,31,10,0,4,6,7,4,78,68,68,57,31,21,19,12,39,39,1,29,17,0
19:07:37,656.6881,Fox,78,31,10,0,2,8,7,4,78,68,68,59,31,21,19,12,39,39,1,29,17,0
19:07:37,657.2933,Fox,78,31,8,2,2,8,7,4,78,70,68,59,31,21,19,12,39,39,1,29,17,0
19:07:38,661.0264,Fox,78,29,8,2,2,6,7,4,78,70,68,59,31,21,18,11,39,39,1,31,17,0
19:07:39,663.575,Fox,78,29,6,4,2,6,7,4,78,72,68,59,31,21,18,11,39,39,1,31,17,0
19:07:40,666.7855,Fox,80,31,8,4,2,6,7,4,80,72,68,59,31,21,20,11,41,39,1,31,17,0
19:07:40,667.3233,Fox,80,29,8,4,2,4,7,4,80,72,68,59,31,21,19,10,41,39,1,33,17,0
19:07:40,668.3265,Fox,80,29,6,6,2,4,7,4,80,74,68,59,31,21,19,10,41,39,1,33,17,0
19:07:43,676.3895,Fox,80,29,4,8,2,4,7,4,80,76,68,59,31,21,19,10,41,39,1,33,17,0
19:07:44,679.4018,Fox,80,29,4,8,2,2,9,4,80,76,68,59,33,21,19,10,41,39,1,33,17,0
19:07:45,680.8126,Fox,80,28,4,8,2,2,9,3,80,76,68,59,33,21,18,10,41,39,1,33,18,0
19:07:46,685.6331,Fox,80,28,2,10,2,2,9,3,80,78,68,59,33,21,18,10,41,39,1,33,18,0
19:07:47,686.8479,Fox,80,28,2,10,2,2,7,5,80,78,68,59,33,23,18,10,41,39,1,33,18,0
19:07:47,688.201,Fox,80,28,2,10,0,4,7,5,80,78,68,61,33,23,18,10,41,39,1,33,18,0
19:07:48,690.4835,Fox,80,28,2,10,0,4,5,7,80,78,68,61,33,25,18,10,41,39,1,33,18,0
19:07:50,695.7971,Fox,80,28,2,8,2,4,5,7,80,78,70,61,33,25,18,10,41,39,1,33,18,0
19:07:51,698.8497,Fox,80,26,2,8,2,2,5,7,80,78,70,61,33,25,16,10,41,39,1,35,18,0
19:07:52,702.0953,Fox,80,26,2,6,4,2,5,7,80,78,72,61,33,25,16,10,41,39,1,35,18,0
19:07:52,702.3518,Fox,82,28,4,6,4,2,5,7,82,78,72,61,33,25,18,10,43,39,1,35,18,0
19:07:53,706.7609,Fox,82,28,4,4,6,2,5,7,82,78,74,61,33,25,18,10,43,39,1,35,18,0
19:07:54,707.817,Fox,82,28,4,4,6,1,6,7,82,78,74,61,34,25,18,10,43,39,1,35,18,0
19:07:55,710.8141,Fox,82,26,4,4,6,1,6,5,82,78,74,61,34,25,16,10,43,39,1,35,20,0
19:07:56,714.8737,Fox,82,26,4,2,8,1,6,5,82,78,76,61,34,25,16,10,43,39,1,35,20,0
19:07:58,720.0639,Fox,82,26,4,2,8,0,7,5,82,78,76,61,35,25,16,10,43,39,1,35,20,0
19:07:58,720.5875,Fox,82,25,4,2,8,0,7,4,82,78,76,61,35,25,16,9,43,39,1,35,21,0
19:07:59,724.1558,Fox,82,25,4,0,10,0,7,4,82,78,78,61,35,25,16,9,43,39,1,35,21,0
19:08:00,728.5446,Fox,82,25,4,0,10,0,5,6,82,78,78,61,35,27,16,9,43,39,1,35,21,0
19:08:01,730.6134,Fox,82,24,4,0,10,0,5,5,82,78,78,61,35,27,16,8,43,39,1,35,22,0
19:08:03,734.8959,Fox,84,26,6,0,10,0,5,5,84,78,78,61,35,27,17,9,44,40,1,35,22,0
19:08:06,744.5251,Fox,84,25,6,0,10,0,4,5,84,78,78,61,35,27,16,9,44,40,1,36,22,0
19:08:07,749.3101,Fox,84,25,4,2,10,0,4,5,84,80,78,61,35,27,16,9,44,40,1,36,22,0
19:08:10,756.2685,Fox,84,25,4,2,8,2,4,5,84,80,78,63,35,27,16,9,44,40,1,36,22,0
19:08:11,758.6621,Fox,84,24,4,2,8,2,4,4,84,80,78,63,35,27,15,9,44,40,1,36,23,0
19:08:11,760.1243,Fox,84,24,4,2,8,2,3,5,84,80,78,63,35,28,15,9,44,40,1,36,23,0
19:08:11,761.2107,Fox,86,25,6,2,7,2,3,5,86,80,78,63,35,28,14,11,44,42,1,37,23,0
19:08:12,762.573,Fox,86,25,6,2,5,4,3,5,86,80,78,65,35,28,14,11,44,42,1,37,23,0
19:08:13,766.9216,Fox,86,23,6,2,5,2,3,5,86,80,78,65,35,28,14,9,44,42,3,37,23,0
19:08:13,767.269,Fox,86,22,6,2,3,4,3,4,86,80,78,67,35,28,14,8,44,42,3,37,24,0
19:08:15,773.2221,Fox,86,20,6,2,3,2,3,4,86,80,78,67,35,28,12,8,44,42,3,39,24,0
19:08:16,775.3759,Fox,86,20,6,2,1,4,3,4,86,80,78,69,35,28,12,8,44,42,3,39,24,0
19:08:17,777.9144,Fox,86,18,6,2,1,2,3,4,86,80,78,69,35,28,10,8,44,42,3,41,24,0
19:08:18,780.4305,Fox,86,17,6,2,1,2,3,3,86,80,78,69,35,28,9,8,44,42,3,41,25,0
19:08:19,784.6693,Fox,86,17,6,2,0,3,3,3,86,80,78,70,35,28,9,8,44,42,3,41,25,0
19:08:19,784.8564,Fox,86,17,4,4,0,3,3,3,86,82,78,70,35,28,9,8,44,42,3,41,25,0
19:08:20,786.0091,Fox,86,15,4,4,0,1,3,3,86,82,78,70,35,28,9,6,44,42,3,43,25,0
19:08:20,787.8425,Fox,86,15,4,2,2,1,3,3,86,82,80,70,35,28,9,6,44,42,3,43,25,0
19:08:23,795.24,Fox,86,14,4,2,2,0,3,3,86,82,80,70,35,28,9,5,44,42,3,44,25,0
19:08:27,807.4247,Fox,86,13,4,2,2,0,3,2,86,82,80,70,35,28,8,5,44,42,3,44,26,0
19:08:27,808.8174,Fox,86,12,4,2,2,0,3,1,86,82,80,70,35,28,7,5,44,42,3,44,27,0
19:08:28,810.284,Fox,86,11,4,2,2,0,3,0,86,82,80,70,35,28,6,5,44,42,3,44,28,0
19:08:30,816.8763,Fox,86,11,4,2,2,0,1,2,86,82,80,70,35,30,6,5,44,42,3,44,28,0
19:08:30,817.3958,Fox,86,11,2,4,2,0,1,2,86,84,80,70,35,30,6,5,44,42,3,44,28,0
19:08:32,823.3767,Fox,86,11,2,2,4,0,1,2,86,84,82,70,35,30,6,5,44,42,3,44,28,0
19:08:33,826.906,Fox,86,10,2,2,4,0,1,1,86,84,82,70,35,30,6,4,44,42,3,44,29,0
19:08:39,843.7311,Fox,86,10,0,4,4,0,1,1,86,86,82,70,35,30,6,4,44,42,3,44,29,0
19:08:39,845.2975,Fox,86,10,0,4,4,0,0,2,86,86,82,70,35,31,6,4,44,42,3,44,29,0
19:08:40,848.2882,Fox,86,10,0,4,2,2,0,2,86,86,82,72,35,31,6,4,44,42,3,44,29,0
19:08:43,855.8942,Fox,86,10,0,2,4,2,0,2,86,86,84,72,35,31,6,4,44,42,3,44,29,0
19:08:44,858.926,Fox,86,8,0,2,4,0,0,2,86,86,84,72,35,31,4,4,44,42,3,46,29,0
19:08:52,882.2335,Fox,86,8,0,0,6,0,0,2,86,86,86,72,35,31,4,4,44,42,3,46,29,0
19:08:52,883.8763,Fox,86,8,0,0,4,2,0,2,86,86,86,74,35,31,4,4,44,42,3,46,29,0
19:08:55,890.6326,Fox,88,9,2,0,3,2,0,2,88,86,86,74,35,31,5,4,46,42,3,47,29,0
19:08:56,894.4768,Fox,88,7,2,0,3,0,0,2,88,86,86,74,35,31,3,4,46,42,3,49,29,0
19:08:56,895.4708,Fox,88,6,2,0,3,0,0,1,88,86,86,74,35,31,3,3,46,42,3,49,30,0
19:08:57,897.1379,Fox,88,5,2,0,3,0,0,0,88,86,86,74,35,31,2,3,46,42,3,49,31,0
19:09:03,916.4063,Fox,88,5,2,0,2,1,0,0,88,86,86,75,35,31,2,3,46,42,3,49,31,0
19:09:12,942.7549,Fox,88,5,2,0,0,3,0,0,88,86,86,77,35,31,2,3,46,42,3,49,31,0
19:09:15,953.3328,Fox,88,3,2,0,0,1,0,0,88,86,86,77,35,31,2,1,46,42,3,51,31,0
19:09:22,973.1455,Fox,88,3,0,2,0,1,0,0,88,88,86,77,35,31,2,1,46,42,3,51,31,0
19:09:34,1009.887,Fox,88,3,0,2,0,0,1,0,88,88,86,77,36,31,2,1,46,42,3,51,31,0
19:09:35,1011.706,Fox,88,3,0,0,2,0,1,0,88,88,88,77,36,31,2,1,46,42,3,51,31,0
19:09:55,1072.134,Fox,88,3,0,0,0,2,1,0,88,88,88,79,36,31,2,1,46,42,3,51,31,0
19:09:57,1078.927,Fox,90,5,2,0,0,2,1,0,90,88,88,79,36,31,3,2,47,43,3,51,31,0
19:10:11,1119.885,Fox,92,7,4,0,0,2,1,0,92,88,88,79,36,31,3,4,47,45,3,51,31,0
19:10:20,1147.492,Fox,92,7,4,0,0,2,0,1,92,88,88,79,36,32,3,4,47,45,3,51,31,0
19:10:24,1160.429,Fox,94,9,6,0,0,2,0,1,94,88,88,79,36,32,4,5,48,46,3,51,31,0
19:10:25,1161.431,Fox,94,9,4,2,0,2,0,1,94,90,88,79,36,32,4,5,48,46,3,51,31,0
19:10:26,1165.722,Fox,94,9,4,2,0,0,2,1,94,90,88,79,38,32,4,5,48,46,3,51,31,0
19:10:38,1199.931,Fox,94,9,4,0,2,0,2,1,94,90,90,79,38,32,4,5,48,46,3,51,31,0
19:10:38,1201.373,Fox,96,11,6,0,2,0,2,1,96,90,90,79,38,32,5,6,49,47,3,51,31,0
19:10:38,1202.401,Fox,96,11,4,2,2,0,2,1,96,92,90,79,38,32,5,6,49,47,3,51,31,0
19:10:40,1207.732,Fox,96,10,4,2,2,0,2,0,96,92,90,79,38,32,5,5,49,47,3,51,32,0
19:10:51,1240.913,Fox,96,10,4,0,4,0,2,0,96,92,92,79,38,32,5,5,49,47,3,51,32,0
19:10:52,1243.025,Fox,96,10,2,2,4,0,2,0,96,94,92,79,38,32,5,5,49,47,3,51,32,0
19:10:58,1260.458,Fox,96,10,2,2,2,2,2,0,96,94,92,81,38,32,5,5,49,47,3,51,32,0
19:11:05,1281.491,Fox,96,10,2,0,4,2,2,0,96,94,94,81,38,32,5,5,49,47,3,51,32,0
19:11:06,1283.935,Fox,96,10,0,2,4,2,2,0,96,96,94,81,38,32,5,5,49,47,3,51,32,0
19:11:11,1301.423,Fox,96,10,0,2,2,4,2,0,96,96,94,83,38,32,5,5,49,47,3,51,32,0
19:11:12,1303.189,Fox,96,10,0,2,2,4,0,2,96,96,94,83,38,34,5,5,49,47,3,51,32,0
19:11:15,1312.035,Fox,96,9,0,2,2,3,0,2,96,96,94,83,38,34,5,4,49,47,4,51,32,0
19:11:18,1319.791,Fox,98,11,2,2,2,3,0,2,98,96,94,83,38,34,7,4,51,47,4,51,32,0
19:11:18,1322.465,Fox,98,11,2,0,4,3,0,2,98,96,96,83,38,34,7,4,51,47,4,51,32,0
19:11:25,1342.015,Fox,98,11,2,0,2,5,0,2,98,96,96,85,38,34,7,4,51,47,4,51,32,0
19:11:25,1343.444,Fox,98,10,2,0,2,5,0,1,98,96,96,85,38,34,6,4,51,47,4,51,33,0
19:11:29,1354.06,Fox,98,10,2,0,2,3,2,1,98,96,96,85,40,34,6,4,51,47,4,51,33,0
19:11:32,1361.621,Fox,100,12,4,0,2,3,2,1,100,96,96,85,40,34,6,6,51,49,4,51,33,0
19:11:32,1363.626,Fox,100,11,4,0,2,3,2,0,100,96,96,85,40,34,5,6,51,49,4,51,34,0
19:11:39,1382.958,Fox,100,11,4,0,0,5,2,0,100,96,96,87,40,34,5,6,51,49,4,51,34,0
19:11:43,1394.946,Fox,100,11,4,0,0,4,3,0,100,96,96,87,41,34,5,6,51,49,4,51,34,0
19:11:45,1402.311,Fox,100,11,2,2,0,4,3,0,100,98,96,87,41,34,5,6,51,49,4,51,34,0
19:11:56,1435.498,Fox,100,11,2,2,0,2,5,0,100,98,96,87,43,34,5,6,51,49,4,51,34,0
19:11:58,1440.816,Fox,100,11,2,0,2,2,5,0,100,98,98,87,43,34,5,6,51,49,4,51,34,0
19:11:59,1444.12,Fox,100,11,0,2,2,2,5,0,100,100,98,87,43,34,5,6,51,49,4,51,34,0
19:12:07,1468.75,Fox,102,13,2,2,2,2,5,0,102,100,98,87,43,34,5,8,51,51,4,51,34,0
19:12:10,1476.482,Fox,102,13,2,2,2,0,7,0,102,100,98,87,45,34,5,8,51,51,4,51,34,0
19:12:12,1482.615,Fox,102,13,2,0,4,0,7,0,102,100,100,87,45,34,5,8,51,51,4,51,34,0
19:12:13,1484.682,Fox,104,15,4,0,4,0,7,0,104,100,100,87,45,34,6,9,52,52,4,51,34,0
19:12:15,1491.506,Fox,104,15,4,0,4,0,5,2,104,100,100,87,45,36,6,9,52,52,4,51,34,0
19:12:18,1501.293,Fox,104,15,4,0,2,2,5,2,104,100,100,89,45,36,6,9,52,52,4,51,34,0
19:12:24,1519.381,Fox,106,17,6,0,2,2,5,2,106,100,100,89,45,36,7,10,53,53,4,51,34,0
19:12:24,1520.175,Fox,108,19,8,0,2,2,5,2,108,100,100,89,45,36,7,12,53,55,4,51,34,0
19:12:28,1531.624,Fox,108,18,8,0,2,2,5,1,108,100,100,89,45,36,7,11,53,55,4,51,35,0
19:12:28,1532.607,Fox,108,18,8,0,2,2,4,2,108,100,100,89,45,37,7,11,53,55,4,51,35,0
19:12:32,1543.248,Fox,108,18,8,0,0,4,4,2,108,100,100,91,45,37,7,11,53,55,4,51,35,0
19:12:35,1551.388,Fox,108,18,6,2,0,4,4,2,108,102,100,91,45,37,7,11,53,55,4,51,35,0
19:12:35,1551.894,Fox,108,17,6,2,0,4,4,1,108,102,100,91,45,37,6,11,53,55,4,51,36,0
19:12:36,1553.759,Fox,108,15,6,2,0,2,4,1,108,102,100,91,45,37,6,9,53,55,6,51,36,0
19:12:40,1567.296,Fox,108,15,4,4,0,2,4,1,108,104,100,91,45,37,6,9,53,55,6,51,36,0
19:12:42,1573.107,Fox,108,15,4,4,0,2,2,3,108,104,100,91,45,39,6,9,53,55,6,51,36,0
19:12:48,1589.83,Fox,108,15,4,2,2,2,2,3,108,104,102,91,45,39,6,9,53,55,6,51,36,0
19:12:49,1592.911,Fox,108,14,4,2,2,2,2,2,108,104,102,91,45,39,6,8,53,55,6,51,37,0
19:12:49,1594.833,Fox,108,14,4,2,2,0,4,2,108,104,102,91,47,39,6,8,53,55,6,51,37,0
19:12:52,1601.938,Fox,108,14,2,4,2,0,4,2,108,106,102,91,47,39,6,8,53,55,6,51,37,0
19:12:52,1602.796,Fox,108,14,0,6,2,0,4,2,108,108,102,91,47,39,6,8,53,55,6,51,37,0
19:12:53,1605.767,Fox,108,14,0,4,4,0,4,2,108,108,104,91,47,39,6,8,53,55,6,51,37,0
19:12:56,1613.985,Fox,108,14,0,4,4,0,2,4,108,108,104,91,47,41,6,8,53,55,6,51,37,0
19:13:03,1634.227,Fox,108,13,0,4,4,0,2,3,108,108,104,91,47,41,6,7,53,55,6,51,38,0
19:13:05,1640.518,Fox,108,13,0,2,6,0,2,3,108,108,106,91,47,41,6,7,53,55,6,51,38,0
19:13:05,1641.368,Fox,108,13,0,0,8,0,2,3,108,108,108,91,47,41,6,7,53,55,6,51,38,0
19:13:06,1644.418,Fox,110,14,0,0,8,0,2,2,108,108,108,91,47,41,7,7,55,55,6,51,39,0
19:13:06,1644.608,Fox,110,14,2,0,8,0,2,2,110,108,108,91,47,41,7,7,55,55,6,51,39,0
19:13:08,1650.453,Fox,110,14,2,0,6,2,2,2,110,108,108,93,47,41,7,7,55,55,6,51,39,0
19:13:13,1666.354,Fox,110,14,2,0,4,4,2,2,110,108,108,95,47,41,7,7,55,55,6,51,39,0
19:13:17,1677.504,Fox,112,16,4,0,4,4,2,2,112,108,108,95,47,41,8,8,56,56,6,51,39,0
19:13:19,1683.706,Fox,112,14,4,0,4,4,2,0,112,108,108,95,47,41,7,7,56,56,6,51,41,0
19:13:25,1700.995,Fox,112,14,4,0,2,6,2,0,112,108,108,97,47,41,7,7,56,56,6,51,41,0
19:13:25,1701.844,Fox,112,14,4,0,0,8,2,0,112,108,108,99,47,41,7,7,56,56,6,51,41,0
19:13:29,1712.416,Fox,112,12,4,0,0,6,2,0,112,108,108,99,47,41,7,5,56,56,8,51,41,0
19:13:34,1727.238,Fox,112,12,2,2,0,6,2,0,112,110,108,99,47,41,7,5,56,56,8,51,41,0
19:13:35,1732.523,Fox,112,12,2,2,0,6,0,2,112,110,108,99,47,43,7,5,56,56,8,51,41,0
19:13:39,1743.98,Fox,114,14,4,2,0,4,2,2,114,110,108,99,49,43,9,5,58,56,8,51,41,0
19:13:43,1754.303,Fox,116,16,6,2,0,4,2,2,116,110,108,99,49,43,9,7,58,58,8,51,41,0
19:13:44,1759.793,Fox,116,16,6,2,0,2,4,2,116,110,108,99,51,43,9,7,58,58,8,51,41,0
19:13:45,1760.213,Fox,116,16,4,4,0,2,4,2,116,112,108,99,51,43,9,7,58,58,8,51,41,0
19:13:45,1762.926,Fox,116,15,4,4,0,2,4,1,116,112,108,99,51,43,8,7,58,58,8,51,42,0
19:13:46,1765.771,Fox,116,15,4,2,2,2,4,1,116,112,110,99,51,43,8,7,58,58,8,51,42,0
19:13:52,1783.172,Fox,116,14,4,2,2,2,4,0,116,112,110,99,51,43,7,7,58,58,8,51,43,0
19:13:56,1794.652,Fox,116,14,4,2,2,0,6,0,116,112,110,99,53,43,7,7,58,58,8,51,43,0
19:13:57,1798.656,Fox,116,14,4,0,4,0,6,0,116,112,112,99,53,43,7,7,58,58,8,51,43,0
19:13:59,1804.78,Fox,118,16,6,0,4,0,6,0,118,112,112,99,53,43,9,7,60,58,8,51,43,0
19:14:07,1826.211,Fox,118,16,6,0,2,2,6,0,118,112,112,101,53,43,9,7,60,58,8,51,43,0
19:14:07,1826.689,Fox,118,16,4,2,2,2,6,0,118,114,112,101,53,43,9,7,60,58,8,51,43,0
19:14:10,1835.979,Fox,120,18,6,2,2,2,6,0,120,114,112,101,53,43,9,9,60,60,8,51,43,0
19:14:10,1836.998,Fox,120,18,4,4,2,2,6,0,120,116,112,101,53,43,9,9,60,60,8,51,43,0
19:14:18,1859.325,Fox,120,18,4,4,0,4,6,0,120,116,112,103,53,43,9,9,60,60,8,51,43,0
19:14:20,1865.069,Fox,120,18,4,2,2,4,6,0,120,116,114,103,53,43,9,9,60,60,8,51,43,0
19:14:23,1875.552,Fox,120,18,4,0,4,4,6,0,120,116,116,103,53,43,9,9,60,60,8,51,43,0
19:14:25,1881.429,Fox,120,18,4,0,4,4,4,2,120,116,116,103,53,45,9,9,60,60,8,51,43,0
19:14:27,1887.398,Fox,120,18,2,2,4,4,4,2,120,118,116,103,53,45,9,9,60,60,8,51,43,0
19:14:30,1897.576,Fox,120,18,2,2,4,4,2,4,120,118,116,103,53,47,9,9,60,60,8,51,43,0
19:14:32,1901.66,Fox,120,17,2,2,4,4,2,3,120,118,116,103,53,47,9,8,60,60,8,51,44,0
19:14:34,1909.304,Fox,122,19,4,2,4,4,2,3,122,118,116,103,53,47,10,9,61,61,8,51,44,0
19:14:35,1911.849,Fox,124,21,6,2,4,4,2,3,124,118,116,103,53,47,10,11,61,63,8,51,44,0
19:14:37,1917.848,Fox,126,22,8,2,3,4,2,3,126,118,116,103,53,47,11,11,63,63,9,51,44,0
19:14:37,1918.664,Fox,126,22,6,4,3,4,2,3,126,120,116,103,53,47,11,11,63,63,9,51,44,0
19:14:38,1919.821,Fox,126,22,6,4,3,2,4,3,126,120,116,103,55,47,11,11,63,63,9,51,44,0
19:14:40,1925.879,Fox,126,22,6,2,4,3,4,3,126,120,118,104,55,47,11,11,63,63,9,51,44,0
19:14:42,1932.324,Fox,126,22,6,2,4,3,2,5,126,120,118,104,55,49,11,11,63,63,9,51,44,0
19:14:43,1936.115,Fox,126,22,6,2,2,5,2,5,126,120,118,106,55,49,11,11,63,63,9,51,44,0
19:14:45,1942.308,Fox,126,21,6,2,2,5,2,4,126,120,118,106,55,49,11,10,63,63,9,51,45,0
19:14:49,1952.717,Fox,126,21,6,2,2,3,4,4,126,120,118,106,57,49,11,10,63,63,9,51,45,0
19:14:51,1957.299,Fox,126,21,6,0,4,3,4,4,126,120,120,106,57,49,11,10,63,63,9,51,45,0
19:14:51,1958.499,Fox,126,20,6,0,4,3,4,3,126,120,120,106,57,49,10,10,63,63,9,51,46,0
19:15:00,1986.573,Fox,126,20,6,0,2,5,4,3,126,120,120,108,57,49,10,10,63,63,9,51,46,0
19:15:01,1987.967,Fox,128,22,8,0,2,5,4,3,128,120,120,108,57,49,11,11,64,64,9,51,46,0
19:15:02,1990.618,Fox,130,24,10,0,2,5,4,3,130,120,120,108,57,49,12,12,65,65,9,51,46,0
19:15:02,1992.051,Fox,130,24,8,2,2,5,4,3,130,122,120,108,57,49,12,12,65,65,9,51,46,0
19:15:03,1994.547,Fox,130,24,6,4,2,5,4,3,130,124,120,108,57,49,12,12,65,65,9,51,46,0
19:15:04,1996.779,Fox,130,23,6,4,2,4,4,3,130,124,120,108,57,49,11,12,65,65,9,52,46,0
19:15:05,2000.642,Fox,130,23,4,6,2,4,4,3,130,126,120,108,57,49,11,12,65,65,9,52,46,0
19:15:06,2003.53,Fox,130,22,4,6,2,4,4,2,130,126,120,108,57,49,10,12,65,65,9,52,47,0
19:15:10,2013.779,Fox,130,21,4,6,2,4,4,1,130,126,120,108,57,49,10,11,65,65,9,52,48,0
19:15:11,2017.538,Fox,130,21,4,6,0,6,4,1,130,126,120,110,57,49,10,11,65,65,9,52,48,0
19:15:11,2019.051,Fox,130,20,4,6,0,5,5,0,130,126,120,110,58,49,10,10,65,65,9,52,49,0
19:15:14,2028.067,Fox,130,18,4,6,0,3,5,0,130,126,120,110,58,49,10,8,65,65,11,52,49,0
19:15:15,2029.557,Fox,130,18,4,6,0,1,7,0,130,126,120,110,60,49,10,8,65,65,11,52,49,0
19:15:15,2030.333,Fox,130,18,4,4,2,1,7,0,130,126,122,110,60,49,10,8,65,65,11,52,49,0
19:15:16,2032.844,Fox,130,18,4,2,4,1,7,0,130,126,124,110,60,49,10,8,65,65,11,52,49,0
19:15:18,2038.907,Fox,130,18,4,0,6,1,7,0,130,126,126,110,60,49,10,8,65,65,11,52,49,0
19:15:24,2057.255,Fox,130,18,4,0,6,1,5,2,130,126,126,110,60,51,10,8,65,65,11,52,49,0
19:15:27,2066.173,Fox,132,20,6,0,6,1,5,2,132,126,126,110,60,51,10,10,65,67,11,52,49,0
19:15:29,2070.574,Fox,132,20,4,2,6,1,5,2,132,128,126,110,60,51,10,10,65,67,11,52,49,0
19:15:29,2073.139,Fox,132,20,2,4,6,1,5,2,132,130,126,110,60,51,10,10,65,67,11,52,49,0
19:15:32,2080.01,Fox,132,20,2,4,6,0,6,2,132,130,126,110,61,51,10,10,65,67,11,52,49,0
19:15:34,2087.709,Fox,132,19,2,4,6,0,6,1,132,130,126,110,61,51,9,10,65,67,11,52,50,0
19:15:35,2090.183,Fox,132,19,2,4,6,0,4,3,132,130,126,110,61,53,9,10,65,67,11,52,50,0
19:15:35,2090.911,Fox,132,19,2,4,4,2,4,3,132,130,126,112,61,53,9,10,65,67,11,52,50,0
19:15:36,2093.365,Fox,132,19,2,4,2,4,4,3,132,130,126,114,61,53,9,10,65,67,11,52,50,0
19:15:37,2095.347,Fox,134,20,4,4,1,4,4,3,134,130,126,114,61,53,8,12,65,69,12,52,50,0
19:15:38,2099.484,Fox,134,20,4,4,0,5,4,3,134,130,126,115,61,53,8,12,65,69,12,52,50,0
19:15:41,2108.063,Fox,134,19,4,4,0,5,4,2,134,130,126,115,61,53,7,12,65,69,12,52,51,0
19:15:41,2109.063,Fox,134,19,4,2,2,5,4,2,134,130,128,115,61,53,7,12,65,69,12,52,51,0
19:15:42,2110.039,Fox,134,18,4,2,2,4,4,2,134,130,128,115,61,53,6,12,65,69,13,52,51,0
19:15:42,2111.713,Fox,134,18,4,0,4,4,4,2,134,130,130,115,61,53,6,12,65,69,13,52,51,0
19:15:49,2130.433,Fox,134,17,4,0,4,4,4,1,134,130,130,115,61,53,5,12,65,69,13,52,52,0
19:15:52,2140.519,Fox,134,16,4,0,4,4,4,0,134,130,130,115,61,53,5,11,65,69,13,52,53,0
19:15:52,2142.062,Fox,136,18,6,0,4,4,4,0,136,130,130,115,61,53,7,11,67,69,13,52,53,0
19:15:54,2147.469,Fox,140,22,8,0,4,4,4,0,138,130,130,115,61,53,9,13,69,71,13,52,53,0
19:15:54,2147.714,Fox,140,22,10,0,4,4,4,0,140,130,130,115,61,53,9,13,69,71,13,52,53,0
19:15:55,2148.699,Fox,140,22,8,2,4,4,4,0,140,132,130,115,61,53,9,13,69,71,13,52,53,0
19:15:57,2156.537,Fox,140,22,8,2,4,4,3,1,140,132,130,115,61,54,9,13,69,71,13,52,53,0
19:16:01,2166.892,Fox,140,22,8,2,4,4,1,3,140,132,130,115,61,56,9,13,69,71,13,52,53,0
19:16:02,2169.605,Fox,140,22,8,2,2,6,1,3,140,132,130,117,61,56,9,13,69,71,13,52,53,0
19:16:02,2172.145,Fox,140,22,8,2,0,8,1,3,140,132,130,119,61,56,9,13,69,71,13,52,53,0
19:16:04,2177.885,Fox,140,22,6,4,0,8,1,3,140,134,130,119,61,56,9,13,69,71,13,52,53,0
19:16:07,2184.359,Fox,140,22,6,4,0,6,3,3,140,134,130,119,63,56,9,13,69,71,13,52,53,0
19:16:07,2186.841,Fox,140,22,6,4,0,4,5,3,140,134,130,119,65,56,9,13,69,71,13,52,53,0
19:16:08,2187.29,Fox,140,22,6,2,2,4,5,3,140,134,132,119,65,56,9,13,69,71,13,52,53,0
19:16:17,2216.35,Fox,140,22,6,0,4,4,5,3,140,134,134,119,65,56,9,13,69,71,13,52,53,0
19:16:18,2217.371,Fox,140,22,6,0,4,4,4,4,140,134,134,119,65,57,9,13,69,71,13,52,53,0
19:16:20,2223.981,Fox,142,24,8,0,4,4,4,4,142,134,134,119,65,57,9,15,69,73,13,52,53,0
19:16:20,2224.622,Fox,142,24,6,2,4,4,4,4,142,136,134,119,65,57,9,15,69,73,13,52,53,0
19:16:22,2230.227,Fox,142,24,2,6,4,4,4,4,142,140,134,119,65,57,9,15,69,73,13,52,53,0
19:16:24,2237.807,Fox,142,23,2,6,4,4,4,3,142,140,134,119,65,57,9,14,69,73,13,52,54,0
19:16:28,2247.771,Fox,142,23,2,6,2,6,4,3,142,140,134,121,65,57,9,14,69,73,13,52,54,0
19:16:30,2255.1,Fox,144,25,4,6,2,6,4,3,144,140,134,121,65,57,11,14,71,73,13,52,54,0
19:16:31,2257.782,Fox,144,24,4,6,2,6,4,2,144,140,134,121,65,57,10,14,71,73,13,52,55,0
19:16:33,2263.194,Fox,144,24,4,4,4,4,6,2,144,140,136,121,67,57,10,14,71,73,13,52,55,0
19:16:34,2265.55,Fox,144,24,4,4,4,2,8,2,144,140,136,121,69,57,10,14,71,73,13,52,55,0
19:16:35,2268.893,Fox,144,24,4,0,8,2,8,2,144,140,140,121,69,57,10,14,71,73,13,52,55,0
19:16:37,2276.817,Fox,144,24,4,0,6,4,8,2,144,140,140,123,69,57,10,14,71,73,13,52,55,0
19:16:41,2287.47,Fox,144,22,4,0,6,2,8,2,144,140,140,123,69,57,10,12,71,73,15,52,55,0
19:16:46,2301.766,Fox,146,23,6,0,5,2,8,2,146,140,140,123,69,57,11,12,73,73,16,52,55,0
19:16:47,2306.631,Fox,146,23,4,2,5,2,8,2,146,142,140,123,69,57,11,12,73,73,16,52,55,0
19:16:48,2307.491,Fox,148,25,6,2,5,2,8,2,148,142,140,123,69,57,12,13,74,74,16,52,55,0
19:16:48,2308.324,Fox,148,24,6,2,5,2,8,1,148,142,140,123,69,57,11,13,74,74,16,52,56,0
19:16:52,2321.763,Fox,148,24,6,2,5,2,6,3,148,142,140,123,69,59,11,13,74,74,16,52,56,0
19:16:53,2323.587,Fox,148,24,6,2,4,3,6,3,148,142,140,124,69,59,11,13,74,74,16,52,56,0
19:16:53,2324.554,Fox,148,24,6,2,4,3,4,5,148,142,140,124,69,61,11,13,74,74,16,52,56,0
19:16:55,2328.716,Fox,148,23,6,2,4,3,4,4,148,142,140,124,69,61,11,12,74,74,16,52,57,0
19:16:55,2329.328,Fox,148,23,6,2,0,7,4,4,148,142,140,128,69,61,11,12,74,74,16,52,57,0
19:16:56,2331.806,Fox,148,22,6,2,0,7,4,3,148,142,140,128,69,61,10,12,74,74,16,52,58,0
19:16:56,2333.034,Fox,152,24,10,2,0,5,4,3,152,142,140,128,69,61,11,13,77,75,18,52,58,0
19:16:57,2334.135,Fox,152,23,10,2,0,4,4,3,152,142,140,128,69,61,10,13,77,75,19,52,58,0
19:16:58,2337.575,Fox,152,23,8,4,0,4,4,3,152,144,140,128,69,61,10,13,77,75,19,52,58,0
19:16:59,2341.223,Fox,152,23,8,4,0,2,6,3,152,144,140,128,71,61,10,13,77,75,19,52,58,0
19:17:00,2345.065,Fox,152,23,8,2,2,2,6,3,152,144,142,128,71,61,10,13,77,75,19,52,58,0
19:17:02,2349.744,Fox,154,25,10,2,2,2,6,3,154,144,142,128,71,61,11,14,78,76,19,52,58,0
19:17:10,2375.252,Fox,156,27,12,2,2,2,6,3,156,144,142,128,71,61,12,15,79,77,19,52,58,0
19:17:11,2376.238,Fox,156,27,12,0,4,2,6,3,156,144,144,128,71,61,12,15,79,77,19,52,58,0
19:17:13,2384.399,Fox,156,27,10,2,4,2,6,3,156,146,144,128,71,61,12,15,79,77,19,52,58,0
19:17:15,2390.085,Fox,156,27,8,4,4,2,6,3,156,148,144,128,71,61,12,15,79,77,19,52,58,0
19:17:16,2392.181,Fox,156,26,8,4,4,2,6,2,156,148,144,128,71,61,12,14,79,77,19,52,59,0
19:17:17,2395.044,Fox,156,25,8,4,4,2,6,1,156,148,144,128,71,61,12,13,79,77,19,52,60,0
19:17:19,2400.559,Fox,156,25,8,4,4,2,4,3,156,148,144,128,71,63,12,13,79,77,19,52,60,0
19:17:20,2403.173,Fox,156,25,8,4,4,2,2,5,156,148,144,128,71,65,12,13,79,77,19,52,60,0
19:17:20,2405.165,Fox,156,24,8,4,4,2,2,4,156,148,144,128,71,65,12,12,79,77,19,52,61,0
19:17:20,2405.563,Fox,156,24,8,4,2,4,2,4,156,148,144,130,71,65,12,12,79,77,19,52,61,0
19:17:24,2415.67,Fox,156,24,4,8,2,4,2,4,156,152,144,130,71,65,12,12,79,77,19,52,61,0
19:17:26,2422.512,Fox,156,24,4,8,2,2,4,4,156,152,144,130,73,65,12,12,79,77,19,52,61,0
19:17:26,2422.979,Fox,156,24,4,6,4,2,4,4,156,152,146,130,73,65,12,12,79,77,19,52,61,0
19:17:28,2426.947,Fox,158,26,6,6,4,2,4,4,158,152,146,130,73,65,12,14,79,79,19,52,61,0
19:17:28,2428.479,Fox,158,26,6,4,6,2,4,4,158,152,148,130,73,65,12,14,79,79,19,52,61,0
19:17:29,2432.406,Fox,158,26,4,6,6,2,4,4,158,154,148,130,73,65,12,14,79,79,19,52,61,0
19:17:31,2436.76,Fox,158,26,4,6,4,4,4,4,158,154,148,132,73,65,12,14,79,79,19,52,61,0
19:17:36,2451.422,Fox,160,28,6,6,4,4,4,4,160,154,148,132,73,65,13,15,80,80,19,52,61,0
19:17:37,2454.217,Fox,160,28,6,2,8,4,4,4,160,154,152,132,73,65,13,15,80,80,19,52,61,0
19:17:38,2457.97,Fox,160,28,4,4,8,4,4,4,160,156,152,132,73,65,13,15,80,80,19,52,61,0
19:17:41,2466.819,Fox,162,30,6,4,8,4,4,4,162,156,152,132,73,65,13,17,80,82,19,52,61,0
19:17:42,2470.833,Fox,162,30,6,2,10,4,4,4,162,156,154,132,73,65,13,17,80,82,19,52,61,0
19:17:45,2478.77,Fox,162,30,6,2,10,4,2,6,162,156,154,132,73,67,13,17,80,82,19,52,61,0
19:17:47,2483.467,Fox,162,30,6,2,8,6,2,6,162,156,154,134,73,67,13,17,80,82,19,52,61,0
19:17:47,2484.558,Fox,162,28,6,2,8,6,2,4,162,156,154,134,73,67,12,16,80,82,19,52,63,0
19:17:48,2489.201,Fox,162,28,6,2,6,8,2,4,162,156,154,136,73,67,12,16,80,82,19,52,63,0
19:17:49,2492.159,Fox,162,27,6,2,6,8,2,3,162,156,154,136,73,67,12,15,80,82,19,52,64,0
19:17:50,2492.954,Fox,164,29,8,2,6,8,2,3,164,156,154,136,73,67,13,16,81,83,19,52,64,0
19:17:51,2496.295,Fox,164,29,8,0,8,8,2,3,164,156,156,136,73,67,13,16,81,83,19,52,64,0
19:17:52,2499.062,Fox,164,29,8,0,8,6,4,3,164,156,156,136,75,67,13,16,81,83,19,52,64,0
19:17:55,2507.698,Fox,166,31,10,0,8,6,4,3,166,156,156,136,75,67,14,17,82,84,19,52,64,0
19:17:55,2509.5,Fox,166,31,8,2,8,6,4,3,166,158,156,136,75,67,14,17,82,84,19,52,64,0
19:17:56,2512.302,Fox,166,30,8,2,8,6,4,2,166,158,156,136,75,67,13,17,82,84,19,52,65,0
19:17:57,2514.601,Fox,166,30,8,2,4,10,4,2,166,158,156,140,75,67,13,17,82,84,19,52,65,0
19:17:58,2519.415,Fox,166,29,8,2,4,10,4,1,166,158,156,140,75,67,13,16,82,84,19,52,66,0
19:18:01,2525.668,Fox,168,31,10,2,4,10,4,1,168,158,156,140,75,67,14,17,83,85,19,52,66,0
19:18:02,2530.245,Fox,168,31,10,2,4,8,6,1,168,158,156,140,77,67,14,17,83,85,19,52,66,0
19:18:03,2531.434,Fox,168,31,10,2,2,10,6,1,168,158,156,142,77,67,14,17,83,85,19,52,66,0
19:18:03,2533.977,Fox,168,31,8,4,2,10,6,1,168,160,156,142,77,67,14,17,83,85,19,52,66,0
19:18:08,2548.114,Fox,168,31,8,2,4,10,6,1,168,160,158,142,77,67,14,17,83,85,19,52,66,0
19:18:09,2549.443,Fox,168,31,6,4,4,10,6,1,168,162,158,142,77,67,14,17,83,85,19,52,66,0
19:18:11,2556.756,Fox,168,31,6,4,2,12,6,1,168,162,158,144,77,67,14,17,83,85,19,52,66,0
19:18:12,2559.318,Fox,170,33,8,4,2,12,6,1,170,162,158,144,77,67,14,19,83,87,19,52,66,0
19:18:12,2559.997,Fox,170,33,8,4,2,12,4,3,170,162,158,144,77,69,14,19,83,87,19,52,66,0
19:18:15,2567.401,Fox,170,31,8,4,2,10,4,3,170,162,158,144,77,69,13,18,83,87,21,52,66,0
19:18:15,2569.951,Fox,170,30,8,4,2,10,4,2,170,162,158,144,77,69,13,17,83,87,21,52,67,0
19:18:16,2572.089,Fox,172,32,10,4,2,10,4,2,172,162,158,144,77,69,14,18,84,88,21,52,67,0
19:18:16,2572.647,Fox,172,32,10,2,4,10,4,2,172,162,160,144,77,69,14,18,84,88,21,52,67,0
19:18:17,2575.472,Fox,172,32,8,4,4,10,4,2,172,164,160,144,77,69,14,18,84,88,21,52,67,0
19:18:18,2576.894,Fox,172,32,8,4,4,8,6,2,172,164,160,144,79,69,14,18,84,88,21,52,67,0
19:18:20,2582.695,Fox,172,32,8,4,4,6,8,2,172,164,160,144,81,69,14,18,84,88,21,52,67,0
19:18:20,2583.638,Fox,174,34,10,4,4,6,8,2,174,164,160,144,81,69,16,18,86,88,21,52,67,0
19:18:22,2587.787,Fox,174,34,10,2,6,6,8,2,174,164,162,144,81,69,16,18,86,88,21,52,67,0
19:18:22,2590.633,Fox,174,32,8,4,6,6,8,0,174,166,162,144,81,69,16,16,86,88,21,52,69,0
19:18:25,2598.558,Fox,176,34,10,4,6,6,8,0,176,166,162,144,81,69,18,16,88,88,21,52,69,0
19:18:28,2608.514,Fox,176,34,8,6,4,4,12,0,176,168,162,146,85,69,18,16,88,88,21,52,69,0
19:18:30,2614.108,Fox,176,34,8,4,6,4,12,0,176,168,164,146,85,69,18,16,88,88,21,52,69,0
19:18:31,2615.012,Fox,178,36,10,4,6,4,12,0,178,168,164,146,85,69,19,17,89,89,21,52,69,0
19:18:34,2624.832,Fox,178,36,10,4,6,2,14,0,178,168,164,146,87,69,19,17,89,89,21,52,69,0
19:18:35,2628.703,Fox,178,36,10,2,8,2,14,0,178,168,166,146,87,69,19,17,89,89,21,52,69,0
19:18:37,2633.013,Fox,178,36,10,2,6,4,14,0,178,168,166,148,87,69,19,17,89,89,21,52,69,0
19:18:38,2636.716,Fox,178,36,10,2,6,4,12,2,178,168,166,148,87,71,19,17,89,89,21,52,69,0
19:18:40,2641.791,Fox,178,36,8,4,6,4,12,2,178,170,166,148,87,71,19,17,89,89,21,52,69,0
19:18:41,2644.999,Fox,180,38,10,4,6,4,12,2,180,170,166,148,87,71,19,19,89,91,21,52,69,0
19:18:41,2646.775,Fox,180,38,10,2,8,4,12,2,180,170,168,148,87,71,19,19,89,91,21,52,69,0
19:18:42,2648.42,Fox,180,38,10,2,6,6,12,2,180,170,168,150,87,71,19,19,89,91,21,52,69,0
19:18:42,2650.203,Fox,182,40,12,2,6,6,12,2,182,170,168,150,87,71,20,20,90,92,21,52,69,0
19:18:43,2651.09,Fox,184,42,14,2,6,6,12,2,184,170,168,150,87,71,21,21,91,93,21,52,69,0
19:18:44,2654.778,Fox,184,42,12,4,6,6,12,2,184,172,168,150,87,71,21,21,91,93,21,52,69,0
19:18:45,2658.804,Fox,184,41,12,4,6,5,12,2,184,172,168,150,87,71,21,20,91,93,22,52,69,0
19:18:48,2666.297,Fox,184,41,10,6,6,5,12,2,184,174,168,150,87,71,21,20,91,93,22,52,69,0
19:18:48,2668.057,Fox,186,43,10,6,6,5,10,4,184,174,168,150,87,73,22,21,92,94,22,52,69,0
19:18:48,2668.317,Fox,186,43,12,6,6,5,10,4,186,174,168,150,87,73,22,21,92,94,22,52,69,0
19:18:49,2670.461,Fox,188,45,14,6,6,5,10,4,188,174,168,150,87,73,23,22,93,95,22,52,69,0
19:18:50,2671.741,Fox,190,47,16,6,6,5,10,4,190,174,168,150,87,73,23,24,93,97,22,52,69,0
19:18:51,2674.639,Fox,190,47,16,6,4,7,10,4,190,174,168,152,87,73,23,24,93,97,22,52,69,0
19:18:51,2675.446,Fox,192,49,18,6,4,7,10,4,192,174,168,152,87,73,23,26,93,99,22,52,69,0
19:18:52,2680.444,Fox,192,49,18,4,6,7,10,4,192,174,170,152,87,73,23,26,93,99,22,52,69,0
19:18:53,2681.173,Fox,192,49,16,6,6,7,10,4,192,176,170,152,87,73,23,26,93,99,22,52,69,0
19:18:54,2685.474,Fox,194,50,18,6,5,7,10,4,194,176,170,152,87,73,22,28,93,101,23,52,69,0
19:18:55,2688.147,Fox,194,49,18,6,5,7,10,3,194,176,170,152,87,73,21,28,93,101,23,52,70,0
19:18:55,2689.294,Fox,194,49,18,6,3,9,10,3,194,176,170,154,87,73,21,28,93,101,23,52,70,0
19:18:56,2692.193,Fox,196,51,20,6,3,9,10,3,196,176,170,154,87,73,21,30,93,103,23,52,70,0
19:18:57,2693.191,Fox,196,51,20,4,5,9,10,3,196,176,172,154,87,73,21,30,93,103,23,52,70,0
19:18:58,2697.592,Fox,196,51,18,6,5,9,10,3,196,178,172,154,87,73,21,30,93,103,23,52,70,0
19:19:00,2702.022,Fox,196,51,18,6,5,7,12,3,196,178,172,154,89,73,21,30,93,103,23,52,70,0
19:19:01,2704.805,Fox,196,51,18,4,7,7,12,3,196,178,174,154,89,73,21,30,93,103,23,52,70,0
19:19:01,2707.42,Fox,196,51,18,4,6,8,12,3,196,178,174,155,89,73,21,30,93,103,23,52,70,0
19:19:04,2714.333,Fox,196,51,18,4,6,8,10,5,196,178,174,155,89,75,21,30,93,103,23,52,70,0
19:19:05,2717.825,Fox,196,50,18,4,6,7,10,5,196,178,174,155,89,75,21,29,93,103,24,52,70,0
19:19:06,2719.594,Fox,196,50,18,2,8,7,10,5,196,178,176,155,89,75,21,29,93,103,24,52,70,0
19:19:06,2720.077,Fox,196,50,18,2,8,7,8,7,196,178,176,155,89,77,21,29,93,103,24,52,70,0
19:19:08,2726.913,Fox,198,52,20,2,8,5,10,7,198,178,176,155,91,77,22,30,94,104,24,52,70,0
19:19:08,2727.72,Fox,198,51,18,4,8,5,10,6,198,180,176,155,91,77,22,29,94,104,24,52,71,0
19:19:09,2730.559,Fox,200,52,20,4,7,5,10,6,200,180,176,155,91,77,22,30,95,105,24,53,71,0
19:19:09,2731.247,Fox,202,54,22,4,7,5,10,6,202,180,176,155,91,77,23,31,96,106,24,53,71,0
19:19:10,2732.609,Fox,204,56,24,4,7,5,10,6,204,180,176,155,91,77,25,31,98,106,24,53,71,0
19:19:10,2732.854,Fox,204,56,22,6,7,5,10,6,204,182,176,155,91,77,25,31,98,106,24,53,71,0
19:19:10,2733.783,Fox,204,56,20,8,7,5,10,6,204,184,176,155,91,77,25,31,98,106,24,53,71,0
19:19:11,2736.08,Fox,204,56,20,6,9,5,10,6,204,184,178,155,91,77,25,31,98,106,24,53,71,0
19:19:12,2740.473,Fox,204,55,20,6,9,5,10,5,204,184,178,155,91,77,25,30,98,106,24,53,72,0
19:19:13,2740.912,Fox,204,55,20,6,7,7,10,5,204,184,178,157,91,77,25,30,98,106,24,53,72,0
19:19:13,2742.005,Fox,204,55,20,6,7,6,11,5,204,184,178,157,92,77,25,30,98,106,24,53,72,0
19:19:14,2744.24,Fox,206,57,22,6,7,6,11,5,206,184,178,157,92,77,26,31,99,107,24,53,72,0
19:19:14,2745.702,Fox,206,57,22,6,7,6,7,9,206,184,178,157,92,81,26,31,99,107,24,53,72,0
19:19:15,2749.02,Fox,208,58,22,6,7,6,7,8,206,184,178,157,92,81,26,32,100,108,24,53,73,0
19:19:15,2749.29,Fox,208,58,24,6,7,6,7,8,208,184,178,157,92,81,26,32,100,108,24,53,73,0
19:19:16,2750.829,Fox,208,58,22,8,7,6,7,8,208,186,178,157,92,81,26,32,100,108,24,53,73,0
19:19:17,2752.988,Fox,208,58,20,10,7,6,7,8,208,188,178,157,92,81,26,32,100,108,24,53,73,0
19:19:17,2753.7,Fox,208,58,20,10,6,7,7,8,208,188,178,158,92,81,26,32,100,108,24,53,73,0
19:19:17,2754.436,Fox,208,58,18,12,6,7,7,8,208,190,178,158,92,81,26,32,100,108,24,53,73,0
19:19:17,2755.216,Fox,210,59,20,12,5,7,7,8,210,190,178,158,92,81,26,33,101,109,24,54,73,0
19:19:18,2755.912,Fox,210,58,20,12,5,7,7,7,210,190,178,158,92,81,25,33,101,109,24,54,74,0
19:19:18,2756.868,Fox,212,59,22,12,4,7,7,7,212,190,178,158,92,81,25,34,102,110,24,55,74,0
19:19:18,2758.099,Fox,212,58,20,14,4,7,7,6,212,192,178,158,92,81,25,33,102,110,24,55,75,0
19:19:20,2762.348,Fox,212,58,20,14,4,7,5,8,212,192,178,158,92,83,25,33,102,110,24,55,75,0
19:19:21,2765.184,Fox,212,58,20,14,2,9,5,8,212,192,178,160,92,83,25,33,102,110,24,55,75,0
19:19:21,2766.12,Fox,212,58,20,12,4,9,5,8,212,192,180,160,92,83,25,33,102,110,24,55,75,0
19:19:22,2767.993,Fox,212,58,18,14,4,7,7,8,212,194,180,160,94,83,25,33,102,110,24,55,75,0
19:19:23,2771.477,Fox,212,58,18,12,6,7,7,8,212,194,182,160,94,83,25,33,102,110,24,55,75,0
19:19:23,2772.258,Fox,212,58,18,10,8,7,7,8,212,194,184,160,94,83,25,33,102,110,24,55,75,0
19:19:24,2774.858,Fox,212,58,16,12,8,7,7,8,212,196,184,160,94,83,25,33,102,110,24,55,75,0
19:19:27,2782.837,Fox,212,58,16,12,8,5,9,8,212,196,184,160,96,83,25,33,102,110,24,55,75,0
19:19:28,2786.394,Fox,212,56,16,12,8,5,9,6,212,196,184,160,96,83,24,32,102,110,24,55,77,0
19:19:29,2789.581,Fox,212,56,16,10,10,5,9,6,212,196,186,160,96,83,24,32,102,110,24,55,77,0
19:19:29,2791.098,Fox,212,55,16,10,10,5,9,5,212,196,186,160,96,83,23,32,102,110,24,55,78,0
19:19:30,2791.636,Fox,212,55,16,8,12,5,9,5,212,196,188,160,96,83,23,32,102,110,24,55,78,0
19:19:30,2792.955,Fox,212,55,16,6,14,5,9,5,212,196,190,160,96,83,23,32,102,110,24,55,78,0
19:19:31,2795.435,Fox,212,54,16,6,14,5,9,4,212,196,190,160,96,83,22,32,102,110,24,55,79,0
19:19:31,2796.758,Fox,212,54,16,4,14,7,9,4,212,196,192,162,96,83,22,32,102,110,24,55,79,0
19:19:34,2805.608,Fox,212,53,16,4,14,7,9,3,212,196,192,162,96,83,21,32,102,110,24,55,80,0
19:19:35,2807.001,Fox,212,52,16,2,16,6,9,3,212,196,194,162,96,83,20,32,102,110,25,55,80,0
19:19:35,2808.846,Fox,214,54,18,2,16,6,9,3,214,196,194,162,96,83,22,32,104,110,25,55,80,0
19:19:36,2809.693,Fox,214,54,16,4,16,6,9,3,214,198,194,162,96,83,22,32,104,110,25,55,80,0
19:19:36,2812.071,Fox,216,55,18,4,15,6,9,3,216,198,194,162,96,83,23,32,106,110,26,55,80,0
19:19:37,2812.616,Fox,218,57,20,4,15,6,9,3,218,198,194,162,96,83,25,32,108,110,26,55,80,0
19:19:37,2813.393,Fox,218,57,18,4,17,6,9,3,218,200,196,162,96,83,25,32,108,110,26,55,80,0
19:19:37,2813.911,Fox,218,57,16,6,17,6,9,3,218,202,196,162,96,83,25,32,108,110,26,55,80,0
19:19:37,2815.24,Fox,218,57,14,8,17,6,9,3,218,204,196,162,96,83,25,32,108,110,26,55,80,0
19:19:38,2816.823,Fox,218,56,14,8,17,6,9,2,218,204,196,162,96,83,24,32,108,110,26,55,81,0
19:19:40,2821.352,Fox,220,58,16,8,17,6,9,2,220,204,196,162,96,83,24,34,108,112,26,55,81,0
19:19:41,2826.521,Fox,222,60,18,8,17,6,9,2,222,204,196,162,96,83,25,35,109,113,26,55,81,0
19:19:41,2826.814,Fox,222,60,16,10,15,8,9,2,222,206,196,164,96,83,25,35,109,113,26,55,81,0
19:19:43,2831.992,Fox,222,60,14,12,14,9,9,2,222,208,196,165,96,83,25,35,109,113,26,55,81,0
19:19:44,2833.159,Fox,222,58,14,12,12,11,9,0,222,208,196,167,96,83,24,34,109,113,26,55,83,0
19:19:44,2834.574,Fox,222,58,14,12,12,9,11,0,222,208,196,167,98,83,24,34,109,113,26,55,83,0
19:19:45,2837.285,Fox,222,56,14,12,12,7,11,0,222,208,196,167,98,83,24,32,109,113,28,55,83,0
19:19:45,2837.885,Fox,222,56,12,14,12,7,11,0,222,210,196,167,98,83,24,32,109,113,28,55,83,0
19:19:46,2839.655,Fox,222,56,10,16,12,7,9,2,222,212,196,167,98,85,24,32,109,113,28,55,83,0
19:19:47,2842.335,Fox,222,55,10,16,12,6,9,2,222,212,196,167,98,85,24,31,109,113,29,55,83,0
19:19:47,2843.228,Fox,222,53,10,16,12,4,9,2,222,212,196,167,98,85,23,30,109,113,31,55,83,0
19:19:48,2847.165,Fox,222,53,10,16,12,3,10,2,222,212,196,167,99,85,23,30,109,113,31,55,83,0
19:19:49,2847.986,Fox,222,53,10,14,14,3,10,2,222,212,198,167,99,85,23,30,109,113,31,55,83,0
19:19:49,2849.919,Fox,222,53,10,14,12,5,10,2,222,212,198,169,99,85,23,30,109,113,31,55,83,0
19:19:50,2851.628,Fox,222,53,10,12,14,5,10,2,222,212,200,169,99,85,23,30,109,113,31,55,83,0
19:19:50,2852.458,Fox,222,53,10,10,14,7,10,2,222,212,202,171,99,85,23,30,109,113,31,55,83,0
19:19:50,2853.324,Fox,222,53,10,10,12,9,10,2,222,212,202,173,99,85,23,30,109,113,31,55,83,0
19:19:51,2853.862,Fox,222,53,10,8,14,9,10,2,222,212,204,173,99,85,23,30,109,113,31,55,83,0
19:19:52,2857.029,Fox,222,53,10,8,12,11,10,2,222,212,204,175,99,85,23,30,109,113,31,55,83,0
19:19:52,2858.759,Fox,222,53,10,8,12,9,12,2,222,212,204,175,101,85,23,30,109,113,31,55,83,0
19:19:53,2861.083,Fox,224,55,12,8,12,9,12,2,224,212,204,175,101,85,25,30,111,113,31,55,83,0
19:19:53,2861.672,Fox,226,57,14,8,12,9,12,2,226,212,204,175,101,85,25,32,111,115,31,55,83,0
19:19:53,2862.528,Fox,226,56,14,8,12,8,12,2,226,212,204,175,101,85,25,31,111,115,32,55,83,0
19:19:54,2864.23,Fox,226,56,14,8,12,8,10,4,226,212,204,175,101,87,25,31,111,115,32,55,83,0
19:19:54,2865.24,Fox,226,56,14,6,14,8,10,4,226,212,206,175,101,87,25,31,111,115,32,55,83,0
19:19:55,2867.029,Fox,226,56,14,6,12,10,10,4,226,212,206,177,101,87,25,31,111,115,32,55,83,0
19:19:56,2870.554,Fox,226,56,14,4,14,10,10,4,226,212,208,177,101,87,25,31,111,115,32,55,83,0
19:19:57,2873.836,Fox,226,56,14,4,12,12,10,4,226,212,208,179,101,87,25,31,111,115,32,55,83,0
19:19:58,2876.23,Fox,226,56,14,2,14,12,10,4,226,212,210,179,101,87,25,31,111,115,32,55,83,0
19:19:58,2877.577,Fox,226,55,14,2,14,11,10,4,226,212,210,179,101,87,25,30,111,115,33,55,83,0
19:19:59,2878.173,Fox,226,55,14,0,16,11,10,4,226,212,212,179,101,87,25,30,111,115,33,55,83,0
19:19:59,2879.624,Fox,226,55,14,0,16,11,9,5,226,212,212,179,101,88,25,30,111,115,33,55,83,0
19:19:59,2880.469,Fox,226,54,14,0,16,11,9,4,226,212,212,179,101,88,25,29,111,115,33,55,84,0
19:20:01,2884.335,Fox,228,56,16,0,16,11,9,4,228,212,212,179,101,88,25,31,111,117,33,55,84,0
19:20:02,2887.417,Fox,230,58,18,0,16,11,9,4,230,212,212,179,101,88,26,32,112,118,33,55,84,0
19:20:03,2889.732,Fox,232,60,20,0,16,11,9,4,232,212,212,179,101,88,27,33,113,119,33,55,84,0
19:20:03,2890.609,Fox,234,62,22,0,16,10,10,4,234,212,212,179,102,88,27,35,113,121,33,55,84,0
19:20:03,2891.509,Fox,234,62,20,2,16,10,10,4,234,214,212,179,102,88,27,35,113,121,33,55,84,0
19:20:04,2894.77,Fox,234,62,18,4,16,10,10,4,234,216,212,179,102,88,27,35,113,121,33,55,84,0
19:20:05,2895.611,Fox,236,64,16,6,16,10,10,4,234,218,212,179,102,88,29,35,115,121,33,55,84,0
19:20:05,2895.911,Fox,236,64,18,6,16,10,10,4,236,218,212,179,102,88,29,35,115,121,33,55,84,0
19:20:06,2897.949,Fox,238,66,20,6,16,10,10,4,238,218,212,179,102,88,30,36,116,122,33,55,84,0
19:20:07,2903.006,Fox,240,68,22,6,16,10,10,4,240,218,212,179,102,88,31,37,117,123,33,55,84,0
19:20:08,2903.906,Fox,240,68,20,8,16,10,10,4,240,220,212,179,102,88,31,37,117,123,33,55,84,0
19:20:08,2905.404,Fox,242,69,22,8,15,10,10,4,242,220,212,179,102,88,30,39,117,125,33,56,84,0
19:20:08,2905.983,Fox,244,71,22,8,15,10,8,6,242,220,212,179,102,90,31,40,118,126,33,56,84,0
19:20:08,2906.283,Fox,244,71,24,8,15,10,8,6,244,220,212,179,102,90,31,40,118,126,33,56,84,0
19:20:09,2908.044,Fox,246,72,26,8,14,10,8,6,246,220,212,179,102,90,31,41,119,127,34,56,84,0
19:20:09,2908.629,Fox,246,72,26,8,12,12,8,6,246,220,212,181,102,90,31,41,119,127,34,56,84,0
19:20:09,2909.224,Fox,246,72,24,10,12,12,8,6,246,222,212,181,102,90,31,41,119,127,34,56,84,0
19:20:10,2910.705,Fox,246,71,24,10,12,12,8,5,246,222,212,181,102,90,31,40,119,127,34,56,85,0
19:20:10,2912.188,Fox,246,71,24,10,10,14,8,5,246,222,212,183,102,90,31,40,119,127,34,56,85,0
19:20:11,2913.088,Fox,246,71,24,10,8,16,8,5,246,222,212,185,102,90,31,40,119,127,34,56,85,0
19:20:11,2914.288,Fox,246,71,24,10,6,18,8,5,246,222,212,187,102,90,31,40,119,127,34,56,85,0
19:20:12,2915.186,Fox,248,72,26,10,5,18,8,5,248,222,212,187,102,90,31,41,120,128,34,57,85,0
19:20:12,2915.786,Fox,248,71,26,10,5,18,8,4,248,222,212,187,102,90,30,41,120,128,34,57,86,0
19:20:13,2920.508,Fox,248,71,26,10,5,18,6,6,248,222,212,187,102,92,30,41,120,128,34,57,86,0
19:20:15,2925.81,Fox,248,70,26,10,4,19,6,5,248,222,212,188,102,92,30,40,120,128,34,57,87,0
19:20:17,2929.93,Fox,248,70,26,8,6,19,6,5,248,222,214,188,102,92,30,40,120,128,34,57,87,0
19:20:17,2930.831,Fox,248,70,26,8,5,20,6,5,248,222,214,189,102,92,30,40,120,128,34,57,87,0
19:20:18,2932.875,Fox,250,72,28,8,5,20,6,5,250,222,214,189,102,92,32,40,122,128,34,57,87,0
19:20:18,2933.161,Fox,250,72,28,6,7,20,6,5,250,222,216,189,102,92,32,40,122,128,34,57,87,0
19:20:18,2933.761,Fox,250,72,28,4,9,20,6,5,250,222,218,189,102,92,32,40,122,128,34,57,87,0
19:20:19,2937.012,Fox,250,72,28,4,8,21,6,5,250,222,218,190,102,92,32,40,122,128,34,57,87,0
19:20:19,2938.456,Fox,250,72,28,4,6,23,6,5,250,222,218,192,102,92,32,40,122,128,34,57,87,0
19:20:20,2941.286,Fox,250,71,28,4,6,22,6,5,250,222,218,192,102,92,32,39,122,128,35,57,87,0
19:20:21,2942.43,Fox,250,71,28,2,8,22,6,5,250,222,220,192,102,92,32,39,122,128,35,57,87,0
19:20:21,2943.837,Fox,250,71,26,4,8,20,8,5,250,224,220,192,104,92,32,39,122,128,35,57,87,0
19:20:21,2944.388,Fox,250,71,24,6,8,20,8,5,250,226,220,192,104,92,32,39,122,128,35,57,87,0
19:20:22,2945.543,Fox,250,71,24,6,8,19,9,5,250,226,220,192,105,92,32,39,122,128,35,57,87,0
19:20:22,2946.981,Fox,250,71,24,6,8,17,11,5,250,226,220,192,107,92,32,39,122,128,35,57,87,0
19:20:22,2947.551,Fox,250,71,24,4,10,17,11,5,250,226,222,192,107,92,32,39,122,128,35,57,87,0
19:20:23,2948.961,Fox,250,69,24,4,10,15,11,5,250,226,222,192,107,92,31,38,122,128,35,59,87,0
19:20:23,2950.608,Fox,250,69,24,4,10,13,13,5,250,226,222,192,109,92,31,38,122,128,35,59,87,0
19:20:25,2955.077,Fox,250,68,24,4,10,13,13,4,250,226,222,192,109,92,30,38,122,128,35,59,88,0
19:20:27,2960.549,Fox,250,68,24,4,10,12,14,4,250,226,222,192,110,92,30,38,122,128,35,59,88,0
19:20:28,2965.211,Fox,250,67,24,4,10,12,14,3,250,226,222,192,110,92,30,37,122,128,35,59,89,0
19:20:29,2966.911,Fox,250,67,22,6,10,12,14,3,250,228,222,192,110,92,30,37,122,128,35,59,89,0
19:20:29,2967.379,Fox,250,67,22,6,10,10,16,3,250,228,222,192,112,92,30,37,122,128,35,59,89,0
19:20:30,2970.184,Fox,252,69,22,8,10,10,16,3,252,230,222,192,112,92,31,38,123,129,35,59,89,0
19:20:30,2971.241,Fox,252,68,22,8,10,10,16,2,252,230,222,192,112,92,30,38,123,129,35,59,90,0
19:20:31,2972.247,Fox,252,67,20,10,10,9,14,4,252,232,222,192,112,94,29,38,123,129,35,60,90,0
19:20:31,2972.747,Fox,254,68,22,10,9,9,14,4,254,232,222,192,112,94,29,39,124,130,35,61,90,0
19:20:31,2973.257,Fox,254,68,20,12,9,9,14,4,254,234,222,192,112,94,29,39,124,130,35,61,90,0
19:20:33,2978.334,Fox,254,68,18,14,9,9,14,4,254,236,222,192,112,94,29,39,124,130,35,61,90,0
19:20:33,2979.063,Fox,256,69,20,14,9,8,14,4,256,236,222,192,112,94,29,40,125,131,35,62,90,0
19:20:33,2980.495,Fox,256,69,18,16,9,8,14,4,256,238,222,192,112,94,29,40,125,131,35,62,90,0
19:20:34,2981.464,Fox,258,71,20,16,9,8,14,4,258,238,222,192,112,94,29,42,125,133,35,62,90,0
19:20:34,2982.217,Fox,258,71,20,14,11,8,14,4,258,238,224,192,112,94,29,42,125,133,35,62,90,0
19:20:34,2982.742,Fox,258,71,20,12,13,8,14,4,258,238,226,192,112,94,29,42,125,133,35,62,90,0
19:20:35,2984.051,Fox,260,72,22,12,12,8,14,4,260,238,226,192,112,94,28,44,125,135,35,63,90,0
19:20:35,2985.072,Fox,262,74,22,12,12,8,13,5,260,238,226,192,112,95,29,45,126,136,35,63,90,0
19:20:35,2985.597,Fox,262,74,22,14,12,8,13,5,262,240,226,192,112,95,29,45,126,136,35,63,90,0
19:20:36,2988.058,Fox,262,74,20,16,12,8,13,5,262,242,226,192,112,95,29,45,126,136,35,63,90,0
19:20:36,2988.738,Fox,262,74,18,18,12,8,13,5,262,244,226,192,112,95,29,45,126,136,35,63,90,0
19:20:37,2990.618,Fox,262,74,16,20,10,10,13,5,262,246,226,194,112,95,29,45,126,136,35,63,90,0
19:20:37,2990.86,Fox,262,73,16,20,10,10,13,4,262,246,226,194,112,95,29,44,126,136,35,63,91,0
19:20:37,2991.609,Fox,262,72,16,20,10,10,13,3,262,246,226,194,112,95,29,43,126,136,35,63,92,0
19:20:38,2994.054,Fox,264,74,18,20,8,12,13,3,264,246,226,196,112,95,30,44,127,137,35,63,92,0
19:20:38,2994.294,Fox,264,74,18,20,7,13,13,3,264,246,226,197,112,95,30,44,127,137,35,63,92,0
19:20:39,2996.323,Fox,264,74,18,20,7,13,11,5,264,246,226,197,112,97,30,44,127,137,35,63,92,0
19:20:39,2997.683,Fox,264,74,16,22,7,13,11,5,264,248,226,197,112,97,30,44,127,137,35,63,92,0
19:20:40,3000.94,Fox,264,72,16,22,7,11,11,5,264,248,226,197,112,97,28,44,127,137,35,65,92,0
19:20:41,3001.999,Fox,264,72,16,22,7,9,13,5,264,248,226,197,114,97,28,44,127,137,35,65,92,0
19:20:41,3002.842,Fox,264,72,16,22,5,11,13,5,264,248,226,199,114,97,28,44,127,137,35,65,92,0
19:20:41,3004.184,Fox,264,71,16,22,5,10,13,5,264,248,226,199,114,97,27,44,127,137,35,66,92,0
19:20:42,3004.614,Fox,264,70,16,22,5,9,13,5,264,248,226,199,114,97,26,44,127,137,35,67,92,0
19:20:42,3005.279,Fox,264,70,16,20,7,9,13,5,264,248,228,199,114,97,26,44,127,137,35,67,92,0
19:20:42,3005.707,Fox,264,70,16,20,7,7,15,5,264,248,228,199,116,97,26,44,127,137,35,67,92,0
19:20:42,3006.311,Fox,264,70,16,20,7,5,17,5,264,248,228,199,118,97,26,44,127,137,35,67,92,0
19:20:43,3008.338,Fox,266,72,16,20,6,6,17,5,264,248,228,200,118,97,27,45,128,138,35,67,92,0
19:20:43,3008.579,Fox,266,72,18,18,8,6,17,5,266,248,230,200,118,97,27,45,128,138,35,67,92,0
19:20:44,3010.804,Fox,266,72,18,16,10,6,17,5,266,248,232,200,118,97,27,45,128,138,35,67,92,0
19:20:44,3011.7,Fox,266,72,18,14,12,6,17,5,266,248,234,200,118,97,27,45,128,138,35,67,92,0
19:20:44,3013.475,Fox,266,70,18,14,12,4,17,5,266,248,234,200,118,97,27,43,128,138,35,69,92,0
19:20:45,3015.497,Fox,266,70,16,16,12,4,17,5,266,250,234,200,118,97,27,43,128,138,35,69,92,0
19:20:46,3016.962,Fox,266,70,16,14,14,4,17,5,266,250,236,200,118,97,27,43,128,138,35,69,92,0
19:20:46,3018.619,Fox,266,69,16,14,14,3,17,5,266,250,236,200,118,97,27,42,128,138,35,70,92,0
19:20:46,3019.263,Fox,266,69,16,12,16,2,18,5,266,250,238,200,119,97,27,42,128,138,35,70,92,0
19:20:47,3021.454,Fox,268,71,18,12,16,2,18,5,268,250,238,200,119,97,29,42,130,138,35,70,92,0
19:20:48,3022.711,Fox,268,70,18,12,16,2,18,4,268,250,238,200,119,97,29,41,130,138,35,70,93,0
19:20:48,3024.064,Fox,268,70,18,10,18,2,18,4,268,250,240,200,119,97,29,41,130,138,35,70,93,0
19:20:49,3026.437,Fox,268,70,18,8,20,2,18,4,268,250,242,200,119,97,29,41,130,138,35,70,93,0
19:20:49,3027.553,Fox,268,70,18,6,22,2,17,5,268,250,244,200,119,98,29,41,130,138,35,70,93,0
19:20:50,3029.178,Fox,268,70,18,4,24,2,17,5,268,250,246,200,119,98,29,41,130,138,35,70,93,0
19:20:50,3030.356,Fox,268,70,18,4,24,1,18,5,268,250,246,200,120,98,29,41,130,138,35,70,93,0
19:20:52,3036.121,Fox,268,70,18,2,26,1,18,5,268,250,248,200,120,98,29,41,130,138,35,70,93,0
19:20:52,3036.815,Fox,268,69,18,2,26,1,18,4,268,250,248,200,120,98,28,41,130,138,35,70,94,0
19:20:54,3042.502,Fox,268,69,18,2,24,3,18,4,268,250,248,202,120,98,28,41,130,138,35,70,94,0
19:20:54,3043.124,Fox,268,68,18,2,22,5,18,3,268,250,248,204,120,98,28,40,130,138,35,70,95,0
19:20:56,3047.908,Fox,270,69,20,2,21,5,18,3,270,250,248,204,120,98,27,42,130,140,35,71,95,0
19:20:56,3048.63,Fox,272,71,22,2,21,5,18,3,272,250,248,204,120,98,29,42,132,140,35,71,95,0
19:20:58,3052.73,Fox,272,71,20,4,21,5,18,3,272,252,248,204,120,98,29,42,132,140,35,71,95,0
19:20:58,3053.2,Fox,272,69,20,4,21,3,18,3,272,252,248,204,120,98,27,42,132,140,35,73,95,0
19:20:58,3053.935,Fox,272,68,20,2,23,2,18,3,272,252,250,204,120,98,27,41,132,140,35,74,95,0
19:20:58,3055.298,Fox,272,68,18,4,23,2,18,3,272,254,250,204,120,98,27,41,132,140,35,74,95,0
19:21:01,3061.541,Fox,272,68,16,6,23,2,18,3,272,256,250,204,120,98,27,41,132,140,35,74,95,0
19:21:01,3063.782,Fox,274,69,18,6,22,2,18,3,274,256,250,204,120,98,27,42,133,141,35,75,95,0
19:21:01,3064.009,Fox,274,69,16,8,22,2,18,3,274,258,250,204,120,98,27,42,133,141,35,75,95,0
19:21:02,3064.872,Fox,278,71,18,8,20,2,18,3,276,258,250,204,120,98,28,43,136,142,35,77,95,0
19:21:02,3065.102,Fox,278,71,20,8,20,2,18,3,278,258,250,204,120,98,28,43,136,142,35,77,95,0
19:21:02,3065.921,Fox,278,70,20,8,18,4,18,2,278,258,250,206,120,98,28,42,136,142,35,77,96,0
19:21:02,3066.523,Fox,278,70,18,10,18,4,18,2,278,260,250,206,120,98,28,42,136,142,35,77,96,0
19:21:03,3067.817,Fox,280,71,18,12,17,4,18,2,280,262,250,206,120,98,29,42,138,142,35,78,96,0
19:21:03,3068.947,Fox,280,71,18,12,16,5,18,2,280,262,250,207,120,98,29,42,138,142,35,78,96,0
19:21:04,3071.333,Fox,280,71,18,12,14,7,18,2,280,262,250,209,120,98,29,42,138,142,35,78,96,0
19:21:04,3072.177,Fox,280,71,18,12,12,9,18,2,280,262,250,211,120,98,29,42,138,142,35,78,96,0
19:21:06,3076.501,Fox,280,69,16,14,12,7,18,2,280,264,250,211,120,98,29,40,138,142,35,80,96,0
19:21:06,3079.429,Fox,280,68,16,14,11,7,18,2,280,264,250,212,120,98,29,39,138,142,35,81,96,0
19:21:07,3080.885,Fox,280,67,16,14,11,7,15,4,280,264,250,212,120,100,29,38,138,142,35,82,96,0
19:21:07,3081.799,Fox,282,68,18,14,11,6,15,4,282,264,250,212,120,100,30,38,139,143,35,83,96,0
19:21:08,3082.476,Fox,284,70,20,14,11,6,15,4,284,264,250,212,120,100,31,39,140,144,35,83,96,0
19:21:08,3082.915,Fox,284,69,20,14,11,5,14,5,284,264,250,212,120,101,31,38,140,144,35,84,96,0
19:21:08,3083.366,Fox,286,71,22,14,11,5,14,5,286,264,250,212,120,101,32,39,141,145,35,84,96,0
19:21:08,3084.482,Fox,286,71,22,14,9,7,12,7,286,264,250,214,120,103,32,39,141,145,35,84,96,0
19:21:09,3087.108,Fox,286,71,22,14,7,8,13,7,286,264,250,216,121,103,32,39,141,145,35,84,96,0
19:21:09,3087.692,Fox,286,70,22,14,6,9,13,6,286,264,250,217,121,103,31,39,141,145,35,84,97,0
19:21:09,3087.901,Fox,286,70,22,14,6,9,11,8,286,264,250,217,121,105,31,39,141,145,35,84,97,0
19:21:10,3089.839,Fox,288,71,24,14,4,10,11,8,288,264,250,219,121,105,32,39,143,145,36,84,97,0
19:21:10,3090.29,Fox,290,72,24,14,4,9,11,8,288,264,250,219,121,105,33,39,144,146,36,85,97,0
19:21:10,3090.52,Fox,290,72,26,14,4,9,11,8,290,264,250,219,121,105,33,39,144,146,36,85,97,0
19:21:10,3091.147,Fox,290,72,24,14,6,9,11,8,290,266,252,219,121,105,33,39,144,146,36,85,97,0
19:21:11,3093.91,Fox,290,72,24,12,8,9,11,8,290,266,254,219,121,105,33,39,144,146,36,85,97,0
19:21:12,3094.943,Fox,290,70,24,12,8,7,11,8,290,266,254,219,121,105,32,38,144,146,36,87,97,0
19:21:12,3096.597,Fox,290,70,24,12,6,9,11,8,290,266,254,221,121,105,32,38,144,146,36,87,97,0
19:21:12,3097.361,Fox,290,68,24,12,6,7,11,8,290,266,254,221,121,105,32,36,144,146,36,89,97,0
19:21:13,3098.189,Fox,292,70,26,12,6,7,10,9,292,266,254,221,121,106,33,37,145,147,36,89,97,0
19:21:13,3098.379,Fox,292,69,26,12,6,7,10,8,292,266,254,221,121,106,33,36,145,147,36,89,98,0
19:21:13,3100.039,Fox,292,68,26,10,8,6,10,8,292,266,256,221,121,106,33,35,145,147,37,89,98,0
19:21:14,3102.411,Fox,292,68,26,8,10,6,10,8,292,266,258,221,121,106,33,35,145,147,37,89,98,0
19:21:15,3104.2,Fox,294,70,26,10,10,6,10,8,294,268,258,221,121,106,34,36,146,148,37,89,98,0
19:21:15,3104.981,Fox,294,70,26,8,12,6,8,10,294,268,260,221,121,108,34,36,146,148,37,89,98,0
19:21:15,3106.337,Fox,294,70,26,6,14,6,8,10,294,268,262,221,121,108,34,36,146,148,37,89,98,0
19:21:16,3107.098,Fox,294,69,26,6,14,5,8,10,294,268,262,221,121,108,34,35,146,148,37,90,98,0
19:21:16,3108.37,Fox,294,68,26,6,14,4,8,10,294,268,262,221,121,108,34,34,146,148,37,91,98,0
19:21:17,3111.058,Fox,294,67,26,6,14,4,8,9,294,268,262,221,121,108,34,33,146,148,37,91,99,0
19:21:18,3114.345,Fox,294,67,26,6,12,6,8,9,294,268,262,223,121,108,34,33,146,148,37,91,99,0
19:21:18,3114.952,Fox,294,67,26,4,14,6,8,9,294,268,264,223,121,108,34,33,146,148,37,91,99,0
19:21:19,3118.26,Fox,294,66,26,4,14,6,8,8,294,268,264,223,121,108,34,32,146,148,37,91,100,0
19:21:20,3120.685,Fox,294,65,26,4,14,5,8,8,294,268,264,223,121,108,33,32,146,148,37,92,100,0
19:21:20,3121.088,Fox,294,64,26,4,14,5,8,7,294,268,264,223,121,108,32,32,146,148,37,92,101,0
19:21:21,3123.447,Fox,296,66,28,4,14,5,8,7,296,268,264,223,121,108,32,34,146,150,37,92,101,0
19:21:22,3124.938,Fox,296,65,28,4,14,4,8,7,296,268,264,223,121,108,31,34,146,150,37,93,101,0
19:21:23,3129.606,Fox,296,65,28,2,16,4,8,7,296,268,266,223,121,108,31,34,146,150,37,93,101,0
19:21:24,3130.531,Fox,296,65,26,4,16,4,8,7,296,270,266,223,121,108,31,34,146,150,37,93,101,0
19:21:24,3131.117,Fox,296,65,24,6,16,4,8,7,296,272,266,223,121,108,31,34,146,150,37,93,101,0
19:21:24,3132.615,Fox,298,66,26,6,15,4,8,7,298,272,266,223,121,108,31,35,147,151,37,94,101,0
19:21:25,3134.703,Fox,298,64,26,6,15,4,8,5,298,272,266,223,121,108,31,33,147,151,37,94,103,0
19:21:26,3136.629,Fox,298,64,26,6,15,3,9,5,298,272,266,223,122,108,31,33,147,151,37,94,103,0
19:21:26,3139.338,Fox,298,64,26,6,15,3,7,7,298,272,266,223,122,110,31,33,147,151,37,94,103,0
19:21:28,3142.491,Fox,298,64,26,4,17,3,7,7,298,272,268,223,122,110,31,33,147,151,37,94,103,0
19:21:28,3143.026,Fox,298,64,26,4,17,3,5,9,298,272,268,223,122,112,31,33,147,151,37,94,103,0
19:21:28,3143.783,Fox,300,65,28,4,16,3,3,11,300,272,268,223,122,114,31,34,148,152,37,95,103,0
19:21:29,3145.478,Fox,300,64,28,4,16,3,3,10,300,272,268,223,122,114,31,33,148,152,37,95,104,0
19:21:29,3146.395,Fox,300,64,26,6,16,3,3,10,300,274,268,223,122,114,31,33,148,152,37,95,104,0
19:21:29,3147.717,Fox,300,64,22,10,16,3,3,10,300,278,268,223,122,114,31,33,148,152,37,95,104,0
19:21:30,3148.471,Fox,300,63,22,10,16,3,3,9,300,278,268,223,122,114,31,32,148,152,37,95,105,0
19:21:30,3150.468,Fox,302,65,22,12,16,3,3,9,302,280,268,223,122,114,32,33,149,153,37,95,105,0
19:21:31,3151.741,Fox,302,65,22,12,14,5,3,9,302,280,268,225,122,114,32,33,149,153,37,95,105,0
19:21:31,3153.04,Fox,302,64,22,12,14,5,3,8,302,280,268,225,122,114,31,33,149,153,37,95,106,0
19:21:31,3154.194,Fox,302,64,22,12,13,6,3,8,302,280,268,226,122,114,31,33,149,153,37,95,106,0
19:21:32,3156.73,Fox,302,64,22,12,13,6,2,9,302,280,268,226,122,115,31,33,149,153,37,95,106,0
19:21:33,3158.713,Fox,304,65,22,12,13,6,2,8,302,280,268,226,122,115,32,33,150,154,37,95,107,0
19:21:33,3158.92,Fox,304,65,24,12,13,6,2,8,304,280,268,226,122,115,32,33,150,154,37,95,107,0
19:21:34,3160.542,Fox,304,65,24,12,11,8,2,8,304,280,268,228,122,115,32,33,150,154,37,95,107,0
19:21:34,3162.903,Fox,304,65,24,12,9,10,2,8,304,280,268,230,122,115,32,33,150,154,37,95,107,0
19:21:35,3164.282,Fox,304,65,22,14,9,10,2,8,304,282,268,230,122,115,32,33,150,154,37,95,107,0
19:21:35,3164.786,Fox,304,64,22,14,9,8,3,8,304,282,268,230,123,115,32,32,150,154,37,96,107,0
19:21:35,3164.974,Fox,304,64,20,16,9,8,3,8,304,284,268,230,123,115,32,32,150,154,37,96,107,0
19:21:35,3165.59,Fox,304,64,20,16,7,9,4,8,304,284,268,232,124,115,32,32,150,154,37,96,107,0
19:21:35,3165.972,Fox,304,64,18,18,7,9,4,8,304,286,268,232,124,115,32,32,150,154,37,96,107,0
19:21:36,3166.94,Fox,304,64,18,18,6,10,4,8,304,286,268,233,124,115,32,32,150,154,37,96,107,0
19:21:36,3168.867,Fox,304,64,18,16,8,10,4,8,304,286,270,233,124,115,32,32,150,154,37,96,107,0
19:21:37,3169.612,Fox,304,63,18,14,10,10,4,7,304,286,272,233,124,115,32,31,150,154,37,96,108,0
19:21:37,3172.238,Fox,306,64,20,14,9,10,4,7,306,286,272,233,124,115,32,32,151,155,37,97,108,0
19:21:38,3172.434,Fox,306,64,18,16,9,10,4,7,306,288,272,233,124,115,32,32,151,155,37,97,108,0
19:21:38,3172.99,Fox,308,66,18,18,9,10,4,7,308,290,272,233,124,115,32,34,151,157,37,97,108,0
19:21:38,3173.952,Fox,308,65,18,18,9,10,4,6,308,290,272,233,124,115,31,34,151,157,37,97,109,0
19:21:38,3174.545,Fox,310,67,20,18,9,10,4,6,310,290,272,233,124,115,32,35,152,158,37,97,109,0
19:21:39,3175.523,Fox,310,67,20,18,7,12,4,6,310,290,272,235,124,115,32,35,152,158,37,97,109,0
19:21:39,3176.083,Fox,310,65,20,18,7,10,4,6,310,290,272,235,124,115,32,33,152,158,37,99,109,0
19:21:39,3177.258,Fox,310,64,20,18,7,9,4,6,310,290,272,235,124,115,32,32,152,158,37,100,109,0
19:21:40,3180.73,Fox,312,65,20,20,6,9,4,6,312,292,272,235,124,115,33,32,154,158,37,101,109,0
19:21:42,3184.964,Fox,312,65,20,18,8,9,4,6,312,292,274,235,124,115,33,32,154,158,37,101,109,0
19:21:42,3186.109,Fox,312,65,20,14,12,9,4,6,312,292,278,235,124,115,33,32,154,158,37,101,109,0
19:21:42,3186.838,Fox,312,65,18,16,12,9,4,6,312,294,278,235,124,115,33,32,154,158,37,101,109,0
19:21:43,3188.891,Fox,312,65,18,14,14,9,4,6,312,294,280,235,124,115,33,32,154,158,37,101,109,0
19:21:43,3190.096,Fox,312,65,18,14,13,10,4,6,312,294,280,236,124,115,33,32,154,158,37,101,109,0
19:21:44,3192.034,Fox,314,67,20,14,13,10,4,6,314,294,280,236,124,115,34,33,155,159,37,101,109,0
19:21:45,3194.042,Fox,314,66,20,14,13,10,4,5,314,294,280,236,124,115,33,33,155,159,37,101,110,0
19:21:47,3200.59,Fox,314,65,20,14,13,9,4,5,314,294,280,236,124,115,33,32,155,159,38,101,110,0
19:21:48,3202.926,Fox,314,65,20,12,14,10,4,5,314,294,282,237,124,115,33,32,155,159,38,101,110,0
19:21:48,3203.478,Fox,314,64,20,10,16,10,4,4,314,294,284,237,124,115,33,31,155,159,38,101,111,0
19:21:48,3204.403,Fox,314,64,20,8,18,10,4,4,314,294,286,237,124,115,33,31,155,159,38,101,111,0
19:21:49,3206.062,Fox,314,63,18,10,18,10,4,3,314,296,286,237,124,115,33,30,155,159,38,101,112,0
19:21:49,3207.104,Fox,314,62,18,10,18,10,4,2,314,296,286,237,124,115,33,29,155,159,38,101,113,0
19:21:49,3207.808,Fox,314,62,18,10,18,9,5,2,314,296,286,237,125,115,33,29,155,159,38,101,113,0
19:21:50,3210.893,Fox,314,62,18,8,20,9,5,2,314,296,288,237,125,115,33,29,155,159,38,101,113,0
19:21:51,3211.606,Fox,314,62,18,6,22,9,5,2,314,296,290,237,125,115,33,29,155,159,38,101,113,0
19:21:51,3213.571,Fox,314,61,18,6,22,8,5,2,314,296,290,237,125,115,32,29,155,159,38,102,113,0
19:21:52,3215.174,Fox,314,61,16,8,22,8,5,2,314,298,290,237,125,115,32,29,155,159,38,102,113,0
19:21:53,3217.732,Fox,316,63,18,8,22,8,5,2,316,298,290,237,125,115,32,31,155,161,38,102,113,0
19:21:53,3219.329,Fox,316,63,18,6,24,8,5,2,316,298,292,237,125,115,32,31,155,161,38,102,113,0
19:21:53,3220.295,Fox,316,62,18,6,24,8,5,1,316,298,292,237,125,115,31,31,155,161,38,102,114,0
19:21:54,3221.976,Fox,318,63,20,6,23,8,5,1,318,298,292,237,125,115,32,31,157,161,38,103,114,0
19:21:55,3223.985,Fox,320,65,22,6,23,8,5,1,320,298,292,237,125,115,33,32,158,162,38,103,114,0
19:21:55,3224.737,Fox,320,65,22,6,23,8,4,2,320,298,292,237,125,116,33,32,158,162,38,103,114,0
19:21:55,3225.224,Fox,320,65,22,4,25,8,4,2,320,298,294,237,125,116,33,32,158,162,38,103,114,0
19:21:56,3226.38,Fox,320,65,20,6,25,8,4,2,320,300,294,237,125,116,33,32,158,162,38,103,114,0
19:21:57,3229.356,Fox,320,65,20,6,23,10,4,2,320,300,294,239,125,116,33,32,158,162,38,103,114,0
19:21:57,3230.324,Fox,320,65,20,6,21,12,4,2,320,300,294,241,125,116,33,32,158,162,38,103,114,0
19:21:58,3232.456,Fox,320,64,20,6,21,12,4,1,320,300,294,241,125,116,33,31,158,162,38,104,114,0
19:21:58,3233.031,Fox,320,64,18,8,21,12,4,1,320,302,294,241,125,116,33,31,158,162,38,104,114,0
19:21:59,3237.611,Fox,322,65,20,8,20,12,4,1,322,302,294,241,125,116,32,33,158,164,38,105,114,0
19:22:00,3240.086,Fox,324,66,22,8,20,11,4,1,324,302,294,241,125,116,34,32,160,164,38,106,114,0
19:22:01,3241.724,Fox,326,67,20,10,19,11,4,1,324,304,294,241,125,116,35,32,162,164,38,107,114,0
19:22:01,3241.89,Fox,326,67,22,10,19,11,4,1,326,304,294,241,125,116,35,32,162,164,38,107,114,0
19:22:02,3244.445,Fox,326,67,22,8,21,11,4,1,326,304,296,241,125,116,35,32,162,164,38,107,114,0
19:22:02,3245.257,Fox,326,67,22,8,19,11,6,1,326,304,296,243,127,116,35,32,162,164,38,107,114,0
19:22:02,3246.602,Fox,326,67,22,8,17,13,6,1,326,304,296,245,127,116,35,32,162,164,38,107,114,0
19:22:03,3249.077,Fox,328,68,24,8,16,13,6,1,328,304,296,245,127,116,35,33,163,165,38,108,114,0
19:22:03,3249.441,Fox,328,68,24,8,14,15,6,1,328,304,296,247,127,116,35,33,163,165,38,108,114,0
19:22:04,3251.797,Fox,330,70,26,8,14,15,6,1,330,304,296,247,127,116,37,33,165,165,38,108,114,0
19:22:05,3253.725,Fox,330,70,26,6,16,15,6,1,330,304,298,247,127,116,37,33,165,165,38,108,114,0
19:22:05,3254.038,Fox,330,70,26,6,16,13,8,1,330,304,298,247,129,116,37,33,165,165,38,108,114,0
19:22:05,3254.898,Fox,330,70,24,8,16,13,8,1,330,306,298,247,129,116,37,33,165,165,38,108,114,0
19:22:05,3255.527,Fox,330,70,22,10,16,13,8,1,330,308,298,247,129,116,37,33,165,165,38,108,114,0
19:22:05,3255.82,Fox,330,69,22,10,16,12,8,1,330,308,298,247,129,116,37,32,165,165,38,109,114,0
19:22:06,3256.477,Fox,330,69,22,10,16,10,10,1,330,308,298,247,131,116,37,32,165,165,38,109,114,0
19:22:06,3257.394,Fox,330,67,20,12,16,8,10,1,330,310,298,247,131,116,36,31,165,165,39,110,114,0
19:22:06,3258.227,Fox,332,69,22,12,16,8,10,1,332,310,298,247,131,116,37,32,166,166,39,110,114,0
19:22:07,3259.799,Fox,332,67,22,12,16,6,10,1,332,310,298,247,131,116,35,32,166,166,39,112,114,0
19:22:08,3263.336,Fox,332,67,20,14,14,8,10,1,332,312,298,249,131,116,35,32,166,166,39,112,114,0
19:22:08,3264.253,Fox,334,68,22,14,12,9,10,1,334,312,298,250,131,116,36,32,168,166,40,112,114,0
19:22:08,3264.848,Fox,334,68,22,12,13,10,10,1,334,312,300,251,131,116,36,32,168,166,40,112,114,0
19:22:09,3266.307,Fox,336,70,24,12,13,10,10,1,336,312,300,251,131,116,37,33,169,167,40,112,114,0
19:22:10,3269.046,Fox,336,70,24,12,13,8,12,1,336,312,300,251,133,116,37,33,169,167,40,112,114,0
19:22:11,3271.365,Fox,338,72,26,12,11,10,12,1,338,312,300,253,133,116,39,33,171,167,40,112,114,0
19:22:11,3271.562,Fox,338,72,26,10,13,10,12,1,338,312,302,253,133,116,39,33,171,167,40,112,114,0
19:22:11,3272.104,Fox,338,72,26,10,12,11,12,1,338,312,302,254,133,116,39,33,171,167,40,112,114,0
19:22:11,3274.127,Fox,338,71,26,10,12,10,11,2,338,312,302,254,133,117,39,32,171,167,40,113,114,0
19:22:12,3274.518,Fox,338,70,24,12,12,9,11,2,338,314,302,254,133,117,39,31,171,167,40,114,114,0
19:22:12,3275.358,Fox,338,69,24,12,12,9,11,1,338,314,302,254,133,117,38,31,171,167,40,114,115,0
19:22:13,3278.503,Fox,340,71,26,12,12,9,11,1,340,314,302,254,133,117,39,32,172,168,40,114,115,0
19:22:13,3279.701,Fox,340,71,26,12,10,11,11,1,340,314,302,256,133,117,39,32,172,168,40,114,115,0
19:22:13,3280.086,Fox,340,71,26,10,12,11,11,1,340,314,304,256,133,117,39,32,172,168,40,114,115,0
19:22:14,3282.542,Fox,340,70,26,10,12,10,11,1,340,314,304,256,133,117,39,31,172,168,40,115,115,0
19:22:15,3285.792,Fox,340,70,26,10,10,12,11,1,340,314,304,258,133,117,39,31,172,168,40,115,115,0
19:22:17,3290.179,Fox,340,68,26,10,10,10,11,1,340,314,304,258,133,117,38,30,172,168,41,116,115,0
19:22:18,3292.054,Fox,342,69,28,10,9,10,11,1,342,314,304,258,133,117,38,31,173,169,41,117,115,0
19:22:18,3293.261,Fox,342,69,28,8,11,10,11,1,342,314,306,258,133,117,38,31,173,169,41,117,115,0
19:22:18,3294.097,Fox,342,69,28,6,13,10,11,1,342,314,308,258,133,117,38,31,173,169,41,117,115,0
19:22:19,3295.693,Fox,342,69,28,4,15,10,11,1,342,314,310,258,133,117,38,31,173,169,41,117,115,0
19:22:19,3296.239,Fox,342,67,28,4,15,8,11,1,342,314,310,258,133,117,37,30,173,169,41,119,115,0
19:22:20,3300.364,Fox,342,67,26,6,15,8,11,1,342,316,310,258,133,117,37,30,173,169,41,119,115,0
19:22:21,3301.795,Fox,342,67,26,4,17,8,11,1,342,316,312,258,133,117,37,30,173,169,41,119,115,0
19:22:21,3302.157,Fox,342,67,26,4,17,8,10,2,342,316,312,258,133,118,37,30,173,169,41,119,115,0
19:22:21,3303.013,Fox,342,67,26,4,17,8,9,3,342,316,312,258,133,119,37,30,173,169,41,119,115,0
19:22:22,3304.69,Fox,344,68,24,6,17,8,8,3,342,318,312,258,133,119,37,31,174,170,41,120,115,0
19:22:22,3305.063,Fox,344,68,26,6,15,10,8,3,344,318,312,260,133,119,37,31,174,170,41,120,115,0
19:22:22,3306.494,Fox,344,68,24,8,15,10,8,3,344,320,312,260,133,119,37,31,174,170,41,120,115,0
19:22:23,3309.402,Fox,346,70,26,8,15,10,8,3,346,320,312,260,133,119,38,32,175,171,41,120,115,0
19:22:25,3313.119,Fox,346,70,26,6,17,10,8,3,346,320,314,260,133,119,38,32,175,171,41,120,115,0
19:22:25,3314.182,Fox,346,70,26,6,16,11,8,3,346,320,314,261,133,119,38,32,175,171,41,120,115,0
19:22:25,3314.909,Fox,348,72,28,6,16,11,8,3,348,320,314,261,133,119,38,34,175,173,41,120,115,0
19:22:25,3315.63,Fox,348,70,28,6,16,9,8,3,348,320,314,261,133,119,38,32,175,173,41,122,115,0
19:22:27,3319.979,Fox,350,71,30,6,15,9,8,3,350,320,314,261,133,119,37,34,175,175,41,123,115,0
19:22:27,3320.156,Fox,350,71,28,8,15,9,8,3,350,322,314,261,133,119,37,34,175,175,41,123,115,0
19:22:28,3322.579,Fox,350,71,26,10,15,9,8,3,350,324,314,261,133,119,37,34,175,175,41,123,115,0
19:22:28,3322.904,Fox,350,71,26,10,15,8,9,3,350,324,314,261,134,119,37,34,175,175,41,123,115,0
19:22:28,3323.618,Fox,350,71,26,10,15,6,11,3,350,324,314,261,136,119,37,34,175,175,41,123,115,0
19:22:28,3324.375,Fox,350,71,24,12,15,6,11,3,350,326,314,261,136,119,37,34,175,175,41,123,115,0
19:22:29,3325.296,Fox,350,71,24,12,14,7,11,3,350,326,314,262,136,119,37,34,175,175,41,123,115,0
19:22:30,3330.875,Fox,352,73,26,12,14,7,11,3,352,326,314,262,136,119,37,36,175,177,41,123,115,0
19:22:31,3331.535,Fox,352,73,24,14,14,7,11,3,352,328,314,262,136,119,37,36,175,177,41,123,115,0
19:22:31,3332.015,Fox,352,73,24,14,12,9,11,3,352,328,314,264,136,119,37,36,175,177,41,123,115,0
19:22:31,3332.479,Fox,354,75,26,14,12,9,11,3,354,328,314,264,136,119,37,38,175,179,41,123,115,0
19:22:32,3334.383,Fox,354,75,24,16,12,9,11,3,354,330,314,264,136,119,37,38,175,179,41,123,115,0
19:22:32,3335.859,Fox,354,74,24,16,12,8,11,3,354,330,314,264,136,119,37,37,175,179,41,124,115,0
19:22:32,3336.362,Fox,354,73,24,16,12,7,11,3,354,330,314,264,136,119,36,37,175,179,41,125,115,0
19:22:33,3338.792,Fox,354,73,24,14,14,6,12,3,354,330,316,264,137,119,36,37,175,179,41,125,115,0
19:22:34,3340.416,Fox,354,73,24,14,12,8,12,3,354,330,316,266,137,119,36,37,175,179,41,125,115,0
19:22:34,3340.911,Fox,354,73,22,16,12,8,12,3,354,332,316,266,137,119,36,37,175,179,41,125,115,0
19:22:34,3342.117,Fox,356,75,24,16,12,8,12,3,356,332,316,266,137,119,36,39,175,181,41,125,115,0
19:22:34,3342.933,Fox,356,75,24,14,14,8,12,3,356,332,318,266,137,119,36,39,175,181,41,125,115,0
19:22:35,3345.049,Fox,356,75,24,12,16,8,12,3,356,332,320,266,137,119,36,39,175,181,41,125,115,0
19:22:35,3345.348,Fox,356,75,24,12,16,8,11,4,356,332,320,266,137,120,36,39,175,181,41,125,115,0
19:22:36,3346.812,Fox,356,75,22,14,16,8,11,4,356,334,320,266,137,120,36,39,175,181,41,125,115,0
19:22:36,3348.044,Fox,358,77,24,14,16,8,11,4,358,334,320,266,137,120,37,40,176,182,41,125,115,0
19:22:36,3348.819,Fox,358,77,22,16,16,8,11,4,358,336,320,266,137,120,37,40,176,182,41,125,115,0
19:22:37,3350.937,Fox,358,75,22,16,16,6,11,4,358,336,320,266,137,120,36,39,176,182,43,125,115,0
19:22:38,3353.824,Fox,358,75,20,18,14,8,11,4,358,338,320,268,137,120,36,39,176,182,43,125,115,0
19:22:38,3354.575,Fox,358,75,20,18,12,10,11,4,358,338,320,270,137,120,36,39,176,182,43,125,115,0
19:22:39,3356.19,Fox,358,75,20,18,10,12,11,4,358,338,320,272,137,120,36,39,176,182,43,125,115,0
19:22:40,3358.407,Fox,358,75,20,18,10,11,12,4,358,338,320,272,138,120,36,39,176,182,43,125,115,0
19:22:40,3358.685,Fox,358,75,20,16,12,11,12,4,358,338,322,272,138,120,36,39,176,182,43,125,115,0
19:22:41,3361.134,Fox,358,75,18,16,14,11,12,4,358,340,324,272,138,120,36,39,176,182,43,125,115,0
19:22:41,3362.256,Fox,358,75,18,16,12,13,12,4,358,340,324,274,138,120,36,39,176,182,43,125,115,0
19:22:41,3362.887,Fox,358,75,18,14,14,13,12,4,358,340,326,274,138,120,36,39,176,182,43,125,115,0
19:22:42,3364.323,Fox,358,74,18,14,14,12,12,4,358,340,326,274,138,120,36,38,176,182,44,125,115,0
19:22:42,3364.782,Fox,358,73,18,14,14,10,14,3,358,340,326,274,140,120,36,37,176,182,44,125,116,0
19:22:42,3365.099,Fox,358,71,18,14,14,8,14,3,358,340,326,274,140,120,36,35,176,182,44,127,116,0
19:22:43,3370.059,Fox,358,71,18,12,16,8,14,3,358,340,328,274,140,120,36,35,176,182,44,127,116,0
19:22:44,3372.843,Fox,358,71,18,10,18,8,14,3,358,340,330,274,140,120,36,35,176,182,44,127,116,0
19:22:45,3373.587,Fox,358,71,18,10,16,10,14,3,358,340,330,276,140,120,36,35,176,182,44,127,116,0
19:22:45,3374.61,Fox,358,71,16,12,16,10,14,3,358,342,330,276,140,120,36,35,176,182,44,127,116,0
19:22:46,3378.137,Fox,360,73,18,12,16,10,14,3,360,342,330,276,140,120,38,35,178,182,44,127,116,0
19:22:47,3379.27,Fox,360,73,18,10,18,10,14,3,360,342,332,276,140,120,38,35,178,182,44,127,116,0
19:22:48,3382.885,Fox,360,72,18,10,18,10,12,4,360,342,332,276,140,122,37,35,178,182,44,127,117,0
19:22:49,3385.414,Fox,362,73,20,8,19,10,12,4,362,342,334,276,140,122,38,35,180,182,44,128,117,0
19:22:49,3387.379,Fox,362,73,18,8,21,10,12,4,362,344,336,276,140,122,38,35,180,182,44,128,117,0
19:22:51,3391.486,Fox,362,73,18,8,21,10,10,6,362,344,336,276,140,124,38,35,180,182,44,128,117,0
19:22:51,3391.934,Fox,362,73,16,10,21,10,10,6,362,346,336,276,140,124,38,35,180,182,44,128,117,0
19:22:51,3392.388,Fox,362,73,16,8,23,10,10,6,362,346,338,276,140,124,38,35,180,182,44,128,117,0
19:22:51,3393.994,Fox,362,73,16,8,23,10,8,8,362,346,338,276,140,126,38,35,180,182,44,128,117,0
19:22:53,3397.453,Fox,362,73,14,10,23,10,8,8,362,348,338,276,140,126,38,35,180,182,44,128,117,0
19:22:53,3397.9,Fox,364,74,16,10,22,10,8,8,364,348,338,276,140,126,38,36,181,183,44,129,117,0
19:22:53,3399.439,Fox,366,76,16,10,20,12,8,8,364,348,338,278,140,126,40,36,183,183,44,129,117,0
19:22:53,3399.595,Fox,366,76,18,8,22,12,8,8,366,348,340,278,140,126,40,36,183,183,44,129,117,0
19:22:54,3402.521,Fox,366,76,16,10,22,12,8,8,366,350,340,278,140,126,40,36,183,183,44,129,117,0
19:22:55,3403.469,Fox,366,76,16,10,20,14,8,8,366,350,340,280,140,126,40,36,183,183,44,129,117,0
19:22:55,3404.056,Fox,366,75,16,10,20,14,8,7,366,350,340,280,140,126,40,35,183,183,44,129,118,0
19:22:55,3405.487,Fox,366,75,16,10,19,15,8,7,366,350,340,281,140,126,40,35,183,183,44,129,118,0
19:22:56,3406.506,Fox,366,75,16,10,19,15,7,8,366,350,340,281,140,127,40,35,183,183,44,129,118,0
19:22:56,3407.632,Fox,366,75,16,10,19,14,8,8,366,350,340,281,141,127,40,35,183,183,44,129,118,0
19:22:56,3408.336,Fox,368,77,18,10,19,14,8,8,368,350,340,281,141,127,41,36,184,184,44,129,118,0
19:22:57,3409.845,Fox,368,75,18,10,19,12,8,8,368,350,340,281,141,127,41,34,184,184,44,131,118,0
19:22:58,3413.004,Fox,368,75,18,8,21,12,8,8,368,350,342,281,141,127,41,34,184,184,44,131,118,0
19:22:58,3413.492,Fox,368,75,16,10,21,12,8,8,368,352,342,281,141,127,41,34,184,184,44,131,118,0
19:22:58,3414.006,Fox,368,73,16,10,21,10,8,8,368,352,342,281,141,127,39,34,184,184,44,133,118,0
19:22:59,3415.144,Fox,368,73,14,12,21,10,8,8,368,354,342,281,141,127,39,34,184,184,44,133,118,0
19:22:59,3416.078,Fox,368,72,14,12,21,9,8,8,368,354,342,281,141,127,39,33,184,184,44,134,118,0
19:22:59,3417.765,Fox,370,73,16,12,20,9,8,8,370,354,342,281,141,127,40,33,186,184,44,135,118,0
19:23:00,3418.134,Fox,372,74,18,12,19,9,8,8,372,354,342,281,141,127,41,33,188,184,44,136,118,0
19:23:00,3418.793,Fox,372,73,18,12,18,9,8,8,372,354,342,281,141,127,40,33,188,184,44,137,118,0
19:23:00,3419.459,Fox,374,75,18,12,16,11,8,8,372,354,342,283,141,127,41,34,189,185,44,137,118,0
19:23:00,3419.616,Fox,374,75,20,12,16,11,8,8,374,354,342,283,141,127,41,34,189,185,44,137,118,0
19:23:01,3421.772,Fox,376,76,20,12,15,12,8,7,374,354,342,284,141,127,43,33,191,185,44,137,119,0
19:23:01,3421.982,Fox,376,76,22,12,15,12,8,7,376,354,342,284,141,127,43,33,191,185,44,137,119,0
19:23:01,3423.025,Fox,378,78,24,12,15,12,8,7,378,354,342,284,141,127,44,34,192,186,44,137,119,0
19:23:01,3423.557,Fox,378,78,24,12,14,13,8,7,378,354,342,285,141,127,44,34,192,186,44,137,119,0
19:23:02,3424.882,Fox,378,78,22,14,14,13,8,7,378,356,342,285,141,127,44,34,192,186,44,137,119,0
19:23:02,3425.514,Fox,378,78,22,14,14,11,10,7,378,356,342,285,143,127,44,34,192,186,44,137,119,0
19:23:02,3426.099,Fox,380,79,24,12,16,11,10,6,380,356,344,285,143,127,44,35,193,187,44,137,120,0
19:23:04,3430.559,Fox,380,79,22,12,17,12,10,6,380,358,346,286,143,127,44,35,193,187,44,137,120,0
19:23:04,3432.154,Fox,380,78,22,12,17,11,10,6,380,358,346,286,143,127,43,35,193,187,45,137,120,0
19:23:05,3433.388,Fox,380,78,22,12,15,13,10,6,380,358,346,288,143,127,43,35,193,187,45,137,120,0
19:23:05,3434.043,Fox,380,77,22,12,15,12,10,6,380,358,346,288,143,127,42,35,193,187,45,138,120,0
19:23:06,3435.941,Fox,380,77,22,10,17,12,10,6,380,358,348,288,143,127,42,35,193,187,45,138,120,0
19:23:06,3437.641,Fox,382,78,24,10,17,11,10,6,382,358,348,288,143,127,42,36,194,188,45,139,120,0
19:23:07,3439.869,Fox,382,78,24,10,16,12,10,6,382,358,348,289,143,127,42,36,194,188,45,139,120,0
19:23:07,3441.036,Fox,382,78,24,8,18,12,10,6,382,358,350,289,143,127,42,36,194,188,45,139,120,0
19:23:08,3443.831,Fox,382,77,24,8,18,11,10,6,382,358,350,289,143,127,41,36,194,188,45,140,120,0
19:23:09,3445.841,Fox,382,77,24,8,16,13,10,6,382,358,350,291,143,127,41,36,194,188,45,140,120,0
19:23:09,3447.216,Fox,382,77,24,8,16,12,11,6,382,358,350,291,144,127,41,36,194,188,45,140,120,0
19:23:09,3447.823,Fox,382,77,24,8,14,14,11,6,382,358,350,293,144,127,41,36,194,188,45,140,120,0
19:23:10,3449.584,Fox,382,77,24,8,14,12,13,6,382,358,350,293,146,127,41,36,194,188,45,140,120,0
19:23:11,3451.945,Fox,382,77,24,6,16,12,13,6,382,358,352,293,146,127,41,36,194,188,45,140,120,0
19:23:11,3452.973,Fox,382,77,24,6,14,14,13,6,382,358,352,295,146,127,41,36,194,188,45,140,120,0
19:23:11,3453.608,Fox,382,77,24,4,16,14,13,6,382,358,354,295,146,127,41,36,194,188,45,140,120,0
19:23:12,3454.741,Fox,384,79,26,4,16,14,13,6,384,358,354,295,146,127,43,36,196,188,45,140,120,0
19:23:12,3455.806,Fox,384,79,26,4,16,12,15,6,384,358,354,295,148,127,43,36,196,188,45,140,120,0
19:23:14,3460.093,Fox,384,78,26,4,14,13,15,6,384,358,354,297,148,127,43,35,196,188,45,141,120,0
19:23:14,3460.362,Fox,384,78,26,4,14,13,14,7,384,358,354,297,148,128,43,35,196,188,45,141,120,0
19:23:14,3460.624,Fox,384,78,24,6,14,13,14,7,384,360,354,297,148,128,43,35,196,188,45,141,120,0
19:23:14,3461.087,Fox,384,78,24,6,14,13,12,9,384,360,354,297,148,130,43,35,196,188,45,141,120,0
19:23:15,3463.367,Fox,384,76,24,4,16,12,12,8,384,360,356,297,148,130,42,34,196,188,45,142,121,0
19:23:15,3464.725,Fox,384,75,24,4,16,12,12,7,384,360,356,297,148,130,42,33,196,188,45,142,122,0
19:23:16,3467.063,Fox,384,75,24,4,16,10,14,7,384,360,356,297,150,130,42,33,196,188,45,142,122,0
19:23:16,3467.95,Fox,384,75,22,6,16,10,14,7,384,362,356,297,150,130,42,33,196,188,45,142,122,0
19:23:17,3469.071,Fox,384,75,22,4,18,10,14,7,384,362,358,297,150,130,42,33,196,188,45,142,122,0
19:23:17,3470.615,Fox,384,74,22,4,18,9,14,7,384,362,358,297,150,130,42,32,196,188,45,143,122,0
19:23:17,3471.678,Fox,386,75,24,4,17,9,14,7,386,362,358,297,150,130,41,34,196,190,45,144,122,0
19:23:18,3473.552,Fox,386,75,24,4,16,10,14,7,386,362,358,298,150,130,41,34,196,190,45,144,122,0
19:23:18,3474.786,Fox,386,74,24,4,16,10,14,6,386,362,358,298,150,130,41,33,196,190,45,144,123,0
19:23:19,3476.22,Fox,386,74,24,4,16,10,13,7,386,362,358,298,150,131,41,33,196,190,45,144,123,0
19:23:20,3480.508,Fox,386,74,22,6,16,10,13,7,386,364,358,298,150,131,41,33,196,190,45,144,123,0
19:23:21,3482.165,Fox,386,73,20,8,16,10,13,6,386,366,358,298,150,131,40,33,196,190,45,144,124,0
19:23:22,3486.397,Fox,388,74,22,8,14,12,13,5,388,366,358,300,150,131,40,34,197,191,45,144,125,0
19:23:22,3486.717,Fox,388,72,22,8,14,10,13,5,388,366,358,300,150,131,38,34,197,191,45,146,125,0
19:23:23,3487.03,Fox,388,71,22,8,14,10,13,4,388,366,358,300,150,131,38,33,197,191,45,146,126,0
19:23:23,3489.141,Fox,390,73,24,8,14,10,13,4,390,366,358,300,150,131,39,34,198,192,45,146,126,0
19:23:24,3490.958,Fox,390,73,22,10,12,12,13,4,390,368,358,302,150,131,39,34,198,192,45,146,126,0
19:23:24,3492.661,Fox,392,75,24,10,12,12,13,4,392,368,358,302,150,131,41,34,200,192,45,146,126,0
19:23:25,3494.017,Fox,394,77,26,10,12,12,13,4,394,368,358,302,150,131,43,34,202,192,45,146,126,0
19:23:25,3495.816,Fox,394,77,26,10,12,12,12,5,394,368,358,302,150,132,43,34,202,192,45,146,126,0
19:23:26,3496.466,Fox,394,77,26,10,10,14,12,5,394,368,358,304,150,132,43,34,202,192,45,146,126,0
19:23:26,3496.951,Fox,394,76,26,10,10,13,12,5,394,368,358,304,150,132,42,34,202,192,45,147,126,0
19:23:26,3498.518,Fox,396,78,28,10,10,13,12,5,396,368,358,304,150,132,44,34,204,192,45,147,126,0
19:23:27,3499.173,Fox,396,78,28,8,12,13,12,5,396,368,360,304,150,132,44,34,204,192,45,147,126,0
19:23:27,3500.22,Fox,398,80,30,8,12,13,12,5,398,368,360,304,150,132,44,36,204,194,45,147,126,0
19:23:27,3500.383,Fox,398,80,28,10,12,13,12,5,398,370,360,304,150,132,44,36,204,194,45,147,126,0
19:23:27,3500.69,Fox,398,79,26,12,12,13,12,4,398,372,360,304,150,132,44,35,204,194,45,147,127,0
19:23:27,3501.522,Fox,398,78,26,12,10,15,12,3,398,372,360,306,150,132,43,35,204,194,45,147,128,0
19:23:28,3502.379,Fox,398,78,24,14,10,15,10,5,398,374,360,306,150,134,43,35,204,194,45,147,128,0
19:23:28,3503.469,Fox,398,77,24,14,10,15,10,4,398,374,360,306,150,134,42,35,204,194,45,147,129,0
19:23:28,3504.588,Fox,398,77,22,16,10,15,10,4,398,376,360,306,150,134,42,35,204,194,45,147,129,0
19:23:29,3505.521,Fox,398,77,20,18,10,15,10,4,398,378,360,306,150,134,42,35,204,194,45,147,129,0
19:23:29,3506.437,Fox,398,77,20,16,12,15,10,4,398,378,362,306,150,134,42,35,204,194,45,147,129,0
19:23:29,3507.469,Fox,400,79,22,16,12,15,10,4,400,378,362,306,150,134,43,36,205,195,45,147,129,0
19:23:30,3508.652,Fox,400,79,20,18,12,15,10,4,400,380,362,306,150,134,43,36,205,195,45,147,129,0
19:23:31,3512.412,Fox,400,79,20,18,10,17,10,4,400,380,362,308,150,134,43,36,205,195,45,147,129,0
19:23:31,3512.729,Fox,400,79,20,18,10,16,11,4,400,380,362,308,151,134,43,36,205,195,45,147,129,0
19:23:32,3514.096,Fox,400,79,20,18,8,18,11,4,400,380,362,310,151,134,43,36,205,195,45,147,129,0
19:23:33,3518.969,Fox,400,79,20,16,10,18,11,4,400,380,364,310,151,134,43,36,205,195,45,147,129,0
19:23:34,3520.284,Fox,400,79,18,18,10,18,11,4,400,382,364,310,151,134,43,36,205,195,45,147,129,0
19:23:34,3520.616,Fox,400,79,18,16,12,18,11,4,400,382,366,310,151,134,43,36,205,195,45,147,129,0
19:23:35,3523.657,Fox,400,79,18,16,10,20,11,4,400,382,366,312,151,134,43,36,205,195,45,147,129,0
19:23:35,3524.088,Fox,400,79,18,16,10,19,12,4,400,382,366,312,152,134,43,36,205,195,45,147,129,0
19:23:35,3524.645,Fox,400,78,18,16,10,18,12,4,400,382,366,312,152,134,43,35,205,195,45,148,129,0
19:23:37,3529.306,Fox,400,78,18,14,12,18,12,4,400,382,368,312,152,134,43,35,205,195,45,148,129,0
19:23:37,3529.708,Fox,402,80,18,14,10,20,12,4,400,382,368,314,152,134,43,37,205,197,45,148,129,0
19:23:37,3529.856,Fox,402,80,20,14,10,20,12,4,402,382,368,314,152,134,43,37,205,197,45,148,129,0
19:23:38,3533.305,Fox,402,80,20,14,10,19,13,4,402,382,368,314,153,134,43,37,205,197,45,148,129,0
19:23:38,3534.225,Fox,402,78,20,14,10,17,13,4,402,382,368,314,153,134,43,35,205,197,47,148,129,0
19:23:39,3534.995,Fox,404,80,22,14,10,17,13,4,404,382,368,314,153,134,44,36,206,198,47,148,129,0
19:23:39,3537.276,Fox,404,80,20,16,10,17,13,4,404,384,368,314,153,134,44,36,206,198,47,148,129,0
19:23:40,3538.797,Fox,404,80,20,14,12,17,13,4,404,384,370,314,153,134,44,36,206,198,47,148,129,0
19:23:40,3539.244,Fox,404,80,20,12,14,17,13,4,404,384,372,314,153,134,44,36,206,198,47,148,129,0
19:23:40,3540.159,Fox,404,79,20,12,14,16,13,4,404,384,372,314,153,134,44,35,206,198,48,148,129,0
19:23:40,3540.621,Fox,404,79,20,10,16,16,13,4,404,384,374,314,153,134,44,35,206,198,48,148,129,0
19:23:41,3541.358,Fox,404,79,20,10,16,14,15,4,404,384,374,314,155,134,44,35,206,198,48,148,129,0
19:23:41,3542.926,Fox,404,79,20,8,18,14,15,4,404,384,376,314,155,134,44,35,206,198,48,148,129,0
19:23:42,3544.019,Fox,404,79,20,6,20,14,15,4,404,384,378,314,155,134,44,35,206,198,48,148,129,0
19:23:42,3545.036,Fox,404,79,20,6,20,14,14,5,404,384,378,314,155,135,44,35,206,198,48,148,129,0
19:23:42,3546.373,Fox,404,79,20,6,20,13,15,5,404,384,378,314,156,135,44,35,206,198,48,148,129,0
19:23:43,3547.024,Fox,404,79,20,4,22,13,15,5,404,384,380,314,156,135,44,35,206,198,48,148,129,0
19:23:45,3553.537,Fox,404,79,20,4,22,12,16,5,404,384,380,314,157,135,44,35,206,198,48,148,129,0
19:23:45,3554.379,Fox,406,81,18,6,22,12,16,5,404,386,380,314,157,135,45,36,207,199,48,148,129,0
19:23:45,3554.536,Fox,406,81,20,6,22,12,16,5,406,386,380,314,157,135,45,36,207,199,48,148,129,0
19:23:46,3556.313,Fox,406,80,20,6,22,12,16,4,406,386,380,314,157,135,45,35,207,199,48,148,130,0
19:23:46,3558.682,Fox,406,80,20,4,24,12,16,4,406,386,382,314,157,135,45,35,207,199,48,148,130,0
19:23:47,3559.678,Fox,406,80,20,4,22,14,16,4,406,386,382,316,157,135,45,35,207,199,48,148,130,0
19:23:48,3562.976,Fox,406,80,20,4,22,14,14,6,406,386,382,316,157,137,45,35,207,199,48,148,130,0
19:23:48,3564.029,Fox,408,82,22,4,22,14,14,6,408,386,382,316,157,137,45,37,207,201,48,148,130,0
19:23:49,3567.015,Fox,408,82,22,4,20,15,15,6,408,386,382,318,158,137,45,37,207,201,48,148,130,0
19:23:50,3569.027,Fox,408,82,20,6,20,15,15,6,408,388,382,318,158,137,45,37,207,201,48,148,130,0
19:23:51,3571.781,Fox,408,82,18,8,20,15,15,6,408,390,382,318,158,137,45,37,207,201,48,148,130,0
19:23:52,3574.425,Fox,412,84,22,8,18,15,15,6,412,390,382,318,158,137,45,39,209,203,50,148,130,0
19:23:52,3575.149,Fox,412,84,20,10,18,15,15,6,412,392,382,318,158,137,45,39,209,203,50,148,130,0
19:23:52,3575.957,Fox,414,86,20,8,20,15,15,6,412,392,384,318,158,137,47,39,211,203,50,148,130,0
19:23:52,3576.095,Fox,414,86,22,8,20,15,15,6,414,392,384,318,158,137,47,39,211,203,50,148,130,0
19:23:52,3576.66,Fox,416,88,20,10,20,15,15,6,414,394,384,318,158,137,48,40,212,204,50,148,130,0
19:23:52,3576.805,Fox,416,88,22,10,20,15,15,6,416,394,384,318,158,137,48,40,212,204,50,148,130,0
19:23:53,3577.509,Fox,416,86,22,10,20,13,15,6,416,394,384,318,158,137,46,40,212,204,52,148,130,0
19:23:53,3578.548,Fox,418,87,24,10,19,13,15,6,418,394,384,318,158,137,46,41,213,205,53,148,130,0
19:23:53,3579.306,Fox,420,88,26,10,18,13,15,6,420,394,384,318,158,137,46,42,214,206,54,148,130,0
19:23:53,3579.466,Fox,420,88,26,10,16,15,15,6,420,394,384,320,158,137,46,42,214,206,54,148,130,0
19:23:54,3579.917,Fox,420,88,26,10,16,14,16,6,420,394,384,320,159,137,46,42,214,206,54,148,130,0
19:23:54,3580.469,Fox,422,89,28,10,16,13,16,6,422,394,384,320,159,137,46,43,215,207,55,148,130,0
19:23:54,3581.103,Fox,422,89,26,12,14,15,16,6,422,396,384,322,159,137,46,43,215,207,55,148,130,0
19:23:54,3582.812,Fox,422,89,24,14,14,15,16,6,422,398,384,322,159,137,46,43,215,207,55,148,130,0
19:23:55,3584.42,Fox,422,89,24,14,14,13,18,6,422,398,384,322,161,137,46,43,215,207,55,148,130,0
19:23:55,3584.745,Fox,422,89,24,14,14,13,17,7,422,398,384,322,161,138,46,43,215,207,55,148,130,0
19:23:55,3585.199,Fox,424,91,26,14,14,13,17,7,424,398,384,322,161,138,47,44,216,208,55,148,130,0
19:23:55,3585.508,Fox,426,92,26,14,14,13,17,6,424,398,384,322,161,138,48,44,217,209,55,148,131,0
19:23:55,3585.687,Fox,426,92,28,14,14,13,17,6,426,398,384,322,161,138,48,44,217,209,55,148,131,0
19:23:56,3587.027,Fox,426,92,28,14,14,13,15,8,426,398,384,322,161,140,48,44,217,209,55,148,131,0
19:23:57,3590.015,Fox,426,91,26,16,12,12,17,8,426,400,384,324,163,140,48,43,217,209,55,149,131,0
19:23:58,3592.204,Fox,426,90,26,16,12,12,17,7,426,400,384,324,163,140,47,43,217,209,55,149,132,0
19:23:58,3592.773,Fox,426,90,26,14,14,12,17,7,426,400,386,324,163,140,47,43,217,209,55,149,132,0
19:23:58,3593.231,Fox,426,89,26,14,14,12,15,8,426,400,386,324,163,142,46,43,217,209,55,149,133,0
19:23:59,3594.96,Fox,426,89,26,14,14,10,17,8,426,400,386,324,165,142,46,43,217,209,55,149,133,0
19:24:00,3599.367,Fox,426,89,26,14,12,12,17,8,426,400,386,326,165,142,46,43,217,209,55,149,133,0
19:24:01,3601.161,Fox,426,89,26,14,11,13,17,8,426,400,386,327,165,142,46,43,217,209,55,149,133,0
19:24:01,3603.317,Fox,426,86,26,14,11,13,17,5,426,400,386,327,165,142,44,42,217,209,55,149,136,0
19:24:01,3603.496,Fox,426,86,26,14,10,14,17,5,426,400,386,328,165,142,44,42,217,209,55,149,136,0
19:24:02,3604.599,Fox,426,86,26,14,8,16,15,7,426,400,386,330,165,144,44,42,217,209,55,149,136,0
19:24:02,3605.918,Fox,426,86,26,14,8,14,17,7,426,400,386,330,167,144,44,42,217,209,55,149,136,0
19:24:02,3606.319,Fox,428,88,28,14,8,14,17,7,428,400,386,330,167,144,45,43,218,210,55,149,136,0
19:24:03,3607.677,Fox,428,88,28,12,8,15,18,7,428,400,388,332,168,144,45,43,218,210,55,149,136,0
19:24:03,3609.827,Fox,428,87,28,12,8,14,18,7,428,400,388,332,168,144,44,43,218,210,55,150,136,0
19:24:04,3610.143,Fox,428,86,28,10,10,13,18,7,428,400,390,332,168,144,43,43,218,210,55,151,136,0
19:24:04,3612.416,Fox,428,86,26,12,10,13,18,7,428,402,390,332,168,144,43,43,218,210,55,151,136,0
19:24:05,3613.709,Fox,428,86,26,10,12,13,18,7,428,402,392,332,168,144,43,43,218,210,55,151,136,0
19:24:05,3614.608,Fox,428,85,26,10,12,13,18,6,428,402,392,332,168,144,43,42,218,210,55,151,137,0
19:24:05,3615.042,Fox,428,84,26,8,14,12,18,6,428,402,394,332,168,144,42,42,218,210,56,151,137,0
19:24:06,3617.548,Fox,428,84,24,10,14,12,18,6,428,404,394,332,168,144,42,42,218,210,56,151,137,0
19:24:07,3619.238,Fox,428,84,24,10,12,14,18,6,428,404,394,334,168,144,42,42,218,210,56,151,137,0
19:24:07,3619.511,Fox,428,84,24,8,14,14,18,6,428,404,396,334,168,144,42,42,218,210,56,151,137,0
19:24:07,3621.316,Fox,428,84,24,6,16,14,18,6,428,404,398,334,168,144,42,42,218,210,56,151,137,0
19:24:08,3623.454,Fox,428,83,24,6,16,14,18,5,428,404,398,334,168,144,41,42,218,210,56,151,138,0
19:24:08,3624.714,Fox,430,85,26,6,16,14,18,5,430,404,398,334,168,144,42,43,219,211,56,151,138,0
19:24:09,3626.309,Fox,432,87,28,6,16,14,18,5,432,404,398,334,168,144,43,44,220,212,56,151,138,0
19:24:10,3628.472,Fox,432,87,28,4,18,14,18,5,432,404,400,334,168,144,43,44,220,212,56,151,138,0
19:24:10,3629.761,Fox,432,86,28,4,18,13,18,5,432,404,400,334,168,144,43,43,220,212,56,152,138,0
19:24:12,3636.321,Fox,432,86,28,4,16,15,18,5,432,404,400,336,168,144,43,43,220,212,56,152,138,0
19:24:13,3637.211,Fox,432,85,26,6,16,15,18,4,432,406,400,336,168,144,42,43,220,212,56,152,139,0
19:24:13,3638.171,Fox,434,87,28,6,16,15,18,4,434,406,400,336,168,144,43,44,221,213,56,152,139,0
19:24:13,3639.719,Fox,436,89,30,6,16,15,18,4,436,406,400,336,168,144,43,46,221,215,56,152,139,0
19:24:15,3645.215,Fox,438,91,32,6,16,15,18,4,438,406,400,336,168,144,44,47,222,216,56,152,139,0
19:24:16,3646.588,Fox,438,91,30,8,16,15,18,4,438,408,400,336,168,144,44,47,222,216,56,152,139,0
19:24:17,3649.938,Fox,440,93,32,8,16,15,18,4,440,408,400,336,168,144,46,47,224,216,56,152,139,0
19:24:17,3650.224,Fox,440,93,32,8,16,15,17,5,440,408,400,336,168,145,46,47,224,216,56,152,139,0
19:24:17,3650.507,Fox,440,92,32,8,16,15,16,5,440,408,400,336,168,145,46,46,224,216,56,153,139,0
19:24:17,3650.917,Fox,440,92,32,6,18,15,16,5,440,408,402,336,168,145,46,46,224,216,56,153,139,0
19:24:18,3653.177,Fox,440,92,32,6,16,15,18,5,440,408,402,338,170,145,46,46,224,216,56,153,139,0
19:24:19,3656.021,Fox,440,92,32,4,18,15,18,5,440,408,404,338,170,145,46,46,224,216,56,153,139,0
19:24:19,3656.942,Fox,440,92,28,8,18,15,18,5,440,412,404,338,170,145,46,46,224,216,56,153,139,0
19:24:19,3657.418,Fox,440,91,28,8,18,15,18,4,440,412,404,338,170,145,46,45,224,216,56,153,140,0
19:24:20,3657.947,Fox,442,93,30,8,18,15,18,4,442,412,404,338,170,145,47,46,225,217,56,153,140,0
19:24:20,3658.497,Fox,444,95,32,8,18,15,18,4,444,412,404,338,170,145,47,48,225,219,56,153,140,0
19:24:20,3658.65,Fox,444,95,30,10,18,15,18,4,444,414,404,338,170,145,47,48,225,219,56,153,140,0
19:24:20,3659.298,Fox,444,95,28,12,18,15,18,4,444,416,404,338,170,145,47,48,225,219,56,153,140,0
19:24:21,3661.062,Fox,444,95,26,14,18,15,18,4,444,418,404,338,170,145,47,48,225,219,56,153,140,0
19:24:21,3661.575,Fox,444,95,26,14,18,15,17,5,444,418,404,338,170,146,47,48,225,219,56,153,140,0
19:24:21,3661.835,Fox,444,95,24,16,18,15,17,5,444,420,404,338,170,146,47,48,225,219,56,153,140,0
19:24:21,3663.025,Fox,444,95,22,18,18,15,17,5,444,422,404,338,170,146,47,48,225,219,56,153,140,0
19:24:22,3665.15,Fox,444,94,22,18,18,15,17,4,444,422,404,338,170,146,46,48,225,219,56,153,141,0
19:24:22,3665.507,Fox,446,96,24,18,18,15,17,4,446,422,404,338,170,146,46,50,225,221,56,153,141,0
19:24:23,3667.718,Fox,446,96,22,20,18,15,17,4,446,424,404,338,170,146,46,50,225,221,56,153,141,0
19:24:23,3667.946,Fox,446,96,22,20,16,17,17,4,446,424,404,340,170,146,46,50,225,221,56,153,141,0
19:24:23,3668.174,Fox,446,96,20,22,16,17,17,4,446,426,404,340,170,146,46,50,225,221,56,153,141,0
19:24:24,3670.751,Fox,446,96,20,22,14,19,16,5,446,426,404,342,170,147,46,50,225,221,56,153,141,0
19:24:25,3674.232,Fox,446,96,20,22,12,21,16,5,446,426,404,344,170,147,46,50,225,221,56,153,141,0
19:24:25,3674.623,Fox,446,96,20,22,12,19,18,5,446,426,404,344,172,147,46,50,225,221,56,153,141,0
19:24:25,3674.917,Fox,446,95,20,22,12,19,18,4,446,426,404,344,172,147,45,50,225,221,56,153,142,0
19:24:25,3675.563,Fox,446,95,20,20,12,21,18,4,446,426,406,346,172,147,45,50,225,221,56,153,142,0
19:24:26,3678.543,Fox,446,93,20,20,12,19,18,4,446,426,406,346,172,147,44,49,225,221,56,155,142,0
19:24:26,3678.797,Fox,446,93,20,20,12,19,16,6,446,426,406,346,172,149,44,49,225,221,56,155,142,0
19:24:27,3680.005,Fox,446,93,20,20,10,21,16,6,446,426,406,348,172,149,44,49,225,221,56,155,142,0
19:24:27,3681.805,Fox,446,93,20,20,8,23,16,6,446,426,406,350,172,149,44,49,225,221,56,155,142,0
19:24:28,3683.297,Fox,446,93,20,20,8,21,18,6,446,426,406,350,174,149,44,49,225,221,56,155,142,0
19:24:28,3683.917,Fox,446,93,20,20,8,21,17,7,446,426,406,350,174,150,44,49,225,221,56,155,142,0
19:24:29,3685.026,Fox,446,93,20,18,10,21,17,7,446,426,408,350,174,150,44,49,225,221,56,155,142,0
19:24:29,3686.091,Fox,446,91,20,18,10,19,17,7,446,426,408,350,174,150,42,49,225,221,56,157,142,0
19:24:30,3689.065,Fox,446,91,18,20,8,21,17,7,446,428,408,352,174,150,42,49,225,221,56,157,142,0
19:24:30,3690.626,Fox,446,89,18,20,8,19,17,7,446,428,408,352,174,150,40,49,225,221,58,157,142,0
19:24:31,3691.041,Fox,446,89,18,20,8,19,16,8,446,428,408,352,174,151,40,49,225,221,58,157,142,0
19:24:31,3692.237,Fox,448,91,20,20,8,19,16,8,448,428,408,352,174,151,41,50,226,222,58,157,142,0
19:24:31,3692.364,Fox,448,89,20,20,8,17,16,8,448,428,408,352,174,151,41,48,226,222,60,157,142,0
19:24:31,3692.771,Fox,448,89,20,20,8,16,17,8,448,428,408,352,175,151,41,48,226,222,60,157,142,0
19:24:32,3694.584,Fox,448,89,20,20,8,15,18,8,448,428,408,352,176,151,41,48,226,222,60,157,142,0
19:24:32,3695.527,Fox,448,88,20,16,12,14,18,8,448,428,412,352,176,151,40,48,226,222,60,158,142,0
19:24:33,3697.187,Fox,448,88,20,14,14,13,19,8,448,428,414,352,177,151,40,48,226,222,60,158,142,0
19:24:33,3697.833,Fox,448,88,20,12,16,13,19,8,448,428,416,352,177,151,40,48,226,222,60,158,142,0
19:24:33,3698.113,Fox,448,88,20,12,16,12,20,8,448,428,416,352,178,151,40,48,226,222,60,158,142,0
19:24:33,3699.586,Fox,448,88,20,10,18,12,20,8,448,428,418,352,178,151,40,48,226,222,60,158,142,0
19:24:34,3700.335,Fox,448,88,20,8,20,12,20,8,448,428,420,352,178,151,40,48,226,222,60,158,142,0
19:24:34,3701.042,Fox,448,88,20,8,20,10,22,8,448,428,420,352,180,151,40,48,226,222,60,158,142,0
19:24:34,3701.512,Fox,448,88,20,6,22,10,22,8,448,428,422,352,180,151,40,48,226,222,60,158,142,0
19:24:35,3703.1,Fox,450,90,22,6,22,10,22,8,450,428,422,352,180,151,41,49,227,223,60,158,142,0
19:24:35,3703.371,Fox,452,92,24,6,22,10,22,8,452,428,422,352,180,151,43,49,229,223,60,158,142,0
19:24:35,3704.507,Fox,452,92,24,6,22,10,21,9,452,428,422,352,180,152,43,49,229,223,60,158,142,0
19:24:36,3706.176,Fox,452,92,24,4,24,10,21,9,452,428,424,352,180,152,43,49,229,223,60,158,142,0
19:24:36,3706.782,Fox,454,94,26,2,26,10,21,9,454,428,426,352,180,152,44,50,230,224,60,158,142,0
19:24:36,3707.286,Fox,454,94,24,4,26,10,21,9,454,430,426,352,180,152,44,50,230,224,60,158,142,0
19:24:37,3708.904,Fox,454,94,22,6,26,10,21,9,454,432,426,352,180,152,44,50,230,224,60,158,142,0
19:24:37,3710.93,Fox,454,93,22,6,26,10,21,8,454,432,426,352,180,152,44,49,230,224,60,158,143,0
19:24:37,3711.425,Fox,454,93,22,6,24,12,21,8,454,432,426,354,180,152,44,49,230,224,60,158,143,0
19:24:38,3712.641,Fox,454,93,22,6,24,11,22,8,454,432,426,354,181,152,44,49,230,224,60,158,143,0
19:24:38,3714.549,Fox,456,95,24,6,24,11,22,8,456,432,426,354,181,152,45,50,231,225,60,158,143,0
19:24:39,3715.97,Fox,458,97,26,6,24,11,22,8,458,432,426,354,181,152,47,50,233,225,60,158,143,0
19:24:39,3716.516,Fox,458,97,26,6,22,13,22,8,458,432,426,356,181,152,47,50,233,225,60,158,143,0
19:24:39,3717.411,Fox,458,97,26,6,22,13,21,9,458,432,426,356,181,153,47,50,233,225,60,158,143,0
19:24:40,3720.819,Fox,458,97,24,8,22,13,21,9,458,434,426,356,181,153,47,50,233,225,60,158,143,0
19:24:41,3721.945,Fox,458,95,24,8,22,11,19,11,458,434,426,356,181,155,47,48,233,225,60,160,143,0
19:24:41,3722.412,Fox,458,95,22,10,22,11,19,11,458,436,426,356,181,155,47,48,233,225,60,160,143,0
19:24:42,3724.664,Fox,458,94,22,10,22,11,19,10,458,436,426,356,181,155,47,47,233,225,60,160,144,0
19:24:42,3726.098,Fox,460,96,24,10,22,11,19,10,460,436,426,356,181,155,48,48,234,226,60,160,144,0
19:24:43,3727.091,Fox,460,94,24,10,22,9,19,10,460,436,426,356,181,155,47,47,234,226,60,162,144,0
19:24:43,3727.493,Fox,460,94,24,8,24,9,17,12,460,436,428,356,181,157,47,47,234,226,60,162,144,0
19:24:43,3727.761,Fox,460,94,22,10,24,9,17,12,460,438,428,356,181,157,47,47,234,226,60,162,144,0
19:24:43,3729.163,Fox,460,93,22,10,24,9,17,11,460,438,428,356,181,157,46,47,234,226,60,162,145,0
19:24:43,3729.827,Fox,460,93,22,10,24,7,19,11,460,438,428,356,183,157,46,47,234,226,60,162,145,0
19:24:44,3732.015,Fox,460,92,22,10,24,7,19,10,460,438,428,356,183,157,46,46,234,226,60,162,146,0
19:24:44,3732.475,Fox,460,92,20,12,24,7,17,12,460,440,428,356,183,159,46,46,234,226,60,162,146,0
19:24:45,3733.77,Fox,462,93,22,12,23,7,17,12,462,440,428,356,183,159,45,48,234,228,60,163,146,0
19:24:45,3734.061,Fox,464,95,24,12,23,7,17,12,464,440,428,356,183,159,47,48,236,228,60,163,146,0
19:24:45,3734.539,Fox,466,97,26,12,23,7,17,12,466,440,428,356,183,159,48,49,237,229,60,163,146,0
19:24:45,3735.015,Fox,468,98,28,12,22,7,17,12,468,440,428,356,183,159,48,50,238,230,61,163,146,0
19:24:46,3736.012,Fox,468,98,28,12,20,9,17,12,468,440,428,358,183,159,48,50,238,230,61,163,146,0
19:24:46,3736.784,Fox,470,100,30,12,20,9,17,12,470,440,428,358,183,159,49,51,239,231,61,163,146,0
19:24:46,3737.182,Fox,472,101,32,12,19,9,17,12,472,440,428,358,183,159,50,51,241,231,62,163,146,0
19:24:46,3738.314,Fox,474,103,34,12,19,9,17,12,474,440,428,358,183,159,51,52,242,232,62,163,146,0
19:24:47,3740.536,Fox,474,103,32,14,19,9,17,12,474,442,428,358,183,159,51,52,242,232,62,163,146,0
19:24:47,3741.156,Fox,476,104,32,16,18,9,17,12,476,444,428,358,183,159,51,53,243,233,62,164,146,0
19:24:48,3743.51,Fox,476,104,32,16,18,9,15,14,476,444,428,358,183,161,51,53,243,233,62,164,146,0
19:24:49,3745.703,Fox,476,104,32,14,18,11,15,14,476,444,430,360,183,161,51,53,243,233,62,164,146,0
19:24:49,3746.269,Fox,478,106,34,14,18,11,15,14,478,444,430,360,183,161,53,53,245,233,62,164,146,0
19:24:49,3746.677,Fox,478,105,34,14,18,8,17,14,478,444,430,360,185,161,52,53,245,233,62,165,146,0
19:24:49,3747.109,Fox,480,107,36,14,18,8,17,14,480,444,430,360,185,161,54,53,247,233,62,165,146,0
19:24:49,3747.409,Fox,480,107,36,12,20,8,17,14,480,444,432,360,185,161,54,53,247,233,62,165,146,0
19:24:50,3748.113,Fox,480,107,34,14,20,8,17,14,480,446,432,360,185,161,54,53,247,233,62,165,146,0
19:24:51,3751.106,Fox,482,109,36,14,20,8,17,14,482,446,432,360,185,161,55,54,248,234,62,165,146,0
19:24:52,3754.398,Fox,482,108,36,14,20,8,17,13,482,446,432,360,185,161,54,54,248,234,62,165,147,0
19:24:52,3755.993,Fox,482,108,36,14,17,11,17,13,482,446,432,363,185,161,54,54,248,234,62,165,147,0
19:24:53,3757.616,Fox,482,108,36,14,16,12,17,13,482,446,432,364,185,161,54,54,248,234,62,165,147,0
19:24:53,3758.311,Fox,482,108,36,14,15,13,17,13,482,446,432,365,185,161,54,54,248,234,62,165,147,0
19:24:53,3759.227,Fox,484,110,38,12,17,13,17,13,484,446,434,365,185,161,54,56,248,236,62,165,147,0
19:24:54,3760.03,Fox,484,110,38,12,15,15,17,13,484,446,434,367,185,161,54,56,248,236,62,165,147,0
19:24:54,3760.835,Fox,484,110,38,10,15,17,17,13,484,446,436,369,185,161,54,56,248,236,62,165,147,0
19:24:54,3762.004,Fox,484,110,38,10,13,19,17,13,484,446,436,371,185,161,54,56,248,236,62,165,147,0
19:24:55,3764.236,Fox,484,110,38,10,13,17,19,13,484,446,436,371,187,161,54,56,248,236,62,165,147,0
19:24:56,3766.201,Fox,484,110,38,8,15,17,19,13,484,446,438,371,187,161,54,56,248,236,62,165,147,0
19:24:56,3766.688,Fox,484,107,38,8,14,15,19,13,484,446,438,372,187,161,53,54,248,236,63,167,147,0
19:24:56,3767.268,Fox,484,107,38,8,12,17,19,13,484,446,438,374,187,161,53,54,248,236,63,167,147,0
19:24:56,3767.669,Fox,484,107,38,8,12,15,21,13,484,446,438,374,189,161,53,54,248,236,63,167,147,0
19:24:57,3768.893,Fox,484,106,38,8,12,14,21,13,484,446,438,374,189,161,53,53,248,236,64,167,147,0
19:24:57,3770.128,Fox,486,107,40,8,11,14,21,13,486,446,438,374,189,161,53,54,249,237,64,168,147,0
19:24:57,3771.04,Fox,486,107,40,6,13,14,21,13,486,446,440,374,189,161,53,54,249,237,64,168,147,0
19:24:58,3772.665,Fox,486,106,40,6,13,14,21,12,486,446,440,374,189,161,53,53,249,237,64,168,148,0
19:24:58,3773.704,Fox,486,104,40,6,13,14,21,10,486,446,440,374,189,161,53,51,249,237,64,168,150,0
19:24:59,3774.857,Fox,486,104,38,8,13,14,21,10,486,448,440,374,189,161,53,51,249,237,64,168,150,0
19:24:59,3776.873,Fox,488,106,40,8,13,14,21,10,488,448,440,374,189,161,55,51,251,237,64,168,150,0
19:24:59,3777.339,Fox,488,105,40,8,13,13,21,10,488,448,440,374,189,161,55,50,251,237,64,169,150,0
19:25:00,3779.056,Fox,488,105,40,6,15,13,21,10,488,448,442,374,189,161,55,50,251,237,64,169,150,0
19:25:00,3779.594,Fox,488,105,40,4,17,13,21,10,488,448,444,374,189,161,55,50,251,237,64,169,150,0
19:25:01,3781.317,Fox,488,104,40,4,17,13,21,9,488,448,444,374,189,161,55,49,251,237,64,169,151,0
19:25:01,3782.564,Fox,488,104,40,4,17,12,22,9,488,448,444,374,190,161,55,49,251,237,64,169,151,0
19:25:01,3783.034,Fox,490,106,42,4,17,12,22,9,490,448,444,374,190,161,57,49,253,237,64,169,151,0
19:25:02,3785.641,Fox,490,105,40,6,17,11,22,9,490,450,444,374,190,161,56,49,253,237,64,170,151,0
19:25:02,3785.923,Fox,492,106,40,8,16,11,22,9,492,452,444,374,190,161,56,50,254,238,64,171,151,0
19:25:02,3786.532,Fox,492,106,40,6,18,11,22,9,492,452,446,374,190,161,56,50,254,238,64,171,151,0
19:25:03,3787.901,Fox,492,106,40,6,17,12,22,9,492,452,446,375,190,161,56,50,254,238,64,171,151,0
19:25:03,3789.665,Fox,492,105,38,8,17,12,22,8,492,454,446,375,190,161,56,49,254,238,64,171,152,0
19:25:04,3790.516,Fox,494,106,40,8,17,12,21,8,494,454,446,375,190,161,57,49,256,238,64,172,152,0
19:25:04,3790.668,Fox,494,106,40,8,17,12,19,10,494,454,446,375,190,163,57,49,256,238,64,172,152,0
19:25:06,3795.879,Fox,496,108,42,8,17,12,19,10,496,454,446,375,190,163,58,50,257,239,64,172,152,0
19:25:06,3797.094,Fox,498,109,42,10,16,12,19,10,498,456,446,375,190,163,58,51,258,240,64,173,152,0
19:25:06,3798.549,Fox,498,108,40,12,16,11,19,10,498,458,446,375,190,163,58,50,258,240,64,174,152,0
19:25:07,3801.149,Fox,500,109,42,12,15,11,19,10,500,458,446,375,190,163,59,50,260,240,64,175,152,0
19:25:08,3804.735,Fox,500,108,42,12,15,11,19,9,500,458,446,375,190,163,58,50,260,240,64,175,153,0
19:25:09,3806.273,Fox,500,108,42,12,13,13,19,9,500,458,446,377,190,163,58,50,260,240,64,175,153,0
19:25:09,3807.815,Fox,500,108,42,12,12,14,19,9,500,458,446,378,190,163,58,50,260,240,64,175,153,0
19:25:10,3808.193,Fox,502,107,44,12,12,14,19,6,502,458,446,378,190,163,59,48,261,241,64,175,156,0
19:25:10,3808.619,Fox,502,107,42,14,12,14,19,6,502,460,446,378,190,163,59,48,261,241,64,175,156,0
19:25:11,3811.678,Fox,502,106,42,14,12,14,19,5,502,460,446,378,190,163,58,48,261,241,64,175,157,0
19:25:11,3812.075,Fox,502,106,42,14,12,14,17,7,502,460,446,378,190,165,58,48,261,241,64,175,157,0
19:25:11,3813.283,Fox,502,106,42,12,14,14,17,7,502,460,448,378,190,165,58,48,261,241,64,175,157,0
19:25:12,3816.339,Fox,502,106,40,14,14,14,17,7,502,462,448,378,190,165,58,48,261,241,64,175,157,0
19:25:12,3816.571,Fox,502,106,38,16,14,14,17,7,502,464,448,378,190,165,58,48,261,241,64,175,157,0
19:25:13,3817.105,Fox,504,107,38,18,13,14,17,7,504,466,448,378,190,165,57,50,261,243,64,176,157,0
19:25:13,3817.509,Fox,504,107,36,20,13,14,17,7,504,468,448,378,190,165,57,50,261,243,64,176,157,0
19:25:13,3818.48,Fox,504,106,36,20,13,13,17,7,504,468,448,378,190,165,57,49,261,243,64,177,157,0
19:25:13,3819.31,Fox,504,106,34,22,13,13,17,7,504,470,448,378,190,165,57,49,261,243,64,177,157,0
19:25:13,3819.786,Fox,504,106,32,24,12,14,17,7,504,472,448,379,190,165,57,49,261,243,64,177,157,0
19:25:14,3820.914,Fox,504,105,30,26,12,14,15,8,504,474,448,379,190,167,56,49,261,243,64,177,158,0
19:25:14,3821.382,Fox,504,105,30,26,10,16,15,8,504,474,448,381,190,167,56,49,261,243,64,177,158,0
19:25:14,3822.663,Fox,506,106,32,26,10,16,15,7,506,474,448,381,190,167,57,49,262,244,64,177,159,0
19:25:15,3822.966,Fox,506,105,32,26,10,16,15,6,506,474,448,381,190,167,57,48,262,244,64,177,160,0
19:25:15,3823.697,Fox,506,105,30,28,10,16,15,6,506,476,448,381,190,167,57,48,262,244,64,177,160,0
19:25:15,3824.158,Fox,508,107,32,26,12,16,15,6,508,476,450,381,190,167,57,50,262,246,64,177,160,0
19:25:15,3824.475,Fox,508,107,32,24,14,16,15,6,508,476,452,381,190,167,57,50,262,246,64,177,160,0
19:25:16,3826.737,Fox,508,107,32,24,13,17,15,6,508,476,452,382,190,167,57,50,262,246,64,177,160,0
19:25:16,3827.935,Fox,508,107,32,22,15,17,15,6,508,476,454,382,190,167,57,50,262,246,64,177,160,0
19:25:17,3828.91,Fox,508,107,30,24,15,17,15,6,508,478,454,382,190,167,57,50,262,246,64,177,160,0
19:25:17,3829.698,Fox,508,107,28,26,15,16,16,6,508,480,454,382,191,167,57,50,262,246,64,177,160,0
19:25:17,3830.302,Fox,508,106,28,26,15,15,15,7,508,480,454,382,191,168,57,49,262,246,65,177,160,0
19:25:17,3831.603,Fox,508,106,28,26,13,17,15,7,508,480,454,384,191,168,57,49,262,246,65,177,160,0
19:25:18,3831.898,Fox,508,104,28,26,13,15,15,7,508,480,454,384,191,168,57,47,262,246,65,179,160,0
19:25:18,3832.168,Fox,508,104,28,26,13,15,14,8,508,480,454,384,191,169,57,47,262,246,65,179,160,0
19:25:18,3832.897,Fox,510,104,30,26,13,14,14,7,510,480,454,384,191,169,56,48,263,247,65,180,161,0
19:25:18,3833.722,Fox,510,104,28,28,13,14,14,7,510,482,454,384,191,169,56,48,263,247,65,180,161,0
19:25:18,3834.622,Fox,510,104,28,28,13,14,13,8,510,482,454,384,191,170,56,48,263,247,65,180,161,0
19:25:19,3835.716,Fox,510,104,28,26,15,14,12,9,510,482,456,384,191,171,56,48,263,247,65,180,161,0
19:25:19,3836.986,Fox,510,104,28,24,17,14,12,9,510,482,458,384,191,171,56,48,263,247,65,180,161,0
19:25:20,3838.562,Fox,510,104,28,24,17,14,11,10,510,482,458,384,191,172,56,48,263,247,65,180,161,0
19:25:20,3839.102,Fox,510,104,28,24,17,12,13,10,510,482,458,384,193,172,56,48,263,247,65,180,161,0
19:25:20,3839.48,Fox,510,104,28,24,16,13,13,10,510,482,458,385,193,172,56,48,263,247,65,180,161,0
19:25:20,3840.07,Fox,510,104,28,24,14,15,13,10,510,482,458,387,193,172,56,48,263,247,65,180,161,0
19:25:21,3841.849,Fox,510,104,26,26,14,15,13,10,510,484,458,387,193,172,56,48,263,247,65,180,161,0
19:25:21,3842.258,Fox,510,101,26,26,14,13,13,9,510,484,458,387,193,172,53,48,263,247,65,182,162,0
19:25:23,3847.206,Fox,510,101,26,24,14,15,13,9,510,484,460,389,193,172,53,48,263,247,65,182,162,0
19:25:24,3850.249,Fox,510,100,26,24,14,14,12,10,510,484,460,389,193,173,53,47,263,247,65,183,162,0
19:25:24,3850.563,Fox,510,98,26,24,14,12,12,10,510,484,460,389,193,173,53,45,263,247,67,183,162,0
19:25:24,3851.164,Fox,512,99,28,24,13,11,13,10,512,484,460,389,194,173,53,46,264,248,67,184,162,0
19:25:24,3851.852,Fox,512,98,28,24,13,10,13,10,512,484,460,389,194,173,53,45,264,248,67,185,162,0
19:25:24,3852.732,Fox,512,98,26,26,13,10,13,10,512,486,460,389,194,173,53,45,264,248,67,185,162,0
19:25:25,3853.627,Fox,512,98,26,26,13,8,15,10,512,486,460,389,196,173,53,45,264,248,67,185,162,0
19:25:25,3854.368,Fox,512,98,26,26,13,7,16,10,512,486,460,389,197,173,53,45,264,248,67,185,162,0
19:25:25,3854.804,Fox,512,98,26,24,15,7,16,10,512,486,462,389,197,173,53,45,264,248,67,185,162,0
19:25:25,3855.063,Fox,512,98,26,22,17,7,16,10,512,486,464,389,197,173,53,45,264,248,67,185,162,0
19:25:25,3855.543,Fox,512,98,26,20,19,6,17,10,512,486,466,389,198,173,53,45,264,248,67,185,162,0
19:25:26,3856.012,Fox,512,98,26,18,21,6,17,10,512,486,468,389,198,173,53,45,264,248,67,185,162,0
19:25:26,3857.46,Fox,514,100,28,18,21,6,17,10,514,486,468,389,198,173,54,46,265,249,67,185,162,0
19:25:26,3857.88,Fox,514,100,28,16,23,6,17,10,514,486,470,389,198,173,54,46,265,249,67,185,162,0
19:25:26,3858.294,Fox,514,100,28,14,25,6,17,10,514,486,472,389,198,173,54,46,265,249,67,185,162,0
19:25:27,3859.15,Fox,516,101,30,14,24,6,17,10,516,486,472,389,198,173,55,46,267,249,67,186,162,0
19:25:27,3859.39,Fox,516,101,28,14,26,6,17,10,516,488,474,389,198,173,55,46,267,249,67,186,162,0
19:25:27,3860.355,Fox,516,100,28,14,26,6,16,10,516,488,474,389,198,173,55,45,267,249,67,187,162,0
19:25:27,3860.761,Fox,516,100,28,14,26,5,17,10,516,488,474,389,199,173,55,45,267,249,67,187,162,0
19:25:28,3862.19,Fox,516,100,28,12,28,5,17,10,516,488,476,389,199,173,55,45,267,249,67,187,162,0
19:25:28,3862.462,Fox,516,99,28,12,28,5,17,9,516,488,476,389,199,173,55,44,267,249,67,187,163,0
19:25:28,3863.543,Fox,518,100,30,12,27,5,17,9,518,488,476,389,199,173,55,45,268,250,67,188,163,0
19:25:29,3865.565,Fox,518,100,28,14,27,5,17,9,518,490,476,389,199,173,55,45,268,250,67,188,163,0
19:25:29,3866.152,Fox,520,102,30,14,27,5,17,9,520,490,476,389,199,173,55,47,268,252,67,188,163,0
19:25:29,3867.334,Fox,520,102,30,12,29,5,15,11,520,490,478,389,199,175,55,47,268,252,67,188,163,0
19:25:30,3868.19,Fox,520,102,30,10,31,5,15,11,520,490,480,389,199,175,55,47,268,252,67,188,163,0
19:25:30,3868.444,Fox,520,102,28,12,31,5,15,11,520,492,480,389,199,175,55,47,268,252,67,188,163,0
19:25:31,3871.515,Fox,522,102,28,12,31,5,15,9,520,492,480,389,199,175,55,47,269,253,67,188,165,0
19:25:31,3871.662,Fox,522,102,30,12,31,5,15,9,522,492,480,389,199,175,55,47,269,253,67,188,165,0
19:25:31,3872.195,Fox,522,102,30,10,33,5,15,9,522,492,482,389,199,175,55,47,269,253,67,188,165,0
19:25:31,3873.128,Fox,522,102,28,12,33,5,15,9,522,494,482,389,199,175,55,47,269,253,67,188,165,0
19:25:31,3873.753,Fox,522,102,28,12,32,6,15,9,522,494,482,390,199,175,55,47,269,253,67,188,165,0
19:25:33,3878.459,Fox,522,102,26,14,32,6,15,9,522,496,482,390,199,175,55,47,269,253,67,188,165,0
19:25:33,3878.707,Fox,522,101,26,14,32,6,15,8,522,496,482,390,199,175,55,46,269,253,67,188,166,0
19:25:33,3879.609,Fox,522,101,24,16,32,6,15,8,522,498,482,390,199,175,55,46,269,253,67,188,166,0
19:25:34,3880.266,Fox,522,101,24,14,34,6,15,8,522,498,484,390,199,175,55,46,269,253,67,188,166,0
19:25:35,3883.753,Fox,522,101,22,16,34,6,15,8,522,500,484,390,199,175,55,46,269,253,67,188,166,0
19:25:35,3884.407,Fox,524,101,24,16,33,5,13,10,524,500,484,390,199,177,54,47,269,255,67,190,166,0
19:25:35,3884.701,Fox,524,101,24,16,32,6,13,10,524,500,484,391,199,177,54,47,269,255,67,190,166,0
19:25:35,3884.967,Fox,524,101,24,16,30,8,13,10,524,500,484,393,199,177,54,47,269,255,67,190,166,0
19:25:36,3887.266,Fox,524,100,24,16,30,8,13,9,524,500,484,393,199,177,53,47,269,255,67,190,167,0
19:25:36,3888.428,Fox,524,100,24,16,29,9,13,9,524,500,484,394,199,177,53,47,269,255,67,190,167,0
19:25:37,3890.83,Fox,524,100,22,18,29,9,13,9,524,502,484,394,199,177,53,47,269,255,67,190,167,0
19:25:37,3891.248,Fox,524,100,22,16,31,9,13,9,524,502,486,394,199,177,53,47,269,255,67,190,167,0
19:25:37,3891.647,Fox,526,102,24,16,31,9,13,9,526,502,486,394,199,177,53,49,269,257,67,190,167,0
19:25:38,3891.959,Fox,528,103,26,16,30,9,13,9,528,502,486,394,199,177,53,50,270,258,67,191,167,0
19:25:38,3894.566,Fox,530,103,26,16,29,9,13,8,528,502,486,394,199,177,52,51,270,260,67,192,168,0
19:25:38,3894.741,Fox,530,103,28,16,29,9,13,8,530,502,486,394,199,177,52,51,270,260,67,192,168,0
19:25:39,3895.188,Fox,530,102,28,16,29,8,13,8,530,502,486,394,199,177,52,50,270,260,67,193,168,0
19:25:39,3895.472,Fox,530,101,28,16,29,7,13,8,530,502,486,394,199,177,51,50,270,260,67,194,168,0
19:25:39,3896.108,Fox,530,101,28,16,27,9,13,8,530,502,486,396,199,177,51,50,270,260,67,194,168,0
19:25:39,3897.359,Fox,532,102,30,16,26,9,13,8,532,502,486,396,199,177,51,51,271,261,68,194,168,0
19:25:39,3897.511,Fox,532,102,30,16,25,10,13,8,532,502,486,397,199,177,51,51,271,261,68,194,168,0
19:25:40,3897.94,Fox,532,102,30,14,27,10,13,8,532,502,488,397,199,177,51,51,271,261,68,194,168,0
19:25:40,3899.679,Fox,532,101,28,16,27,9,13,8,532,504,488,397,199,177,50,51,271,261,68,195,168,0
19:25:40,3899.986,Fox,534,102,28,16,26,7,15,8,532,504,488,397,201,177,50,52,272,262,68,196,168,0
19:25:40,3900.154,Fox,534,102,30,16,26,7,15,8,534,504,488,397,201,177,50,52,272,262,68,196,168,0
19:25:41,3901.698,Fox,534,102,30,16,26,7,13,10,534,504,488,397,201,179,50,52,272,262,68,196,168,0
19:25:42,3904.033,Fox,534,102,30,14,28,7,13,10,534,504,490,397,201,179,50,52,272,262,68,196,168,0
19:25:42,3905.295,Fox,534,102,28,16,28,7,11,12,534,506,490,397,201,181,50,52,272,262,68,196,168,0
19:25:42,3906.788,Fox,534,101,26,18,28,6,11,12,534,508,490,397,201,181,50,51,272,262,68,197,168,0
19:25:43,3906.945,Fox,534,101,26,16,30,6,11,12,534,508,492,397,201,181,50,51,272,262,68,197,168,0
19:25:43,3907.634,Fox,534,101,26,16,29,7,11,12,534,508,492,398,201,181,50,51,272,262,68,197,168,0
19:25:43,3908.056,Fox,534,100,26,16,29,6,11,12,534,508,492,398,201,181,49,51,272,262,68,198,168,0
19:25:44,3910.896,Fox,534,99,26,16,29,6,11,11,534,508,492,398,201,181,48,51,272,262,68,198,169,0
19:25:44,3911.5,Fox,534,99,26,14,31,6,11,11,534,508,494,398,201,181,48,51,272,262,68,198,169,0
19:25:45,3914.073,Fox,536,101,28,14,31,6,11,11,536,508,494,398,201,181,48,53,272,264,68,198,169,0
19:25:45,3914.515,Fox,536,100,28,14,31,6,11,10,536,508,494,398,201,181,48,52,272,264,68,198,170,0
19:25:45,3915.496,Fox,536,100,26,16,29,8,11,10,536,510,494,400,201,181,48,52,272,264,68,198,170,0
19:25:45,3915.773,Fox,538,102,28,16,27,10,11,10,538,510,494,402,201,181,48,54,272,266,68,198,170,0
19:25:46,3916.077,Fox,538,102,28,16,25,12,11,10,538,510,494,404,201,181,48,54,272,266,68,198,170,0
19:25:46,3916.526,Fox,538,102,28,16,24,13,11,10,538,510,494,405,201,181,48,54,272,266,68,198,170,0
19:25:46,3916.959,Fox,538,102,28,14,26,13,11,10,538,510,496,405,201,181,48,54,272,266,68,198,170,0
19:25:46,3918.358,Fox,538,101,28,12,27,13,11,10,538,510,498,406,201,181,48,53,272,266,68,199,170,0
19:25:46,3918.786,Fox,538,101,28,12,25,15,11,10,538,510,498,408,201,181,48,53,272,266,68,199,170,0
19:25:47,3919.99,Fox,538,101,28,12,23,17,10,11,538,510,498,410,201,182,48,53,272,266,68,199,170,0
19:25:47,3920.273,Fox,538,101,28,12,23,16,11,11,538,510,498,410,202,182,48,53,272,266,68,199,170,0
19:25:47,3920.885,Fox,538,100,28,12,23,16,11,10,538,510,498,410,202,182,47,53,272,266,68,199,171,0
19:25:48,3922.156,Fox,538,100,28,10,25,16,11,10,538,510,500,410,202,182,47,53,272,266,68,199,171,0
19:25:48,3922.833,Fox,540,102,28,10,24,17,11,10,538,510,500,411,202,182,48,54,273,267,68,199,171,0
19:25:48,3923.003,Fox,540,102,30,10,24,17,11,10,540,510,500,411,202,182,48,54,273,267,68,199,171,0
19:25:49,3925.838,Fox,540,101,30,10,24,16,11,10,540,510,500,411,202,182,48,53,273,267,68,200,171,0
19:25:49,3926.136,Fox,540,100,30,10,24,16,11,9,540,510,500,411,202,182,48,52,273,267,68,200,172,0
19:25:49,3927.104,Fox,540,99,30,10,24,15,11,9,540,510,500,411,202,182,48,51,273,267,68,201,172,0
19:25:49,3927.857,Fox,540,99,30,10,22,17,11,9,540,510,500,413,202,182,48,51,273,267,68,201,172,0
19:25:50,3928.798,Fox,542,100,30,10,19,19,11,9,540,510,500,415,202,182,47,53,273,269,68,202,172,0
19:25:50,3928.948,Fox,542,100,32,10,19,19,11,9,542,510,500,415,202,182,47,53,273,269,68,202,172,0
19:25:50,3929.249,Fox,542,98,32,8,21,17,11,9,542,510,502,415,202,182,45,53,273,269,68,204,172,0
19:25:50,3930.463,Fox,542,96,32,8,21,15,11,9,542,510,502,415,202,182,44,52,273,269,68,206,172,0
19:25:51,3932.611,Fox,542,96,32,8,19,17,11,9,542,510,502,417,202,182,44,52,273,269,68,206,172,0
19:25:51,3933.343,Fox,542,95,32,8,19,16,11,9,542,510,502,417,202,182,44,51,273,269,68,207,172,0
19:25:51,3933.82,Fox,542,95,30,10,19,16,11,9,542,512,502,417,202,182,44,51,273,269,68,207,172,0
19:25:53,3938.233,Fox,542,95,30,8,21,16,11,9,542,512,504,417,202,182,44,51,273,269,68,207,172,0
19:25:53,3939.253,Fox,542,93,30,8,21,14,11,9,542,512,504,417,202,182,42,51,273,269,68,209,172,0
19:25:53,3939.729,Fox,544,95,32,8,21,14,11,9,544,512,504,417,202,182,43,52,274,270,68,209,172,0
19:25:54,3940.057,Fox,544,95,30,10,21,14,11,9,544,514,504,417,202,182,43,52,274,270,68,209,172,0
19:25:54,3940.716,Fox,546,97,32,10,21,12,13,9,546,514,504,417,204,182,44,53,275,271,68,209,172,0
19:25:54,3940.87,Fox,546,97,32,10,19,14,13,9,546,514,504,419,204,182,44,53,275,271,68,209,172,0
19:25:54,3941.348,Fox,548,98,34,10,18,14,13,9,548,514,504,419,204,182,45,53,277,271,68,210,172,0
19:25:54,3941.869,Fox,548,97,32,12,18,14,13,8,548,516,504,419,204,182,44,53,277,271,68,210,173,0
19:25:54,3942.184,Fox,548,96,32,12,18,14,13,7,548,516,504,419,204,182,44,52,277,271,68,210,174,0
19:25:55,3943.801,Fox,548,95,32,10,20,13,13,7,548,516,506,419,204,182,43,52,277,271,68,211,174,0
19:25:55,3945.216,Fox,548,95,32,8,22,13,13,7,548,516,508,419,204,182,43,52,277,271,68,211,174,0
19:25:56,3946.097,Fox,548,95,30,10,22,13,13,7,548,518,508,419,204,182,43,52,277,271,68,211,174,0
19:25:56,3947.32,Fox,550,96,32,10,21,13,13,7,550,518,508,419,204,182,42,54,277,273,68,212,174,0
19:25:56,3947.716,Fox,550,95,32,10,21,13,13,6,550,518,508,419,204,182,41,54,277,273,68,212,175,0
19:25:57,3948.854,Fox,552,97,32,12,21,13,13,6,552,520,508,419,204,182,43,54,279,273,68,212,175,0
19:25:57,3951.382,Fox,554,97,34,12,21,11,13,6,554,520,508,419,204,182,44,53,280,274,68,214,175,0
19:25:57,3951.681,Fox,554,97,34,12,20,12,13,6,554,520,508,420,204,182,44,53,280,274,68,214,175,0
19:25:58,3954.007,Fox,554,97,34,10,22,12,13,6,554,520,510,420,204,182,44,53,280,274,68,214,175,0
19:25:58,3954.294,Fox,554,97,32,12,22,12,13,6,554,522,510,420,204,182,44,53,280,274,68,214,175,0
19:25:59,3955.631,Fox,556,96,34,12,21,12,13,4,556,522,510,420,204,182,42,54,281,275,68,215,177,0
19:26:00,3958.45,Fox,556,96,34,12,19,14,13,4,556,522,510,422,204,182,42,54,281,275,68,215,177,0
19:26:01,3962.294,Fox,556,95,34,12,19,13,13,4,556,522,510,422,204,182,42,53,281,275,68,216,177,0
19:26:02,3965.304,Fox,558,96,36,12,18,13,13,4,558,522,510,422,204,182,43,53,283,275,69,216,177,0
19:26:03,3967.033,Fox,558,96,34,14,18,13,12,5,558,524,510,422,204,183,43,53,283,275,69,216,177,0
19:26:03,3967.503,Fox,558,96,34,14,17,14,12,5,558,524,510,423,204,183,43,53,283,275,69,216,177,0
19:26:03,3969.053,Fox,558,95,34,14,17,13,12,5,558,524,510,423,204,183,42,53,283,275,69,217,177,0
19:26:04,3971.989,Fox,558,95,34,14,15,15,12,5,558,524,510,425,204,183,42,53,283,275,69,217,177,0
19:26:04,3972.259,Fox,558,95,34,12,17,15,12,5,558,524,512,425,204,183,42,53,283,275,69,217,177,0
19:26:05,3973.073,Fox,558,94,34,12,17,15,12,4,558,524,512,425,204,183,41,53,283,275,69,217,178,0
19:26:05,3974.194,Fox,558,94,32,14,17,15,12,4,558,526,512,425,204,183,41,53,283,275,69,217,178,0
19:26:05,3974.455,Fox,558,94,30,16,17,15,12,4,558,528,512,425,204,183,41,53,283,275,69,217,178,0
19:26:05,3975.396,Fox,560,95,32,16,16,15,12,4,560,528,512,425,204,183,41,54,284,276,69,218,178,0
19:26:06,3976.566,Fox,560,95,32,16,16,15,10,6,560,528,512,425,204,185,41,54,284,276,69,218,178,0
19:26:06,3977.363,Fox,560,95,30,18,14,17,10,6,560,530,512,427,204,185,41,54,284,276,69,218,178,0
19:26:06,3978.061,Fox,560,94,30,18,14,16,10,6,560,530,512,427,204,185,41,53,284,276,69,219,178,0
19:26:06,3978.601,Fox,560,94,30,16,15,17,10,6,560,530,514,428,204,185,41,53,284,276,69,219,178,0
19:26:07,3979.587,Fox,562,96,32,16,15,17,10,6,562,530,514,428,204,185,42,54,285,277,69,219,178,0
19:26:07,3979.908,Fox,562,96,30,18,15,17,10,6,562,532,514,428,204,185,42,54,285,277,69,219,178,0
19:26:07,3980.175,Fox,562,96,30,16,17,17,10,6,562,532,516,428,204,185,42,54,285,277,69,219,178,0
19:26:08,3981.833,Fox,564,98,32,16,17,16,11,6,564,532,516,428,205,185,44,54,287,277,69,219,178,0
19:26:08,3982.405,Fox,566,100,34,16,17,16,11,6,566,532,516,428,205,185,46,54,289,277,69,219,178,0
19:26:08,3982.708,Fox,566,99,32,18,15,17,11,6,566,534,516,430,205,185,45,54,289,277,69,220,178,0
19:26:08,3984.087,Fox,568,100,34,18,14,17,11,6,568,534,516,430,205,185,44,56,289,279,69,221,178,0
19:26:08,3984.6,Fox,568,100,34,16,16,17,11,6,568,534,518,430,205,185,44,56,289,279,69,221,178,0
19:26:09,3987.417,Fox,568,100,34,14,18,17,11,6,568,534,520,430,205,185,44,56,289,279,69,221,178,0
19:26:10,3988.052,Fox,568,98,34,14,18,15,11,6,568,534,520,430,205,185,43,55,289,279,69,223,178,0
19:26:10,3988.686,Fox,568,97,34,14,18,14,10,7,568,534,520,430,205,186,42,55,289,279,69,224,178,0
19:26:10,3988.99,Fox,570,99,36,14,18,14,10,7,570,534,520,430,205,186,43,56,290,280,69,224,178,0
19:26:10,3989.728,Fox,570,99,36,14,17,15,10,7,570,534,520,431,205,186,43,56,290,280,69,224,178,0
19:26:11,3991.096,Fox,570,99,36,14,17,15,8,9,570,534,520,431,205,188,43,56,290,280,69,224,178,0
19:26:11,3991.683,Fox,572,101,38,14,17,15,8,9,572,534,520,431,205,188,43,58,290,282,69,224,178,0
19:26:11,3991.999,Fox,574,102,38,14,16,15,7,10,572,534,520,431,205,189,43,59,291,283,69,225,178,0
19:26:11,3992.168,Fox,574,102,40,14,16,15,7,10,574,534,520,431,205,189,43,59,291,283,69,225,178,0
19:26:11,3992.812,Fox,574,102,40,12,18,15,7,10,574,534,522,431,205,189,43,59,291,283,69,225,178,0
19:26:12,3995.933,Fox,574,101,40,12,18,15,7,9,574,534,522,431,205,189,42,59,291,283,69,225,179,0
19:26:12,3996.642,Fox,574,101,38,14,18,15,7,9,574,536,522,431,205,189,42,59,291,283,69,225,179,0
19:26:13,3998.38,Fox,574,101,36,16,18,15,6,10,574,538,522,431,205,190,42,59,291,283,69,225,179,0
19:26:13,3998.652,Fox,574,101,36,16,16,17,6,10,574,538,522,433,205,190,42,59,291,283,69,225,179,0
19:26:14,4000.293,Fox,574,100,36,16,16,16,6,10,574,538,522,433,205,190,42,58,291,283,69,226,179,0
19:26:15,4004.38,Fox,574,100,36,16,15,17,6,10,574,538,522,434,205,190,42,58,291,283,69,226,179,0
19:26:15,4005.776,Fox,574,100,34,16,15,19,6,10,574,540,524,436,205,190,42,58,291,283,69,226,179,0
19:26:17,4009.165,Fox,576,100,34,16,15,15,8,10,574,540,524,436,207,190,42,58,291,285,69,228,179,0
19:26:17,4009.699,Fox,576,100,36,16,15,13,10,10,576,540,524,436,209,190,42,58,291,285,69,228,179,0
19:26:17,4010.46,Fox,576,99,36,16,15,13,10,9,576,540,524,436,209,190,42,57,291,285,69,228,180,0
19:26:18,4011.923,Fox,576,99,34,18,15,12,11,9,576,542,524,436,210,190,42,57,291,285,69,228,180,0
19:26:18,4012.993,Fox,576,98,34,14,19,12,11,8,576,542,528,436,210,190,41,57,291,285,69,228,181,0
19:26:18,4014.529,Fox,576,98,34,14,18,13,11,8,576,542,528,437,210,190,41,57,291,285,69,228,181,0
19:26:19,4014.854,Fox,576,97,34,14,18,12,11,8,576,542,528,437,210,190,41,56,291,285,69,229,181,0
19:26:19,4015.73,Fox,576,97,34,12,20,12,11,8,576,542,530,437,210,190,41,56,291,285,69,229,181,0
19:26:19,4016.707,Fox,576,96,34,12,20,12,11,7,576,542,530,437,210,190,41,55,291,285,69,229,182,0
19:26:20,4018.218,Fox,578,97,36,12,19,12,11,7,578,542,530,437,210,190,42,55,293,285,69,230,182,0
19:26:20,4018.378,Fox,578,97,36,10,21,12,11,7,578,542,532,437,210,190,42,55,293,285,69,230,182,0
19:26:21,4020.858,Fox,580,98,38,10,20,12,11,7,580,542,532,437,210,190,42,56,294,286,69,231,182,0
19:26:21,4021.316,Fox,582,99,38,8,21,10,13,7,580,542,534,437,212,190,43,56,296,286,69,232,182,0
19:26:21,4021.465,Fox,582,99,40,8,21,10,13,7,582,542,534,437,212,190,43,56,296,286,69,232,182,0
19:26:21,4022.335,Fox,582,99,38,10,21,10,13,7,582,544,534,437,212,190,43,56,296,286,69,232,182,0
19:26:21,4023.29,Fox,582,99,36,12,21,10,13,7,582,546,534,437,212,190,43,56,296,286,69,232,182,0
19:26:22,4023.844,Fox,582,99,34,14,21,10,13,7,582,548,534,437,212,190,43,56,296,286,69,232,182,0
19:26:22,4026.253,Fox,582,99,34,14,21,8,15,7,582,548,534,437,214,190,43,56,296,286,69,232,182,0
19:26:23,4027.043,Fox,584,101,36,14,21,8,15,7,584,548,534,437,214,190,44,57,297,287,69,232,182,0
19:26:23,4028.589,Fox,586,103,38,14,21,8,15,7,586,548,534,437,214,190,46,57,299,287,69,232,182,0
19:26:24,4030.099,Fox,588,105,36,16,21,8,15,7,586,550,534,437,214,190,47,58,300,288,69,232,182,0
19:26:24,4030.251,Fox,588,105,38,16,21,8,15,7,588,550,534,437,214,190,47,58,300,288,69,232,182,0
19:26:24,4031.398,Fox,588,105,36,18,21,8,15,7,588,552,534,437,214,190,47,58,300,288,69,232,182,0
19:26:24,4031.718,Fox,588,104,36,18,21,8,15,6,588,552,534,437,214,190,47,57,300,288,69,232,183,0
19:26:24,4032.698,Fox,588,104,36,18,19,10,15,6,588,552,534,439,214,190,47,57,300,288,69,232,183,0
19:26:25,4033.911,Fox,588,104,34,20,19,10,15,6,588,554,534,439,214,190,47,57,300,288,69,232,183,0
19:26:25,4035.103,Fox,588,104,34,18,21,10,15,6,588,554,536,439,214,190,47,57,300,288,69,232,183,0
19:26:26,4036.846,Fox,590,106,36,16,23,10,15,6,590,554,538,439,214,190,48,58,301,289,69,232,183,0
19:26:26,4037.344,Fox,590,106,36,16,23,10,13,8,590,554,538,439,214,192,48,58,301,289,69,232,183,0
19:26:26,4038.249,Fox,590,106,34,18,23,10,13,8,590,556,538,439,214,192,48,58,301,289,69,232,183,0
19:26:26,4038.538,Fox,590,105,34,18,23,10,13,7,590,556,538,439,214,192,48,57,301,289,69,232,184,0
19:26:27,4039.124,Fox,590,105,34,18,21,12,13,7,590,556,538,441,214,192,48,57,301,289,69,232,184,0
19:26:27,4041.769,Fox,590,104,34,18,21,12,13,6,590,556,538,441,214,192,47,57,301,289,69,232,185,0
19:26:28,4043.371,Fox,590,102,34,18,21,10,13,6,590,556,538,441,214,192,46,56,301,289,69,234,185,0
19:26:28,4044.026,Fox,590,102,34,16,23,10,13,6,590,556,540,441,214,192,46,56,301,289,69,234,185,0
19:26:29,4045.164,Fox,590,102,34,16,22,11,13,6,590,556,540,442,214,192,46,56,301,289,69,234,185,0
19:26:30,4047.979,Fox,592,102,32,18,19,13,13,5,590,558,540,444,214,192,46,56,302,290,69,235,186,0
19:26:30,4048.157,Fox,592,102,34,18,19,13,13,5,592,558,540,444,214,192,46,56,302,290,69,235,186,0
19:26:30,4049.64,Fox,592,100,34,18,19,11,13,5,592,558,540,444,214,192,45,55,302,290,69,237,186,0
19:26:30,4049.968,Fox,592,100,34,16,21,11,13,5,592,558,542,444,214,192,45,55,302,290,69,237,186,0
19:26:31,4051.984,Fox,592,100,34,16,21,10,14,5,592,558,542,444,215,192,45,55,302,290,69,237,186,0
19:26:31,4053.188,Fox,592,100,34,16,19,12,14,5,592,558,542,446,215,192,45,55,302,290,69,237,186,0
19:26:31,4053.628,Fox,594,101,36,16,18,12,14,5,594,558,542,446,215,192,45,56,303,291,69,238,186,0
19:26:32,4056.634,Fox,596,103,38,16,18,12,14,5,596,558,542,446,215,192,46,57,304,292,69,238,186,0
19:26:33,4057.11,Fox,598,104,40,16,18,12,14,4,598,558,542,446,215,192,48,56,306,292,69,238,187,0
19:26:33,4057.918,Fox,598,104,38,18,18,12,13,5,598,560,542,446,215,193,48,56,306,292,69,238,187,0
19:26:33,4059.391,Fox,600,104,38,18,17,12,13,4,598,560,542,446,215,193,47,57,307,293,69,239,188,0
19:26:33,4059.544,Fox,600,104,40,18,17,12,13,4,600,560,542,446,215,193,47,57,307,293,69,239,188,0
19:26:34,4060.715,Fox,600,104,40,16,19,12,13,4,600,560,544,446,215,193,47,57,307,293,69,239,188,0
19:26:34,4061.876,Fox,600,104,40,14,21,12,13,4,600,560,546,446,215,193,47,57,307,293,69,239,188,0
19:26:34,4062.36,Fox,600,104,38,14,23,12,13,4,600,562,548,446,215,193,47,57,307,293,69,239,188,0
19:26:35,4064.489,Fox,600,104,36,16,23,12,13,4,600,564,548,446,215,193,47,57,307,293,69,239,188,0
19:26:35,4065.03,Fox,600,104,34,18,23,12,13,4,600,566,548,446,215,193,47,57,307,293,69,239,188,0
19:26:35,4065.527,Fox,600,104,34,18,23,11,14,4,600,566,548,446,216,193,47,57,307,293,69,239,188,0
19:26:36,4065.988,Fox,602,106,36,18,21,13,14,4,602,566,548,448,216,193,49,57,309,293,69,239,188,0
19:26:36,4066.668,Fox,602,106,34,20,21,13,14,4,602,568,548,448,216,193,49,57,309,293,69,239,188,0
19:26:36,4068.37,Fox,602,106,34,18,23,13,14,4,602,568,550,448,216,193,49,57,309,293,69,239,188,0
19:26:37,4069.946,Fox,602,106,34,16,25,13,14,4,602,568,552,448,216,193,49,57,309,293,69,239,188,0
19:26:37,4071.55,Fox,602,106,32,18,25,13,14,4,602,570,552,448,216,193,49,57,309,293,69,239,188,0
19:26:38,4072.184,Fox,602,106,32,18,25,12,15,4,602,570,552,448,217,193,49,57,309,293,69,239,188,0
19:26:38,4072.505,Fox,602,106,32,16,27,12,15,4,602,570,554,448,217,193,49,57,309,293,69,239,188,0
19:26:38,4073.335,Fox,602,105,32,16,25,14,14,4,602,570,554,450,217,193,48,57,309,293,69,240,188,0
19:26:38,4073.596,Fox,602,105,32,16,24,15,14,4,602,570,554,451,217,193,48,57,309,293,69,240,188,0
19:26:38,4074.383,Fox,602,105,30,18,24,15,14,4,602,572,554,451,217,193,48,57,309,293,69,240,188,0
19:26:38,4074.725,Fox,602,105,28,20,24,15,14,4,602,574,554,451,217,193,48,57,309,293,69,240,188,0
19:26:39,4076.232,Fox,602,105,28,20,22,15,16,4,602,574,554,453,219,193,48,57,309,293,69,240,188,0
19:26:39,4076.705,Fox,602,103,28,18,24,13,16,4,602,574,556,453,219,193,48,55,309,293,69,242,188,0
19:26:40,4078.431,Fox,604,105,28,18,24,13,14,6,602,574,556,453,219,195,50,55,311,293,69,242,188,0
19:26:40,4078.659,Fox,604,105,30,18,24,13,14,6,604,574,556,453,219,195,50,55,311,293,69,242,188,0
19:26:40,4079.131,Fox,604,105,30,18,23,14,14,6,604,574,556,454,219,195,50,55,311,293,69,242,188,0
19:26:41,4081.914,Fox,606,106,32,18,21,15,14,6,606,574,556,455,219,195,50,56,312,294,69,243,188,0
19:26:41,4082.749,Fox,606,105,32,18,21,15,14,5,606,574,556,455,219,195,49,56,312,294,69,243,189,0
19:26:42,4083.968,Fox,608,105,34,18,21,13,14,5,608,574,556,455,219,195,50,55,313,295,69,245,189,0
19:26:42,4086.453,Fox,608,105,34,16,23,13,14,5,608,574,558,455,219,195,50,55,313,295,69,245,189,0
19:26:43,4086.894,Fox,608,103,34,16,23,11,14,5,608,574,558,455,219,195,50,53,313,295,69,247,189,0
19:26:43,4089.528,Fox,608,102,34,16,23,10,14,5,608,574,558,455,219,195,50,52,313,295,69,248,189,0
19:26:44,4092.056,Fox,608,102,32,18,23,10,14,5,608,576,558,455,219,195,50,52,313,295,69,248,189,0
19:26:46,4095.805,Fox,608,102,32,18,21,12,14,5,608,576,558,457,219,195,50,52,313,295,69,248,189,0
19:26:46,4096.456,Fox,608,102,32,16,23,12,14,5,608,576,560,457,219,195,50,52,313,295,69,248,189,0
19:26:46,4097.176,Fox,610,104,34,16,23,12,14,5,610,576,560,457,219,195,50,54,313,297,69,248,189,0
19:26:46,4097.387,Fox,610,104,34,16,21,14,14,5,610,576,560,459,219,195,50,54,313,297,69,248,189,0
19:26:46,4097.945,Fox,610,103,34,16,21,14,14,4,610,576,560,459,219,195,49,54,313,297,69,248,190,0
19:26:47,4099.252,Fox,610,103,34,16,21,12,16,4,610,576,560,459,221,195,49,54,313,297,69,248,190,0
19:26:47,4100.907,Fox,612,104,34,16,22,12,16,4,612,578,562,459,221,195,49,55,314,298,69,249,190,0
19:26:48,4102.922,Fox,612,104,34,14,24,12,16,4,612,578,564,459,221,195,49,55,314,298,69,249,190,0
19:26:48,4103.464,Fox,612,104,32,14,26,12,16,4,612,580,566,459,221,195,49,55,314,298,69,249,190,0
19:26:48,4104.078,Fox,612,104,30,16,26,12,16,4,612,582,566,459,221,195,49,55,314,298,69,249,190,0
19:26:49,4104.703,Fox,614,106,32,16,25,13,16,4,614,582,566,460,221,195,50,56,315,299,69,249,190,0
19:26:49,4105.2,Fox,614,106,32,14,27,13,16,4,614,582,568,460,221,195,50,56,315,299,69,249,190,0
19:26:50,4108.065,Fox,618,109,34,14,27,11,17,4,616,582,568,460,222,195,52,57,317,301,69,250,190,0
19:26:50,4108.239,Fox,618,109,36,14,27,11,17,4,618,582,568,460,222,195,52,57,317,301,69,250,190,0
19:26:50,4109.57,Fox,618,109,34,16,27,11,17,4,618,584,568,460,222,195,52,57,317,301,69,250,190,0
19:26:50,4110.08,Fox,618,109,34,14,29,11,17,4,618,584,570,460,222,195,52,57,317,301,69,250,190,0
19:26:51,4110.795,Fox,620,110,34,14,26,13,17,4,618,584,570,462,222,195,51,59,317,303,69,251,190,0
19:26:51,4111.166,Fox,620,110,34,16,26,13,17,4,620,586,570,462,222,195,51,59,317,303,69,251,190,0
19:26:51,4112.8,Fox,620,110,32,16,28,13,17,4,620,588,572,462,222,195,51,59,317,303,69,251,190,0
19:26:51,4113.257,Fox,620,110,32,14,30,13,17,4,620,588,574,462,222,195,51,59,317,303,69,251,190,0
19:26:52,4115.177,Fox,622,110,32,14,29,12,17,4,620,588,574,462,222,195,51,59,318,304,69,253,190,0
19:26:52,4115.334,Fox,622,110,34,14,29,12,17,4,622,588,574,462,222,195,51,59,318,304,69,253,190,0
19:26:53,4117.203,Fox,624,111,36,14,28,12,17,4,624,588,574,462,222,195,52,59,320,304,69,254,190,0
19:26:53,4118.469,Fox,624,110,36,14,28,12,17,3,624,588,574,462,222,195,52,58,320,304,69,254,191,0
19:26:53,4119.526,Fox,624,110,34,16,28,12,16,4,624,590,574,462,222,196,52,58,320,304,69,254,191,0
19:26:54,4120.708,Fox,626,111,36,16,27,12,16,4,626,590,574,462,222,196,52,59,321,305,69,255,191,0
19:26:54,4121.391,Fox,626,109,36,16,26,11,16,4,626,590,574,463,222,196,52,57,321,305,70,256,191,0
19:26:54,4122.31,Fox,626,109,36,16,24,13,16,4,626,590,574,465,222,196,52,57,321,305,70,256,191,0
19:26:55,4123.264,Fox,628,110,38,16,23,13,16,4,628,590,574,465,222,196,53,57,323,305,70,257,191,0
19:26:55,4124.019,Fox,630,112,40,16,23,13,16,4,630,590,574,465,222,196,54,58,324,306,70,257,191,0
19:26:57,4129.007,Fox,630,112,40,16,21,15,16,4,630,590,574,467,222,196,54,58,324,306,70,257,191,0
19:26:57,4130.513,Fox,630,112,40,14,21,17,16,4,630,590,576,469,222,196,54,58,324,306,70,257,191,0
19:26:57,4130.694,Fox,630,112,38,16,21,17,16,4,630,592,576,469,222,196,54,58,324,306,70,257,191,0
19:26:58,4131.841,Fox,630,111,38,16,21,16,16,4,630,592,576,469,222,196,54,57,324,306,70,258,191,0
19:26:58,4133.039,Fox,630,111,38,16,20,17,16,4,630,592,576,470,222,196,54,57,324,306,70,258,191,0
19:26:59,4136.193,Fox,630,111,36,18,20,17,16,4,630,594,576,470,222,196,54,57,324,306,70,258,191,0
19:26:59,4137.051,Fox,632,112,38,18,19,17,16,4,632,594,576,470,222,196,53,59,324,308,70,259,191,0
19:26:59,4137.467,Fox,634,114,40,18,18,18,16,4,634,594,576,471,222,196,54,60,325,309,70,259,191,0
19:27:00,4138.315,Fox,634,113,40,18,18,18,16,3,634,594,576,471,222,196,54,59,325,309,70,259,192,0
19:27:00,4138.654,Fox,634,113,40,18,18,17,17,3,634,594,576,471,223,196,54,59,325,309,70,259,192,0
19:27:00,4139.383,Fox,634,112,38,18,20,16,17,3,634,596,578,471,223,196,54,58,325,309,70,260,192,0
19:27:00,4139.755,Fox,634,112,36,20,20,16,17,3,634,598,578,471,223,196,54,58,325,309,70,260,192,0
19:27:01,4141.284,Fox,634,112,36,20,20,14,19,3,634,598,578,471,225,196,54,58,325,309,70,260,192,0
19:27:01,4142.183,Fox,634,112,34,20,22,14,19,3,634,600,580,471,225,196,54,58,325,309,70,260,192,0
19:27:01,4142.554,Fox,634,112,34,18,24,14,19,3,634,600,582,471,225,196,54,58,325,309,70,260,192,0
19:27:03,4146.647,Fox,636,114,34,18,24,14,17,5,634,600,582,471,225,198,54,60,325,311,70,260,192,0
19:27:03,4147.046,Fox,636,114,36,18,23,13,19,5,636,600,582,472,227,198,54,60,325,311,70,260,192,0
19:27:03,4147.228,Fox,636,114,36,18,23,13,17,7,636,600,582,472,227,200,54,60,325,311,70,260,192,0
19:27:03,4147.76,Fox,636,113,36,18,23,12,17,7,636,600,582,472,227,200,54,59,325,311,70,261,192,0
19:27:03,4148.335,Fox,636,112,36,16,25,12,17,6,636,600,584,472,227,200,54,58,325,311,70,261,193,0
19:27:03,4148.524,Fox,636,112,34,18,25,12,17,6,636,602,584,472,227,200,54,58,325,311,70,261,193,0
19:27:03,4149.396,Fox,636,112,34,18,25,12,16,7,636,602,584,472,227,201,54,58,325,311,70,261,193,0
19:27:04,4149.838,Fox,636,112,34,16,27,12,16,7,636,602,586,472,227,201,54,58,325,311,70,261,193,0
19:27:04,4151.31,Fox,636,112,34,14,29,12,16,7,636,602,588,472,227,201,54,58,325,311,70,261,193,0
19:27:06,4157.284,Fox,638,114,36,14,27,14,16,7,638,602,588,474,227,201,56,58,327,311,70,261,193,0
19:27:06,4157.472,Fox,638,113,36,14,27,13,16,7,638,602,588,474,227,201,55,58,327,311,70,262,193,0
19:27:06,4158.063,Fox,638,113,36,12,29,13,16,7,638,602,590,474,227,201,55,58,327,311,70,262,193,0
19:27:07,4158.821,Fox,638,112,36,12,29,13,14,8,638,602,590,474,227,203,55,57,327,311,70,262,194,0
19:27:07,4160.9,Fox,640,113,38,12,28,13,14,8,640,602,590,474,227,203,54,59,327,313,70,263,194,0
19:27:08,4161.294,Fox,640,113,36,14,27,14,14,8,640,604,590,475,227,203,54,59,327,313,70,263,194,0
19:27:08,4163.648,Fox,640,113,36,14,25,16,13,9,640,604,590,477,227,204,54,59,327,313,70,263,194,0
19:27:08,4163.972,Fox,640,113,36,14,23,18,13,9,640,604,590,479,227,204,54,59,327,313,70,263,194,0
19:27:09,4164.506,Fox,640,113,34,16,23,18,13,9,640,606,590,479,227,204,54,59,327,313,70,263,194,0
19:27:09,4165.699,Fox,640,113,34,16,21,20,13,9,640,606,590,481,227,204,54,59,327,313,70,263,194,0
19:27:09,4166.618,Fox,640,113,32,18,21,20,13,9,640,608,590,481,227,204,54,59,327,313,70,263,194,0
19:27:10,4167.267,Fox,640,113,32,18,21,19,14,9,640,608,590,481,228,204,54,59,327,313,70,263,194,0
19:27:10,4169.344,Fox,640,113,32,16,23,19,14,9,640,608,592,481,228,204,54,59,327,313,70,263,194,0
19:27:11,4170.793,Fox,642,115,32,16,21,21,14,9,640,608,592,483,228,204,56,59,329,313,70,263,194,0
19:27:11,4170.984,Fox,642,115,34,16,21,21,14,9,642,608,592,483,228,204,56,59,329,313,70,263,194,0
19:27:11,4171.68,Fox,642,114,34,16,21,20,14,9,642,608,592,483,228,204,56,58,329,313,70,264,194,0
19:27:12,4173.2,Fox,642,114,34,16,19,22,14,9,642,608,592,485,228,204,56,58,329,313,70,264,194,0
19:27:12,4173.707,Fox,642,114,34,16,18,23,14,9,642,608,592,486,228,204,56,58,329,313,70,264,194,0
19:27:12,4174.262,Fox,644,116,36,16,18,23,14,9,644,608,592,486,228,204,57,59,330,314,70,264,194,0
19:27:12,4174.813,Fox,644,114,36,14,20,21,14,9,644,608,594,486,228,204,55,59,330,314,70,266,194,0
19:27:12,4175.185,Fox,644,114,36,14,20,20,15,9,644,608,594,486,229,204,55,59,330,314,70,266,194,0
19:27:13,4176.286,Fox,644,113,36,14,20,19,15,9,644,608,594,486,229,204,55,58,330,314,70,267,194,0
19:27:13,4177.333,Fox,646,114,38,14,19,19,15,9,646,608,594,486,229,204,55,59,331,315,70,268,194,0
19:27:13,4177.715,Fox,646,113,38,12,21,19,15,8,646,608,596,486,229,204,54,59,331,315,70,268,195,0
19:27:13,4178.292,Fox,650,116,40,10,22,19,15,8,648,608,598,486,229,204,54,62,332,318,70,269,195,0
19:27:13,4178.494,Fox,650,116,42,10,22,19,15,8,650,608,598,486,229,204,54,62,332,318,70,269,195,0
19:27:14,4179.269,Fox,652,118,44,10,22,19,15,8,652,608,598,486,229,204,54,64,332,320,70,269,195,0
19:27:14,4179.847,Fox,652,118,42,12,22,19,15,8,652,610,598,486,229,204,54,64,332,320,70,269,195,0
19:27:14,4180.733,Fox,652,118,42,10,24,19,15,8,652,610,600,486,229,204,54,64,332,320,70,269,195,0
19:27:15,4182.92,Fox,654,120,44,10,24,19,15,8,654,610,600,486,229,204,56,64,334,320,70,269,195,0
19:27:15,4183.5,Fox,654,120,42,12,24,19,15,8,654,612,600,486,229,204,56,64,334,320,70,269,195,0
19:27:15,4183.894,Fox,654,118,42,12,24,17,15,8,654,612,600,486,229,204,56,62,334,320,70,271,195,0
19:27:15,4184.276,Fox,654,117,42,12,24,16,15,8,654,612,600,486,229,204,56,61,334,320,70,272,195,0
19:27:16,4185.932,Fox,656,118,44,12,23,16,15,8,656,612,600,486,229,204,56,62,335,321,71,272,195,0
19:27:16,4187.019,Fox,656,118,44,10,25,16,15,8,656,612,602,486,229,204,56,62,335,321,71,272,195,0
19:27:16,4187.602,Fox,660,121,46,12,24,16,15,8,660,614,602,486,229,204,57,64,337,323,72,272,195,0
19:27:17,4188.195,Fox,664,125,48,12,24,16,15,8,662,614,602,486,229,204,58,67,338,326,72,272,195,0
19:27:17,4188.404,Fox,664,125,50,12,24,16,15,8,664,614,602,486,229,204,58,67,338,326,72,272,195,0
19:27:17,4188.986,Fox,666,126,52,12,23,16,15,8,666,614,602,486,229,204,58,68,339,327,72,273,195,0
19:27:17,4189.18,Fox,666,126,52,12,23,14,17,8,666,614,602,486,231,204,58,68,339,327,72,273,195,0
19:27:17,4189.564,Fox,666,126,52,12,23,14,16,9,666,614,602,486,231,205,58,68,339,327,72,273,195,0
19:27:17,4190.889,Fox,666,126,48,16,21,15,17,9,666,618,602,488,232,205,58,68,339,327,72,273,195,0
19:27:18,4193.586,Fox,666,126,46,18,21,15,17,9,666,620,602,488,232,205,58,68,339,327,72,273,195,0
19:27:19,4194.896,Fox,668,128,48,18,21,15,17,9,668,620,602,488,232,205,58,70,339,329,72,273,195,0
19:27:19,4197.184,Fox,668,126,48,18,21,15,17,7,668,620,602,488,232,205,57,69,339,329,72,273,197,0
19:27:20,4198.093,Fox,668,126,46,20,21,15,17,7,668,622,602,488,232,205,57,69,339,329,72,273,197,0
19:27:20,4198.907,Fox,670,128,48,20,21,15,17,7,670,622,602,488,232,205,57,71,339,331,72,273,197,0
19:27:20,4199.934,Fox,670,128,46,20,23,15,17,7,670,624,604,488,232,205,57,71,339,331,72,273,197,0
19:27:21,4201.478,Fox,670,126,46,20,23,13,17,7,670,624,604,488,232,205,57,69,339,331,72,275,197,0
19:27:21,4202.548,Fox,670,126,46,20,22,14,17,7,670,624,604,489,232,205,57,69,339,331,72,275,197,0
19:27:22,4203.352,Fox,670,126,44,20,22,16,16,8,670,626,606,491,232,206,57,69,339,331,72,275,197,0
19:27:22,4204.441,Fox,672,128,46,20,22,16,16,8,672,626,606,491,232,206,58,70,340,332,72,275,197,0
19:27:22,4205.117,Fox,672,128,46,18,24,16,16,8,672,626,608,491,232,206,58,70,340,332,72,275,197,0
19:27:23,4206.187,Fox,672,128,44,20,24,16,16,8,672,628,608,491,232,206,58,70,340,332,72,275,197,0
19:27:23,4206.786,Fox,672,128,42,22,24,16,16,8,672,630,608,491,232,206,58,70,340,332,72,275,197,0
19:27:24,4208.796,Fox,672,128,42,22,23,17,16,8,672,630,608,492,232,206,58,70,340,332,72,275,197,0
19:27:24,4210.086,Fox,674,130,44,22,23,17,15,9,674,630,608,492,232,207,58,72,340,334,72,275,197,0
19:27:24,4210.386,Fox,674,130,44,22,22,18,15,9,674,630,608,493,232,207,58,72,340,334,72,275,197,0
19:27:25,4211.066,Fox,676,132,46,22,22,18,15,9,676,630,608,493,232,207,59,73,341,335,72,275,197,0
19:27:25,4212.08,Fox,676,132,46,22,20,20,15,9,676,630,608,495,232,207,59,73,341,335,72,275,197,0
19:27:25,4212.984,Fox,678,132,48,22,19,19,15,9,678,630,608,495,232,207,60,72,343,335,72,277,197,0
19:27:25,4213.61,Fox,680,133,50,22,18,19,15,9,680,630,608,495,232,207,59,74,343,337,72,278,197,0
19:27:26,4213.842,Fox,680,133,50,22,18,19,13,11,680,630,608,495,232,209,59,74,343,337,72,278,197,0
19:27:26,4215.795,Fox,680,133,50,22,18,17,15,11,680,630,608,495,234,209,59,74,343,337,72,278,197,0
19:27:27,4218.392,Fox,680,133,50,20,18,19,15,11,680,630,610,497,234,209,59,74,343,337,72,278,197,0
19:27:27,4219.741,Fox,680,133,48,22,18,19,15,11,680,632,610,497,234,209,59,74,343,337,72,278,197,0
19:27:28,4220.148,Fox,680,133,46,24,18,19,15,11,680,634,610,497,234,209,59,74,343,337,72,278,197,0
19:27:28,4222.263,Fox,682,135,48,22,20,19,15,11,682,634,612,497,234,209,61,74,345,337,72,278,197,0
19:27:28,4222.453,Fox,682,133,48,22,20,16,16,11,682,634,612,497,235,209,60,73,345,337,72,280,197,0
19:27:29,4223.96,Fox,682,133,48,22,20,14,18,11,682,634,612,497,237,209,60,73,345,337,72,280,197,0
19:27:29,4224.333,Fox,682,132,48,22,20,14,18,10,682,634,612,497,237,209,60,72,345,337,72,280,198,0
19:27:30,4225.932,Fox,682,132,48,20,22,14,18,10,682,634,614,497,237,209,60,72,345,337,72,280,198,0
19:27:30,4226.476,Fox,682,132,48,20,22,13,19,10,682,634,614,497,238,209,60,72,345,337,72,280,198,0
19:27:31,4229.29,Fox,682,132,48,16,26,13,19,10,682,634,618,497,238,209,60,72,345,337,72,280,198,0
19:27:31,4229.688,Fox,682,132,46,18,24,15,19,10,682,636,618,499,238,209,60,72,345,337,72,280,198,0
19:27:32,4232.037,Fox,682,132,46,16,26,15,19,10,682,636,620,499,238,209,60,72,345,337,72,280,198,0
19:27:33,4235.328,Fox,682,132,46,16,24,17,19,10,682,636,620,501,238,209,60,72,345,337,72,280,198,0
19:27:33,4236.374,Fox,682,132,46,14,26,17,19,10,682,636,622,501,238,209,60,72,345,337,72,280,198,0
19:27:33,4236.732,Fox,682,132,46,14,26,17,17,12,682,636,622,501,238,211,60,72,345,337,72,280,198,0
19:27:34,4238.404,Fox,682,132,46,12,27,18,17,12,682,636,624,502,238,211,60,72,345,337,72,280,198,0
19:27:34,4238.827,Fox,682,132,46,12,26,19,17,12,682,636,624,503,238,211,60,72,345,337,72,280,198,0
19:27:34,4239.955,Fox,682,131,44,14,26,19,17,11,682,638,624,503,238,211,59,72,345,337,72,280,199,0
19:27:35,4240.785,Fox,684,133,46,14,26,19,17,11,684,638,624,503,238,211,59,74,345,339,72,280,199,0
19:27:35,4241.174,Fox,684,133,46,14,24,21,17,11,684,638,624,505,238,211,59,74,345,339,72,280,199,0
19:27:35,4241.745,Fox,684,133,46,12,26,21,17,11,684,638,626,505,238,211,59,74,345,339,72,280,199,0
19:27:35,4243.44,Fox,686,134,46,14,25,21,17,11,686,640,626,505,238,211,59,75,346,340,73,280,199,0
19:27:36,4244.385,Fox,686,134,46,12,27,21,17,11,686,640,628,505,238,211,59,75,346,340,73,280,199,0
19:27:36,4244.939,Fox,688,135,48,12,26,21,17,11,688,640,628,505,238,211,60,75,348,340,73,281,199,0
19:27:36,4245.15,Fox,688,135,48,10,28,21,17,11,688,640,630,505,238,211,60,75,348,340,73,281,199,0
19:27:36,4245.538,Fox,688,135,48,10,28,21,16,12,688,640,630,505,238,212,60,75,348,340,73,281,199,0
19:27:37,4247.636,Fox,690,137,50,10,26,23,16,12,690,640,630,507,238,212,60,77,348,342,73,281,199,0
19:27:37,4249.023,Fox,692,137,52,10,26,21,16,12,692,640,630,507,238,212,60,77,349,343,73,283,199,0
19:27:37,4249.239,Fox,692,136,52,10,26,20,16,12,692,640,630,507,238,212,59,77,349,343,73,284,199,0
19:27:38,4250.5,Fox,692,135,52,10,26,18,18,11,692,640,630,507,240,212,59,76,349,343,73,284,200,0
19:27:38,4252.239,Fox,694,137,54,10,26,18,18,11,694,640,630,507,240,212,60,77,350,344,73,284,200,0
19:27:39,4253.492,Fox,694,137,52,12,26,18,18,11,694,642,630,507,240,212,60,77,350,344,73,284,200,0
19:27:39,4254.049,Fox,694,136,52,12,26,18,18,10,694,642,630,507,240,212,59,77,350,344,73,284,201,0
19:27:40,4257.077,Fox,694,135,50,14,26,16,20,9,694,644,630,507,242,212,59,76,350,344,73,284,202,0
19:27:40,4258.078,Fox,694,135,50,12,28,16,20,9,694,644,632,507,242,212,59,76,350,344,73,284,202,0
19:27:41,4258.705,Fox,696,136,50,10,29,16,20,9,694,644,634,507,242,212,59,77,351,345,73,285,202,0
19:27:41,4259.142,Fox,698,138,54,10,29,16,20,9,698,644,634,507,242,212,61,77,353,345,73,285,202,0
19:27:41,4259.368,Fox,698,138,54,10,29,15,21,9,698,644,634,507,243,212,61,77,353,345,73,285,202,0
19:27:41,4260.212,Fox,698,137,52,12,27,17,21,8,698,646,634,509,243,212,60,77,353,345,73,285,203,0
19:27:41,4261.039,Fox,700,139,48,16,27,17,21,8,698,650,634,509,243,212,60,79,353,347,73,285,203,0
19:27:41,4261.247,Fox,700,139,50,16,27,17,21,8,700,650,634,509,243,212,60,79,353,347,73,285,203,0
19:27:42,4261.866,Fox,702,140,50,18,27,16,21,8,702,652,634,509,243,212,61,79,355,347,73,286,203,0
19:27:42,4263.554,Fox,702,140,50,18,26,17,21,8,702,652,634,510,243,212,61,79,355,347,73,286,203,0
19:27:42,4264.174,Fox,702,139,50,18,26,15,23,7,702,652,634,510,245,212,60,79,355,347,73,286,204,0
19:27:43,4265.619,Fox,704,141,50,20,25,16,23,7,704,654,634,511,245,212,61,80,356,348,73,286,204,0
19:27:44,4267.855,Fox,704,141,50,18,27,16,23,7,704,654,636,511,245,212,61,80,356,348,73,286,204,0
19:27:44,4268.224,Fox,704,140,50,18,27,16,23,6,704,654,636,511,245,212,61,79,356,348,73,286,205,0
19:27:44,4268.623,Fox,704,140,48,20,27,16,23,6,704,656,636,511,245,212,61,79,356,348,73,286,205,0
19:27:44,4270.16,Fox,704,140,44,24,27,16,23,6,704,660,636,511,245,212,61,79,356,348,73,286,205,0
19:27:45,4270.802,Fox,704,138,42,26,27,15,23,5,704,662,636,511,245,212,59,79,356,348,73,287,206,0
19:27:45,4271.243,Fox,704,137,40,28,27,15,23,4,704,664,636,511,245,212,59,78,356,348,73,287,207,0
19:27:45,4271.677,Fox,704,137,38,30,27,15,23,4,704,666,636,511,245,212,59,78,356,348,73,287,207,0
19:27:46,4274.064,Fox,704,135,38,30,27,14,23,3,704,666,636,511,245,212,58,77,356,348,73,288,208,0
19:27:46,4276.155,Fox,704,134,38,30,27,13,22,4,704,666,636,511,245,213,58,76,356,348,74,288,208,0
19:27:47,4277.166,Fox,704,133,38,30,27,13,22,3,704,666,636,511,245,213,58,75,356,348,74,288,209,0
19:27:47,4277.55,Fox,704,133,36,32,27,13,22,3,704,668,636,511,245,213,58,75,356,348,74,288,209,0
19:27:47,4278.33,Fox,704,133,36,30,29,13,22,3,704,668,638,511,245,213,58,75,356,348,74,288,209,0
19:27:47,4278.897,Fox,704,133,36,30,27,15,20,5,704,668,638,513,245,215,58,75,356,348,74,288,209,0
19:27:48,4280.315,Fox,706,135,38,30,27,15,20,5,706,668,638,513,245,215,59,76,357,349,74,288,209,0
19:27:48,4280.924,Fox,708,136,40,30,26,15,20,5,708,668,638,513,245,215,58,78,357,351,74,289,209,0
19:27:48,4281.36,Fox,708,136,38,32,26,15,20,5,708,670,638,513,245,215,58,78,357,351,74,289,209,0
19:27:48,4281.994,Fox,708,136,38,30,28,15,20,5,708,670,640,513,245,215,58,78,357,351,74,289,209,0
19:27:49,4282.893,Fox,710,138,38,30,27,16,20,5,708,670,640,514,245,215,58,80,357,353,74,289,209,0
19:27:49,4283.147,Fox,710,138,40,30,27,16,20,5,710,670,640,514,245,215,58,80,357,353,74,289,209,0
19:27:49,4284.421,Fox,710,138,40,30,27,16,18,7,710,670,640,514,245,217,58,80,357,353,74,289,209,0
19:27:50,4286.346,Fox,710,138,40,30,25,18,18,7,710,670,640,516,245,217,58,80,357,353,74,289,209,0
19:27:50,4287.036,Fox,710,138,38,32,25,18,18,7,710,672,640,516,245,217,58,80,357,353,74,289,209,0
19:27:50,4287.946,Fox,712,140,40,32,25,18,18,7,712,672,640,516,245,217,59,81,358,354,74,289,209,0
19:27:51,4289.071,Fox,714,142,42,32,25,18,18,7,714,672,640,516,245,217,61,81,360,354,74,289,209,0
19:27:51,4289.959,Fox,716,144,42,32,21,22,18,7,714,672,640,520,245,217,63,81,362,354,74,289,209,0
19:27:51,4290.189,Fox,716,144,44,32,21,22,18,7,716,672,640,520,245,217,63,81,362,354,74,289,209,0
19:27:52,4291.899,Fox,720,148,46,32,21,22,18,7,718,672,640,520,245,217,66,82,365,355,74,289,209,0
19:27:52,4292.131,Fox,720,148,48,30,23,22,18,7,720,672,642,520,245,217,66,82,365,355,74,289,209,0
19:27:52,4292.583,Fox,720,148,46,32,21,24,18,7,720,674,642,522,245,217,66,82,365,355,74,289,209,0
19:27:52,4293.015,Fox,720,147,46,32,21,23,18,7,720,674,642,522,245,217,66,81,365,355,74,290,209,0
19:27:52,4293.698,Fox,720,147,44,34,21,23,18,7,720,676,642,522,245,217,66,81,365,355,74,290,209,0
19:27:53,4294.784,Fox,722,148,46,34,20,23,18,7,722,676,642,522,245,217,66,82,366,356,74,291,209,0
19:27:53,4295.674,Fox,722,148,44,34,22,23,18,7,722,678,644,522,245,217,66,82,366,356,74,291,209,0
19:27:53,4296.33,Fox,724,149,44,36,21,23,18,7,724,680,644,522,245,217,66,83,367,357,74,292,209,0
19:27:53,4296.813,Fox,724,147,44,36,21,19,20,7,724,680,644,522,247,217,65,82,367,357,74,294,209,0
19:27:53,4297.248,Fox,726,149,44,36,19,21,20,7,724,680,644,524,247,217,66,83,368,358,74,294,209,0
19:27:53,4297.455,Fox,726,149,46,36,19,21,20,7,726,680,644,524,247,217,66,83,368,358,74,294,209,0
19:27:54,4298.496,Fox,726,149,46,34,21,21,20,7,726,680,646,524,247,217,66,83,368,358,74,294,209,0
19:27:54,4299.192,Fox,728,151,46,34,19,23,20,7,726,680,646,526,247,217,67,84,369,359,74,294,209,0
19:27:54,4299.67,Fox,728,151,48,30,23,23,20,7,728,680,650,526,247,217,67,84,369,359,74,294,209,0
19:27:54,4300.328,Fox,728,150,48,28,25,22,20,7,728,680,652,526,247,217,67,83,369,359,74,295,209,0
19:27:55,4301.175,Fox,728,149,48,28,25,22,20,6,728,680,652,526,247,217,67,82,369,359,74,295,210,0
19:27:55,4302.442,Fox,728,149,48,28,24,22,21,6,728,680,652,527,248,217,67,82,369,359,74,295,210,0
19:27:55,4303.04,Fox,728,148,48,28,24,21,21,6,728,680,652,527,248,217,67,81,369,359,74,296,210,0
19:27:56,4303.861,Fox,730,150,48,28,24,20,22,6,728,680,652,527,249,217,67,83,369,361,74,296,210,0
19:27:56,4304.394,Fox,732,152,50,26,26,20,22,6,730,680,654,527,249,217,67,85,369,363,74,296,210,0
19:27:56,4304.856,Fox,732,152,50,28,25,21,21,7,732,682,654,528,249,218,67,85,369,363,74,296,210,0
19:27:56,4305.771,Fox,732,152,50,28,23,23,21,7,732,682,654,530,249,218,67,85,369,363,74,296,210,0
19:27:57,4307.103,Fox,732,152,50,26,25,23,21,7,732,682,656,530,249,218,67,85,369,363,74,296,210,0
19:27:57,4308.438,Fox,734,154,52,26,25,23,21,7,734,682,656,530,249,218,68,86,370,364,74,296,210,0
19:27:57,4308.682,Fox,734,154,52,22,29,23,21,7,734,682,660,530,249,218,68,86,370,364,74,296,210,0
19:27:58,4309.594,Fox,734,154,52,18,33,23,21,7,734,682,664,530,249,218,68,86,370,364,74,296,210,0
19:27:58,4310.024,Fox,734,154,52,16,35,23,21,7,734,682,666,530,249,218,68,86,370,364,74,296,210,0
19:27:58,4311.958,Fox,734,154,52,16,35,21,23,7,734,682,666,530,251,218,68,86,370,364,74,296,210,0
19:27:59,4312.831,Fox,734,154,52,16,35,21,22,8,734,682,666,530,251,219,68,86,370,364,74,296,210,0
19:27:59,4314.774,Fox,734,153,52,16,35,21,22,7,734,682,666,530,251,219,68,85,370,364,74,296,211,0
19:27:59,4315.422,Fox,734,152,52,16,35,20,22,7,734,682,666,530,251,219,67,85,370,364,74,297,211,0
19:28:00,4316.06,Fox,734,152,52,14,37,20,22,7,734,682,668,530,251,219,67,85,370,364,74,297,211,0
19:28:00,4316.848,Fox,734,150,52,14,37,20,22,5,734,682,668,530,251,219,67,83,370,364,74,297,213,0
19:28:01,4318.986,Fox,734,150,52,14,34,23,22,5,734,682,668,533,251,219,67,83,370,364,74,297,213,0
19:28:01,4319.842,Fox,734,150,52,12,36,23,22,5,734,682,670,533,251,219,67,83,370,364,74,297,213,0
19:28:02,4323.33,Fox,736,152,52,14,36,21,24,5,736,684,670,533,253,219,69,83,372,364,74,297,213,0
19:28:03,4325.464,Fox,736,152,52,12,38,21,24,5,736,684,672,533,253,219,69,83,372,364,74,297,213,0
19:28:03,4326.109,Fox,736,152,50,14,38,21,24,5,736,686,672,533,253,219,69,83,372,364,74,297,213,0
19:28:03,4326.692,Fox,736,152,50,14,38,21,22,7,736,686,672,533,253,221,69,83,372,364,74,297,213,0
19:28:04,4327.581,Fox,736,152,48,16,38,21,22,7,736,688,672,533,253,221,69,83,372,364,74,297,213,0
19:28:04,4328.455,Fox,736,152,48,16,36,23,21,8,736,688,672,535,253,222,69,83,372,364,74,297,213,0
19:28:04,4329.067,Fox,738,153,48,16,35,21,23,8,736,688,672,535,255,222,70,83,374,364,74,298,213,0
19:28:04,4329.527,Fox,740,152,50,16,34,19,23,8,738,688,672,535,255,222,70,82,375,365,74,301,213,0
19:28:04,4329.763,Fox,740,152,52,16,34,19,23,8,740,688,672,535,255,222,70,82,375,365,74,301,213,0
19:28:04,4330.226,Fox,740,152,50,18,34,19,23,8,740,690,672,535,255,222,70,82,375,365,74,301,213,0
19:28:05,4331.158,Fox,740,152,50,16,36,19,23,8,740,690,674,535,255,222,70,82,375,365,74,301,213,0
19:28:05,4331.87,Fox,742,154,48,18,36,19,23,8,740,692,674,535,255,222,71,83,376,366,74,301,213,0
19:28:05,4332.102,Fox,742,154,50,16,38,19,23,8,742,692,676,535,255,222,71,83,376,366,74,301,213,0
19:28:06,4334.01,Fox,742,154,50,14,40,19,23,8,742,692,678,535,255,222,71,83,376,366,74,301,213,0
19:28:06,4334.669,Fox,744,155,52,12,41,17,25,8,744,692,680,535,257,222,70,85,376,368,74,302,213,0
19:28:06,4335.118,Fox,746,156,52,14,40,17,25,8,746,694,680,535,257,222,69,87,376,370,74,303,213,0
19:28:07,4337.114,Fox,748,157,54,14,39,17,25,8,748,694,680,535,257,222,70,87,378,370,74,304,213,0
19:28:07,4338.781,Fox,750,158,56,14,37,19,24,8,750,694,680,537,257,222,69,89,378,372,74,305,213,0
19:28:08,4340.471,Fox,752,159,58,14,37,18,24,8,752,694,680,537,257,222,70,89,380,372,75,305,213,0
19:28:08,4341.141,Fox,752,159,58,14,37,17,25,8,752,694,680,537,258,222,70,89,380,372,75,305,213,0
19:28:08,4341.799,Fox,752,159,54,18,37,17,25,8,752,698,680,537,258,222,70,89,380,372,75,305,213,0
19:28:08,4342.455,Fox,752,159,54,18,35,19,25,8,752,698,680,539,258,222,70,89,380,372,75,305,213,0
19:28:09,4343.314,Fox,752,159,54,16,37,19,25,8,752,698,682,539,258,222,70,89,380,372,75,305,213,0
19:28:09,4343.926,Fox,754,161,54,18,37,19,25,8,754,700,682,539,258,222,70,91,380,374,75,305,213,0
19:28:09,4344.585,Fox,754,161,52,20,37,19,25,8,754,702,682,539,258,222,70,91,380,374,75,305,213,0
19:28:10,4348.264,Fox,754,161,50,22,37,19,25,8,754,704,682,539,258,222,70,91,380,374,75,305,213,0
19:28:11,4348.904,Fox,758,164,52,22,36,19,25,8,756,704,682,539,258,222,71,93,382,376,75,306,213,0
19:28:11,4349.395,Fox,760,164,54,22,35,18,25,8,758,704,682,539,258,222,69,95,382,378,76,307,213,0
19:28:11,4349.655,Fox,760,164,56,22,35,18,25,8,760,704,682,539,258,222,69,95,382,378,76,307,213,0
19:28:12,4353.326,Fox,760,162,56,22,35,16,23,10,760,704,682,539,258,224,69,93,382,378,78,307,213,0
19:28:13,4355.971,Fox,760,162,56,22,34,17,23,10,760,704,682,540,258,224,69,93,382,378,78,307,213,0
19:28:14,4359.066,Fox,760,162,56,22,33,18,23,10,760,704,682,541,258,224,69,93,382,378,78,307,213,0
19:28:14,4359.95,Fox,760,160,56,22,32,19,22,9,760,704,682,542,258,225,69,91,382,378,78,307,215,0
19:28:14,4360.158,Fox,760,160,56,22,30,21,22,9,760,704,682,544,258,225,69,91,382,378,78,307,215,0
19:28:15,4360.852,Fox,760,160,56,22,28,23,22,9,760,704,682,546,258,225,69,91,382,378,78,307,215,0
19:28:15,4361.479,Fox,760,160,56,22,28,23,20,11,760,704,682,546,258,227,69,91,382,378,78,307,215,0
19:28:15,4362.1,Fox,762,161,56,20,30,22,20,11,760,704,684,546,258,227,69,92,383,379,78,308,215,0
19:28:15,4362.574,Fox,766,164,60,20,29,22,20,11,764,704,684,546,258,227,71,93,386,380,78,309,215,0
19:28:15,4363.086,Fox,766,164,60,22,29,22,20,11,766,706,684,546,258,227,71,93,386,380,78,309,215,0
19:28:16,4363.585,Fox,766,164,58,24,29,22,20,11,766,708,684,546,258,227,71,93,386,380,78,309,215,0
19:28:16,4364.061,Fox,766,164,58,24,29,22,19,12,766,708,684,546,258,228,71,93,386,380,78,309,215,0
19:28:16,4364.544,Fox,766,164,58,22,29,24,19,12,766,708,686,548,258,228,71,93,386,380,78,309,215,0
19:28:16,4365.881,Fox,768,166,56,24,29,24,19,12,766,710,686,548,258,228,71,95,386,382,78,309,215,0
19:28:16,4366.308,Fox,770,167,58,22,31,23,19,12,768,710,688,548,258,228,73,94,388,382,78,310,215,0
19:28:17,4366.771,Fox,772,168,60,22,31,23,18,12,770,710,688,548,258,228,72,96,388,384,78,311,215,0
19:28:17,4367.246,Fox,772,167,62,22,31,23,18,11,772,710,688,548,258,228,72,95,388,384,78,311,216,0
19:28:17,4367.702,Fox,772,167,62,22,30,24,18,11,772,710,688,549,258,228,72,95,388,384,78,311,216,0
19:28:17,4368.806,Fox,772,167,62,20,32,24,18,11,772,710,690,549,258,228,72,95,388,384,78,311,216,0
19:28:18,4369.49,Fox,774,168,62,20,29,26,18,11,772,710,690,552,258,228,72,96,388,386,78,312,216,0
19:28:18,4369.96,Fox,774,168,64,20,25,30,18,11,774,710,690,556,258,228,72,96,388,386,78,312,216,0
19:28:18,4370.509,Fox,776,166,64,20,26,27,18,11,776,712,692,556,258,228,72,94,389,387,78,316,216,0
19:28:18,4370.75,Fox,776,166,64,20,25,28,18,11,776,712,692,557,258,228,72,94,389,387,78,316,216,0
19:28:18,4371.652,Fox,776,166,62,22,25,28,18,11,776,714,692,557,258,228,72,94,389,387,78,316,216,0
19:28:18,4372.28,Fox,776,166,62,22,25,26,20,11,776,714,692,557,260,228,72,94,389,387,78,316,216,0
19:28:19,4372.709,Fox,776,166,60,24,25,26,20,11,776,716,692,557,260,228,72,94,389,387,78,316,216,0
19:28:19,4373.351,Fox,776,166,60,22,27,26,20,11,776,716,694,557,260,228,72,94,389,387,78,316,216,0
19:28:19,4374.716,Fox,776,166,56,26,27,26,20,11,776,720,694,557,260,228,72,94,389,387,78,316,216,0
19:28:19,4375.376,Fox,776,163,56,26,27,24,20,10,776,720,694,557,260,228,70,93,389,387,78,318,217,0
19:28:20,4376.459,Fox,776,163,56,26,25,26,20,10,776,720,694,559,260,228,70,93,389,387,78,318,217,0
19:28:20,4377.148,Fox,778,165,58,26,25,26,20,10,778,720,694,559,260,228,71,94,390,388,78,318,217,0
19:28:20,4377.368,Fox,778,165,56,28,25,26,20,10,778,722,694,559,260,228,71,94,390,388,78,318,217,0
19:28:20,4378.242,Fox,780,166,56,28,25,25,20,10,778,722,694,559,260,228,71,95,390,390,78,319,217,0
19:28:21,4378.463,Fox,780,166,58,28,25,25,20,10,780,722,694,559,260,228,71,95,390,390,78,319,217,0
19:28:21,4378.902,Fox,780,166,56,30,25,25,20,10,780,724,694,559,260,228,71,95,390,390,78,319,217,0
19:28:21,4380.173,Fox,780,166,54,28,29,25,20,10,780,726,698,559,260,228,71,95,390,390,78,319,217,0
19:28:21,4380.365,Fox,780,165,54,28,27,26,20,10,780,726,698,561,260,228,71,94,390,390,79,319,217,0
19:28:21,4381.17,Fox,782,166,56,28,27,25,20,10,782,726,698,561,260,228,72,94,391,391,79,320,217,0
19:28:22,4382,Fox,782,166,54,30,27,25,20,10,782,728,698,561,260,228,72,94,391,391,79,320,217,0
19:28:22,4382.431,Fox,782,166,54,28,29,25,20,10,782,728,700,561,260,228,72,94,391,391,79,320,217,0
19:28:22,4383.152,Fox,782,166,54,26,31,24,21,10,782,728,702,561,261,228,72,94,391,391,79,320,217,0
19:28:22,4383.409,Fox,782,166,54,26,31,22,23,10,782,728,702,561,263,228,72,94,391,391,79,320,217,0
19:28:23,4385.674,Fox,784,168,56,26,31,22,23,10,784,728,702,561,263,228,72,96,391,393,79,320,217,0
19:28:23,4386.12,Fox,784,168,56,26,29,23,24,10,784,728,702,563,264,228,72,96,391,393,79,320,217,0
19:28:23,4387.02,Fox,784,166,54,26,31,21,24,10,784,730,704,563,264,228,72,94,391,393,81,320,217,0
19:28:23,4387.239,Fox,784,166,52,28,31,21,24,10,784,732,704,563,264,228,72,94,391,393,81,320,217,0
19:28:24,4388.054,Fox,784,166,52,28,31,21,23,11,784,732,704,563,264,229,72,94,391,393,81,320,217,0
19:28:25,4390.719,Fox,786,168,54,28,31,19,25,11,786,732,704,563,266,229,73,95,392,394,81,320,217,0
19:28:25,4390.942,Fox,786,166,52,30,31,17,25,11,786,734,704,563,266,229,73,93,392,394,81,322,217,0
19:28:25,4391.598,Fox,786,166,52,30,29,19,25,11,786,734,704,565,266,229,73,93,392,394,81,322,217,0
19:28:25,4392.596,Fox,786,166,52,30,28,18,27,11,786,734,704,566,268,229,73,93,392,394,81,322,217,0
19:28:26,4394.488,Fox,786,165,52,30,26,20,25,12,786,734,704,568,268,231,73,92,392,394,81,322,218,0
19:28:26,4395.341,Fox,786,165,52,30,24,22,25,12,786,734,704,570,268,231,73,92,392,394,81,322,218,0
19:28:26,4395.738,Fox,786,165,52,30,24,21,26,12,786,734,704,570,269,231,73,92,392,394,81,322,218,0
19:28:27,4396.758,Fox,786,165,52,30,24,21,25,13,786,734,704,570,269,232,73,92,392,394,81,322,218,0
19:28:27,4397.589,Fox,788,167,54,30,24,21,25,13,788,734,704,570,269,232,74,93,393,395,81,322,218,0
19:28:27,4399.046,Fox,788,167,54,30,24,20,26,13,788,734,704,570,270,232,74,93,393,395,81,322,218,0
19:28:28,4401.563,Fox,788,167,54,28,26,20,24,15,788,734,706,570,270,234,74,93,393,395,81,322,218,0
19:28:28,4402.143,Fox,788,164,54,26,28,18,24,14,788,734,708,570,270,234,73,91,393,395,81,324,219,0
19:28:29,4403.191,Fox,788,163,54,26,28,17,24,14,788,734,708,570,270,234,73,90,393,395,81,325,219,0
19:28:29,4403.829,Fox,788,162,54,26,26,19,24,13,788,734,708,572,270,234,73,89,393,395,81,325,220,0
19:28:29,4404.251,Fox,788,162,54,24,28,19,24,13,788,734,710,572,270,234,73,89,393,395,81,325,220,0
19:28:30,4405.873,Fox,788,159,52,26,28,17,24,12,788,736,710,572,270,234,72,87,393,395,81,327,221,0
19:28:30,4407.906,Fox,790,159,54,26,27,17,24,11,790,736,710,572,270,234,73,86,395,395,81,328,222,0
19:28:31,4408.977,Fox,790,159,54,24,29,17,24,11,790,736,712,572,270,234,73,86,395,395,81,328,222,0
19:28:31,4410.245,Fox,790,159,54,22,31,17,24,11,790,736,714,572,270,234,73,86,395,395,81,328,222,0
19:28:31,4411.2,Fox,790,159,54,20,33,17,24,11,790,736,716,572,270,234,73,86,395,395,81,328,222,0
19:28:32,4411.771,Fox,790,159,52,22,33,17,24,11,790,738,716,572,270,234,73,86,395,395,81,328,222,0
19:28:32,4412.38,Fox,790,159,50,24,33,16,25,11,790,740,716,572,271,234,73,86,395,395,81,328,222,0
19:28:32,4413.188,Fox,790,159,50,20,37,16,25,11,790,740,720,572,271,234,73,86,395,395,81,328,222,0
19:28:32,4413.615,Fox,792,160,52,20,37,16,25,10,792,740,720,572,271,234,74,86,397,395,81,329,222,0
19:28:32,4413.847,Fox,792,159,52,20,37,16,25,9,792,740,720,572,271,234,73,86,397,395,81,329,223,0
19:28:33,4414.693,Fox,792,159,50,22,37,16,25,9,792,742,720,572,271,234,73,86,397,395,81,329,223,0
19:28:33,4415.546,Fox,794,160,52,22,36,16,25,9,794,742,720,572,271,234,73,87,398,396,81,330,223,0
19:28:33,4415.971,Fox,794,160,52,20,38,16,25,9,794,742,722,572,271,234,73,87,398,396,81,330,223,0
19:28:33,4417.174,Fox,796,162,54,20,38,16,25,9,796,742,722,572,271,234,74,88,399,397,81,330,223,0
19:28:34,4417.616,Fox,796,162,50,22,40,16,25,9,796,746,724,572,271,234,74,88,399,397,81,330,223,0
19:28:34,4418.682,Fox,798,163,50,20,41,16,25,9,796,746,726,572,271,234,73,90,399,399,81,331,223,0
19:28:34,4418.914,Fox,798,163,52,20,41,16,25,9,798,746,726,572,271,234,73,90,399,399,81,331,223,0
19:28:34,4419.767,Fox,798,163,50,22,41,16,25,9,798,748,726,572,271,234,73,90,399,399,81,331,223,0
19:28:34,4420.407,Fox,798,163,50,20,43,16,25,9,798,748,728,572,271,234,73,90,399,399,81,331,223,0
19:28:35,4421.479,Fox,798,163,48,22,43,16,25,9,798,750,728,572,271,234,73,90,399,399,81,331,223,0
19:28:35,4421.868,Fox,798,163,48,22,43,14,27,9,798,750,728,572,273,234,73,90,399,399,81,331,223,0
19:28:35,4422.466,Fox,798,163,48,22,41,16,27,9,798,750,728,574,273,234,73,90,399,399,81,331,223,0
19:28:35,4423.083,Fox,798,163,46,24,41,16,27,9,798,752,728,574,273,234,73,90,399,399,81,331,223,0
19:28:36,4423.898,Fox,800,164,48,24,40,16,27,9,800,752,728,574,273,234,74,90,401,399,81,332,223,0
19:28:36,4425.22,Fox,800,164,48,22,40,18,27,9,800,752,730,576,273,234,74,90,401,399,81,332,223,0
19:28:36,4425.665,Fox,804,167,50,20,41,18,27,9,802,752,732,576,273,234,76,91,404,400,81,333,223,0
19:28:36,4425.895,Fox,804,167,52,20,41,18,27,9,804,752,732,576,273,234,76,91,404,400,81,333,223,0
19:28:37,4426.561,Fox,804,167,50,22,41,18,27,9,804,754,732,576,273,234,76,91,404,400,81,333,223,0
19:28:38,4429.521,Fox,804,167,50,20,41,20,27,9,804,754,734,578,273,234,76,91,404,400,81,333,223,0
19:28:38,4430.588,Fox,804,167,50,20,39,22,27,9,804,754,734,580,273,234,76,91,404,400,81,333,223,0
19:28:38,4431.638,Fox,804,167,46,24,39,22,27,9,804,758,734,580,273,234,76,91,404,400,81,333,223,0
19:28:38,4432.204,Fox,804,166,44,26,39,22,27,8,804,760,734,580,273,234,75,91,404,400,81,333,224,0
19:28:39,4432.793,Fox,804,164,44,26,39,20,27,8,804,760,734,580,273,234,75,89,404,400,81,335,224,0
19:28:39,4434.184,Fox,804,164,44,26,38,21,25,10,804,760,734,581,273,236,75,89,404,400,81,335,224,0
19:28:39,4434.798,Fox,804,163,44,26,38,21,25,9,804,760,734,581,273,236,74,89,404,400,81,335,225,0
19:28:40,4435.462,Fox,804,161,44,26,38,19,25,9,804,760,734,581,273,236,73,88,404,400,81,337,225,0
19:28:40,4436.34,Fox,806,163,46,26,38,19,25,9,806,760,734,581,273,236,74,89,405,401,81,337,225,0
19:28:41,4439.655,Fox,806,161,46,26,38,17,24,10,806,760,734,581,273,237,74,87,405,401,81,339,225,0
19:28:41,4440.097,Fox,806,160,46,26,38,17,24,9,806,760,734,581,273,237,74,86,405,401,81,339,226,0
19:28:41,4440.788,Fox,806,160,46,26,35,20,24,9,806,760,734,584,273,237,74,86,405,401,81,339,226,0
19:28:42,4441.397,Fox,808,159,46,26,34,18,24,9,806,760,734,584,273,237,72,87,405,403,81,342,226,0
19:28:42,4441.834,Fox,808,158,48,26,34,18,24,8,808,760,734,584,273,237,72,86,405,403,81,342,227,0
19:28:42,4442.839,Fox,808,158,48,26,32,20,24,8,808,760,734,586,273,237,72,86,405,403,81,342,227,0
19:28:42,4443.418,Fox,808,158,48,26,30,22,24,8,808,760,734,588,273,237,72,86,405,403,81,342,227,0
19:28:43,4444.442,Fox,808,157,48,24,32,21,24,8,808,760,736,588,273,237,72,85,405,403,81,343,227,0
19:28:43,4445.106,Fox,808,157,44,28,32,21,24,8,808,764,736,588,273,237,72,85,405,403,81,343,227,0
19:28:43,4445.322,Fox,808,157,42,30,32,21,24,8,808,766,736,588,273,237,72,85,405,403,81,343,227,0
19:28:43,4447.184,Fox,808,157,42,30,31,22,24,8,808,766,736,589,273,237,72,85,405,403,81,343,227,0
19:28:44,4448.607,Fox,808,156,40,32,31,22,23,8,808,768,736,589,273,237,71,85,405,403,81,344,227,0
19:28:44,4448.998,Fox,808,156,38,34,31,22,23,8,808,770,736,589,273,237,71,85,405,403,81,344,227,0
19:28:45,4449.875,Fox,814,161,42,36,30,22,21,10,814,772,736,589,273,239,73,88,408,406,81,345,227,0
19:28:45,4450.345,Fox,816,162,44,34,31,22,21,10,816,772,738,589,273,239,73,89,409,407,81,346,227,0
19:28:45,4450.922,Fox,816,161,44,32,33,21,21,10,816,772,740,589,273,239,73,88,409,407,81,347,227,0
19:28:45,4451.276,Fox,816,160,44,32,33,20,21,10,816,772,740,589,273,239,72,88,409,407,81,348,227,0
19:28:45,4452.295,Fox,816,160,42,34,33,20,21,10,816,774,740,589,273,239,72,88,409,407,81,348,227,0
19:28:46,4453.132,Fox,822,163,46,34,32,20,21,10,822,776,742,589,273,239,70,93,410,412,81,351,227,0
19:28:46,4453.349,Fox,822,161,46,34,32,18,21,10,822,776,742,589,273,239,70,91,410,412,81,353,227,0
19:28:46,4454.341,Fox,826,162,50,34,31,14,23,10,826,776,742,589,275,239,69,93,412,414,81,356,227,0
19:28:46,4455.579,Fox,828,164,52,34,31,14,23,10,828,776,742,589,275,239,70,94,413,415,81,356,227,0
19:28:47,4456.059,Fox,830,166,52,32,33,14,23,10,828,776,744,589,275,239,70,96,413,417,81,356,227,0
19:28:47,4456.304,Fox,830,166,54,30,35,14,23,10,830,776,746,589,275,239,70,96,413,417,81,356,227,0
19:28:47,4457.284,Fox,832,167,56,30,34,14,23,10,832,776,746,589,275,239,70,97,414,418,81,357,227,0
19:28:47,4457.772,Fox,832,166,56,30,34,13,23,10,832,776,746,589,275,239,70,96,414,418,81,358,227,0
19:28:47,4458.224,Fox,832,166,56,28,36,13,23,10,832,776,748,589,275,239,70,96,414,418,81,358,227,0
19:28:48,4459.855,Fox,832,166,54,28,38,13,23,10,832,778,750,589,275,239,70,96,414,418,81,358,227,0
19:28:48,4460.609,Fox,834,168,56,28,38,13,23,10,834,778,750,589,275,239,71,97,415,419,81,358,227,0
19:28:48,4461.091,Fox,834,168,54,30,38,13,21,12,834,780,750,589,275,241,71,97,415,419,81,358,227,0
19:28:48,4461.56,Fox,834,168,54,28,40,13,21,12,834,780,752,589,275,241,71,97,415,419,81,358,227,0
19:28:49,4462.235,Fox,836,170,54,28,39,14,21,12,834,780,752,590,275,241,72,98,416,420,81,358,227,0
19:28:49,4462.702,Fox,836,170,56,28,37,13,24,12,836,780,752,592,278,241,72,98,416,420,81,358,227,0
19:28:49,4463.605,Fox,836,170,56,28,37,10,27,12,836,780,752,592,281,241,72,98,416,420,81,358,227,0
19:28:49,4463.832,Fox,836,170,54,30,37,10,27,12,836,782,752,592,281,241,72,98,416,420,81,358,227,0
19:28:49,4464.233,Fox,836,169,54,30,37,10,27,11,836,782,752,592,281,241,72,97,416,420,81,358,228,0
19:28:49,4464.667,Fox,836,169,54,30,35,12,27,11,836,782,752,594,281,241,72,97,416,420,81,358,228,0
19:28:50,4465.104,Fox,836,169,54,28,37,12,27,11,836,782,754,594,281,241,72,97,416,420,81,358,228,0
19:28:50,4466.214,Fox,836,169,54,28,37,12,26,12,836,782,754,594,281,242,72,97,416,420,81,358,228,0
19:28:51,4468.422,Fox,838,170,54,30,36,12,26,12,838,784,754,594,281,242,73,97,418,420,81,359,228,0
19:28:51,4469.206,Fox,840,172,56,30,36,12,26,12,840,784,754,594,281,242,74,98,419,421,81,359,228,0
19:28:51,4469.644,Fox,840,172,56,30,35,13,26,12,840,784,754,595,281,242,74,98,419,421,81,359,228,0
19:28:51,4470.256,Fox,840,172,56,26,39,13,26,12,840,784,758,595,281,242,74,98,419,421,81,359,228,0
19:28:51,4470.645,Fox,840,172,56,24,39,15,26,12,840,784,760,597,281,242,74,98,419,421,81,359,228,0
19:28:52,4471.721,Fox,840,172,56,24,38,16,26,12,840,784,760,598,281,242,74,98,419,421,81,359,228,0
19:28:52,4472.105,Fox,840,171,56,24,38,16,24,13,840,784,760,598,281,244,73,98,419,421,81,359,229,0
19:28:52,4472.493,Fox,840,170,56,24,38,15,24,13,840,784,760,598,281,244,73,97,419,421,81,360,229,0
19:28:52,4472.936,Fox,840,168,56,24,38,13,24,13,840,784,760,598,281,244,73,95,419,421,81,362,229,0
19:28:52,4473.343,Fox,840,168,54,26,38,13,24,13,840,786,760,598,281,244,73,95,419,421,81,362,229,0
19:28:52,4473.769,Fox,840,168,54,26,37,14,24,13,840,786,760,599,281,244,73,95,419,421,81,362,229,0
19:28:53,4474.581,Fox,840,167,54,26,37,14,24,12,840,786,760,599,281,244,72,95,419,421,81,362,230,0
19:28:53,4475.222,Fox,840,166,54,26,37,13,24,12,840,786,760,599,281,244,72,94,419,421,81,363,230,0
19:28:53,4476.256,Fox,840,166,54,26,36,14,24,12,840,786,760,600,281,244,72,94,419,421,81,363,230,0
19:28:54,4477.876,Fox,840,166,54,26,35,15,24,12,840,786,760,601,281,244,72,94,419,421,81,363,230,0
19:28:54,4478.617,Fox,840,166,54,26,35,15,23,13,840,786,760,601,281,245,72,94,419,421,81,363,230,0
19:28:54,4479.215,Fox,842,167,54,26,33,16,23,13,840,786,760,603,281,245,72,95,420,422,81,364,230,0
19:28:54,4479.411,Fox,842,167,56,26,33,14,25,13,842,786,760,603,283,245,72,95,420,422,81,364,230,0
19:28:55,4480.213,Fox,842,166,54,28,33,13,25,13,842,788,760,603,283,245,72,94,420,422,81,365,230,0
19:28:55,4481.007,Fox,842,165,54,28,32,14,25,12,842,788,760,604,283,245,71,94,420,422,81,365,231,0
19:28:55,4481.558,Fox,842,164,54,28,32,14,25,11,842,788,760,604,283,245,71,93,420,422,81,365,232,0
19:28:55,4482.158,Fox,842,163,54,28,32,13,25,11,842,788,760,604,283,245,70,93,420,422,81,366,232,0
19:28:56,4483.498,Fox,842,163,54,24,36,13,25,11,842,788,764,604,283,245,70,93,420,422,81,366,232,0
19:28:56,4483.852,Fox,842,163,54,22,38,13,25,11,842,788,766,604,283,245,70,93,420,422,81,366,232,0
19:28:56,4484.462,Fox,844,164,56,22,38,12,25,11,844,788,766,604,283,245,70,94,420,424,81,367,232,0
19:28:56,4485.673,Fox,844,164,56,22,36,14,25,11,844,788,766,606,283,245,70,94,420,424,81,367,232,0
19:28:57,4486.268,Fox,844,163,56,22,34,16,25,10,844,788,766,608,283,245,70,93,420,424,81,367,233,0
19:28:57,4486.816,Fox,844,162,56,22,34,15,25,10,844,788,766,608,283,245,70,92,420,424,81,368,233,0
19:28:57,4487.23,Fox,844,162,56,20,36,15,25,10,844,788,768,608,283,245,70,92,420,424,81,368,233,0
19:28:57,4487.63,Fox,844,162,56,18,38,15,25,10,844,788,770,608,283,245,70,92,420,424,81,368,233,0
19:28:57,4488.014,Fox,844,162,56,16,40,13,27,10,844,788,772,608,285,245,70,92,420,424,81,368,233,0
19:28:57,4488.387,Fox,844,161,56,16,40,12,27,10,844,788,772,608,285,245,70,91,420,424,81,369,233,0
19:28:58,4489.164,Fox,844,160,56,16,40,12,27,9,844,788,772,608,285,245,70,90,420,424,81,369,234,0
19:28:58,4489.572,Fox,844,159,56,16,40,11,27,9,844,788,772,608,285,245,70,89,420,424,81,370,234,0
19:28:58,4489.964,Fox,844,159,56,16,38,13,27,9,844,788,772,610,285,245,70,89,420,424,81,370,234,0
19:28:58,4490.641,Fox,846,160,56,18,37,13,27,9,846,790,772,610,285,245,70,90,421,425,81,371,234,0
19:28:58,4491.085,Fox,848,162,56,16,39,13,27,9,846,790,774,610,285,245,72,90,423,425,81,371,234,0
19:28:58,4491.508,Fox,848,161,58,14,41,12,27,9,848,790,776,610,285,245,72,89,423,425,81,372,234,0
19:29:00,4496.257,Fox,850,160,58,16,40,10,27,9,850,792,776,610,285,245,72,88,424,426,81,375,234,0
19:29:00,4497.593,Fox,852,161,58,16,39,8,29,9,850,792,776,610,287,245,71,90,424,428,81,376,234,0
19:29:01,4498.068,Fox,852,160,58,18,39,8,29,8,852,794,776,610,287,245,71,89,424,428,81,376,235,0
19:29:01,4498.302,Fox,852,160,58,16,41,8,29,8,852,794,778,610,287,245,71,89,424,428,81,376,235,0
19:29:01,4499.932,Fox,852,160,56,16,43,8,29,8,852,796,780,610,287,245,71,89,424,428,81,376,235,0
19:29:02,4500.758,Fox,854,161,56,16,43,7,29,8,852,796,780,610,287,245,71,90,425,429,81,377,235,0
19:29:02,4500.963,Fox,854,161,58,16,43,7,29,8,854,796,780,610,287,245,71,90,425,429,81,377,235,0
19:29:02,4501.627,Fox,856,163,58,18,43,7,29,8,856,798,780,610,287,245,73,90,427,429,81,377,235,0
19:29:02,4502.319,Fox,856,163,58,16,45,7,29,8,856,798,782,610,287,245,73,90,427,429,81,377,235,0
19:29:03,4504.883,Fox,856,163,58,16,44,8,29,8,856,798,782,611,287,245,73,90,427,429,81,377,235,0
19:29:03,4506.456,Fox,856,163,56,18,44,8,29,8,856,800,782,611,287,245,73,90,427,429,81,377,235,0
19:29:04,4507.144,Fox,858,164,58,16,45,8,29,8,858,800,784,611,287,245,72,92,427,431,81,378,235,0
19:29:04,4507.597,Fox,860,165,60,16,44,8,29,8,860,800,784,611,287,245,72,93,428,432,81,379,235,0
19:29:04,4508.475,Fox,860,165,56,20,44,8,29,8,860,804,784,611,287,245,72,93,428,432,81,379,235,0
19:29:05,4509.895,Fox,860,165,56,20,44,8,27,10,860,804,784,611,287,247,72,93,428,432,81,379,235,0
19:29:05,4510.934,Fox,860,165,56,20,43,9,27,10,860,804,784,612,287,247,72,93,428,432,81,379,235,0
19:29:05,4511.322,Fox,860,164,56,20,42,10,27,9,860,804,784,613,287,247,72,92,428,432,81,379,236,0
19:29:05,4511.74,Fox,860,164,56,18,44,10,27,9,860,804,786,613,287,247,72,92,428,432,81,379,236,0
19:29:06,4513.71,Fox,862,166,58,18,43,11,27,9,862,804,786,614,287,247,74,92,430,432,81,379,236,0
19:29:06,4515.007,Fox,862,165,58,18,43,11,27,8,862,804,786,614,287,247,73,92,430,432,81,379,237,0
19:29:07,4516.273,Fox,862,165,58,18,41,13,27,8,862,804,786,616,287,247,73,92,430,432,81,379,237,0
19:29:07,4516.672,Fox,862,165,58,18,39,15,27,8,862,804,786,618,287,247,73,92,430,432,81,379,237,0
19:29:08,4518.917,Fox,862,165,56,18,39,17,27,8,862,806,788,620,287,247,73,92,430,432,81,379,237,0
19:29:08,4520.271,Fox,862,165,56,18,37,19,27,8,862,806,788,622,287,247,73,92,430,432,81,379,237,0
19:29:08,4520.839,Fox,862,165,56,18,37,19,24,11,862,806,788,622,287,250,73,92,430,432,81,379,237,0
19:29:08,4521.271,Fox,862,163,56,18,37,18,24,10,862,806,788,622,287,250,72,91,430,432,81,380,238,0
19:29:09,4521.918,Fox,864,163,58,18,36,17,24,10,864,806,788,622,287,250,72,91,431,433,81,382,238,0
19:29:09,4522.129,Fox,864,163,58,18,34,19,24,10,864,806,788,624,287,250,72,91,431,433,81,382,238,0
19:29:09,4522.822,Fox,866,164,58,18,34,19,24,9,864,806,788,624,287,250,73,91,432,434,81,382,239,0
19:29:09,4523.235,Fox,868,165,60,18,33,19,24,9,866,806,788,624,287,250,74,91,434,434,81,383,239,0
19:29:09,4523.693,Fox,868,165,62,18,33,19,23,10,868,806,788,624,287,251,74,91,434,434,81,383,239,0
19:29:09,4524.136,Fox,868,164,60,20,33,18,23,10,868,808,788,624,287,251,74,90,434,434,81,384,239,0
19:29:10,4525.412,Fox,870,165,62,20,33,17,23,10,870,808,788,624,287,251,73,92,434,436,81,385,239,0
19:29:10,4525.629,Fox,870,165,62,20,31,19,23,10,870,808,788,626,287,251,73,92,434,436,81,385,239,0
19:29:10,4526.676,Fox,870,163,62,20,31,17,23,10,870,808,788,626,287,251,73,90,434,436,81,387,239,0
19:29:10,4527.141,Fox,870,161,62,20,31,15,23,10,870,808,788,626,287,251,73,88,434,436,81,389,239,0
19:29:11,4528.035,Fox,870,161,62,20,31,15,21,12,870,808,788,626,287,253,73,88,434,436,81,389,239,0
19:29:11,4528.741,Fox,872,163,64,20,31,15,21,12,872,808,788,626,287,253,75,88,436,436,81,389,239,0
19:29:11,4528.973,Fox,872,162,64,18,33,15,21,11,872,808,790,626,287,253,74,88,436,436,81,389,240,0
19:29:11,4529.888,Fox,872,162,64,18,33,15,19,13,872,808,790,626,287,255,74,88,436,436,81,389,240,0
19:29:11,4530.7,Fox,872,162,64,18,30,18,19,13,872,808,790,629,287,255,74,88,436,436,81,389,240,0
19:29:12,4531.128,Fox,874,163,66,18,27,20,19,13,874,808,790,631,287,255,73,90,436,438,81,390,240,0
19:29:12,4532.771,Fox,874,162,60,24,27,20,19,12,874,814,790,631,287,255,72,90,436,438,81,390,241,0
19:29:12,4532.977,Fox,874,162,58,26,27,20,19,12,874,816,790,631,287,255,72,90,436,438,81,390,241,0
19:29:12,4533.404,Fox,874,162,58,26,27,20,18,13,874,816,790,631,287,256,72,90,436,438,81,390,241,0
19:29:13,4534.241,Fox,874,162,58,26,27,19,19,13,874,816,790,631,288,256,72,90,436,438,81,390,241,0
19:29:13,4534.688,Fox,874,162,58,24,29,19,19,13,874,816,792,631,288,256,72,90,436,438,81,390,241,0
19:29:13,4535.782,Fox,874,162,52,30,29,19,19,13,874,822,792,631,288,256,72,90,436,438,81,390,241,0
19:29:14,4536.813,Fox,874,162,48,32,31,19,18,14,874,826,794,631,288,257,72,90,436,438,81,390,241,0
19:29:14,4537.419,Fox,876,164,50,32,31,19,18,14,876,826,794,631,288,257,73,91,437,439,81,390,241,0
19:29:14,4538.247,Fox,876,164,48,32,33,19,18,14,876,828,796,631,288,257,73,91,437,439,81,390,241,0
19:29:14,4538.885,Fox,876,164,46,34,33,19,18,14,876,830,796,631,288,257,73,91,437,439,81,390,241,0
19:29:15,4540.143,Fox,878,165,44,34,34,19,18,14,876,832,798,631,288,257,72,93,437,441,81,391,241,0
19:29:15,4540.59,Fox,878,164,46,34,34,19,18,13,878,832,798,631,288,257,72,92,437,441,81,391,242,0
19:29:15,4541.235,Fox,878,161,46,34,34,16,18,13,878,832,798,631,288,257,71,90,437,441,81,394,242,0
19:29:15,4541.708,Fox,878,159,46,34,34,14,18,13,878,832,798,631,288,257,71,88,437,441,81,396,242,0
19:29:16,4543.343,Fox,880,161,46,36,34,14,18,13,880,834,798,631,288,257,71,90,437,443,81,396,242,0
19:29:16,4544.165,Fox,880,161,46,36,32,16,18,13,880,834,798,633,288,257,71,90,437,443,81,396,242,0
19:29:16,4544.355,Fox,880,161,46,36,30,18,18,13,880,834,798,635,288,257,71,90,437,443,81,396,242,0
19:29:16,4544.955,Fox,882,163,46,36,32,18,18,13,882,836,800,635,288,257,71,92,437,445,81,396,242,0
19:29:17,4546.972,Fox,882,163,46,32,36,18,18,13,882,836,804,635,288,257,71,92,437,445,81,396,242,0
19:29:17,4547.739,Fox,882,163,46,32,34,20,18,13,882,836,804,637,288,257,71,92,437,445,81,396,242,0
19:29:17,4548.155,Fox,882,163,46,32,32,22,18,13,882,836,804,639,288,257,71,92,437,445,81,396,242,0
19:29:17,4548.577,Fox,882,163,46,32,30,24,18,13,882,836,804,641,288,257,71,92,437,445,81,396,242,0
19:29:18,4549.581,Fox,882,163,46,32,30,24,17,14,882,836,804,641,288,258,71,92,437,445,81,396,242,0
19:29:18,4549.959,Fox,882,162,46,32,30,24,17,13,882,836,804,641,288,258,70,92,437,445,81,396,243,0
19:29:18,4550.766,Fox,884,164,48,32,30,24,17,13,884,836,804,641,288,258,71,93,438,446,81,396,243,0
19:29:18,4550.98,Fox,884,163,46,34,30,24,17,12,884,838,804,641,288,258,70,93,438,446,81,396,244,0
19:29:18,4551.407,Fox,884,163,46,34,28,26,17,12,884,838,804,643,288,258,70,93,438,446,81,396,244,0
19:29:19,4552.011,Fox,884,163,44,36,27,27,17,12,884,840,804,644,288,258,70,93,438,446,81,396,244,0
19:29:19,4554.503,Fox,884,161,44,36,27,25,17,12,884,840,804,644,288,258,70,91,438,446,81,398,244,0
19:29:20,4554.885,Fox,884,160,44,36,27,24,17,12,884,840,804,644,288,258,69,91,438,446,81,399,244,0
19:29:20,4556.062,Fox,886,162,46,36,27,24,17,12,886,840,804,644,288,258,69,93,438,448,81,399,244,0
19:29:20,4557.343,Fox,886,162,46,34,29,24,17,12,886,840,806,644,288,258,69,93,438,448,81,399,244,0
19:29:21,4558.166,Fox,886,162,46,34,29,23,18,12,886,840,806,644,289,258,69,93,438,448,81,399,244,0
19:29:21,4558.765,Fox,886,162,46,34,27,25,18,12,886,840,806,646,289,258,69,93,438,448,81,399,244,0
19:29:21,4559.386,Fox,886,160,46,34,27,23,16,14,886,840,806,646,289,260,69,91,438,448,81,401,244,0
19:29:21,4560.045,Fox,886,160,46,34,25,25,16,14,886,840,806,648,289,260,69,91,438,448,81,401,244,0
19:29:22,4562.048,Fox,886,158,44,36,25,23,16,14,886,842,806,648,289,260,69,89,438,448,81,403,244,0
19:29:22,4562.684,Fox,886,157,44,34,26,23,16,14,886,842,808,649,289,260,69,88,438,448,81,404,244,0
19:29:22,4563.508,Fox,888,159,46,34,26,23,16,14,888,842,808,649,289,260,70,89,439,449,81,404,244,0
19:29:23,4564.131,Fox,888,158,46,34,26,21,18,13,888,842,808,649,291,260,70,88,439,449,81,404,245,0
19:29:23,4564.35,Fox,888,157,46,34,26,21,18,12,888,842,808,649,291,260,70,87,439,449,81,404,246,0
19:29:23,4566.331,Fox,890,159,48,34,26,21,18,12,890,842,808,649,291,260,71,88,440,450,81,404,246,0
19:29:24,4567.233,Fox,890,159,46,36,24,23,18,12,890,844,808,651,291,260,71,88,440,450,81,404,246,0
19:29:25,4570.547,Fox,890,157,46,36,24,22,18,11,890,844,808,651,291,260,71,86,440,450,82,404,247,0
19:29:25,4570.931,Fox,890,157,46,30,30,22,18,11,890,844,814,651,291,260,71,86,440,450,82,404,247,0
19:29:25,4571.382,Fox,890,157,46,28,32,22,18,11,890,844,816,651,291,260,71,86,440,450,82,404,247,0
19:29:25,4572.385,Fox,890,157,46,28,30,24,18,11,890,844,816,653,291,260,71,86,440,450,82,404,247,0
19:29:26,4573.443,Fox,892,158,46,30,29,24,18,11,892,846,816,653,291,260,71,87,441,451,82,405,247,0
19:29:26,4574.095,Fox,896,161,46,32,28,24,18,11,894,848,816,653,291,260,71,90,442,454,82,406,247,0
19:29:26,4574.565,Fox,898,163,50,26,34,24,18,11,898,848,822,653,291,260,71,92,442,456,82,406,247,0
19:29:26,4575.473,Fox,898,163,50,22,38,24,18,11,898,848,826,653,291,260,71,92,442,456,82,406,247,0
19:29:27,4576.536,Fox,898,163,50,20,40,24,18,11,898,848,828,653,291,260,71,92,442,456,82,406,247,0
19:29:27,4577.335,Fox,898,163,50,18,42,24,18,11,898,848,830,653,291,260,71,92,442,456,82,406,247,0
19:29:27,4577.992,Fox,900,162,50,18,41,22,18,11,898,848,830,653,291,260,70,92,442,458,82,409,247,0
19:29:27,4578.461,Fox,900,161,52,16,43,22,18,10,900,848,832,653,291,260,70,91,442,458,82,409,248,0
19:29:28,4579.141,Fox,900,161,50,18,41,24,18,10,900,850,832,655,291,260,70,91,442,458,82,409,248,0
19:29:28,4579.787,Fox,900,161,50,18,41,22,20,10,900,850,832,655,293,260,70,91,442,458,82,409,248,0
19:29:28,4580.419,Fox,900,161,48,20,41,22,20,10,900,852,832,655,293,260,70,91,442,458,82,409,248,0
19:29:28,4581.585,Fox,900,161,48,18,43,22,20,10,900,852,834,655,293,260,70,91,442,458,82,409,248,0
19:29:29,4582.859,Fox,900,159,48,18,43,20,20,10,900,852,834,655,293,260,69,90,442,458,82,411,248,0
19:29:29,4583.552,Fox,900,159,46,18,45,19,21,10,900,854,836,655,294,260,69,90,442,458,82,411,248,0
19:29:29,4584.415,Fox,902,160,44,20,44,19,21,10,900,856,836,655,294,260,69,91,443,459,82,412,248,0
19:29:30,4584.619,Fox,902,160,46,20,44,19,21,10,902,856,836,655,294,260,69,91,443,459,82,412,248,0
19:29:30,4585.721,Fox,904,162,48,20,44,19,21,10,904,856,836,655,294,260,70,92,444,460,82,412,248,0
19:29:30,4586.184,Fox,906,163,50,20,43,19,21,10,906,856,836,655,294,260,70,93,445,461,82,413,248,0
19:29:30,4587.536,Fox,908,164,50,20,43,19,21,9,906,856,836,655,294,260,71,93,446,462,82,413,249,0
19:29:31,4587.773,Fox,908,164,52,20,43,19,21,9,908,856,836,655,294,260,71,93,446,462,82,413,249,0
19:29:31,4589.839,Fox,908,164,50,20,44,20,21,9,908,858,838,656,294,260,71,93,446,462,82,413,249,0
19:29:31,4590.305,Fox,908,164,48,20,46,20,21,9,908,860,840,656,294,260,71,93,446,462,82,413,249,0
19:29:32,4591.817,Fox,908,163,48,20,46,20,19,10,908,860,840,656,294,262,71,92,446,462,82,413,250,0
19:29:32,4592.694,Fox,910,164,50,20,45,20,19,10,910,860,840,656,294,262,71,93,447,463,82,414,250,0
19:29:33,4595.38,Fox,912,166,52,20,45,20,19,10,912,860,840,656,294,262,72,94,448,464,82,414,250,0
19:29:33,4596.321,Fox,912,166,50,22,45,20,19,10,912,862,840,656,294,262,72,94,448,464,82,414,250,0
19:29:34,4597.187,Fox,912,166,50,22,43,22,19,10,912,862,840,658,294,262,72,94,448,464,82,414,250,0
19:29:34,4598.709,Fox,912,166,50,22,42,22,20,10,912,862,840,659,295,262,72,94,448,464,82,414,250,0
19:29:34,4599.382,Fox,914,167,52,22,42,21,20,10,914,862,840,659,295,262,73,94,450,464,82,415,250,0
19:29:34,4599.614,Fox,914,166,52,22,42,21,20,9,914,862,840,659,295,262,73,93,450,464,82,415,251,0
19:29:35,4600.516,Fox,914,165,52,20,42,23,17,11,914,862,842,661,295,265,73,92,450,464,82,415,252,0
19:29:35,4601.044,Fox,914,164,52,20,42,23,14,13,914,862,842,661,295,268,73,91,450,464,82,415,253,0
19:29:36,4602.783,Fox,916,166,54,20,42,23,14,13,916,862,842,661,295,268,74,92,451,465,82,415,253,0
19:29:36,4604.494,Fox,916,166,52,22,42,23,14,13,916,864,842,661,295,268,74,92,451,465,82,415,253,0
19:29:37,4605.587,Fox,916,166,50,22,42,25,14,13,916,866,844,663,295,268,74,92,451,465,82,415,253,0
19:29:37,4606.044,Fox,916,166,48,24,42,25,14,13,916,868,844,663,295,268,74,92,451,465,82,415,253,0
19:29:37,4607.575,Fox,916,164,48,24,39,26,14,13,916,868,844,666,295,268,73,91,451,465,82,417,253,0
19:29:37,4608.194,Fox,918,166,48,26,39,26,14,13,918,870,844,666,295,268,74,92,452,466,82,417,253,0
19:29:38,4608.842,Fox,918,165,48,26,39,26,14,12,918,870,844,666,295,268,73,92,452,466,82,417,254,0
19:29:38,4609.482,Fox,920,166,50,26,39,25,14,12,920,870,844,666,295,268,75,91,454,466,82,418,254,0
19:29:38,4609.957,Fox,924,169,52,26,38,25,14,12,922,870,844,666,295,268,78,91,458,466,82,419,254,0
19:29:38,4610.22,Fox,924,169,54,26,38,25,14,12,924,870,844,666,295,268,78,91,458,466,82,419,254,0
19:29:38,4610.96,Fox,924,166,54,26,38,23,14,11,924,870,844,666,295,268,77,89,458,466,82,421,255,0
19:29:39,4611.714,Fox,924,165,52,26,40,23,14,10,924,872,846,666,295,268,76,89,458,466,82,421,256,0
19:29:39,4612.389,Fox,928,168,54,24,41,22,15,10,926,872,848,666,296,268,77,91,460,468,82,422,256,0
19:29:39,4612.608,Fox,928,168,56,24,41,22,15,10,928,872,848,666,296,268,77,91,460,468,82,422,256,0
19:29:39,4613.902,Fox,928,168,54,26,41,20,17,10,928,874,848,666,298,268,77,91,460,468,82,422,256,0
19:29:40,4615.554,Fox,928,168,54,26,41,18,19,10,928,874,848,666,300,268,77,91,460,468,82,422,256,0
19:29:40,4615.979,Fox,928,166,54,26,41,16,19,10,928,874,848,666,300,268,75,91,460,468,82,424,256,0
19:29:40,4616.897,Fox,928,166,54,26,41,16,17,12,928,874,848,666,300,270,75,91,460,468,82,424,256,0
19:29:41,4617.629,Fox,930,168,54,24,43,16,17,12,928,874,850,666,300,270,76,92,461,469,82,424,256,0
19:29:41,4617.897,Fox,930,165,56,24,42,14,17,12,930,874,850,667,300,270,74,91,461,469,82,427,256,0
19:29:41,4619.097,Fox,930,165,56,22,44,12,19,12,930,874,852,667,302,270,74,91,461,469,82,427,256,0
19:29:41,4619.823,Fox,932,166,58,22,43,12,19,12,932,874,852,667,302,270,73,93,461,471,82,428,256,0
19:29:41,4620.295,Fox,934,168,58,24,43,12,19,12,934,876,852,667,302,270,74,94,462,472,82,428,256,0
19:29:42,4620.777,Fox,936,170,60,24,43,12,19,12,936,876,852,667,302,270,75,95,463,473,82,428,256,0
19:29:42,4622.22,Fox,938,170,62,22,44,12,19,11,938,876,854,667,302,270,74,96,464,474,82,429,257,0
19:29:42,4622.978,Fox,938,170,60,22,46,12,19,11,938,878,856,667,302,270,74,96,464,474,82,429,257,0
19:29:42,4623.221,Fox,938,170,60,22,44,14,19,11,938,878,856,669,302,270,74,96,464,474,82,429,257,0
19:29:43,4625.899,Fox,938,170,58,24,44,14,17,13,938,880,856,669,302,272,74,96,464,474,82,429,257,0
19:29:44,4627.512,Fox,938,170,56,26,44,14,17,13,938,882,856,669,302,272,74,96,464,474,82,429,257,0
19:29:44,4628.176,Fox,938,170,56,24,46,14,17,13,938,882,858,669,302,272,74,96,464,474,82,429,257,0
19:29:44,4628.741,Fox,938,170,56,22,48,14,17,13,938,882,860,669,302,272,74,96,464,474,82,429,257,0
19:29:45,4629.748,Fox,940,172,58,22,48,14,17,13,940,882,860,669,302,272,76,96,466,474,82,429,257,0
19:29:45,4630.006,Fox,940,171,58,22,48,14,17,12,940,882,860,669,302,272,76,95,466,474,82,429,258,0
19:29:45,4631.454,Fox,940,171,58,22,43,19,17,12,940,882,860,674,302,272,76,95,466,474,82,429,258,0
19:29:45,4631.93,Fox,940,171,58,22,41,21,17,12,940,882,860,676,302,272,76,95,466,474,82,429,258,0
19:29:46,4633.713,Fox,940,170,56,24,41,20,17,12,940,884,860,676,302,272,76,94,466,474,82,430,258,0
19:29:46,4634.802,Fox,940,170,56,22,38,25,15,14,940,884,862,681,302,274,76,94,466,474,82,430,258,0
19:29:46,4635.476,Fox,942,172,58,22,38,25,15,14,942,884,862,681,302,274,76,96,466,476,82,430,258,0
19:29:47,4635.933,Fox,942,172,58,22,35,28,15,14,942,884,862,684,302,274,76,96,466,476,82,430,258,0
19:29:47,4637.23,Fox,942,172,58,22,33,30,15,14,942,884,862,686,302,274,76,96,466,476,82,430,258,0
19:29:47,4637.967,Fox,942,172,58,22,31,31,16,14,942,884,862,688,303,274,76,96,466,476,82,430,258,0
19:29:48,4639.067,Fox,946,174,58,24,28,32,16,14,944,886,862,690,303,274,77,97,469,477,82,432,258,0
19:29:48,4639.313,Fox,946,174,60,24,28,32,16,14,946,886,862,690,303,274,77,97,469,477,82,432,258,0
19:29:49,4641.19,Fox,946,174,60,24,28,30,18,14,946,886,862,690,305,274,77,97,469,477,82,432,258,0
19:29:49,4641.87,Fox,946,173,60,24,28,27,20,14,946,886,862,690,307,274,77,96,469,477,82,433,258,0
19:29:49,4642.073,Fox,946,173,60,24,27,28,20,14,946,886,862,691,307,274,77,96,469,477,82,433,258,0
19:29:49,4642.499,Fox,946,172,60,24,27,27,20,14,946,886,862,691,307,274,77,95,469,477,82,434,258,0
19:29:49,4642.956,Fox,946,172,60,22,29,27,20,14,946,886,864,691,307,274,77,95,469,477,82,434,258,0
19:29:50,4644.058,Fox,946,172,60,20,29,29,20,14,946,886,866,693,307,274,77,95,469,477,82,434,258,0
19:29:50,4644.494,Fox,946,172,60,18,31,29,20,14,946,886,868,693,307,274,77,95,469,477,82,434,258,0
19:29:50,4645.295,Fox,946,167,60,18,31,24,20,14,946,886,868,693,307,274,77,90,469,477,82,439,258,0
19:29:50,4646.441,Fox,946,165,58,18,33,22,20,14,946,888,870,693,307,274,77,88,469,477,82,441,258,0
19:29:51,4648.493,Fox,946,163,58,18,33,20,20,14,946,888,870,693,307,274,77,86,469,477,82,443,258,0
19:29:51,4649.279,Fox,946,161,56,20,33,18,20,14,946,890,870,693,307,274,76,85,469,477,82,445,258,0
19:29:51,4649.948,Fox,946,161,56,18,33,20,20,14,946,890,872,695,307,274,76,85,469,477,82,445,258,0
19:29:52,4650.892,Fox,946,161,56,18,31,22,20,14,946,890,872,697,307,274,76,85,469,477,82,445,258,0
19:29:52,4652.405,Fox,946,160,56,16,33,20,22,13,946,890,874,697,309,274,76,84,469,477,82,445,259,0
19:29:52,4652.635,Fox,946,159,56,16,33,19,22,13,946,890,874,697,309,274,76,83,469,477,82,446,259,0
19:29:53,4653.582,Fox,946,159,56,16,33,18,23,13,946,890,874,697,310,274,76,83,469,477,82,446,259,0
19:29:53,4654.499,Fox,946,157,56,16,33,16,23,13,946,890,874,697,310,274,75,82,469,477,82,448,259,0
19:29:54,4656.313,Fox,946,157,54,18,33,15,24,13,946,892,874,697,311,274,75,82,469,477,82,448,259,0
19:29:54,4657.019,Fox,946,157,50,22,33,15,24,13,946,896,874,697,311,274,75,82,469,477,82,448,259,0
19:29:54,4657.246,Fox,946,156,48,24,33,15,24,12,946,898,874,697,311,274,75,81,469,477,82,448,260,0
19:29:54,4658.577,Fox,946,156,48,22,35,15,24,12,946,898,876,697,311,274,75,81,469,477,82,448,260,0
19:29:55,4661.067,Fox,946,156,46,24,34,16,24,12,946,900,876,698,311,274,75,81,469,477,82,448,260,0
19:29:55,4661.527,Fox,948,154,48,22,35,16,24,9,948,900,878,698,311,274,75,79,471,477,82,449,263,0
19:29:56,4663.94,Fox,950,155,50,22,34,16,24,9,950,900,878,698,311,274,75,80,472,478,82,450,263,0
19:29:56,4664.352,Fox,950,155,50,20,36,16,24,9,950,900,880,698,311,274,75,80,472,478,82,450,263,0
19:29:57,4666.153,Fox,950,154,50,18,36,18,24,8,950,900,882,700,311,274,74,80,472,478,82,450,264,0
19:29:57,4666.829,Fox,952,156,52,18,36,18,24,8,952,900,882,700,311,274,75,81,473,479,82,450,264,0
19:29:57,4667.47,Fox,952,155,50,20,36,17,24,8,952,902,882,700,311,274,75,80,473,479,82,451,264,0
19:29:58,4668.565,Fox,954,157,50,22,36,17,24,8,954,904,882,700,311,274,75,82,473,481,82,451,264,0
19:29:58,4668.782,Fox,954,157,48,24,36,17,24,8,954,906,882,700,311,274,75,82,473,481,82,451,264,0
19:29:58,4670.305,Fox,954,157,46,26,36,17,24,8,954,908,882,700,311,274,75,82,473,481,82,451,264,0
19:29:59,4671.715,Fox,954,156,46,26,36,16,23,9,954,908,882,700,311,275,75,81,473,481,82,452,264,0
19:29:59,4672.141,Fox,954,156,46,24,37,17,23,9,954,908,884,701,311,275,75,81,473,481,82,452,264,0
19:29:59,4672.953,Fox,954,156,46,24,35,17,25,9,954,908,884,703,313,275,75,81,473,481,82,452,264,0
19:29:59,4673.325,Fox,956,158,48,24,35,17,25,9,956,908,884,703,313,275,75,83,473,483,82,452,264,0
19:30:00,4675.313,Fox,956,156,46,26,35,17,25,7,956,910,884,703,313,275,73,83,473,483,82,452,266,0
19:30:00,4676.263,Fox,958,158,48,26,35,17,25,7,958,910,884,703,313,275,74,84,474,484,82,452,266,0
19:30:01,4677.031,Fox,958,158,48,24,37,17,25,7,958,910,886,703,313,275,74,84,474,484,82,452,266,0
19:30:01,4677.943,Fox,958,158,46,26,35,19,25,7,958,912,886,705,313,275,74,84,474,484,82,452,266,0
19:30:01,4679.289,Fox,958,158,46,26,33,21,25,7,958,912,886,707,313,275,74,84,474,484,82,452,266,0
19:30:02,4681.403,Fox,960,159,48,26,32,21,25,7,960,912,886,707,313,275,74,85,475,485,82,453,266,0
19:30:02,4681.806,Fox,962,161,50,26,32,21,25,7,962,912,886,707,313,275,75,86,476,486,82,453,266,0
19:30:02,4682.015,Fox,962,161,48,28,32,21,25,7,962,914,886,707,313,275,75,86,476,486,82,453,266,0
19:30:02,4682.615,Fox,962,160,48,28,31,21,25,7,962,914,886,708,313,275,75,85,476,486,82,454,266,0
19:30:03,4683.216,Fox,964,161,50,28,28,23,25,7,964,914,886,710,313,275,76,85,478,486,82,455,266,0
19:30:03,4684.602,Fox,964,161,50,26,30,23,25,7,964,914,888,710,313,275,76,85,478,486,82,455,266,0
19:30:03,4685.339,Fox,964,161,48,28,30,23,25,7,964,916,888,710,313,275,76,85,478,486,82,455,266,0
19:30:04,4686.063,Fox,966,163,50,28,30,23,25,7,966,916,888,710,313,275,77,86,479,487,82,455,266,0
19:30:04,4686.245,Fox,966,162,50,28,30,23,25,6,966,916,888,710,313,275,76,86,479,487,82,455,267,0
19:30:04,4687.456,Fox,966,162,50,26,32,23,25,6,966,916,890,710,313,275,76,86,479,487,82,455,267,0
19:30:05,4688.976,Fox,968,164,50,26,30,25,25,6,966,916,890,712,313,275,76,88,479,489,82,455,267,0
19:30:05,4689.161,Fox,968,164,52,26,28,27,25,6,968,916,890,714,313,275,76,88,479,489,82,455,267,0
19:30:05,4690.136,Fox,970,164,52,26,28,25,25,6,968,916,890,714,313,275,78,86,481,489,82,457,267,0
19:30:05,4690.364,Fox,970,164,54,26,28,25,25,6,970,916,890,714,313,275,78,86,481,489,82,457,267,0
19:30:05,4690.78,Fox,970,164,52,28,28,25,25,6,970,918,890,714,313,275,78,86,481,489,82,457,267,0
19:30:05,4691.509,Fox,970,163,52,28,28,25,25,5,970,918,890,714,313,275,78,85,481,489,82,457,268,0
19:30:06,4692.294,Fox,970,162,50,30,28,25,25,4,970,920,890,714,313,275,77,85,481,489,82,457,269,0
19:30:06,4692.693,Fox,970,162,46,34,28,25,25,4,970,924,890,714,313,275,77,85,481,489,82,457,269,0
19:30:06,4693.707,Fox,972,161,48,34,27,23,25,4,972,924,890,714,313,275,76,85,483,489,82,460,269,0
19:30:06,4694.521,Fox,972,161,48,32,29,23,25,4,972,924,892,714,313,275,76,85,483,489,82,460,269,0
19:30:07,4695.117,Fox,972,161,44,34,31,23,25,4,972,928,894,714,313,275,76,85,483,489,82,460,269,0
19:30:07,4695.533,Fox,972,161,44,30,33,25,25,4,972,928,898,716,313,275,76,85,483,489,82,460,269,0
19:30:07,4695.711,Fox,972,161,44,30,33,25,24,5,972,928,898,716,313,276,76,85,483,489,82,460,269,0
19:30:07,4697.463,Fox,972,160,44,30,33,25,24,4,972,928,898,716,313,276,75,85,483,489,82,460,270,0
19:30:08,4698.794,Fox,974,161,46,30,32,25,24,4,974,928,898,716,313,276,74,87,483,491,82,461,270,0
19:30:08,4699.337,Fox,974,161,46,28,34,25,24,4,974,928,900,716,313,276,74,87,483,491,82,461,270,0
19:30:08,4700.357,Fox,974,161,44,30,34,25,24,4,974,930,900,716,313,276,74,87,483,491,82,461,270,0
19:30:09,4701.626,Fox,974,161,44,30,34,25,22,6,974,930,900,716,313,278,74,87,483,491,82,461,270,0
19:30:09,4702.436,Fox,974,161,42,32,34,25,22,6,974,932,900,716,313,278,74,87,483,491,82,461,270,0
19:30:09,4703.137,Fox,974,160,40,34,34,25,22,5,974,934,900,716,313,278,74,86,483,491,82,461,271,0
19:30:09,4703.567,Fox,974,160,38,36,33,26,22,5,974,936,900,717,313,278,74,86,483,491,82,461,271,0
19:30:10,4704.576,Fox,976,162,40,36,32,27,22,5,976,936,900,718,313,278,75,87,484,492,82,461,271,0
19:30:10,4704.978,Fox,976,162,38,38,31,28,22,5,976,938,900,719,313,278,75,87,484,492,82,461,271,0
19:30:10,4705.791,Fox,976,160,38,36,33,26,22,5,976,938,902,719,313,278,73,87,484,492,82,463,271,0
19:30:11,4706.946,Fox,976,160,38,34,33,28,22,5,976,938,904,721,313,278,73,87,484,492,82,463,271,0
19:30:11,4707.303,Fox,976,160,38,32,35,28,22,5,976,938,906,721,313,278,73,87,484,492,82,463,271,0
19:30:11,4708.078,Fox,978,162,40,32,35,28,22,5,978,938,906,721,313,278,75,87,486,492,82,463,271,0
19:30:11,4708.846,Fox,978,162,40,30,37,28,22,5,978,938,908,721,313,278,75,87,486,492,82,463,271,0
19:30:12,4710.225,Fox,978,162,40,30,35,30,22,5,978,938,908,723,313,278,75,87,486,492,82,463,271,0
19:30:12,4712.268,Fox,978,162,38,32,35,30,22,5,978,940,908,723,313,278,75,87,486,492,82,463,271,0
19:30:12,4712.623,Fox,978,162,38,32,33,32,22,5,978,940,908,725,313,278,75,87,486,492,82,463,271,0
19:30:13,4714.044,Fox,978,161,38,30,35,31,22,5,978,940,910,725,313,278,75,86,486,492,82,464,271,0
19:30:13,4715.105,Fox,978,160,38,30,35,30,22,5,978,940,910,725,313,278,75,85,486,492,82,465,271,0
19:30:13,4715.528,Fox,978,159,38,30,35,29,22,5,978,940,910,725,313,278,74,85,486,492,82,466,271,0
19:30:14,4716.589,Fox,978,159,38,28,37,28,23,5,978,940,912,725,314,278,74,85,486,492,82,466,271,0
19:30:14,4717.163,Fox,978,159,38,28,37,28,21,7,978,940,912,725,314,280,74,85,486,492,82,466,271,0
19:30:14,4717.577,Fox,978,157,38,28,37,26,21,7,978,940,912,725,314,280,74,83,486,492,82,468,271,0
19:30:14,4717.982,Fox,978,157,36,30,37,26,21,7,978,942,912,725,314,280,74,83,486,492,82,468,271,0
19:30:15,4718.973,Fox,978,157,36,30,36,27,21,7,978,942,912,726,314,280,74,83,486,492,82,468,271,0
19:30:15,4720.737,Fox,978,155,36,28,38,25,21,7,978,942,914,726,314,280,72,83,486,492,82,470,271,0
19:30:15,4721.214,Fox,980,157,38,28,38,25,20,8,980,942,914,726,314,281,74,83,488,492,82,470,271,0
19:30:16,4721.853,Fox,980,157,34,32,38,25,20,8,980,946,914,726,314,281,74,83,488,492,82,470,271,0
19:30:16,4722.269,Fox,980,156,34,32,36,27,20,7,980,946,914,728,314,281,73,83,488,492,82,470,272,0
19:30:16,4722.495,Fox,980,155,34,32,36,27,20,6,980,946,914,728,314,281,73,82,488,492,82,470,273,0
19:30:16,4723.296,Fox,980,154,34,32,36,26,20,6,980,946,914,728,314,281,73,81,488,492,82,471,273,0
19:30:16,4723.865,Fox,980,154,34,30,38,26,20,6,980,946,916,728,314,281,73,81,488,492,82,471,273,0
19:30:17,4725.004,Fox,980,154,34,30,36,24,24,6,980,946,916,730,318,281,73,81,488,492,82,471,273,0
19:30:17,4726.452,Fox,980,154,34,30,34,26,24,6,980,946,916,732,318,281,73,81,488,492,82,471,273,0
19:30:18,4729.407,Fox,980,154,34,28,36,25,25,6,980,946,918,732,319,281,73,81,488,492,82,471,273,0
19:30:18,4729.6,Fox,980,153,34,28,36,24,25,6,980,946,918,732,319,281,73,80,488,492,82,472,273,0
19:30:18,4730.593,Fox,980,153,34,26,38,22,27,6,980,946,920,732,321,281,73,80,488,492,82,472,273,0
19:30:19,4731.158,Fox,980,153,34,22,42,22,27,6,980,946,924,732,321,281,73,80,488,492,82,472,273,0
19:30:19,4732.388,Fox,980,153,34,22,40,24,27,6,980,946,924,734,321,281,73,80,488,492,82,472,273,0
19:30:19,4733.701,Fox,980,153,34,18,44,24,27,6,980,946,928,734,321,281,73,80,488,492,82,472,273,0
19:30:20,4735.805,Fox,980,153,34,18,44,24,26,7,980,946,928,734,321,282,73,80,488,492,82,472,273,0
19:30:21,4737.321,Fox,980,150,34,18,44,22,26,6,980,946,928,734,321,282,73,77,488,492,82,474,274,0
19:30:21,4737.729,Fox,980,150,34,18,42,24,26,6,980,946,928,736,321,282,73,77,488,492,82,474,274,0
19:30:21,4738.834,Fox,980,150,34,16,44,24,26,6,980,946,930,736,321,282,73,77,488,492,82,474,274,0
19:30:22,4740.822,Fox,980,150,34,14,46,24,26,6,980,946,932,736,321,282,73,77,488,492,82,474,274,0
19:30:22,4741.32,Fox,980,149,34,12,48,24,26,5,980,946,934,736,321,282,73,76,488,492,82,474,275,0
19:30:22,4741.854,Fox,980,149,34,10,50,24,26,5,980,946,936,736,321,282,73,76,488,492,82,474,275,0
19:30:23,4742.879,Fox,982,149,36,10,50,22,26,5,982,946,936,736,321,282,74,75,490,492,82,476,275,0
19:30:23,4743.424,Fox,982,149,36,8,52,20,28,5,982,946,938,736,323,282,74,75,490,492,82,476,275,0
19:30:23,4743.808,Fox,984,151,38,8,52,20,28,5,984,946,938,736,323,282,75,76,491,493,82,476,275,0
19:30:23,4744.168,Fox,984,151,36,10,52,18,30,5,984,948,938,736,325,282,75,76,491,493,82,476,275,0
19:30:23,4745.005,Fox,984,151,36,10,50,20,30,5,984,948,938,738,325,282,75,76,491,493,82,476,275,0
19:30:24,4746.262,Fox,986,153,38,10,50,20,30,5,986,948,938,738,325,282,75,78,491,495,82,476,275,0
19:30:24,4746.612,Fox,988,155,36,12,50,20,30,5,986,950,938,738,325,282,75,80,491,497,82,476,275,0
19:30:24,4746.818,Fox,988,155,38,12,50,20,30,5,988,950,938,738,325,282,75,80,491,497,82,476,275,0
19:30:24,4747.389,Fox,990,156,40,12,49,20,30,5,990,950,938,738,325,282,75,81,492,498,82,477,275,0
19:30:24,4748.187,Fox,990,154,40,12,47,20,30,5,990,950,938,740,325,282,75,79,492,498,82,479,275,0
19:30:25,4749.38,Fox,990,154,38,14,47,20,30,5,990,952,938,740,325,282,75,79,492,498,82,479,275,0
19:30:25,4749.805,Fox,990,154,38,14,47,20,29,6,990,952,938,740,325,283,75,79,492,498,82,479,275,0
19:30:25,4750.788,Fox,990,154,38,12,49,20,29,6,990,952,940,740,325,283,75,79,492,498,82,479,275,0
19:30:25,4751.34,Fox,992,155,36,14,48,20,27,8,990,954,940,740,325,285,75,80,493,499,82,480,275,0
19:30:25,4751.715,Fox,994,156,40,14,47,20,27,8,994,954,940,740,325,285,75,81,494,500,82,481,275,0
19:30:26,4752.099,Fox,994,155,40,14,47,20,27,7,994,954,940,740,325,285,74,81,494,500,82,481,276,0
19:30:26,4753.372,Fox,996,156,42,14,46,20,25,9,996,954,940,740,325,287,73,83,494,502,82,482,276,0
19:30:27,4755.128,Fox,996,156,42,14,45,21,25,9,996,954,940,741,325,287,73,83,494,502,82,482,276,0
19:30:27,4755.847,Fox,996,156,40,16,41,25,25,9,996,956,940,745,325,287,73,83,494,502,82,482,276,0
19:30:27,4756.026,Fox,996,156,40,16,39,27,25,9,996,956,940,747,325,287,73,83,494,502,82,482,276,0
19:30:27,4756.601,Fox,996,156,40,14,41,27,23,11,996,956,942,747,325,289,73,83,494,502,82,482,276,0
19:30:28,4758.043,Fox,998,157,42,14,40,27,23,11,998,956,942,747,325,289,73,84,495,503,82,483,276,0
19:30:28,4758.455,Fox,998,155,42,14,40,25,23,11,998,956,942,747,325,289,72,83,495,503,82,485,276,0
19:30:28,4759.148,Fox,1000,156,42,16,39,25,23,11,1000,958,942,747,325,289,72,84,496,504,82,486,276,0
19:30:28,4759.778,Fox,1000,156,42,16,37,25,25,11,1000,958,942,749,327,289,72,84,496,504,82,486,276,0
19:30:28,4759.975,Fox,1000,156,42,14,39,25,25,11,1000,958,944,749,327,289,72,84,496,504,82,486,276,0
19:30:28,4760.381,Fox,1000,156,42,12,41,25,25,11,1000,958,946,749,327,289,72,84,496,504,82,486,276,0
19:30:29,4761.423,Fox,1002,158,44,12,41,25,25,11,1002,958,946,749,327,289,73,85,497,505,82,486,276,0
19:30:29,4762.279,Fox,1004,159,46,12,40,25,25,11,1004,958,946,749,327,289,73,86,498,506,82,487,276,0
19:30:29,4762.707,Fox,1006,160,48,12,39,25,25,11,1006,958,946,749,327,289,74,86,500,506,82,488,276,0
19:30:30,4763.922,Fox,1006,160,46,14,39,25,25,11,1006,960,946,749,327,289,74,86,500,506,82,488,276,0
19:30:30,4764.302,Fox,1006,160,44,16,39,25,25,11,1006,962,946,749,327,289,74,86,500,506,82,488,276,0
19:30:30,4765.814,Fox,1008,160,42,18,39,24,24,11,1006,964,946,749,327,289,73,87,500,508,82,490,276,0
19:30:30,4766.297,Fox,1008,160,44,18,38,25,24,11,1008,964,946,750,327,289,73,87,500,508,82,490,276,0
19:30:30,4766.719,Fox,1008,157,44,18,38,20,26,11,1008,964,946,750,329,289,72,85,500,508,82,493,276,0
19:30:31,4767.34,Fox,1008,157,44,18,36,22,26,11,1008,964,946,752,329,289,72,85,500,508,82,493,276,0
19:30:31,4767.767,Fox,1008,157,44,18,35,23,26,11,1008,964,946,753,329,289,72,85,500,508,82,493,276,0
19:30:31,4768.681,Fox,1008,157,42,20,35,23,26,11,1008,966,946,753,329,289,72,85,500,508,82,493,276,0
19:30:31,4769.203,Fox,1008,157,42,20,34,24,26,11,1008,966,946,754,329,289,72,85,500,508,82,493,276,0
19:30:32,4770.281,Fox,1012,157,46,20,32,22,26,11,1012,966,946,754,329,289,71,86,501,511,82,497,276,0
19:30:32,4771.437,Fox,1012,156,46,20,32,20,28,10,1012,966,946,754,331,289,71,85,501,511,82,497,277,0
19:30:32,4771.842,Fox,1014,157,46,22,31,20,28,10,1014,968,946,754,331,289,71,86,502,512,82,498,277,0
19:30:32,4772.278,Fox,1018,161,48,22,31,20,28,10,1016,968,946,754,331,289,72,89,503,515,82,498,277,0
19:30:32,4772.5,Fox,1018,161,50,22,31,20,28,10,1018,968,946,754,331,289,72,89,503,515,82,498,277,0
19:30:33,4772.925,Fox,1018,161,48,24,31,20,28,10,1018,970,946,754,331,289,72,89,503,515,82,498,277,0
19:30:33,4774.222,Fox,1018,161,48,24,30,21,28,10,1018,970,946,755,331,289,72,89,503,515,82,498,277,0
19:30:33,4775.456,Fox,1022,164,50,24,29,21,27,11,1020,970,946,755,331,290,71,93,503,519,82,499,277,0
19:30:34,4775.698,Fox,1022,164,52,24,29,21,27,11,1022,970,946,755,331,290,71,93,503,519,82,499,277,0
19:30:34,4776.355,Fox,1022,164,50,26,29,20,28,11,1022,972,946,755,332,290,71,93,503,519,82,499,277,0
19:30:34,4776.943,Fox,1022,163,50,26,28,20,28,11,1022,972,946,756,332,290,71,92,503,519,82,500,277,0
19:30:34,4778.217,Fox,1022,162,50,26,28,19,28,11,1022,972,946,756,332,290,71,91,503,519,82,501,277,0
19:30:34,4778.623,Fox,1022,162,50,26,28,19,26,13,1022,972,946,756,332,292,71,91,503,519,82,501,277,0
19:30:35,4779.025,Fox,1022,162,50,26,28,19,24,15,1022,972,946,756,332,294,71,91,503,519,82,501,277,0
19:30:35,4779.594,Fox,1024,164,52,26,28,19,24,15,1024,972,946,756,332,294,71,93,503,521,82,501,277,0
19:30:35,4779.964,Fox,1026,165,54,26,28,18,24,15,1026,972,946,756,332,294,72,93,504,522,82,502,277,0
19:30:35,4780.784,Fox,1028,166,56,26,27,18,24,15,1028,972,946,756,332,294,72,94,505,523,82,503,277,0
19:30:35,4781.44,Fox,1028,166,54,28,27,18,24,15,1028,974,946,756,332,294,72,94,505,523,82,503,277,0
19:30:36,4782.26,Fox,1028,166,54,28,27,16,26,15,1028,974,946,756,334,294,72,94,505,523,82,503,277,0
19:30:36,4782.659,Fox,1028,165,54,26,29,14,28,14,1028,974,948,756,336,294,71,94,505,523,82,503,278,0
19:30:36,4784.451,Fox,1028,165,54,26,27,16,28,14,1028,974,948,758,336,294,71,94,505,523,82,503,278,0
19:30:37,4785.033,Fox,1028,164,54,24,29,15,28,14,1028,974,950,758,336,294,71,93,505,523,82,504,278,0
19:30:37,4786.673,Fox,1028,163,54,24,29,15,28,13,1028,974,950,758,336,294,71,92,505,523,82,504,279,0
19:30:37,4787.085,Fox,1028,163,52,26,29,15,28,13,1028,976,950,758,336,294,71,92,505,523,82,504,279,0
19:30:37,4787.521,Fox,1028,162,52,26,29,14,28,13,1028,976,950,758,336,294,71,91,505,523,82,505,279,0
19:30:38,4787.948,Fox,1028,162,52,24,31,14,28,13,1028,976,952,758,336,294,71,91,505,523,82,505,279,0
19:30:38,4788.82,Fox,1030,164,54,24,31,14,28,13,1030,976,952,758,336,294,71,93,505,525,82,505,279,0
19:30:38,4789.235,Fox,1030,163,54,24,31,14,28,12,1030,976,952,758,336,294,70,93,505,525,82,505,280,0
19:30:38,4789.806,Fox,1030,163,54,22,31,16,27,13,1030,976,954,760,336,295,70,93,505,525,82,505,280,0
19:30:39,4790.962,Fox,1030,163,52,24,31,16,26,14,1030,978,954,760,336,296,70,93,505,525,82,505,280,0
19:30:39,4791.759,Fox,1030,163,52,24,28,19,26,14,1030,978,954,763,336,296,70,93,505,525,82,505,280,0
19:30:40,4794.045,Fox,1030,163,52,24,26,21,25,15,1030,978,954,765,336,297,70,93,505,525,82,505,280,0
19:30:40,4794.398,Fox,1030,163,52,22,27,22,25,15,1030,978,956,766,336,297,70,93,505,525,82,505,280,0
19:30:40,4795.744,Fox,1032,164,54,22,26,22,25,15,1032,978,956,766,336,297,71,93,507,525,82,506,280,0
19:30:41,4797.613,Fox,1034,166,56,20,28,22,25,15,1034,978,958,766,336,297,73,93,509,525,82,506,280,0
19:30:41,4797.86,Fox,1034,165,56,20,28,22,25,14,1034,978,958,766,336,297,73,92,509,525,82,506,281,0
19:30:42,4799.671,Fox,1036,166,56,20,27,22,25,14,1034,978,958,767,336,297,74,92,511,525,82,507,281,0
19:30:42,4800.06,Fox,1038,167,58,20,26,22,25,14,1036,978,958,767,336,297,75,92,513,525,82,508,281,0
19:30:42,4800.265,Fox,1038,166,60,20,26,21,25,14,1038,978,958,767,336,297,75,91,513,525,82,509,281,0
19:30:42,4801.369,Fox,1038,166,60,20,24,23,25,14,1038,978,958,769,336,297,75,91,513,525,82,509,281,0
19:30:42,4802.028,Fox,1038,163,60,20,23,22,25,13,1038,978,958,770,336,297,73,90,513,525,82,511,282,0
19:30:42,4802.469,Fox,1038,163,60,18,24,23,25,13,1038,978,960,771,336,297,73,90,513,525,82,511,282,0
19:30:43,4802.846,Fox,1038,163,60,16,26,23,25,13,1038,978,962,771,336,297,73,90,513,525,82,511,282,0
19:30:43,4803.731,Fox,1038,162,58,18,24,25,25,12,1038,980,962,773,336,297,72,90,513,525,82,511,283,0
19:30:43,4804.457,Fox,1038,160,58,16,26,23,25,12,1038,980,964,773,336,297,71,89,513,525,82,513,283,0
19:30:43,4804.654,Fox,1038,159,58,16,26,22,25,12,1038,980,964,773,336,297,71,88,513,525,82,514,283,0
19:30:44,4806.212,Fox,1038,159,58,16,26,21,26,12,1038,980,964,773,337,297,71,88,513,525,82,514,283,0
19:30:44,4807.225,Fox,1038,156,58,14,28,21,25,10,1038,980,966,773,337,297,71,85,513,525,82,515,285,0
19:30:45,4809.813,Fox,1038,155,58,14,28,20,25,10,1038,980,966,773,337,297,71,84,513,525,82,516,285,0
19:30:45,4810.166,Fox,1038,155,58,12,30,20,23,12,1038,980,968,773,337,299,71,84,513,525,82,516,285,0
19:30:45,4811.283,Fox,1040,157,60,12,28,22,23,12,1040,980,968,775,337,299,72,85,514,526,82,516,285,0
19:30:45,4811.506,Fox,1040,157,60,10,30,22,23,12,1040,980,970,775,337,299,72,85,514,526,82,516,285,0
19:30:46,4811.964,Fox,1040,155,60,10,30,20,23,12,1040,980,970,775,337,299,72,83,514,526,82,518,285,0
19:30:46,4812.374,Fox,1040,154,60,10,30,19,23,12,1040,980,970,775,337,299,72,82,514,526,82,519,285,0
19:30:46,4812.752,Fox,1040,153,60,10,30,18,23,12,1040,980,970,775,337,299,72,81,514,526,82,520,285,0
19:30:46,4814.192,Fox,1040,151,60,10,30,16,23,12,1040,980,970,775,337,299,71,80,514,526,82,522,285,0
19:30:46,4814.726,Fox,1040,151,60,8,32,16,23,12,1040,980,972,775,337,299,71,80,514,526,82,522,285,0
19:30:47,4815.495,Fox,1040,151,60,8,32,14,25,12,1040,980,972,775,339,299,71,80,514,526,82,522,285,0
19:30:47,4815.86,Fox,1040,150,60,8,32,14,25,11,1040,980,972,775,339,299,70,80,514,526,82,522,286,0
19:30:47,4816.868,Fox,1042,151,62,8,31,14,25,11,1042,980,972,775,339,299,71,80,516,526,82,523,286,0
19:30:47,4817.057,Fox,1042,151,62,8,29,16,25,11,1042,980,972,777,339,299,71,80,516,526,82,523,286,0
19:30:48,4818.457,Fox,1042,151,62,8,29,14,27,11,1042,980,972,777,341,299,71,80,516,526,82,523,286,0
19:30:48,4819.774,Fox,1042,151,62,6,31,14,27,11,1042,980,974,777,341,299,71,80,516,526,82,523,286,0
19:30:48,4820.412,Fox,1044,151,62,6,31,13,27,10,1042,980,974,777,341,299,71,80,516,528,82,524,287,0
19:30:49,4820.809,Fox,1046,152,66,6,28,15,27,10,1046,980,974,780,341,299,71,81,517,529,82,525,287,0
19:30:49,4821.724,Fox,1046,151,66,6,28,14,27,10,1046,980,974,780,341,299,70,81,517,529,82,526,287,0
19:30:50,4825.699,Fox,1046,151,64,6,30,14,27,10,1046,982,976,780,341,299,70,81,517,529,82,526,287,0
19:30:50,4826.56,Fox,1046,150,62,8,30,14,27,9,1046,984,976,780,341,299,69,81,517,529,82,526,288,0
19:30:51,4827.566,Fox,1046,148,62,8,30,12,27,9,1046,984,976,780,341,299,69,79,517,529,82,528,288,0
19:30:51,4828.761,Fox,1046,148,60,10,30,12,27,9,1046,986,976,780,341,299,69,79,517,529,82,528,288,0
19:30:51,4829.222,Fox,1046,147,60,8,32,12,27,8,1046,986,978,780,341,299,69,78,517,529,82,528,289,0
19:30:51,4829.376,Fox,1046,147,58,10,32,12,27,8,1046,988,978,780,341,299,69,78,517,529,82,528,289,0
19:30:52,4829.887,Fox,1046,147,56,12,32,12,27,8,1046,990,978,780,341,299,69,78,517,529,82,528,289,0
19:30:52,4830.235,Fox,1046,146,56,12,32,12,27,7,1046,990,978,780,341,299,69,77,517,529,82,528,290,0
19:30:52,4831.08,Fox,1046,144,56,12,32,10,27,7,1046,990,978,780,341,299,67,77,517,529,82,530,290,0
19:30:52,4831.387,Fox,1046,143,56,12,32,9,27,7,1046,990,978,780,341,299,67,76,517,529,82,531,290,0
19:30:53,4832.75,Fox,1048,144,58,12,31,9,27,7,1048,990,978,780,341,299,68,76,519,529,82,532,290,0
19:30:53,4833.089,Fox,1050,146,60,12,31,9,27,7,1050,990,978,780,341,299,69,77,520,530,82,532,290,0
19:30:53,4834.385,Fox,1050,146,56,16,31,9,27,7,1050,994,978,780,341,299,69,77,520,530,82,532,290,0
19:30:54,4835.832,Fox,1050,146,54,18,31,9,27,7,1050,996,978,780,341,299,69,77,520,530,82,532,290,0
19:30:54,4838.536,Fox,1050,146,54,18,31,7,29,7,1050,996,978,780,343,299,69,77,520,530,82,532,290,0
19:30:55,4840.76,Fox,1050,145,52,20,31,7,29,6,1050,998,978,780,343,299,68,77,520,530,82,532,291,0
19:30:55,4841.25,Fox,1052,147,54,20,31,7,29,6,1052,998,978,780,343,299,69,78,521,531,82,532,291,0
19:30:55,4841.59,Fox,1052,147,52,22,31,7,29,6,1052,1000,978,780,343,299,69,78,521,531,82,532,291,0
19:30:56,4842.242,Fox,1052,147,52,20,33,7,29,6,1052,1000,980,780,343,299,69,78,521,531,82,532,291,0
19:30:56,4843.056,Fox,1052,147,52,20,31,9,29,6,1052,1000,980,782,343,299,69,78,521,531,82,532,291,0
19:30:56,4843.949,Fox,1052,147,50,22,31,9,29,6,1052,1002,980,782,343,299,69,78,521,531,82,532,291,0
19:30:56,4844.498,Fox,1054,147,50,22,30,9,29,5,1052,1002,980,782,343,299,69,78,523,531,82,533,292,0
19:30:57,4844.918,Fox,1054,147,50,24,30,9,29,5,1054,1004,980,782,343,299,69,78,523,531,82,533,292,0
19:30:57,4845.465,Fox,1054,147,48,26,28,11,29,5,1054,1006,980,784,343,299,69,78,523,531,82,533,292,0
19:30:58,4848.129,Fox,1056,149,50,26,28,11,29,5,1056,1006,980,784,343,299,70,79,524,532,82,533,292,0
19:30:58,4848.312,Fox,1056,149,50,26,26,13,29,5,1056,1006,980,786,343,299,70,79,524,532,82,533,292,0
19:30:58,4848.649,Fox,1056,149,48,28,26,13,29,5,1056,1008,980,786,343,299,70,79,524,532,82,533,292,0
19:30:58,4849.304,Fox,1056,149,48,28,26,10,32,5,1056,1008,980,786,346,299,70,79,524,532,82,533,292,0
19:30:58,4850.078,Fox,1056,149,48,28,24,12,32,5,1056,1008,980,788,346,299,70,79,524,532,82,533,292,0
19:30:59,4852.828,Fox,1056,149,44,32,24,12,32,5,1056,1012,980,788,346,299,70,79,524,532,82,533,292,0
19:30:59,4853.671,Fox,1056,147,44,32,24,10,32,5,1056,1012,980,788,346,299,68,79,524,532,82,535,292,0
19:31:00,4854.398,Fox,1056,147,42,34,24,10,32,5,1056,1014,980,788,346,299,68,79,524,532,82,535,292,0
19:31:00,4855.021,Fox,1056,147,38,38,22,12,32,5,1056,1018,980,790,346,299,68,79,524,532,82,535,292,0
19:31:00,4855.959,Fox,1056,146,38,38,22,11,32,5,1056,1018,980,790,346,299,67,79,524,532,82,536,292,0
19:31:01,4857.967,Fox,1056,146,36,40,21,12,32,5,1056,1020,980,791,346,299,67,79,524,532,82,536,292,0
19:31:01,4858.33,Fox,1058,148,34,42,21,12,32,5,1056,1022,980,791,346,299,69,79,526,532,82,536,292,0
19:31:01,4858.5,Fox,1058,148,36,42,21,12,32,5,1058,1022,980,791,346,299,69,79,526,532,82,536,292,0
19:31:02,4860.851,Fox,1058,148,36,42,21,11,33,5,1058,1022,980,791,347,299,69,79,526,532,82,536,292,0
19:31:02,4862.519,Fox,1058,148,32,46,21,11,29,9,1058,1026,980,791,347,303,69,79,526,532,82,536,292,0
19:31:03,4863.071,Fox,1060,149,34,46,18,13,29,9,1060,1026,980,793,347,303,69,80,527,533,82,537,292,0
19:31:03,4863.489,Fox,1060,149,32,48,16,15,29,9,1060,1028,980,795,347,303,69,80,527,533,82,537,292,0
19:31:03,4863.9,Fox,1060,149,32,46,18,15,29,9,1060,1028,982,795,347,303,69,80,527,533,82,537,292,0
19:31:03,4864.819,Fox,1060,149,32,44,18,17,29,9,1060,1028,984,797,347,303,69,80,527,533,82,537,292,0
19:31:03,4865.341,Fox,1062,148,34,44,17,15,29,9,1062,1028,984,797,347,303,69,79,528,534,82,540,292,0
19:31:04,4866.814,Fox,1062,148,34,44,17,15,28,10,1062,1028,984,797,347,304,69,79,528,534,82,540,292,0
19:31:04,4867.371,Fox,1062,148,34,42,19,15,28,10,1062,1028,986,797,347,304,69,79,528,534,82,540,292,0
19:31:04,4867.938,Fox,1062,148,34,40,20,16,28,10,1062,1028,988,798,347,304,69,79,528,534,82,540,292,0
19:31:04,4868.306,Fox,1062,147,34,40,20,15,26,12,1062,1028,988,798,347,306,69,78,528,534,82,541,292,0
19:31:04,4868.495,Fox,1062,147,34,38,22,15,26,12,1062,1028,990,798,347,306,69,78,528,534,82,541,292,0
19:31:05,4869.613,Fox,1062,146,34,38,22,15,26,11,1062,1028,990,798,347,306,69,77,528,534,82,541,293,0
19:31:05,4870.703,Fox,1062,146,34,38,20,17,26,11,1062,1028,990,800,347,306,69,77,528,534,82,541,293,0
19:31:05,4871.359,Fox,1062,146,32,40,20,17,26,11,1062,1030,990,800,347,306,69,77,528,534,82,541,293,0
19:31:06,4871.849,Fox,1062,146,32,40,18,19,26,11,1062,1030,990,802,347,306,69,77,528,534,82,541,293,0
19:31:06,4872.7,Fox,1062,146,32,36,22,19,26,11,1062,1030,994,802,347,306,69,77,528,534,82,541,293,0
19:31:06,4873.513,Fox,1062,144,32,36,22,17,26,11,1062,1030,994,802,347,306,68,76,528,534,82,543,293,0
19:31:06,4874.028,Fox,1064,145,32,36,22,16,26,11,1062,1030,994,802,347,306,68,77,528,536,82,544,293,0
19:31:06,4874.409,Fox,1064,145,34,34,24,16,26,11,1064,1030,996,802,347,306,68,77,528,536,82,544,293,0
19:31:07,4875.287,Fox,1064,144,34,34,22,17,26,11,1064,1030,996,804,347,306,67,77,528,536,82,545,293,0
19:31:07,4875.862,Fox,1066,145,36,34,22,16,26,11,1066,1030,996,804,347,306,66,79,528,538,82,546,293,0
19:31:08,4877.893,Fox,1066,145,36,34,22,15,27,11,1066,1030,996,804,348,306,66,79,528,538,82,546,293,0
19:31:08,4878.219,Fox,1066,143,34,36,22,14,27,10,1066,1032,996,804,348,306,65,78,528,538,82,547,294,0
19:31:08,4879.2,Fox,1066,143,34,34,24,14,27,10,1066,1032,998,804,348,306,65,78,528,538,82,547,294,0
19:31:08,4880.401,Fox,1066,143,32,34,24,16,27,10,1066,1034,1000,806,348,306,65,78,528,538,82,547,294,0
19:31:09,4880.948,Fox,1066,143,32,34,24,16,25,12,1066,1034,1000,806,348,308,65,78,528,538,82,547,294,0
19:31:09,4881.354,Fox,1066,141,32,34,24,14,25,12,1066,1034,1000,806,348,308,65,76,528,538,82,549,294,0
19:31:09,4881.907,Fox,1068,142,32,34,24,14,23,13,1066,1034,1000,806,348,310,66,76,529,539,82,549,295,0
19:31:09,4882.091,Fox,1068,142,34,34,24,14,23,13,1068,1034,1000,806,348,310,66,76,529,539,82,549,295,0
19:31:09,4882.483,Fox,1068,140,32,34,26,13,23,12,1068,1036,1002,806,348,310,64,76,529,539,82,550,296,0
19:31:09,4882.871,Fox,1068,140,30,36,26,13,23,12,1068,1038,1002,806,348,310,64,76,529,539,82,550,296,0
19:31:09,4883.425,Fox,1068,140,30,34,28,12,24,12,1068,1038,1004,806,349,310,64,76,529,539,82,550,296,0
19:31:10,4883.783,Fox,1068,140,30,32,30,12,24,12,1068,1038,1006,806,349,310,64,76,529,539,82,550,296,0
19:31:10,4885.787,Fox,1068,138,30,32,30,10,24,12,1068,1038,1006,806,349,310,62,76,529,539,82,552,296,0
19:31:10,4886.108,Fox,1068,138,30,32,29,11,24,12,1068,1038,1006,807,349,310,62,76,529,539,82,552,296,0
19:31:11,4887.086,Fox,1068,138,30,30,31,11,24,12,1068,1038,1008,807,349,310,62,76,529,539,82,552,296,0
19:31:11,4888.057,Fox,1070,140,32,30,31,11,24,12,1070,1038,1008,807,349,310,64,76,531,539,82,552,296,0
19:31:11,4889.616,Fox,1070,140,32,30,30,12,24,12,1070,1038,1008,808,349,310,64,76,531,539,82,552,296,0
19:31:12,4890.818,Fox,1070,138,32,30,30,10,24,12,1070,1038,1008,808,349,310,64,74,531,539,82,554,296,0
19:31:12,4891.373,Fox,1070,138,32,26,34,10,24,12,1070,1038,1012,808,349,310,64,74,531,539,82,554,296,0
19:31:13,4892.809,Fox,1070,138,32,24,36,10,24,12,1070,1038,1014,808,349,310,64,74,531,539,82,554,296,0
19:31:13,4893.478,Fox,1070,138,32,20,40,10,24,12,1070,1038,1018,808,349,310,64,74,531,539,82,554,296,0
19:31:13,4893.857,Fox,1070,138,30,22,40,10,24,12,1070,1040,1018,808,349,310,64,74,531,539,82,554,296,0
19:31:14,4896.666,Fox,1070,137,30,18,44,9,24,12,1070,1040,1022,808,349,310,64,73,531,539,82,555,296,0
19:31:14,4897.15,Fox,1070,137,30,18,44,9,22,14,1070,1040,1022,808,349,312,64,73,531,539,82,555,296,0
19:31:15,4898.793,Fox,1072,139,32,18,44,9,22,14,1072,1040,1022,808,349,312,65,74,532,540,82,555,296,0
19:31:15,4899.475,Fox,1072,139,30,20,44,9,22,14,1072,1042,1022,808,349,312,65,74,532,540,82,555,296,0
19:31:15,4900.134,Fox,1072,138,30,20,44,8,22,14,1072,1042,1022,808,349,312,64,74,532,540,82,556,296,0
19:31:15,4900.667,Fox,1072,138,30,18,46,8,22,14,1072,1042,1024,808,349,312,64,74,532,540,82,556,296,0
19:31:15,4900.998,Fox,1072,138,30,16,48,8,22,14,1072,1042,1026,808,349,312,64,74,532,540,82,556,296,0
19:31:16,4901.658,Fox,1074,140,32,16,48,8,22,14,1074,1042,1026,808,349,312,65,75,533,541,82,556,296,0
19:31:16,4901.837,Fox,1074,140,32,14,50,8,22,14,1074,1042,1028,808,349,312,65,75,533,541,82,556,296,0
19:31:16,4902.867,Fox,1074,140,32,14,48,10,22,14,1074,1042,1028,810,349,312,65,75,533,541,82,556,296,0
19:31:16,4903.377,Fox,1074,140,28,18,48,10,22,14,1074,1046,1028,810,349,312,65,75,533,541,82,556,296,0
19:31:16,4903.858,Fox,1074,140,28,18,48,10,20,16,1074,1046,1028,810,349,314,65,75,533,541,82,556,296,0
19:31:17,4904.951,Fox,1074,139,28,18,48,10,20,15,1074,1046,1028,810,349,314,65,74,533,541,82,556,297,0
19:31:17,4907.341,Fox,1074,138,28,18,48,10,20,14,1074,1046,1028,810,349,314,64,74,533,541,82,556,298,0
19:31:18,4908.86,Fox,1074,138,28,18,48,10,18,16,1074,1046,1028,810,349,316,64,74,533,541,82,556,298,0
19:31:18,4909.918,Fox,1074,138,28,16,50,10,18,16,1074,1046,1030,810,349,316,64,74,533,541,82,556,298,0
19:31:19,4912.962,Fox,1076,138,30,16,50,10,18,14,1076,1046,1030,810,349,316,64,74,534,542,82,556,300,0
19:31:19,4913.501,Fox,1078,139,32,16,49,10,17,15,1078,1046,1030,810,349,317,64,75,535,543,82,557,300,0
19:31:20,4915.361,Fox,1078,139,30,18,49,10,17,15,1078,1048,1030,810,349,317,64,75,535,543,82,557,300,0
19:31:20,4915.694,Fox,1078,139,28,20,49,10,17,15,1078,1050,1030,810,349,317,64,75,535,543,82,557,300,0
19:31:21,4917.048,Fox,1082,142,32,18,50,10,17,15,1082,1050,1032,810,349,317,66,76,538,544,82,558,300,0
19:31:21,4917.419,Fox,1082,141,32,18,50,10,17,14,1082,1050,1032,810,349,317,66,75,538,544,82,558,301,0
19:31:21,4918.704,Fox,1082,141,32,16,52,10,17,14,1082,1050,1034,810,349,317,66,75,538,544,82,558,301,0
19:31:22,4919.768,Fox,1084,142,34,16,51,10,15,16,1084,1050,1034,810,349,319,66,76,539,545,82,559,301,0
19:31:22,4920.132,Fox,1084,142,34,16,51,10,13,18,1084,1050,1034,810,349,321,66,76,539,545,82,559,301,0
19:31:22,4921.13,Fox,1086,143,34,14,52,10,13,18,1084,1050,1036,810,349,321,65,78,539,547,82,560,301,0
19:31:22,4921.516,Fox,1088,144,38,12,53,10,13,18,1088,1050,1038,810,349,321,66,78,541,547,82,561,301,0
19:31:22,4922.188,Fox,1088,143,38,12,53,10,13,17,1088,1050,1038,810,349,321,65,78,541,547,82,561,302,0
19:31:23,4924.004,Fox,1088,142,36,14,53,10,13,16,1088,1052,1038,810,349,321,64,78,541,547,82,561,303,0
19:31:23,4924.436,Fox,1088,142,36,14,51,12,13,16,1088,1052,1038,812,349,321,64,78,541,547,82,561,303,0
19:31:23,4925.387,Fox,1088,142,36,14,49,14,13,16,1088,1052,1038,814,349,321,64,78,541,547,82,561,303,0
19:31:24,4927.292,Fox,1088,142,34,16,49,14,13,16,1088,1054,1038,814,349,321,64,78,541,547,82,561,303,0
19:31:24,4928.008,Fox,1090,143,34,16,46,16,13,16,1088,1054,1038,816,349,321,65,78,543,547,82,562,303,0
19:31:24,4928.38,Fox,1090,143,36,16,44,18,13,16,1090,1054,1038,818,349,321,65,78,543,547,82,562,303,0
19:31:25,4928.901,Fox,1090,143,36,16,43,19,13,16,1090,1054,1038,819,349,321,65,78,543,547,82,562,303,0
19:31:25,4930.697,Fox,1090,143,34,18,43,19,13,16,1090,1056,1038,819,349,321,65,78,543,547,82,562,303,0
19:31:26,4931.538,Fox,1094,145,36,18,41,19,13,16,1092,1056,1038,819,349,321,65,80,545,549,82,564,303,0
19:31:26,4931.737,Fox,1094,145,38,18,41,19,13,16,1094,1056,1038,819,349,321,65,80,545,549,82,564,303,0
19:31:26,4932.283,Fox,1094,145,38,16,43,19,13,16,1094,1056,1040,819,349,321,65,80,545,549,82,564,303,0
19:31:26,4933.36,Fox,1094,145,38,16,40,22,13,16,1094,1056,1040,822,349,321,65,80,545,549,82,564,303,0
19:31:27,4934.952,Fox,1094,145,38,16,38,24,13,16,1094,1056,1040,824,349,321,65,80,545,549,82,564,303,0
19:31:27,4935.454,Fox,1096,146,38,16,38,24,12,16,1094,1056,1040,824,349,321,66,80,546,550,82,565,303,0
19:31:27,4935.658,Fox,1096,146,40,16,38,24,12,16,1096,1056,1040,824,349,321,66,80,546,550,82,565,303,0
19:31:27,4937.294,Fox,1098,147,42,16,37,24,12,16,1098,1056,1040,824,349,321,66,81,547,551,82,566,303,0
19:31:28,4937.998,Fox,1098,147,42,14,39,24,12,16,1098,1056,1042,824,349,321,66,81,547,551,82,566,303,0
19:31:28,4938.853,Fox,1098,144,42,14,39,22,12,15,1098,1056,1042,824,349,321,66,78,547,551,82,568,304,0
19:31:28,4939.035,Fox,1098,144,42,14,39,21,13,15,1098,1056,1042,824,350,321,66,78,547,551,82,568,304,0
19:31:28,4939.558,Fox,1098,143,42,14,38,21,13,15,1098,1056,1042,825,350,321,66,77,547,551,82,569,304,0
19:31:28,4940.224,Fox,1098,142,42,14,38,21,13,14,1098,1056,1042,825,350,321,65,77,547,551,82,569,305,0
19:31:29,4940.724,Fox,1098,142,42,14,37,22,13,14,1098,1056,1042,826,350,321,65,77,547,551,82,569,305,0
19:31:29,4941.224,Fox,1098,141,40,16,37,22,13,13,1098,1058,1042,826,350,321,64,77,547,551,82,569,306,0
19:31:29,4941.898,Fox,1098,141,40,12,41,20,15,13,1098,1058,1046,826,352,321,64,77,547,551,82,569,306,0
19:31:29,4942.929,Fox,1098,141,40,12,40,21,15,13,1098,1058,1046,827,352,321,64,77,547,551,82,569,306,0
19:31:30,4943.736,Fox,1098,138,40,12,40,16,16,14,1098,1058,1046,827,354,322,63,75,547,551,83,571,306,0
19:31:30,4943.908,Fox,1098,138,40,12,39,17,16,14,1098,1058,1046,828,354,322,63,75,547,551,83,571,306,0
19:31:30,4944.248,Fox,1098,137,40,12,37,19,16,13,1098,1058,1046,830,354,322,62,75,547,551,83,571,307,0
19:31:30,4945.578,Fox,1098,136,38,14,37,18,16,13,1098,1060,1046,830,354,322,62,74,547,551,83,572,307,0
19:31:31,4947.563,Fox,1098,136,38,14,35,20,16,13,1098,1060,1046,832,354,322,62,74,547,551,83,572,307,0
19:31:31,4947.923,Fox,1098,136,36,16,35,20,16,13,1098,1062,1046,832,354,322,62,74,547,551,83,572,307,0
19:31:31,4949.193,Fox,1098,135,36,16,35,20,16,12,1098,1062,1046,832,354,322,61,74,547,551,83,572,308,0
19:31:32,4950.137,Fox,1098,134,36,16,35,19,16,12,1098,1062,1046,832,354,322,61,73,547,551,83,573,308,0
19:31:32,4950.706,Fox,1098,133,36,16,35,19,16,11,1098,1062,1046,832,354,322,60,73,547,551,83,573,309,0
19:31:32,4951.279,Fox,1098,130,36,16,35,18,16,9,1098,1062,1046,832,354,322,58,72,547,551,83,574,311,0
19:31:32,4951.798,Fox,1098,130,36,16,31,22,16,9,1098,1062,1046,836,354,322,58,72,547,551,83,574,311,0
19:31:33,4952.625,Fox,1100,130,38,16,30,22,16,8,1100,1062,1046,836,354,322,58,72,548,552,83,575,312,0
19:31:33,4953.101,Fox,1100,129,38,16,30,22,14,9,1100,1062,1046,836,354,324,58,71,548,552,83,575,313,0
19:31:33,4953.436,Fox,1100,128,38,16,29,22,14,9,1100,1062,1046,837,354,324,58,70,548,552,83,576,313,0
19:31:33,4953.942,Fox,1100,128,38,14,28,25,14,9,1100,1062,1048,840,354,324,58,70,548,552,83,576,313,0
19:31:33,4954.314,Fox,1100,127,38,12,30,24,14,9,1100,1062,1050,840,354,324,58,69,548,552,83,577,313,0
19:31:34,4955.831,Fox,1100,127,38,12,30,24,13,10,1100,1062,1050,840,354,325,58,69,548,552,83,577,313,0
19:31:34,4956.966,Fox,1100,127,36,14,28,25,14,10,1100,1064,1050,842,355,325,58,69,548,552,83,577,313,0
19:31:34,4957.132,Fox,1100,127,36,14,26,27,14,10,1100,1064,1050,844,355,325,58,69,548,552,83,577,313,0
19:31:34,4958.188,Fox,1100,125,36,14,26,24,15,10,1100,1064,1050,844,356,325,58,67,548,552,83,579,313,0
19:31:34,4958.354,Fox,1100,125,34,16,26,24,15,10,1100,1066,1050,844,356,325,58,67,548,552,83,579,313,0
19:31:35,4961.169,Fox,1100,125,34,16,24,26,15,10,1100,1066,1050,846,356,325,58,67,548,552,83,579,313,0
19:31:35,4961.488,Fox,1100,125,34,16,23,27,15,10,1100,1066,1050,847,356,325,58,67,548,552,83,579,313,0
19:31:36,4962.324,Fox,1100,121,34,14,24,24,15,10,1100,1066,1052,848,356,325,57,64,548,552,83,583,313,0
19:31:36,4963.909,Fox,1100,119,34,14,24,23,15,9,1100,1066,1052,848,356,325,57,62,548,552,83,584,314,0
19:31:36,4964.533,Fox,1100,116,34,14,24,20,15,9,1100,1066,1052,848,356,325,57,59,548,552,83,587,314,0
19:31:37,4964.698,Fox,1100,116,32,16,24,20,15,9,1100,1068,1052,848,356,325,57,59,548,552,83,587,314,0
19:31:37,4965.357,Fox,1102,117,34,16,23,19,16,9,1102,1068,1052,848,357,325,57,60,549,553,83,588,314,0
19:31:37,4965.688,Fox,1102,117,34,14,25,19,16,9,1102,1068,1054,848,357,325,57,60,549,553,83,588,314,0
19:31:38,4967.59,Fox,1102,114,34,14,25,17,16,8,1102,1068,1054,848,357,325,57,57,549,553,83,590,315,0
19:31:38,4967.756,Fox,1102,112,34,14,25,15,16,8,1102,1068,1054,848,357,325,57,55,549,553,83,592,315,0
19:31:38,4969.181,Fox,1102,112,34,12,27,15,16,8,1102,1068,1056,848,357,325,57,55,549,553,83,592,315,0
19:31:38,4970.297,Fox,1102,112,34,12,25,17,16,8,1102,1068,1056,850,357,325,57,55,549,553,83,592,315,0
19:31:39,4970.584,Fox,1102,112,32,14,25,17,16,8,1102,1070,1056,850,357,325,57,55,549,553,83,592,315,0
19:31:39,4971.696,Fox,1102,110,32,14,25,15,16,8,1102,1070,1056,850,357,325,57,53,549,553,83,594,315,0
19:31:39,4972.085,Fox,1102,109,32,14,25,14,16,8,1102,1070,1056,850,357,325,57,52,549,553,83,595,315,0
19:31:39,4972.991,Fox,1102,107,32,14,25,13,16,7,1102,1070,1056,850,357,325,57,50,549,553,83,596,316,0
19:31:40,4976.099,Fox,1102,107,32,14,25,13,14,9,1102,1070,1056,850,357,327,57,50,549,553,83,596,316,0
19:31:41,4977.293,Fox,1102,107,32,14,23,15,14,9,1102,1070,1056,852,357,327,57,50,549,553,83,596,316,0
19:31:41,4979.034,Fox,1102,107,32,14,21,17,14,9,1102,1070,1056,854,357,327,57,50,549,553,83,596,316,0
19:31:41,4979.482,Fox,1102,107,32,12,23,17,14,9,1102,1070,1058,854,357,327,57,50,549,553,83,596,316,0
19:31:42,4980.282,Fox,1102,106,32,12,23,17,14,8,1102,1070,1058,854,357,327,57,49,549,553,83,596,317,0
19:31:42,4980.75,Fox,1104,106,34,12,22,17,14,7,1104,1070,1058,854,357,327,58,48,551,553,83,597,318,0
19:31:42,4981.337,Fox,1104,106,32,14,21,18,14,7,1104,1072,1058,855,357,327,58,48,551,553,83,597,318,0
19:31:42,4981.729,Fox,1104,106,32,14,19,20,14,7,1104,1072,1058,857,357,327,58,48,551,553,83,597,318,0
19:31:43,4984.131,Fox,1104,105,30,14,21,20,14,6,1104,1074,1060,857,357,327,58,47,551,553,83,597,319,0
19:31:44,4986.531,Fox,1104,105,30,12,23,20,12,8,1104,1074,1062,857,357,329,58,47,551,553,83,597,319,0
19:31:44,4986.834,Fox,1104,105,30,12,23,20,11,9,1104,1074,1062,857,357,330,58,47,551,553,83,597,319,0
19:31:44,4987.756,Fox,1104,103,30,12,23,18,11,9,1104,1074,1062,857,357,330,56,47,551,553,83,599,319,0
19:31:45,4990.758,Fox,1106,104,32,12,22,18,11,9,1106,1074,1062,857,357,330,57,47,553,553,83,600,319,0
19:31:46,4991.972,Fox,1106,103,32,12,22,17,11,9,1106,1074,1062,857,357,330,56,47,553,553,83,601,319,0
19:31:46,4992.823,Fox,1106,103,32,12,20,19,11,9,1106,1074,1062,859,357,330,56,47,553,553,83,601,319,0
19:31:46,4993.346,Fox,1108,105,34,12,20,19,11,9,1108,1074,1062,859,357,330,56,49,553,555,83,601,319,0
19:31:47,4995.237,Fox,1108,105,34,10,22,19,11,9,1108,1074,1064,859,357,330,56,49,553,555,83,601,319,0
19:31:47,4995.552,Fox,1108,105,32,12,22,19,11,9,1108,1076,1064,859,357,330,56,49,553,555,83,601,319,0
19:31:47,4995.962,Fox,1108,105,30,14,22,19,11,9,1108,1078,1064,859,357,330,56,49,553,555,83,601,319,0
19:31:47,4996.236,Fox,1108,105,30,14,22,17,13,9,1108,1078,1064,859,359,330,56,49,553,555,83,601,319,0
19:31:47,4996.788,Fox,1108,105,30,12,24,17,13,9,1108,1078,1066,859,359,330,56,49,553,555,83,601,319,0
19:31:48,4998.138,Fox,1108,105,30,12,24,17,12,10,1108,1078,1066,859,359,331,56,49,553,555,83,601,319,0
19:31:48,4998.402,Fox,1108,105,30,12,22,19,12,10,1108,1078,1066,861,359,331,56,49,553,555,83,601,319,0
19:31:48,4998.916,Fox,1110,106,32,12,21,19,12,10,1110,1078,1066,861,359,331,57,49,555,555,83,602,319,0
19:31:48,4999.511,Fox,1110,106,28,16,21,19,12,10,1110,1082,1066,861,359,331,57,49,555,555,83,602,319,0
19:31:48,5000.212,Fox,1112,107,30,16,20,19,12,10,1112,1082,1066,861,359,331,58,49,557,555,83,603,319,0
19:31:49,5002.227,Fox,1112,107,28,18,18,21,12,10,1112,1084,1066,863,359,331,58,49,557,555,83,603,319,0
19:31:49,5002.374,Fox,1112,107,28,18,17,22,12,10,1112,1084,1066,864,359,331,58,49,557,555,83,603,319,0
19:31:49,5003.063,Fox,1112,107,28,16,19,22,12,10,1112,1084,1068,864,359,331,58,49,557,555,83,603,319,0
19:31:50,5003.768,Fox,1112,107,26,18,19,22,12,10,1112,1086,1068,864,359,331,58,49,557,555,83,603,319,0
19:31:50,5004.063,Fox,1112,107,24,20,19,22,12,10,1112,1088,1068,864,359,331,58,49,557,555,83,603,319,0
19:31:50,5005.313,Fox,1114,109,26,20,19,22,12,10,1114,1088,1068,864,359,331,59,50,558,556,83,603,319,0
19:31:50,5005.893,Fox,1116,110,28,20,18,22,12,10,1116,1088,1068,864,359,331,59,51,559,557,83,604,319,0
19:31:51,5006.685,Fox,1116,108,28,20,18,22,12,8,1116,1088,1068,864,359,331,59,49,559,557,83,604,321,0
19:31:51,5009.115,Fox,1116,106,28,18,20,20,12,8,1116,1088,1070,864,359,331,57,49,559,557,83,606,321,0
19:31:52,5010.422,Fox,1116,105,28,18,20,20,12,7,1116,1088,1070,864,359,331,57,48,559,557,83,606,322,0
19:31:52,5010.669,Fox,1116,105,26,20,20,20,12,7,1116,1090,1070,864,359,331,57,48,559,557,83,606,322,0
19:31:53,5012.627,Fox,1116,104,26,20,20,19,12,7,1116,1090,1070,864,359,331,57,47,559,557,83,607,322,0
19:31:53,5012.891,Fox,1116,103,26,20,20,18,12,7,1116,1090,1070,864,359,331,57,46,559,557,83,608,322,0
19:31:53,5014.036,Fox,1116,103,24,22,20,18,12,7,1116,1092,1070,864,359,331,57,46,559,557,83,608,322,0
19:31:53,5014.275,Fox,1116,103,22,24,19,19,12,7,1116,1094,1070,865,359,331,57,46,559,557,83,608,322,0
19:31:53,5014.693,Fox,1118,105,24,24,18,20,12,7,1118,1094,1070,866,359,331,58,47,560,558,83,608,322,0
19:31:53,5015.302,Fox,1118,105,24,24,18,20,11,8,1118,1094,1070,866,359,332,58,47,560,558,83,608,322,0
19:31:54,5017.916,Fox,1118,105,24,24,18,18,13,8,1118,1094,1070,866,361,332,58,47,560,558,83,608,322,0
19:31:54,5018.179,Fox,1118,105,22,26,18,18,13,8,1118,1096,1070,866,361,332,58,47,560,558,83,608,322,0
19:31:55,5018.873,Fox,1118,105,22,26,18,16,15,8,1118,1096,1070,866,363,332,58,47,560,558,83,608,322,0
19:31:55,5019.41,Fox,1120,107,24,26,18,16,15,8,1120,1096,1070,866,363,332,58,49,560,560,83,608,322,0
19:31:55,5019.833,Fox,1120,107,22,26,20,16,15,8,1120,1098,1072,866,363,332,58,49,560,560,83,608,322,0
19:31:55,5020.798,Fox,1122,108,24,26,19,16,14,9,1122,1098,1072,866,363,333,59,49,562,560,83,609,322,0
19:31:55,5021.203,Fox,1122,108,24,26,19,14,16,9,1122,1098,1072,866,365,333,59,49,562,560,83,609,322,0
19:31:56,5022.791,Fox,1124,109,26,24,19,15,16,9,1124,1098,1074,867,365,333,60,49,564,560,83,610,322,0
19:31:57,5025.252,Fox,1124,108,26,24,19,14,16,9,1124,1098,1074,867,365,333,60,48,564,560,83,611,322,0
19:31:57,5026.127,Fox,1124,108,26,24,17,16,16,9,1124,1098,1074,869,365,333,60,48,564,560,83,611,322,0
19:31:58,5028.348,Fox,1124,108,26,24,17,15,17,9,1124,1098,1074,869,366,333,60,48,564,560,83,611,322,0
19:31:58,5029.588,Fox,1124,108,26,24,16,16,17,9,1124,1098,1074,870,366,333,60,48,564,560,83,611,322,0
19:31:59,5033.35,Fox,1124,107,26,24,16,15,17,9,1124,1098,1074,870,366,333,60,47,564,560,83,612,322,0
19:32:00,5034.026,Fox,1124,107,26,22,18,15,17,9,1124,1098,1076,870,366,333,60,47,564,560,83,612,322,0
19:32:00,5034.461,Fox,1124,107,26,20,20,15,17,9,1124,1098,1078,870,366,333,60,47,564,560,83,612,322,0
19:32:00,5035.133,Fox,1124,107,24,22,20,15,17,9,1124,1100,1078,870,366,333,60,47,564,560,83,612,322,0
19:32:00,5035.576,Fox,1126,108,26,22,19,15,17,9,1126,1100,1078,870,366,333,60,48,565,561,83,613,322,0
19:32:00,5036.32,Fox,1126,107,26,22,19,15,17,8,1126,1100,1078,870,366,333,60,47,565,561,83,613,323,0
19:32:01,5036.741,Fox,1126,105,26,22,19,13,17,8,1126,1100,1078,870,366,333,58,47,565,561,83,615,323,0
19:32:01,5037.691,Fox,1126,105,26,22,19,11,19,8,1126,1100,1078,870,368,333,58,47,565,561,83,615,323,0
19:32:01,5038.074,Fox,1126,105,26,18,23,11,19,8,1126,1100,1082,870,368,333,58,47,565,561,83,615,323,0
19:32:02,5040.003,Fox,1126,105,26,18,22,12,19,8,1126,1100,1082,871,368,333,58,47,565,561,83,615,323,0
19:32:02,5040.27,Fox,1126,104,26,18,22,11,19,8,1126,1100,1082,871,368,333,58,46,565,561,83,616,323,0
19:32:02,5040.817,Fox,1126,104,26,16,24,11,19,8,1126,1100,1084,871,368,333,58,46,565,561,83,616,323,0
19:32:02,5042.47,Fox,1126,104,26,12,28,11,19,8,1126,1100,1088,871,368,333,58,46,565,561,83,616,323,0
19:32:03,5043.437,Fox,1126,103,26,12,28,11,19,7,1126,1100,1088,871,368,333,58,45,565,561,83,616,324,0
19:32:03,5044.605,Fox,1126,103,26,12,27,12,19,7,1126,1100,1088,872,368,333,58,45,565,561,83,616,324,0
19:32:04,5046.865,Fox,1126,103,26,12,26,13,19,7,1126,1100,1088,873,368,333,58,45,565,561,83,616,324,0
19:32:04,5047.222,Fox,1126,102,26,12,26,13,19,6,1126,1100,1088,873,368,333,58,44,565,561,83,616,325,0
19:32:04,5047.828,Fox,1126,102,24,14,26,13,19,6,1126,1102,1088,873,368,333,58,44,565,561,83,616,325,0
19:32:05,5049.173,Fox,1126,102,24,12,28,13,19,6,1126,1102,1090,873,368,333,58,44,565,561,83,616,325,0
19:32:05,5049.936,Fox,1126,101,24,12,28,13,19,5,1126,1102,1090,873,368,333,58,43,565,561,83,616,326,0
19:32:05,5050.58,Fox,1126,100,24,12,28,12,19,5,1126,1102,1090,873,368,333,57,43,565,561,83,617,326,0
19:32:06,5052.716,Fox,1126,100,24,8,32,12,19,5,1126,1102,1094,873,368,333,57,43,565,561,83,617,326,0
19:32:07,5055.179,Fox,1126,99,24,8,32,11,19,5,1126,1102,1094,873,368,333,57,42,565,561,83,618,326,0
19:32:07,5055.699,Fox,1126,99,24,8,30,13,19,5,1126,1102,1094,875,368,333,57,42,565,561,83,618,326,0
19:32:07,5056.067,Fox,1128,100,26,8,29,13,19,5,1128,1102,1094,875,368,333,57,43,566,562,83,619,326,0
19:32:07,5056.598,Fox,1128,99,26,6,31,13,19,4,1128,1102,1096,875,368,333,57,42,566,562,83,619,327,0
19:32:08,5057.52,Fox,1128,98,26,6,29,14,19,4,1128,1102,1096,877,368,333,57,41,566,562,83,620,327,0
19:32:08,5058.263,Fox,1128,98,26,4,31,14,19,4,1128,1102,1098,877,368,333,57,41,566,562,83,620,327,0
19:32:08,5058.842,Fox,1130,100,28,4,31,14,19,4,1130,1102,1098,877,368,333,57,43,566,564,83,620,327,0
19:32:09,5061.278,Fox,1132,102,30,4,31,14,19,4,1132,1102,1098,877,368,333,59,43,568,564,83,620,327,0
19:32:09,5063.296,Fox,1132,102,28,6,31,14,19,4,1132,1104,1098,877,368,333,59,43,568,564,83,620,327,0
19:32:10,5063.537,Fox,1132,102,28,6,29,16,19,4,1132,1104,1098,879,368,333,59,43,568,564,83,620,327,0
19:32:10,5063.812,Fox,1132,102,28,6,29,14,21,4,1132,1104,1098,879,370,333,59,43,568,564,83,620,327,0
19:32:10,5066.266,Fox,1132,101,28,6,29,13,21,4,1132,1104,1098,879,370,333,59,42,568,564,83,621,327,0
19:32:11,5067.872,Fox,1132,99,28,6,29,11,21,4,1132,1104,1098,879,370,333,59,40,568,564,83,623,327,0
19:32:11,5068.724,Fox,1134,101,30,6,29,11,21,4,1134,1104,1098,879,370,333,60,41,569,565,83,623,327,0
19:32:11,5069.101,Fox,1136,103,32,6,29,11,21,4,1136,1104,1098,879,370,333,62,41,571,565,83,623,327,0
19:32:12,5069.743,Fox,1138,104,32,6,26,13,21,4,1136,1104,1098,881,370,333,63,41,573,565,83,624,327,0
19:32:12,5069.884,Fox,1138,104,34,6,26,13,21,4,1138,1104,1098,881,370,333,63,41,573,565,83,624,327,0
19:32:12,5072.515,Fox,1138,104,34,6,26,11,23,4,1138,1104,1098,881,372,333,63,41,573,565,83,624,327,0
19:32:13,5073.149,Fox,1140,105,36,6,25,11,23,4,1140,1104,1098,881,372,333,62,43,573,567,83,625,327,0
19:32:13,5073.315,Fox,1140,105,34,8,25,11,23,4,1140,1106,1098,881,372,333,62,43,573,567,83,625,327,0
19:32:13,5073.703,Fox,1140,105,34,6,27,11,23,4,1140,1106,1100,881,372,333,62,43,573,567,83,625,327,0
19:32:13,5074.274,Fox,1142,105,34,6,27,9,23,4,1140,1106,1100,881,372,333,62,43,574,568,83,627,327,0
19:32:13,5074.576,Fox,1146,107,36,6,25,9,23,4,1142,1106,1100,881,372,333,61,46,575,571,83,629,327,0
19:32:13,5074.736,Fox,1146,107,40,6,25,9,23,4,1146,1106,1100,881,372,333,61,46,575,571,83,629,327,0
19:32:13,5075.309,Fox,1146,107,40,6,25,7,25,4,1146,1106,1100,881,374,333,61,46,575,571,83,629,327,0
19:32:14,5075.951,Fox,1146,107,38,8,25,7,25,4,1146,1108,1100,881,374,333,61,46,575,571,83,629,327,0
19:32:14,5076.468,Fox,1146,107,38,8,25,7,24,5,1146,1108,1100,881,374,334,61,46,575,571,83,629,327,0
19:32:15,5078.608,Fox,1146,106,38,8,25,7,24,4,1146,1108,1100,881,374,334,61,45,575,571,83,629,328,0
19:32:15,5079.013,Fox,1148,107,40,8,24,7,24,4,1148,1108,1100,881,374,334,62,45,577,571,84,629,328,0
19:32:15,5079.277,Fox,1148,107,40,8,24,7,22,6,1148,1108,1100,881,374,336,62,45,577,571,84,629,328,0
19:32:15,5080.075,Fox,1148,105,40,8,24,5,22,6,1148,1108,1100,881,374,336,60,45,577,571,84,631,328,0
19:32:15,5080.363,Fox,1148,105,40,8,23,6,22,6,1148,1108,1100,882,374,336,60,45,577,571,84,631,328,0
19:32:15,5081.002,Fox,1148,104,40,8,23,6,20,7,1148,1108,1100,882,374,338,59,45,577,571,84,631,329,0
19:32:16,5081.518,Fox,1148,104,38,10,23,6,20,7,1148,1110,1100,882,374,338,59,45,577,571,84,631,329,0
19:32:16,5082.683,Fox,1148,104,36,12,23,6,20,7,1148,1112,1100,882,374,338,59,45,577,571,84,631,329,0
19:32:16,5083.191,Fox,1148,104,36,12,21,8,20,7,1148,1112,1100,884,374,338,59,45,577,571,84,631,329,0
19:32:17,5086.402,Fox,1148,104,36,10,23,6,22,7,1148,1112,1102,884,376,338,59,45,577,571,84,631,329,0
19:32:18,5087.933,Fox,1148,104,34,12,23,6,22,7,1148,1114,1102,884,376,338,59,45,577,571,84,631,329,0
19:32:18,5088.635,Fox,1148,104,32,14,23,6,22,7,1148,1116,1102,884,376,338,59,45,577,571,84,631,329,0
19:32:19,5090.861,Fox,1148,103,32,14,23,5,22,7,1148,1116,1102,884,376,338,59,44,577,571,84,632,329,0
19:32:20,5094.423,Fox,1148,103,32,14,22,6,21,8,1148,1116,1102,885,376,339,59,44,577,571,84,632,329,0
19:32:20,5095.107,Fox,1152,105,36,14,19,7,21,8,1152,1116,1102,886,376,339,59,46,579,573,85,633,329,0
19:32:20,5095.742,Fox,1152,105,36,14,19,6,21,9,1152,1116,1102,886,377,340,59,46,579,573,85,633,329,0
19:32:20,5095.974,Fox,1152,104,36,14,19,6,21,8,1152,1116,1102,886,377,340,58,46,579,573,85,633,330,0
19:32:21,5096.828,Fox,1152,103,36,14,19,6,21,7,1152,1116,1102,886,377,340,57,46,579,573,85,633,331,0
19:32:21,5097.22,Fox,1152,103,34,16,19,6,21,7,1152,1118,1102,886,377,340,57,46,579,573,85,633,331,0
19:32:21,5098.513,Fox,1152,103,34,16,17,8,21,7,1152,1118,1102,888,377,340,57,46,579,573,85,633,331,0
19:32:22,5100.202,Fox,1154,105,36,16,17,8,21,7,1154,1118,1102,888,377,340,59,46,581,573,85,633,331,0
19:32:22,5101.315,Fox,1154,105,36,16,15,10,21,7,1154,1118,1102,890,377,340,59,46,581,573,85,633,331,0
19:32:22,5101.903,Fox,1154,105,34,16,17,10,21,7,1154,1120,1104,890,377,340,59,46,581,573,85,633,331,0
19:32:23,5102.797,Fox,1154,105,34,16,15,12,20,8,1154,1120,1104,892,377,341,59,46,581,573,85,633,331,0
19:32:23,5103.075,Fox,1154,105,34,16,14,13,20,8,1154,1120,1104,893,377,341,59,46,581,573,85,633,331,0
19:32:23,5103.333,Fox,1154,105,32,18,14,13,20,8,1154,1122,1104,893,377,341,59,46,581,573,85,633,331,0
19:32:23,5105.071,Fox,1154,104,32,18,14,12,20,8,1154,1122,1104,893,377,341,59,45,581,573,85,634,331,0
19:32:23,5105.309,Fox,1154,104,30,20,14,12,20,8,1154,1124,1104,893,377,341,59,45,581,573,85,634,331,0
19:32:24,5105.59,Fox,1154,103,30,20,14,11,20,8,1154,1124,1104,893,377,341,59,44,581,573,85,635,331,0
19:32:24,5107.695,Fox,1154,103,30,20,14,10,21,8,1154,1124,1104,893,378,341,59,44,581,573,85,635,331,0
19:32:25,5108.754,Fox,1156,104,32,20,14,9,21,8,1156,1124,1104,893,378,341,59,45,582,574,85,636,331,0
19:32:25,5109.143,Fox,1156,103,32,20,14,8,21,8,1156,1124,1104,893,378,341,59,44,582,574,85,637,331,0
19:32:25,5109.655,Fox,1156,103,32,20,13,9,21,8,1156,1124,1104,894,378,341,59,44,582,574,85,637,331,0
19:32:26,5111.877,Fox,1158,104,32,18,14,9,21,8,1156,1124,1106,894,378,341,58,46,582,576,85,638,331,0
19:32:26,5112.001,Fox,1158,104,34,18,14,9,21,8,1158,1124,1106,894,378,341,58,46,582,576,85,638,331,0
19:32:26,5113.203,Fox,1158,104,34,18,10,13,21,8,1158,1124,1106,898,378,341,58,46,582,576,85,638,331,0
19:32:26,5113.326,Fox,1158,103,34,18,10,12,21,8,1158,1124,1106,898,378,341,58,45,582,576,85,639,331,0
19:32:26,5113.56,Fox,1158,102,34,18,10,11,21,8,1158,1124,1106,898,378,341,57,45,582,576,85,640,331,0
19:32:26,5114.453,Fox,1158,101,34,16,12,11,21,7,1158,1124,1108,898,378,341,56,45,582,576,85,640,332,0
19:32:27,5115.698,Fox,1160,102,36,16,12,10,21,7,1160,1124,1108,898,378,341,56,46,583,577,85,641,332,0
19:32:27,5117.097,Fox,1160,102,36,16,11,11,21,7,1160,1124,1108,899,378,341,56,46,583,577,85,641,332,0
19:32:28,5118.08,Fox,1160,102,34,18,11,11,21,7,1160,1126,1108,899,378,341,56,46,583,577,85,641,332,0
19:32:28,5118.769,Fox,1160,102,34,18,9,13,21,7,1160,1126,1108,901,378,341,56,46,583,577,85,641,332,0
19:32:28,5119.967,Fox,1160,102,34,16,11,13,21,7,1160,1126,1110,901,378,341,56,46,583,577,85,641,332,0
19:32:28,5120.246,Fox,1160,101,34,16,11,12,21,7,1160,1126,1110,901,378,341,55,46,583,577,85,642,332,0
19:32:29,5121.258,Fox,1160,101,34,14,13,12,21,7,1160,1126,1112,901,378,341,55,46,583,577,85,642,332,0
19:32:30,5123.652,Fox,1160,99,34,14,13,10,21,7,1160,1126,1112,901,378,341,54,45,583,577,85,644,332,0
19:32:30,5124.987,Fox,1162,101,36,14,13,10,21,7,1162,1126,1112,901,378,341,54,47,583,579,85,644,332,0
19:32:30,5125.596,Fox,1164,103,38,14,13,10,21,7,1164,1126,1112,901,378,341,55,48,584,580,85,644,332,0
19:32:30,5126.313,Fox,1164,103,38,12,15,10,21,7,1164,1126,1114,901,378,341,55,48,584,580,85,644,332,0
19:32:31,5126.872,Fox,1164,103,38,10,17,10,21,7,1164,1126,1116,901,378,341,55,48,584,580,85,644,332,0
19:32:31,5127.663,Fox,1164,102,38,10,17,9,21,7,1164,1126,1116,901,378,341,55,47,584,580,85,645,332,0
19:32:31,5129.359,Fox,1164,100,38,10,17,7,21,7,1164,1126,1116,901,378,341,54,46,584,580,85,647,332,0
19:32:33,5133.653,Fox,1164,100,38,10,17,7,19,9,1164,1126,1116,901,378,343,54,46,584,580,85,647,332,0
19:32:33,5134.128,Fox,1164,100,38,10,16,8,19,9,1164,1126,1116,902,378,343,54,46,584,580,85,647,332,0
19:32:34,5135.75,Fox,1164,100,38,8,18,8,19,9,1164,1126,1118,902,378,343,54,46,584,580,85,647,332,0
19:32:34,5135.971,Fox,1164,99,38,8,18,8,19,8,1164,1126,1118,902,378,343,53,46,584,580,85,647,333,0
19:32:34,5136.588,Fox,1166,100,40,8,17,8,19,8,1166,1126,1118,902,378,343,53,47,585,581,85,648,333,0
19:32:35,5138.593,Fox,1168,102,40,10,17,8,19,8,1168,1128,1118,902,378,343,54,48,586,582,85,648,333,0
19:32:35,5140.411,Fox,1168,102,40,8,19,8,19,8,1168,1128,1120,902,378,343,54,48,586,582,85,648,333,0
19:32:35,5140.662,Fox,1168,100,40,8,19,8,17,8,1168,1128,1120,902,378,343,54,46,586,582,85,650,333,0
19:32:35,5141.428,Fox,1168,100,38,10,19,8,17,8,1168,1130,1120,902,378,343,54,46,586,582,85,650,333,0
19:32:36,5141.88,Fox,1168,100,38,8,21,8,17,8,1168,1130,1122,902,378,343,54,46,586,582,85,650,333,0
19:32:36,5143.003,Fox,1168,99,38,8,21,8,17,7,1168,1130,1122,902,378,343,53,46,586,582,85,650,334,0
19:32:36,5143.889,Fox,1168,99,36,8,23,8,17,7,1168,1132,1124,902,378,343,53,46,586,582,85,650,334,0
19:32:37,5144.667,Fox,1168,98,36,8,23,7,17,7,1168,1132,1124,902,378,343,53,45,586,582,85,651,334,0
19:32:37,5146.937,Fox,1168,97,36,8,22,8,17,6,1168,1132,1124,903,378,343,53,44,586,582,85,651,335,0
19:32:38,5147.538,Fox,1170,99,38,8,22,8,17,6,1170,1132,1124,903,378,343,55,44,588,582,85,651,335,0
19:32:38,5149.154,Fox,1170,99,38,8,22,7,18,6,1170,1132,1124,903,379,343,55,44,588,582,85,651,335,0
19:32:39,5151.654,Fox,1174,101,36,12,21,7,18,5,1172,1136,1124,903,379,343,57,44,591,583,85,652,336,0
19:32:39,5151.801,Fox,1174,101,38,12,21,7,18,5,1174,1136,1124,903,379,343,57,44,591,583,85,652,336,0
19:32:39,5152.458,Fox,1174,101,36,14,21,7,18,5,1174,1138,1124,903,379,343,57,44,591,583,85,652,336,0
19:32:40,5154.198,Fox,1174,100,36,14,21,7,17,5,1174,1138,1124,903,379,343,57,43,591,583,85,653,336,0
19:32:40,5155.4,Fox,1174,100,36,14,21,7,15,7,1174,1138,1124,903,379,345,57,43,591,583,85,653,336,0
19:32:40,5155.625,Fox,1174,100,34,16,21,7,15,7,1174,1140,1124,903,379,345,57,43,591,583,85,653,336,0
19:32:40,5156.25,Fox,1174,100,34,16,21,7,13,9,1174,1140,1124,903,379,347,57,43,591,583,85,653,336,0
19:32:41,5156.603,Fox,1174,100,34,14,23,7,13,9,1174,1140,1126,903,379,347,57,43,591,583,85,653,336,0
19:32:41,5156.936,Fox,1174,100,32,16,23,7,13,9,1174,1142,1126,903,379,347,57,43,591,583,85,653,336,0
19:32:41,5157.431,Fox,1174,99,28,20,23,6,13,9,1174,1146,1126,903,379,347,57,42,591,583,85,654,336,0
19:32:42,5161.669,Fox,1178,103,26,22,23,6,13,9,1174,1148,1126,903,379,347,59,44,593,585,85,654,336,0
19:32:42,5161.805,Fox,1178,103,30,22,23,6,13,9,1178,1148,1126,903,379,347,59,44,593,585,85,654,336,0
19:32:42,5162.304,Fox,1178,103,30,22,22,7,13,9,1178,1148,1126,904,379,347,59,44,593,585,85,654,336,0
19:32:43,5163.883,Fox,1178,102,30,22,22,7,13,8,1178,1148,1126,904,379,347,58,44,593,585,85,654,337,0
19:32:44,5165.485,Fox,1180,104,32,22,22,7,13,8,1180,1148,1126,904,379,347,59,45,594,586,85,654,337,0
19:32:44,5165.932,Fox,1180,104,32,22,22,7,12,9,1180,1148,1126,904,379,348,59,45,594,586,85,654,337,0
19:32:45,5169.638,Fox,1182,104,34,22,22,7,12,7,1182,1148,1126,904,379,348,59,45,595,587,85,654,339,0
19:32:46,5172.318,Fox,1182,104,34,22,20,9,12,7,1182,1148,1126,906,379,348,59,45,595,587,85,654,339,0
19:32:46,5172.791,Fox,1182,103,34,22,20,8,12,7,1182,1148,1126,906,379,348,58,45,595,587,85,655,339,0
19:32:46,5173.653,Fox,1184,104,36,22,19,8,12,7,1184,1148,1126,906,379,348,59,45,597,587,85,656,339,0
19:32:47,5174.892,Fox,1184,104,36,22,17,10,12,7,1184,1148,1126,908,379,348,59,45,597,587,85,656,339,0
19:32:47,5175.17,Fox,1184,104,36,22,17,10,10,9,1184,1148,1126,908,379,350,59,45,597,587,85,656,339,0
19:32:47,5176.639,Fox,1184,104,36,22,17,8,12,9,1184,1148,1126,908,381,350,59,45,597,587,85,656,339,0
19:32:47,5177.149,Fox,1184,104,36,20,19,8,12,9,1184,1148,1128,908,381,350,59,45,597,587,85,656,339,0
19:32:48,5177.618,Fox,1184,104,32,24,19,8,12,9,1184,1152,1128,908,381,350,59,45,597,587,85,656,339,0
19:32:48,5179.96,Fox,1184,104,32,22,21,8,12,9,1184,1152,1130,908,381,350,59,45,597,587,85,656,339,0
19:32:49,5180.497,Fox,1184,104,32,22,19,10,12,9,1184,1152,1130,910,381,350,59,45,597,587,85,656,339,0
19:32:49,5180.907,Fox,1186,105,34,22,18,10,12,9,1186,1152,1130,910,381,350,59,46,598,588,85,657,339,0
19:32:49,5181.687,Fox,1186,105,34,22,16,12,12,9,1186,1152,1130,912,381,350,59,46,598,588,85,657,339,0
19:32:49,5182.294,Fox,1186,105,34,20,18,12,12,9,1186,1152,1132,912,381,350,59,46,598,588,85,657,339,0
19:32:49,5182.908,Fox,1186,103,32,22,18,10,12,9,1186,1154,1132,912,381,350,57,46,598,588,85,659,339,0
19:32:49,5183.207,Fox,1188,104,34,22,17,10,12,9,1188,1154,1132,912,381,350,58,46,600,588,85,660,339,0
19:32:50,5184.045,Fox,1188,103,34,22,17,10,12,8,1188,1154,1132,912,381,350,57,46,600,588,85,660,340,0
19:32:50,5185.432,Fox,1188,101,34,22,17,8,12,8,1188,1154,1132,912,381,350,57,44,600,588,85,662,340,0
19:32:50,5185.707,Fox,1188,100,34,22,17,8,12,7,1188,1154,1132,912,381,350,56,44,600,588,85,662,341,0
19:32:50,5186.109,Fox,1188,99,34,22,17,8,12,6,1188,1154,1132,912,381,350,56,43,600,588,85,662,342,0
19:32:51,5186.88,Fox,1188,99,34,22,15,10,12,6,1188,1154,1132,914,381,350,56,43,600,588,85,662,342,0
19:32:51,5187.543,Fox,1188,99,34,22,13,12,12,6,1188,1154,1132,916,381,350,56,43,600,588,85,662,342,0
19:32:51,5188.407,Fox,1190,100,36,22,12,12,12,6,1190,1154,1132,916,381,350,56,44,601,589,85,663,342,0
19:32:52,5189.832,Fox,1190,100,36,20,14,12,12,6,1190,1154,1134,916,381,350,56,44,601,589,85,663,342,0
19:32:52,5190.187,Fox,1190,100,36,18,16,12,12,6,1190,1154,1136,916,381,350,56,44,601,589,85,663,342,0
19:32:52,5190.959,Fox,1190,100,36,16,18,12,12,6,1190,1154,1138,916,381,350,56,44,601,589,85,663,342,0
19:32:52,5191.361,Fox,1190,100,34,18,18,12,12,6,1190,1156,1138,916,381,350,56,44,601,589,85,663,342,0
19:32:52,5191.996,Fox,1190,100,34,18,18,11,13,6,1190,1156,1138,916,382,350,56,44,601,589,85,663,342,0
19:32:52,5192.279,Fox,1190,98,34,18,18,9,13,6,1190,1156,1138,916,382,350,54,44,601,589,85,665,342,0
19:32:53,5194.14,Fox,1190,98,34,16,20,9,13,6,1190,1156,1140,916,382,350,54,44,601,589,85,665,342,0
19:32:53,5194.514,Fox,1190,98,32,18,20,9,13,6,1190,1158,1140,916,382,350,54,44,601,589,85,665,342,0
19:32:53,5194.794,Fox,1190,98,32,18,20,8,14,6,1190,1158,1140,916,383,350,54,44,601,589,85,665,342,0
19:32:54,5195.489,Fox,1190,98,32,16,22,8,14,6,1190,1158,1142,916,383,350,54,44,601,589,85,665,342,0
19:32:54,5195.76,Fox,1190,98,32,12,26,8,14,6,1190,1158,1146,916,383,350,54,44,601,589,85,665,342,0
19:32:54,5196.391,Fox,1190,98,32,12,25,8,15,6,1190,1158,1146,917,384,350,54,44,601,589,85,665,342,0
19:32:54,5197.991,Fox,1190,96,32,12,25,6,15,6,1190,1158,1146,917,384,350,53,43,601,589,85,667,342,0
19:32:54,5198.272,Fox,1190,96,30,14,25,6,15,6,1190,1160,1146,917,384,350,53,43,601,589,85,667,342,0
19:32:55,5200.01,Fox,1190,96,30,12,27,6,15,6,1190,1160,1148,917,384,350,53,43,601,589,85,667,342,0
19:32:55,5200.904,Fox,1190,96,30,12,25,8,15,6,1190,1160,1148,919,384,350,53,43,601,589,85,667,342,0
19:32:55,5201.266,Fox,1190,96,30,12,25,8,13,8,1190,1160,1148,919,384,352,53,43,601,589,85,667,342,0
19:32:56,5202.297,Fox,1190,96,30,12,24,9,13,8,1190,1160,1148,920,384,352,53,43,601,589,85,667,342,0
19:32:57,5206.791,Fox,1190,95,30,12,24,7,14,8,1190,1160,1148,920,385,352,53,42,601,589,85,668,342,0
19:32:58,5207.571,Fox,1190,95,28,14,24,7,14,8,1190,1162,1148,920,385,352,53,42,601,589,85,668,342,0
19:32:58,5208.104,Fox,1190,95,26,16,24,7,14,8,1190,1164,1148,920,385,352,53,42,601,589,85,668,342,0
19:32:58,5209.995,Fox,1190,95,26,16,24,7,12,10,1190,1164,1148,920,385,354,53,42,601,589,85,668,342,0
19:32:59,5211.528,Fox,1190,93,26,16,24,5,12,10,1190,1164,1148,920,385,354,53,40,601,589,85,670,342,0
19:32:59,5212.663,Fox,1190,93,26,16,24,5,10,12,1190,1164,1148,920,385,356,53,40,601,589,85,670,342,0
19:32:59,5212.864,Fox,1190,92,26,16,24,4,10,12,1190,1164,1148,920,385,356,52,40,601,589,85,671,342,0
19:33:00,5215.447,Fox,1190,91,26,16,24,4,10,11,1190,1164,1148,920,385,356,51,40,601,589,85,671,343,0
19:33:00,5216.093,Fox,1190,91,26,12,28,4,10,11,1190,1164,1152,920,385,356,51,40,601,589,85,671,343,0
19:33:01,5217.117,Fox,1190,91,26,12,26,6,10,11,1190,1164,1152,922,385,356,51,40,601,589,85,671,343,0
19:33:01,5219.074,Fox,1190,91,24,14,26,6,10,11,1190,1166,1152,922,385,356,51,40,601,589,85,671,343,0
19:33:02,5220.048,Fox,1190,90,24,14,26,6,10,10,1190,1166,1152,922,385,356,50,40,601,589,85,671,344,0
19:33:02,5221.244,Fox,1190,90,22,14,28,6,10,10,1190,1168,1154,922,385,356,50,40,601,589,85,671,344,0
19:33:02,5222.127,Fox,1192,91,22,14,28,6,10,9,1190,1168,1154,922,385,356,52,39,603,589,85,671,345,0
19:33:02,5222.273,Fox,1192,91,24,14,28,6,10,9,1192,1168,1154,922,385,356,52,39,603,589,85,671,345,0
19:33:03,5223.723,Fox,1192,91,24,14,28,6,8,11,1192,1168,1154,922,385,358,52,39,603,589,85,671,345,0
19:33:03,5224.548,Fox,1192,90,24,14,28,6,8,10,1192,1168,1154,922,385,358,51,39,603,589,85,672,345,0
19:33:04,5226.974,Fox,1194,92,26,14,28,6,8,10,1194,1168,1154,922,385,358,53,39,605,589,85,672,345,0
19:33:04,5227.634,Fox,1194,90,26,14,28,4,8,10,1194,1168,1154,922,385,358,52,38,605,589,85,674,345,0
19:33:05,5229.797,Fox,1194,90,26,12,30,4,8,10,1194,1168,1156,922,385,358,52,38,605,589,85,674,345,0
19:33:05,5230.026,Fox,1194,90,24,14,30,4,8,10,1194,1170,1156,922,385,358,52,38,605,589,85,674,345,0
19:33:05,5231.413,Fox,1194,89,24,14,30,4,8,9,1194,1170,1156,922,385,358,52,37,605,589,85,674,346,0
19:33:06,5233.04,Fox,1194,89,24,12,32,4,7,10,1194,1170,1158,922,385,359,52,37,605,589,85,674,346,0
19:33:06,5233.796,Fox,1196,90,26,12,31,4,7,10,1196,1170,1158,922,385,359,52,38,606,590,85,675,346,0
19:33:06,5234.147,Fox,1196,90,24,14,31,4,7,10,1196,1172,1158,922,385,359,52,38,606,590,85,675,346,0
19:33:06,5234.36,Fox,1196,90,22,16,31,4,7,10,1196,1174,1158,922,385,359,52,38,606,590,85,675,346,0
19:33:07,5236.764,Fox,1196,89,22,14,33,4,7,9,1196,1174,1160,922,385,359,52,37,606,590,85,675,347,0
19:33:08,5237.627,Fox,1196,89,22,14,31,6,7,9,1196,1174,1160,924,385,359,52,37,606,590,85,675,347,0
19:33:08,5238.214,Fox,1198,90,24,14,30,6,7,9,1198,1174,1160,924,385,359,52,38,607,591,85,676,347,0
19:33:08,5240.303,Fox,1198,90,24,14,28,8,7,9,1198,1174,1160,926,385,359,52,38,607,591,85,676,347,0
19:33:09,5241.092,Fox,1200,92,26,14,28,8,7,9,1200,1174,1160,926,385,359,53,39,608,592,85,676,347,0
19:33:09,5242.911,Fox,1200,91,26,14,26,10,7,8,1200,1174,1160,928,385,359,52,39,608,592,85,676,348,0
19:33:10,5244.327,Fox,1200,91,22,18,26,10,7,8,1200,1178,1160,928,385,359,52,39,608,592,85,676,348,0
19:33:10,5245.264,Fox,1200,91,22,18,26,10,6,9,1200,1178,1160,928,385,360,52,39,608,592,85,676,348,0
19:33:10,5246.047,Fox,1200,91,22,16,28,10,6,9,1200,1178,1162,928,385,360,52,39,608,592,85,676,348,0
19:33:11,5246.614,Fox,1200,91,22,14,30,10,6,9,1200,1178,1164,928,385,360,52,39,608,592,85,676,348,0
19:33:11,5248.176,Fox,1200,89,20,16,30,8,6,9,1200,1180,1164,928,385,360,51,38,608,592,85,678,348,0
19:33:11,5248.681,Fox,1202,90,22,16,29,8,6,9,1202,1180,1164,928,385,360,51,39,609,593,85,679,348,0
19:33:12,5250.264,Fox,1202,89,22,16,28,9,6,8,1202,1180,1164,929,385,360,50,39,609,593,85,679,349,0
19:33:12,5250.604,Fox,1202,89,22,16,26,11,6,8,1202,1180,1164,931,385,360,50,39,609,593,85,679,349,0
19:33:12,5250.969,Fox,1202,87,22,16,26,9,6,8,1202,1180,1164,931,385,360,50,37,609,593,85,681,349,0
19:33:12,5251.578,Fox,1202,86,22,16,26,9,6,7,1202,1180,1164,931,385,360,50,36,609,593,85,681,350,0
19:33:12,5252.177,Fox,1202,86,20,18,26,9,6,7,1202,1182,1164,931,385,360,50,36,609,593,85,681,350,0
19:33:13,5252.98,Fox,1202,85,20,18,26,9,6,6,1202,1182,1164,931,385,360,49,36,609,593,85,681,351,0
19:33:13,5253.388,Fox,1202,83,20,18,26,7,6,6,1202,1182,1164,931,385,360,47,36,609,593,85,683,351,0
19:33:13,5254.495,Fox,1204,84,22,18,25,7,6,6,1204,1182,1164,931,385,360,46,38,609,595,85,684,351,0
19:33:13,5254.69,Fox,1204,84,22,18,23,9,6,6,1204,1182,1164,933,385,360,46,38,609,595,85,684,351,0
19:33:14,5255.939,Fox,1204,84,22,18,21,11,6,6,1204,1182,1164,935,385,360,46,38,609,595,85,684,351,0
19:33:14,5256.229,Fox,1204,84,20,20,17,15,6,6,1204,1184,1164,939,385,360,46,38,609,595,85,684,351,0
19:33:14,5256.764,Fox,1204,83,20,20,17,15,6,5,1204,1184,1164,939,385,360,45,38,609,595,85,684,352,0
19:33:14,5257.587,Fox,1204,83,20,18,19,15,6,5,1204,1184,1166,939,385,360,45,38,609,595,85,684,352,0
19:33:15,5259.584,Fox,1206,84,22,18,18,15,6,5,1206,1184,1166,939,385,360,44,40,609,597,85,685,352,0
19:33:15,5259.708,Fox,1206,84,22,16,20,15,6,5,1206,1184,1168,939,385,360,44,40,609,597,85,685,352,0
19:33:15,5260.538,Fox,1206,84,22,16,19,16,6,5,1206,1184,1168,940,385,360,44,40,609,597,85,685,352,0
19:33:15,5260.84,Fox,1206,83,22,16,19,15,6,5,1206,1184,1168,940,385,360,44,39,609,597,85,686,352,0
19:33:15,5261.183,Fox,1206,81,22,16,19,13,6,5,1206,1184,1168,940,385,360,42,39,609,597,85,688,352,0
19:33:16,5263.429,Fox,1206,81,20,18,19,13,6,5,1206,1186,1168,940,385,360,42,39,609,597,85,688,352,0
19:33:17,5265.203,Fox,1206,79,20,18,19,11,6,5,1206,1186,1168,940,385,360,42,37,609,597,85,690,352,0
19:33:17,5265.555,Fox,1206,78,20,18,19,11,6,4,1206,1186,1168,940,385,360,41,37,609,597,85,690,353,0
19:33:17,5265.807,Fox,1206,78,18,20,19,11,6,4,1206,1188,1168,940,385,360,41,37,609,597,85,690,353,0
19:33:17,5266.542,Fox,1206,76,18,20,19,9,6,4,1206,1188,1168,940,385,360,40,36,609,597,85,692,353,0
19:33:17,5266.858,Fox,1208,73,20,20,18,5,6,4,1208,1188,1168,940,385,360,40,33,611,597,85,697,353,0
19:33:18,5268.527,Fox,1208,73,20,18,20,5,6,4,1208,1188,1170,940,385,360,40,33,611,597,85,697,353,0
19:33:19,5270.911,Fox,1208,73,18,20,20,5,6,4,1208,1190,1170,940,385,360,40,33,611,597,85,697,353,0
19:33:19,5271.157,Fox,1208,72,18,20,20,4,6,4,1208,1190,1170,940,385,360,39,33,611,597,86,697,353,0
19:33:19,5271.775,Fox,1210,73,20,20,19,4,6,4,1210,1190,1170,940,385,360,40,33,613,597,86,698,353,0
19:33:19,5272.835,Fox,1210,73,20,16,23,4,6,4,1210,1190,1174,940,385,360,40,33,613,597,86,698,353,0
19:33:20,5273.99,Fox,1210,72,20,16,23,2,8,3,1210,1190,1174,940,387,360,39,33,613,597,86,698,354,0
19:33:21,5276.637,Fox,1210,72,20,16,19,6,8,3,1210,1190,1174,944,387,360,39,33,613,597,86,698,354,0
19:33:22,5279.416,Fox,1212,73,22,16,18,6,8,3,1212,1190,1174,944,387,360,39,34,614,598,86,699,354,0
19:33:22,5280.356,Fox,1212,73,22,16,18,4,10,3,1212,1190,1174,944,389,360,39,34,614,598,86,699,354,0
19:33:23,5282.786,Fox,1212,73,22,12,22,4,10,3,1212,1190,1178,944,389,360,39,34,614,598,86,699,354,0
19:33:23,5284.553,Fox,1214,74,24,12,21,4,10,3,1214,1190,1178,944,389,360,39,35,615,599,86,700,354,0
19:33:24,5286.542,Fox,1214,74,24,10,23,4,10,3,1214,1190,1180,944,389,360,39,35,615,599,86,700,354,0
19:33:24,5287.171,Fox,1214,71,24,10,23,1,10,3,1214,1190,1180,944,389,360,38,33,615,599,87,702,354,0
19:33:25,5290.275,Fox,1214,71,24,10,22,2,10,3,1214,1190,1180,945,389,360,38,33,615,599,87,702,354,0
19:33:25,5290.692,Fox,1214,71,24,8,24,2,10,3,1214,1190,1182,945,389,360,38,33,615,599,87,702,354,0
19:33:26,5293.515,Fox,1214,71,24,8,22,4,10,3,1214,1190,1182,947,389,360,38,33,615,599,87,702,354,0
19:33:27,5294.675,Fox,1214,71,24,6,24,4,10,3,1214,1190,1184,947,389,360,38,33,615,599,87,702,354,0
19:33:27,5295.882,Fox,1216,72,26,6,23,4,10,3,1216,1190,1184,947,389,360,37,35,615,601,87,703,354,0
19:33:27,5297.2,Fox,1216,72,26,6,22,5,10,3,1216,1190,1184,948,389,360,37,35,615,601,87,703,354,0
19:33:29,5300.884,Fox,1216,71,26,6,22,4,10,3,1216,1190,1184,948,389,360,37,34,615,601,87,704,354,0
19:33:29,5301.945,Fox,1216,71,26,4,24,4,10,3,1216,1190,1186,948,389,360,37,34,615,601,87,704,354,0
19:33:30,5304.224,Fox,1216,68,26,2,26,2,10,2,1216,1190,1188,948,389,360,37,31,615,601,87,706,355,0
19:33:30,5304.845,Fox,1216,68,24,4,26,2,10,2,1216,1192,1188,948,389,360,37,31,615,601,87,706,355,0
19:33:31,5306.453,Fox,1216,68,24,4,24,4,10,2,1216,1192,1188,950,389,360,37,31,615,601,87,706,355,0
19:33:31,5307.188,Fox,1216,68,24,4,23,5,10,2,1216,1192,1188,951,389,360,37,31,615,601,87,706,355,0
19:33:31,5307.634,Fox,1218,69,26,4,22,5,10,2,1218,1192,1188,951,389,360,37,32,616,602,87,707,355,0
19:33:31,5307.848,Fox,1218,68,26,4,22,4,10,2,1218,1192,1188,951,389,360,37,31,616,602,87,708,355,0
19:33:32,5309.481,Fox,1218,68,24,4,24,4,10,2,1218,1194,1190,951,389,360,37,31,616,602,87,708,355,0
19:33:33,5313.476,Fox,1218,67,24,4,24,4,10,1,1218,1194,1190,951,389,360,37,30,616,602,87,708,356,0
19:33:33,5314.093,Fox,1218,67,24,4,24,4,8,3,1218,1194,1190,951,389,362,37,30,616,602,87,708,356,0
19:33:34,5315.557,Fox,1218,66,24,4,24,4,8,2,1218,1194,1190,951,389,362,36,30,616,602,87,708,357,0
19:33:34,5316.337,Fox,1218,66,22,6,24,4,8,2,1218,1196,1190,951,389,362,36,30,616,602,87,708,357,0
19:33:34,5317.104,Fox,1218,65,22,6,24,3,8,2,1218,1196,1190,951,389,362,36,29,616,602,87,709,357,0
19:33:34,5317.705,Fox,1218,64,22,6,24,2,8,2,1218,1196,1190,951,389,362,36,28,616,602,87,710,357,0
19:33:34,5318.248,Fox,1220,65,22,6,22,3,8,2,1218,1196,1190,952,389,362,36,29,617,603,87,711,357,0
19:33:35,5318.414,Fox,1220,65,24,6,22,3,8,2,1220,1196,1190,952,389,362,36,29,617,603,87,711,357,0
19:33:35,5320.191,Fox,1220,65,24,6,20,5,8,2,1220,1196,1190,954,389,362,36,29,617,603,87,711,357,0
19:33:35,5320.757,Fox,1220,65,22,8,20,5,8,2,1220,1198,1190,954,389,362,36,29,617,603,87,711,357,0
19:33:36,5321.47,Fox,1222,67,24,8,20,5,8,2,1222,1198,1190,954,389,362,36,31,617,605,87,711,357,0
19:33:36,5323.581,Fox,1222,67,22,10,20,5,8,2,1222,1200,1190,954,389,362,36,31,617,605,87,711,357,0
19:33:38,5328.238,Fox,1224,68,24,10,19,5,8,2,1224,1200,1190,954,389,362,37,31,619,605,87,712,357,0
19:33:38,5328.494,Fox,1226,70,26,10,19,5,8,2,1226,1200,1190,954,389,362,39,31,621,605,87,712,357,0
19:33:38,5328.721,Fox,1226,69,26,10,19,4,8,2,1226,1200,1190,954,389,362,39,30,621,605,87,713,357,0
19:33:38,5329.081,Fox,1226,69,26,10,17,6,8,2,1226,1200,1190,956,389,362,39,30,621,605,87,713,357,0
19:33:38,5329.538,Fox,1226,69,26,10,17,6,7,3,1226,1200,1190,956,389,363,39,30,621,605,87,713,357,0
19:33:39,5330.745,Fox,1226,68,26,10,17,5,7,3,1226,1200,1190,956,389,363,39,29,621,605,88,713,357,0
19:33:39,5331.2,Fox,1226,68,24,12,17,5,7,3,1226,1202,1190,956,389,363,39,29,621,605,88,713,357,0
19:33:39,5332.208,Fox,1226,68,24,12,17,5,6,4,1226,1202,1190,956,389,364,39,29,621,605,88,713,357,0
19:33:39,5333.299,Fox,1226,68,24,12,14,8,6,4,1226,1202,1190,959,389,364,39,29,621,605,88,713,357,0
19:33:40,5333.736,Fox,1226,68,24,12,14,8,5,5,1226,1202,1190,959,389,365,39,29,621,605,88,713,357,0
19:33:40,5334.545,Fox,1228,70,26,12,14,8,5,5,1228,1202,1190,959,389,365,39,31,621,607,88,713,357,0
19:33:41,5337,Fox,1228,70,24,14,14,8,5,5,1228,1204,1190,959,389,365,39,31,621,607,88,713,357,0
19:33:42,5339.655,Fox,1228,68,24,14,14,6,5,5,1228,1204,1190,959,389,365,37,31,621,607,90,713,357,0
19:33:42,5342.191,Fox,1228,68,22,16,14,6,5,5,1228,1206,1190,959,389,365,37,31,621,607,90,713,357,0
19:33:43,5342.822,Fox,1230,69,24,16,13,6,5,5,1230,1206,1190,959,389,365,36,33,621,609,90,714,357,0
19:33:43,5343.327,Fox,1230,69,24,14,12,9,5,5,1230,1206,1192,962,389,365,36,33,621,609,90,714,357,0
19:33:43,5343.802,Fox,1230,68,24,14,12,8,5,5,1230,1206,1192,962,389,365,36,32,621,609,90,715,357,0
19:33:43,5344.263,Fox,1230,68,24,14,12,8,4,6,1230,1206,1192,962,389,366,36,32,621,609,90,715,357,0
19:33:44,5347.208,Fox,1230,68,24,14,10,10,4,6,1230,1206,1192,964,389,366,36,32,621,609,90,715,357,0
19:33:44,5347.999,Fox,1230,68,24,12,12,10,4,6,1230,1206,1194,964,389,366,36,32,621,609,90,715,357,0
19:33:45,5349.418,Fox,1230,68,22,14,12,10,4,6,1230,1208,1194,964,389,366,36,32,621,609,90,715,357,0
19:33:45,5351.156,Fox,1230,68,22,14,11,11,4,6,1230,1208,1194,965,389,366,36,32,621,609,90,715,357,0
19:33:46,5353.991,Fox,1230,65,22,14,11,8,4,6,1230,1208,1194,965,389,366,35,30,621,609,90,718,357,0
19:33:46,5354.343,Fox,1230,65,20,16,11,8,4,6,1230,1210,1194,965,389,366,35,30,621,609,90,718,357,0
19:33:47,5354.867,Fox,1230,65,20,14,13,8,4,6,1230,1210,1196,965,389,366,35,30,621,609,90,718,357,0
19:33:47,5355.166,Fox,1230,65,20,14,11,10,4,6,1230,1210,1196,967,389,366,35,30,621,609,90,718,357,0
19:33:48,5359.273,Fox,1230,65,20,12,13,10,4,6,1230,1210,1198,967,389,366,35,30,621,609,90,718,357,0
19:33:49,5361.736,Fox,1230,64,20,12,13,9,4,6,1230,1210,1198,967,389,366,35,29,621,609,90,719,357,0
19:33:49,5362.104,Fox,1230,64,18,12,15,9,4,6,1230,1212,1200,967,389,366,35,29,621,609,90,719,357,0
19:33:49,5362.47,Fox,1230,64,18,12,13,11,4,6,1230,1212,1200,969,389,366,35,29,621,609,90,719,357,0
19:33:50,5364.3,Fox,1230,63,18,12,13,11,4,5,1230,1212,1200,969,389,366,35,28,621,609,90,719,358,0
19:33:50,5364.737,Fox,1230,63,18,12,12,12,4,5,1230,1212,1200,970,389,366,35,28,621,609,90,719,358,0
19:33:50,5365.831,Fox,1230,61,18,12,12,10,4,5,1230,1212,1200,970,389,366,33,28,621,609,90,721,358,0
19:33:51,5367.09,Fox,1230,61,16,14,12,10,4,5,1230,1214,1200,970,389,366,33,28,621,609,90,721,358,0
19:33:52,5369.697,Fox,1230,61,16,12,14,10,4,5,1230,1214,1202,970,389,366,33,28,621,609,90,721,358,0
19:33:52,5369.996,Fox,1232,63,18,12,12,12,4,5,1232,1214,1202,972,389,366,35,28,623,609,90,721,358,0
19:33:52,5370.099,Fox,1232,63,18,12,12,11,5,5,1232,1214,1202,972,390,366,35,28,623,609,90,721,358,0
19:33:53,5373.1,Fox,1232,61,18,12,12,9,5,5,1232,1214,1202,972,390,366,34,27,623,609,92,721,358,0
19:33:53,5375.27,Fox,1232,60,18,12,12,8,5,5,1232,1214,1202,972,390,366,33,27,623,609,93,721,358,0
19:33:54,5375.619,Fox,1232,60,18,10,14,8,5,5,1232,1214,1204,972,390,366,33,27,623,609,93,721,358,0
19:33:54,5378.367,Fox,1232,60,16,12,14,8,5,5,1232,1216,1204,972,390,366,33,27,623,609,93,721,358,0
19:33:55,5380.005,Fox,1234,61,18,12,13,8,5,5,1234,1216,1204,972,390,366,34,27,625,609,93,722,358,0
19:33:55,5380.591,Fox,1234,59,18,10,15,6,5,5,1234,1216,1206,972,390,366,33,26,625,609,93,724,358,0
19:33:57,5387.219,Fox,1236,61,20,10,15,6,5,5,1236,1216,1206,972,390,366,35,26,627,609,93,724,358,0
19:33:58,5387.95,Fox,1236,61,20,8,17,6,5,5,1236,1216,1208,972,390,366,35,26,627,609,93,724,358,0
19:33:58,5389.922,Fox,1236,60,20,8,17,6,5,4,1236,1216,1208,972,390,366,34,26,627,609,93,724,359,0
19:33:58,5390.128,Fox,1236,60,18,10,17,6,5,4,1236,1218,1208,972,390,366,34,26,627,609,93,724,359,0
19:33:59,5392.8,Fox,1236,60,18,8,19,6,5,4,1236,1218,1210,972,390,366,34,26,627,609,93,724,359,0
19:34:00,5394.43,Fox,1236,59,18,8,19,6,5,3,1236,1218,1210,972,390,366,33,26,627,609,93,724,360,0
19:34:01,5396.737,Fox,1238,61,20,8,19,6,5,3,1238,1218,1210,972,390,366,33,28,627,611,93,724,360,0
19:34:01,5397.654,Fox,1240,62,22,8,19,5,5,3,1240,1218,1210,972,390,366,32,30,627,613,93,725,360,0
19:34:02,5399.974,Fox,1240,62,22,8,19,4,6,3,1240,1218,1210,972,391,366,32,30,627,613,93,725,360,0
19:34:02,5400.649,Fox,1240,62,22,6,21,4,6,3,1240,1218,1212,972,391,366,32,30,627,613,93,725,360,0
19:34:02,5400.917,Fox,1240,62,20,8,21,4,6,3,1240,1220,1212,972,391,366,32,30,627,613,93,725,360,0
19:34:03,5402.743,Fox,1240,61,20,8,21,4,6,2,1240,1220,1212,972,391,366,32,29,627,613,93,725,361,0
19:34:03,5403.823,Fox,1242,62,22,8,20,5,5,2,1242,1220,1212,973,391,366,32,30,628,614,93,726,361,0
19:34:03,5404.074,Fox,1242,62,20,10,20,5,5,2,1242,1222,1212,973,391,366,32,30,628,614,93,726,361,0
19:34:04,5405.603,Fox,1242,62,20,8,22,5,5,2,1242,1222,1214,973,391,366,32,30,628,614,93,726,361,0
19:34:05,5408.468,Fox,1242,62,20,8,20,7,5,2,1242,1222,1214,975,391,366,32,30,628,614,93,726,361,0
19:34:05,5410.77,Fox,1242,62,18,10,20,7,5,2,1242,1224,1214,975,391,366,32,30,628,614,93,726,361,0
19:34:05,5410.991,Fox,1242,62,16,12,20,7,5,2,1242,1226,1214,975,391,366,32,30,628,614,93,726,361,0
19:34:05,5411.432,Fox,1242,62,16,12,20,7,3,4,1242,1226,1214,975,391,368,32,30,628,614,93,726,361,0
19:34:06,5413.688,Fox,1242,62,16,12,20,6,4,4,1242,1226,1214,975,392,368,32,30,628,614,93,726,361,0
19:34:07,5414.448,Fox,1242,61,16,12,20,5,4,4,1242,1226,1214,975,392,368,31,30,628,614,93,727,361,0
19:34:07,5415.329,Fox,1242,61,16,12,18,7,4,4,1242,1226,1214,977,392,368,31,30,628,614,93,727,361,0
19:34:07,5416.925,Fox,1242,61,16,10,20,7,4,4,1242,1226,1216,977,392,368,31,30,628,614,93,727,361,0
19:34:07,5417.351,Fox,1242,61,14,12,20,7,4,4,1242,1228,1216,977,392,368,31,30,628,614,93,727,361,0
19:34:08,5417.787,Fox,1242,61,14,12,20,7,3,5,1242,1228,1216,977,392,369,31,30,628,614,93,727,361,0
19:34:08,5419.103,Fox,1242,59,14,12,20,5,3,5,1242,1228,1216,977,392,369,29,30,628,614,93,729,361,0
19:34:08,5419.789,Fox,1242,59,14,12,18,7,3,5,1242,1228,1216,979,392,369,29,30,628,614,93,729,361,0
19:34:09,5422.618,Fox,1242,59,14,12,16,9,3,5,1242,1228,1216,981,392,369,29,30,628,614,93,729,361,0
19:34:09,5423.192,Fox,1244,61,16,12,16,9,3,5,1244,1228,1216,981,392,369,29,32,628,616,93,729,361,0
19:34:10,5424.193,Fox,1244,60,16,12,16,9,3,4,1244,1228,1216,981,392,369,29,31,628,616,93,729,362,0
19:34:10,5425.415,Fox,1244,60,14,14,16,9,3,4,1244,1230,1216,981,392,369,29,31,628,616,93,729,362,0
19:34:11,5426.972,Fox,1246,62,14,14,16,8,4,4,1244,1230,1216,981,393,369,30,32,629,617,93,729,362,0
19:34:11,5427.104,Fox,1246,62,16,14,16,8,4,4,1246,1230,1216,981,393,369,30,32,629,617,93,729,362,0
19:34:11,5428.722,Fox,1246,62,16,12,18,8,4,4,1246,1230,1218,981,393,369,30,32,629,617,93,729,362,0
19:34:12,5430.173,Fox,1246,62,16,12,16,10,4,4,1246,1230,1218,983,393,369,30,32,629,617,93,729,362,0
19:34:12,5431.659,Fox,1250,66,20,12,16,10,4,4,1250,1230,1218,983,393,369,33,33,632,618,93,729,362,0
19:34:13,5432.748,Fox,1252,68,22,12,16,10,4,4,1252,1230,1218,983,393,369,34,34,633,619,93,729,362,0
19:34:13,5433.218,Fox,1252,66,22,12,16,8,4,4,1252,1230,1218,983,393,369,33,33,633,619,93,731,362,0
19:34:14,5436.008,Fox,1252,66,22,12,14,10,4,4,1252,1230,1218,985,393,369,33,33,633,619,93,731,362,0
19:34:15,5439.207,Fox,1254,67,24,12,13,10,4,4,1254,1230,1218,985,393,369,34,33,635,619,93,732,362,0
19:34:15,5439.458,Fox,1254,67,24,10,15,10,4,4,1254,1230,1220,985,393,369,34,33,635,619,93,732,362,0
19:34:15,5440.473,Fox,1254,67,24,10,15,8,6,4,1254,1230,1220,985,395,369,34,33,635,619,93,732,362,0
19:34:15,5440.782,Fox,1254,66,24,10,15,7,6,4,1254,1230,1220,985,395,369,34,32,635,619,93,733,362,0
19:34:15,5441.128,Fox,1254,66,24,10,13,9,6,4,1254,1230,1220,987,395,369,34,32,635,619,93,733,362,0
19:34:16,5442.449,Fox,1254,66,24,8,15,9,6,4,1254,1230,1222,987,395,369,34,32,635,619,93,733,362,0
19:34:18,5448.484,Fox,1254,66,24,8,13,11,6,4,1254,1230,1222,989,395,369,34,32,635,619,93,733,362,0
19:34:18,5449.269,Fox,1254,66,24,6,15,11,6,4,1254,1230,1224,989,395,369,34,32,635,619,93,733,362,0
19:34:18,5449.474,Fox,1254,66,24,4,17,11,6,4,1254,1230,1226,989,395,369,34,32,635,619,93,733,362,0
19:34:19,5451.723,Fox,1254,64,24,4,17,9,6,4,1254,1230,1226,989,395,369,34,30,635,619,93,735,362,0
19:34:19,5452.601,Fox,1254,64,22,6,17,9,6,4,1254,1232,1226,989,395,369,34,30,635,619,93,735,362,0
19:34:19,5453.322,Fox,1254,64,22,6,15,11,6,4,1254,1232,1226,991,395,369,34,30,635,619,93,735,362,0
19:34:20,5455.619,Fox,1254,64,22,4,17,11,6,4,1254,1232,1228,991,395,369,34,30,635,619,93,735,362,0
19:34:21,5458.001,Fox,1254,63,22,4,17,11,6,3,1254,1232,1228,991,395,369,34,29,635,619,93,735,363,0
19:34:21,5458.986,Fox,1254,61,22,4,17,9,6,3,1254,1232,1228,991,395,369,32,29,635,619,93,737,363,0
19:34:22,5460.948,Fox,1254,61,22,4,16,10,6,3,1254,1232,1228,992,395,369,32,29,635,619,93,737,363,0
19:34:22,5462.03,Fox,1256,62,24,4,15,10,6,3,1256,1232,1228,992,395,369,31,31,635,621,93,738,363,0
19:34:23,5462.549,Fox,1256,62,22,6,15,10,6,3,1256,1234,1228,992,395,369,31,31,635,621,93,738,363,0
19:34:23,5463.844,Fox,1256,60,22,4,17,8,6,3,1256,1234,1230,992,395,369,29,31,635,621,93,740,363,0
19:34:24,5466.043,Fox,1256,60,22,4,16,9,6,3,1256,1234,1230,993,395,369,29,31,635,621,93,740,363,0
19:34:25,5469.774,Fox,1256,60,20,6,16,9,6,3,1256,1236,1230,993,395,369,29,31,635,621,93,740,363,0
19:34:26,5471.516,Fox,1256,59,20,6,16,8,6,3,1256,1236,1230,993,395,369,29,30,635,621,93,741,363,0
19:34:27,5475.059,Fox,1256,58,20,6,16,8,6,2,1256,1236,1230,993,395,369,29,29,635,621,93,741,364,0
19:34:27,5476.701,Fox,1256,57,20,6,16,7,6,2,1256,1236,1230,993,395,369,29,28,635,621,93,742,364,0
19:34:27,5477.411,Fox,1256,57,20,6,14,9,6,2,1256,1236,1230,995,395,369,29,28,635,621,93,742,364,0
19:34:28,5479.215,Fox,1256,57,18,8,14,9,6,2,1256,1238,1230,995,395,369,29,28,635,621,93,742,364,0
19:34:28,5480.232,Fox,1256,57,16,10,14,9,6,2,1256,1240,1230,995,395,369,29,28,635,621,93,742,364,0
19:34:30,5485.967,Fox,1258,58,18,10,13,9,6,2,1258,1240,1230,995,395,369,29,29,636,622,93,743,364,0
19:34:30,5486.338,Fox,1258,58,16,12,13,9,6,2,1258,1242,1230,995,395,369,29,29,636,622,93,743,364,0
19:34:31,5487.157,Fox,1260,59,18,12,12,9,6,2,1260,1242,1230,995,395,369,30,29,638,622,93,744,364,0
19:34:31,5487.89,Fox,1262,60,20,12,11,9,6,2,1262,1242,1230,995,395,369,30,30,639,623,93,745,364,0
19:34:31,5488.017,Fox,1262,58,20,12,11,7,6,2,1262,1242,1230,995,395,369,30,28,639,623,93,747,364,0
19:34:31,5489.214,Fox,1262,58,20,12,9,9,6,2,1262,1242,1230,997,395,369,30,28,639,623,93,747,364,0
19:34:32,5491.033,Fox,1262,58,20,10,11,9,6,2,1262,1242,1232,997,395,369,30,28,639,623,93,747,364,0
19:34:34,5496.551,Fox,1264,60,22,10,11,9,6,2,1264,1242,1232,997,395,369,30,30,639,625,93,747,364,0
19:34:35,5499.731,Fox,1264,58,22,10,11,7,6,2,1264,1242,1232,997,395,369,29,29,639,625,93,749,364,0
19:34:35,5499.929,Fox,1264,58,22,10,9,9,6,2,1264,1242,1232,999,395,369,29,29,639,625,93,749,364,0
19:34:35,5501.07,Fox,1264,58,22,8,11,9,6,2,1264,1242,1234,999,395,369,29,29,639,625,93,749,364,0
19:34:36,5501.856,Fox,1264,57,22,8,11,9,6,1,1264,1242,1234,999,395,369,28,29,639,625,93,749,365,0
19:34:36,5503.017,Fox,1264,57,22,8,9,11,6,1,1264,1242,1234,1001,395,369,28,29,639,625,93,749,365,0
19:34:36,5503.362,Fox,1266,59,24,8,9,11,6,1,1266,1242,1234,1001,395,369,30,29,641,625,93,749,365,0
19:34:37,5504.975,Fox,1270,63,28,8,9,11,6,1,1270,1242,1234,1001,395,369,32,31,643,627,93,749,365,0
19:34:37,5505.801,Fox,1270,63,26,10,9,11,6,1,1270,1244,1234,1001,395,369,32,31,643,627,93,749,365,0
19:34:38,5507.569,Fox,1270,63,26,10,9,11,5,2,1270,1244,1234,1001,395,370,32,31,643,627,93,749,365,0
19:34:38,5508.253,Fox,1270,63,26,8,11,11,5,2,1270,1244,1236,1001,395,370,32,31,643,627,93,749,365,0
19:34:38,5508.844,Fox,1270,63,26,8,11,9,7,2,1270,1244,1236,1001,397,370,32,31,643,627,93,749,365,0
19:34:38,5509.661,Fox,1270,63,24,10,11,9,7,2,1270,1246,1236,1001,397,370,32,31,643,627,93,749,365,0
19:34:38,5509.958,Fox,1270,63,24,10,10,10,7,2,1270,1246,1236,1002,397,370,32,31,643,627,93,749,365,0
19:34:39,5510.482,Fox,1270,62,24,10,10,9,7,2,1270,1246,1236,1002,397,370,32,30,643,627,93,750,365,0
19:34:39,5511.933,Fox,1270,61,24,10,10,9,7,1,1270,1246,1236,1002,397,370,31,30,643,627,93,750,366,0
19:34:39,5513.229,Fox,1270,61,24,10,10,7,9,1,1270,1246,1236,1002,399,370,31,30,643,627,93,750,366,0
19:34:40,5514.237,Fox,1270,61,20,14,10,7,9,1,1270,1250,1236,1002,399,370,31,30,643,627,93,750,366,0
19:34:40,5515.32,Fox,1270,61,18,16,10,7,9,1,1270,1252,1236,1002,399,370,31,30,643,627,93,750,366,0
19:34:40,5516.046,Fox,1270,61,18,16,8,9,9,1,1270,1252,1236,1004,399,370,31,30,643,627,93,750,366,0
19:34:41,5517.807,Fox,1270,61,18,14,10,9,9,1,1270,1252,1238,1004,399,370,31,30,643,627,93,750,366,0
19:34:41,5518.688,Fox,1270,61,18,12,12,9,9,1,1270,1252,1240,1004,399,370,31,30,643,627,93,750,366,0
19:34:42,5520.64,Fox,1270,60,18,12,12,8,9,1,1270,1252,1240,1004,399,370,30,30,643,627,93,751,366,0
19:34:42,5521.781,Fox,1270,60,16,14,12,8,9,1,1270,1254,1240,1004,399,370,30,30,643,627,93,751,366,0
19:34:43,5523.677,Fox,1270,60,16,14,12,7,10,1,1270,1254,1240,1004,400,370,30,30,643,627,93,751,366,0
19:34:43,5524.357,Fox,1270,60,16,14,10,9,10,1,1270,1254,1240,1006,400,370,30,30,643,627,93,751,366,0
19:34:43,5524.85,Fox,1270,60,16,12,12,9,10,1,1270,1254,1242,1006,400,370,30,30,643,627,93,751,366,0
19:34:44,5526.667,Fox,1270,58,16,12,12,7,10,1,1270,1254,1242,1006,400,370,30,28,643,627,94,752,366,0
19:34:45,5529.571,Fox,1270,58,16,12,12,5,12,1,1270,1254,1242,1006,402,370,30,28,643,627,94,752,366,0
19:34:47,5536.102,Fox,1272,60,18,12,12,5,12,1,1272,1254,1242,1006,402,370,30,30,643,629,94,752,366,0
19:34:48,5537.561,Fox,1272,60,18,12,12,5,11,2,1272,1254,1242,1006,402,371,30,30,643,629,94,752,366,0
19:34:50,5544.222,Fox,1272,60,18,10,14,5,11,2,1272,1254,1244,1006,402,371,30,30,643,629,94,752,366,0
19:34:50,5544.518,Fox,1272,60,16,12,14,5,11,2,1272,1256,1244,1006,402,371,30,30,643,629,94,752,366,0
19:34:51,5548.106,Fox,1272,60,16,10,16,5,11,2,1272,1256,1246,1006,402,371,30,30,643,629,94,752,366,0
19:34:52,5551.135,Fox,1272,60,16,10,16,5,10,3,1272,1256,1246,1006,402,372,30,30,643,629,94,752,366,0
19:34:52,5551.514,Fox,1272,60,16,10,14,7,10,3,1272,1256,1246,1008,402,372,30,30,643,629,94,752,366,0
19:34:53,5552.692,Fox,1272,60,16,6,18,7,10,3,1272,1256,1250,1008,402,372,30,30,643,629,94,752,366,0
19:34:53,5553.783,Fox,1272,60,16,4,20,7,10,3,1272,1256,1252,1008,402,372,30,30,643,629,94,752,366,0
19:34:55,5560.281,Fox,1272,60,16,2,22,7,10,3,1272,1256,1254,1008,402,372,30,30,643,629,94,752,366,0
19:34:56,5561.515,Fox,1272,60,16,2,20,9,10,3,1272,1256,1254,1010,402,372,30,30,643,629,94,752,366,0
19:34:56,5564.31,Fox,1272,60,16,2,20,9,9,4,1272,1256,1254,1010,402,373,30,30,643,629,94,752,366,0
19:34:58,5567.943,Fox,1272,59,16,2,20,9,9,3,1272,1256,1254,1010,402,373,29,30,643,629,94,752,367,0
19:34:58,5568.563,Fox,1272,59,14,4,20,9,9,3,1272,1258,1254,1010,402,373,29,30,643,629,94,752,367,0
19:34:58,5568.817,Fox,1272,59,14,4,18,11,9,3,1272,1258,1254,1012,402,373,29,30,643,629,94,752,367,0
19:34:58,5569.722,Fox,1272,59,12,6,18,11,9,3,1272,1260,1254,1012,402,373,29,30,643,629,94,752,367,0
19:34:59,5570.373,Fox,1272,59,10,8,18,11,9,3,1272,1262,1254,1012,402,373,29,30,643,629,94,752,367,0
19:34:59,5571.229,Fox,1272,58,10,8,18,11,9,2,1272,1262,1254,1012,402,373,28,30,643,629,94,752,368,0
19:34:59,5572.088,Fox,1272,56,10,8,18,9,9,2,1272,1262,1254,1012,402,373,26,30,643,629,94,754,368,0
19:35:01,5577.969,Fox,1272,56,10,8,18,9,7,4,1272,1262,1254,1012,402,375,26,30,643,629,94,754,368,0
19:35:01,5578.267,Fox,1272,56,10,8,16,11,7,4,1272,1262,1254,1014,402,375,26,30,643,629,94,754,368,0
19:35:01,5578.936,Fox,1274,58,12,8,16,11,7,4,1274,1262,1254,1014,402,375,27,31,644,630,94,754,368,0
19:35:01,5579.272,Fox,1274,58,10,10,14,13,7,4,1274,1264,1254,1016,402,375,27,31,644,630,94,754,368,0
19:35:03,5583.104,Fox,1274,58,10,8,16,13,7,4,1274,1264,1256,1016,402,375,27,31,644,630,94,754,368,0
19:35:03,5584.51,Fox,1276,60,12,8,16,13,7,4,1276,1264,1256,1016,402,375,28,32,645,631,94,754,368,0
19:35:04,5585.376,Fox,1276,60,12,8,14,15,7,4,1276,1264,1256,1018,402,375,28,32,645,631,94,754,368,0
19:35:04,5585.903,Fox,1276,60,10,10,14,15,7,4,1276,1266,1256,1018,402,375,28,32,645,631,94,754,368,0
19:35:04,5587.535,Fox,1276,60,6,14,14,15,7,4,1276,1270,1256,1018,402,375,28,32,645,631,94,754,368,0
19:35:05,5588.875,Fox,1276,58,6,14,14,13,7,4,1276,1270,1256,1018,402,375,28,30,645,631,96,754,368,0
19:35:05,5589.692,Fox,1278,60,8,14,14,13,7,4,1278,1270,1256,1018,402,375,30,30,647,631,96,754,368,0
19:35:06,5591.805,Fox,1280,62,10,14,14,13,7,4,1280,1270,1256,1018,402,375,30,32,647,633,96,754,368,0
19:35:06,5593.428,Fox,1280,62,10,14,14,12,8,4,1280,1270,1256,1018,403,375,30,32,647,633,96,754,368,0
19:35:07,5595.884,Fox,1280,60,10,14,14,10,8,4,1280,1270,1256,1018,403,375,29,31,647,633,96,756,368,0
19:35:07,5596.508,Fox,1280,60,10,14,14,8,10,4,1280,1270,1256,1018,405,375,29,31,647,633,96,756,368,0
19:35:08,5598.072,Fox,1280,59,10,14,14,8,10,3,1280,1270,1256,1018,405,375,29,30,647,633,96,756,369,0
19:35:10,5604.763,Fox,1280,59,10,14,12,10,10,3,1280,1270,1256,1020,405,375,29,30,647,633,96,756,369,0
19:35:10,5605.725,Fox,1282,61,12,14,12,10,10,3,1282,1270,1256,1020,405,375,30,31,648,634,96,756,369,0
19:35:11,5607.03,Fox,1282,61,12,12,14,10,10,3,1282,1270,1258,1020,405,375,30,31,648,634,96,756,369,0
19:35:11,5608.189,Fox,1282,61,12,10,16,10,10,3,1282,1270,1260,1020,405,375,30,31,648,634,96,756,369,0
19:35:11,5608.575,Fox,1282,61,12,10,14,12,10,3,1282,1270,1260,1022,405,375,30,31,648,634,96,756,369,0
19:35:11,5608.864,Fox,1282,61,12,8,16,12,10,3,1282,1270,1262,1022,405,375,30,31,648,634,96,756,369,0
19:35:13,5613.242,Fox,1282,61,12,8,12,16,10,3,1282,1270,1262,1026,405,375,30,31,648,634,96,756,369,0
19:35:13,5614.249,Fox,1282,61,12,8,10,18,10,3,1282,1270,1262,1028,405,375,30,31,648,634,96,756,369,0
19:35:14,5617.65,Fox,1282,61,12,6,12,18,10,3,1282,1270,1264,1028,405,375,30,31,648,634,96,756,369,0
19:35:14,5618.01,Fox,1282,60,12,6,12,16,12,2,1282,1270,1264,1028,407,375,30,30,648,634,96,756,370,0
19:35:15,5618.625,Fox,1282,60,10,8,12,16,12,2,1282,1272,1264,1028,407,375,30,30,648,634,96,756,370,0
19:35:15,5620.79,Fox,1282,60,10,8,10,18,12,2,1282,1272,1264,1030,407,375,30,30,648,634,96,756,370,0
19:35:17,5624.704,Fox,1282,59,10,6,12,18,12,1,1282,1272,1266,1030,407,375,29,30,648,634,96,756,371,0
19:35:17,5624.928,Fox,1282,58,10,6,12,17,12,1,1282,1272,1266,1030,407,375,29,29,648,634,96,757,371,0
19:35:17,5625.989,Fox,1282,58,10,2,16,17,12,1,1282,1272,1270,1030,407,375,29,29,648,634,96,757,371,0
19:35:19,5631.317,Fox,1282,56,10,2,16,15,12,1,1282,1272,1270,1030,407,375,27,29,648,634,96,759,371,0
19:35:23,5642.623,Fox,1284,57,12,2,15,15,12,1,1284,1272,1270,1030,407,375,27,30,649,635,96,760,371,0
19:35:23,5643.813,Fox,1284,57,12,2,13,17,12,1,1284,1272,1270,1032,407,375,27,30,649,635,96,760,371,0
19:35:23,5645.039,Fox,1284,57,12,2,13,15,14,1,1284,1272,1270,1032,409,375,27,30,649,635,96,760,371,0
19:35:24,5646.373,Fox,1286,59,14,2,13,15,12,3,1286,1272,1270,1032,409,377,27,32,649,637,96,760,371,0
19:35:24,5646.754,Fox,1288,60,16,2,12,15,12,3,1288,1272,1270,1032,409,377,28,32,651,637,96,761,371,0
19:35:25,5648.449,Fox,1288,59,16,2,12,15,12,2,1288,1272,1270,1032,409,377,27,32,651,637,96,761,372,0
19:35:25,5650.712,Fox,1288,59,16,2,12,15,10,4,1288,1272,1270,1032,409,379,27,32,651,637,96,761,372,0
19:35:27,5654.241,Fox,1294,63,16,2,12,13,10,4,1288,1272,1270,1032,409,379,30,33,654,640,96,763,372,0
19:35:27,5654.378,Fox,1294,63,22,2,12,13,10,4,1294,1272,1270,1032,409,379,30,33,654,640,96,763,372,0
19:35:28,5657.36,Fox,1294,63,22,0,14,13,10,4,1294,1272,1272,1032,409,379,30,33,654,640,96,763,372,0
19:35:29,5661.04,Fox,1296,64,24,0,13,13,10,4,1296,1272,1272,1032,409,379,30,34,655,641,97,763,372,0
19:35:29,5661.167,Fox,1296,64,24,0,13,13,9,5,1296,1272,1272,1032,409,380,30,34,655,641,97,763,372,0
19:35:29,5661.649,Fox,1298,65,24,2,12,13,9,5,1298,1274,1272,1032,409,380,30,35,656,642,98,763,372,0
19:35:29,5662.258,Fox,1298,65,24,2,12,11,11,5,1298,1274,1272,1032,411,380,30,35,656,642,98,763,372,0
19:35:30,5664.773,Fox,1300,67,26,2,12,11,11,5,1300,1274,1272,1032,411,380,30,37,656,644,98,763,372,0
19:35:31,5667.033,Fox,1300,67,24,4,12,11,9,7,1300,1276,1272,1032,411,382,30,37,656,644,98,763,372,0
19:35:31,5667.497,Fox,1300,67,24,4,11,12,9,7,1300,1276,1272,1033,411,382,30,37,656,644,98,763,372,0
19:35:31,5668.703,Fox,1300,67,24,4,9,14,9,7,1300,1276,1272,1035,411,382,30,37,656,644,98,763,372,0
19:35:32,5669.407,Fox,1300,67,24,4,8,15,9,7,1300,1276,1272,1036,411,382,30,37,656,644,98,763,372,0
19:35:33,5672.235,Fox,1300,67,22,6,8,15,9,7,1300,1278,1272,1036,411,382,30,37,656,644,98,763,372,0
19:35:33,5672.712,Fox,1300,67,22,6,8,13,11,7,1300,1278,1272,1036,413,382,30,37,656,644,98,763,372,0
19:35:33,5674.388,Fox,1300,67,20,8,8,13,11,7,1300,1280,1272,1036,413,382,30,37,656,644,98,763,372,0
19:35:35,5678.144,Fox,1300,66,20,8,6,14,11,7,1300,1280,1272,1038,413,382,30,36,656,644,98,764,372,0
19:35:35,5679.294,Fox,1300,64,20,8,6,12,11,7,1300,1280,1272,1038,413,382,28,36,656,644,98,766,372,0
19:35:36,5681.284,Fox,1300,63,20,8,6,12,11,6,1300,1280,1272,1038,413,382,27,36,656,644,98,766,373,0
19:35:37,5683.977,Fox,1302,65,22,8,6,12,11,6,1302,1280,1272,1038,413,382,27,38,656,646,98,766,373,0
19:35:37,5684.946,Fox,1302,65,22,8,5,13,11,6,1302,1280,1272,1039,413,382,27,38,656,646,98,766,373,0
19:35:38,5686.583,Fox,1302,64,22,8,2,16,11,5,1302,1280,1272,1042,413,382,27,37,656,646,98,766,374,0
19:35:38,5688.502,Fox,1302,64,20,10,2,16,11,5,1302,1282,1272,1042,413,382,27,37,656,646,98,766,374,0
19:35:39,5690.976,Fox,1302,63,20,10,2,16,11,4,1302,1282,1272,1042,413,382,27,36,656,646,98,766,375,0
19:35:40,5694.521,Fox,1304,64,22,10,2,15,11,4,1304,1282,1272,1042,413,382,26,38,656,648,99,766,375,0
19:35:41,5698.202,Fox,1304,64,22,10,2,13,13,4,1304,1282,1272,1042,415,382,26,38,656,648,99,766,375,0
19:35:42,5699.999,Fox,1304,64,22,8,4,13,13,4,1304,1282,1274,1042,415,382,26,38,656,648,99,766,375,0
19:35:43,5702.198,Fox,1306,66,24,8,4,11,15,4,1306,1282,1274,1042,417,382,27,39,657,649,99,766,375,0
19:35:44,5705.584,Fox,1306,66,24,6,6,11,15,4,1306,1282,1276,1042,417,382,27,39,657,649,99,766,375,0
19:35:44,5706.657,Fox,1306,66,24,6,6,7,19,4,1306,1282,1276,1042,421,382,27,39,657,649,99,766,375,0
19:35:44,5707.229,Fox,1306,65,24,6,6,7,19,3,1306,1282,1276,1042,421,382,27,38,657,649,99,766,376,0
19:35:45,5708.268,Fox,1308,67,24,6,6,6,20,3,1306,1282,1276,1042,422,382,28,39,658,650,99,766,376,0
19:35:45,5708.385,Fox,1308,67,26,6,6,6,20,3,1308,1282,1276,1042,422,382,28,39,658,650,99,766,376,0
19:35:46,5710.752,Fox,1308,67,26,4,8,6,20,3,1308,1282,1278,1042,422,382,28,39,658,650,99,766,376,0
19:35:46,5712.845,Fox,1308,67,26,2,10,6,20,3,1308,1282,1280,1042,422,382,28,39,658,650,99,766,376,0
19:35:47,5713.967,Fox,1310,69,28,2,10,6,20,3,1310,1282,1280,1042,422,382,29,40,659,651,99,766,376,0
19:35:48,5716.81,Fox,1310,68,28,2,10,6,20,2,1310,1282,1280,1042,422,382,28,40,659,651,99,766,377,0
19:35:48,5717.771,Fox,1310,68,28,2,8,8,20,2,1310,1282,1280,1044,422,382,28,40,659,651,99,766,377,0
19:35:49,5721.283,Fox,1310,67,28,2,8,8,20,1,1310,1282,1280,1044,422,382,27,40,659,651,99,766,378,0
19:35:51,5725.239,Fox,1310,67,26,4,8,8,20,1,1310,1284,1280,1044,422,382,27,40,659,651,99,766,378,0
19:35:51,5726.773,Fox,1310,67,26,2,10,8,20,1,1310,1284,1282,1044,422,382,27,40,659,651,99,766,378,0
19:35:51,5727.824,Fox,1312,69,28,2,10,8,20,1,1312,1284,1282,1044,422,382,29,40,661,651,99,766,378,0
19:35:52,5728.903,Fox,1312,69,26,4,10,8,20,1,1312,1286,1282,1044,422,382,29,40,661,651,99,766,378,0
19:35:52,5729.319,Fox,1312,69,24,6,10,8,20,1,1312,1288,1282,1044,422,382,29,40,661,651,99,766,378,0
19:35:52,5730.902,Fox,1312,69,24,6,10,8,19,2,1312,1288,1282,1044,422,383,29,40,661,651,99,766,378,0
19:35:53,5733.993,Fox,1312,69,24,6,10,8,17,4,1312,1288,1282,1044,422,385,29,40,661,651,99,766,378,0
19:35:54,5736.499,Fox,1314,70,26,6,9,8,17,4,1314,1288,1282,1044,422,385,29,41,662,652,99,767,378,0
19:35:54,5736.979,Fox,1314,70,20,12,9,8,17,4,1314,1294,1282,1044,422,385,29,41,662,652,99,767,378,0
19:35:55,5737.436,Fox,1314,69,20,12,9,8,17,3,1314,1294,1282,1044,422,385,29,40,662,652,99,767,379,0
19:35:55,5738.259,Fox,1318,73,24,12,9,8,17,3,1318,1294,1282,1044,422,385,32,41,665,653,99,767,379,0
19:35:57,5743.564,Fox,1318,73,22,14,9,8,17,3,1318,1296,1282,1044,422,385,32,41,665,653,99,767,379,0
19:35:57,5744.253,Fox,1318,73,20,16,9,8,17,3,1318,1298,1282,1044,422,385,32,41,665,653,99,767,379,0
19:35:58,5747.416,Fox,1318,73,18,18,9,8,17,3,1318,1300,1282,1044,422,385,32,41,665,653,99,767,379,0
19:35:59,5749.982,Fox,1320,75,20,18,9,8,17,3,1320,1300,1282,1044,422,385,33,42,666,654,99,767,379,0
19:35:59,5751.794,Fox,1322,77,22,18,9,8,17,3,1322,1300,1282,1044,422,385,34,43,667,655,99,767,379,0
19:36:01,5755.611,Fox,1324,79,24,18,9,8,15,5,1324,1300,1282,1044,422,387,35,44,668,656,99,767,379,0
19:36:02,5760.627,Fox,1324,79,24,18,8,9,15,5,1324,1300,1282,1045,422,387,35,44,668,656,99,767,379,0
19:36:03,5763.088,Fox,1324,79,24,18,8,8,16,5,1324,1300,1282,1045,423,387,35,44,668,656,99,767,379,0
19:36:03,5763.698,Fox,1324,79,24,16,10,8,16,5,1324,1300,1284,1045,423,387,35,44,668,656,99,767,379,0
19:36:04,5766.197,Fox,1324,79,24,16,8,10,16,5,1324,1300,1284,1047,423,387,35,44,668,656,99,767,379,0
19:36:04,5766.614,Fox,1324,79,22,18,8,10,16,5,1324,1302,1284,1047,423,387,35,44,668,656,99,767,379,0
19:36:05,5767.985,Fox,1324,79,22,14,12,10,16,5,1324,1302,1288,1047,423,387,35,44,668,656,99,767,379,0
19:36:06,5771.034,Fox,1324,78,22,14,12,9,16,5,1324,1302,1288,1047,423,387,35,43,668,656,99,768,379,0
19:36:06,5771.258,Fox,1324,78,22,14,10,11,16,5,1324,1302,1288,1049,423,387,35,43,668,656,99,768,379,0
19:36:06,5771.646,Fox,1324,78,22,14,10,9,18,5,1324,1302,1288,1049,425,387,35,43,668,656,99,768,379,0
19:36:07,5773.448,Fox,1324,78,22,14,8,11,18,5,1324,1302,1288,1051,425,387,35,43,668,656,99,768,379,0
19:36:07,5775.426,Fox,1324,78,22,8,14,11,18,5,1324,1302,1294,1051,425,387,35,43,668,656,99,768,379,0
19:36:08,5777.155,Fox,1324,78,20,10,14,11,18,5,1324,1304,1294,1051,425,387,35,43,668,656,99,768,379,0
19:36:09,5779.997,Fox,1324,78,20,10,14,8,21,5,1324,1304,1294,1051,428,387,35,43,668,656,99,768,379,0
19:36:10,5782.004,Fox,1326,80,22,10,14,8,21,5,1326,1304,1294,1051,428,387,36,44,669,657,99,768,379,0
19:36:10,5782.133,Fox,1326,80,22,8,16,8,21,5,1326,1304,1296,1051,428,387,36,44,669,657,99,768,379,0
19:36:10,5782.736,Fox,1326,80,22,6,18,8,19,7,1326,1304,1298,1051,428,389,36,44,669,657,99,768,379,0
19:36:11,5784.736,Fox,1326,80,20,8,18,8,19,7,1326,1306,1298,1051,428,389,36,44,669,657,99,768,379,0
19:36:11,5785.872,Fox,1326,80,20,6,20,8,19,7,1326,1306,1300,1051,428,389,36,44,669,657,99,768,379,0
19:36:12,5787.261,Fox,1326,80,20,6,18,10,19,7,1326,1306,1300,1053,428,389,36,44,669,657,99,768,379,0
19:36:12,5788.298,Fox,1328,82,22,6,18,10,19,7,1328,1306,1300,1053,428,389,37,45,670,658,99,768,379,0
19:36:13,5790.956,Fox,1328,82,20,8,18,10,19,7,1328,1308,1300,1053,428,389,37,45,670,658,99,768,379,0
19:36:14,5794.518,Fox,1328,81,20,8,18,10,19,6,1328,1308,1300,1053,428,389,37,44,670,658,99,768,380,0
19:36:15,5796.556,Fox,1328,81,18,10,18,10,19,6,1328,1310,1300,1053,428,389,37,44,670,658,99,768,380,0
19:36:16,5799.907,Fox,1330,82,20,10,17,10,17,8,1330,1310,1300,1053,428,391,37,45,671,659,99,769,380,0
19:36:16,5800.999,Fox,1332,84,22,10,17,10,17,8,1332,1310,1300,1053,428,391,38,46,672,660,99,769,380,0
19:36:17,5801.599,Fox,1332,83,22,10,17,10,17,7,1332,1310,1300,1053,428,391,37,46,672,660,99,769,381,0
19:36:18,5805.079,Fox,1332,83,22,8,19,10,17,7,1332,1310,1302,1053,428,391,37,46,672,660,99,769,381,0
19:36:18,5806.381,Fox,1334,85,24,8,19,10,17,7,1334,1310,1302,1053,428,391,39,46,674,660,99,769,381,0
19:36:19,5807.686,Fox,1336,87,26,8,19,10,17,7,1336,1310,1302,1053,428,391,40,47,675,661,99,769,381,0
19:36:20,5810.167,Fox,1336,87,26,8,19,10,15,9,1336,1310,1302,1053,428,393,40,47,675,661,99,769,381,0
19:36:20,5810.394,Fox,1336,87,24,10,19,10,15,9,1336,1312,1302,1053,428,393,40,47,675,661,99,769,381,0
19:36:20,5811.212,Fox,1336,87,24,10,19,8,17,9,1336,1312,1302,1053,430,393,40,47,675,661,99,769,381,0
19:36:20,5812.749,Fox,1336,86,24,10,19,8,17,8,1336,1312,1302,1053,430,393,39,47,675,661,99,769,382,0
19:36:21,5815.552,Fox,1336,86,24,8,21,8,17,8,1336,1312,1304,1053,430,393,39,47,675,661,99,769,382,0
19:36:23,5819.052,Fox,1336,86,22,10,21,8,17,8,1336,1314,1304,1053,430,393,39,47,675,661,99,769,382,0
19:36:23,5820.029,Fox,1338,88,24,10,21,8,17,8,1338,1314,1304,1053,430,393,41,47,677,661,99,769,382,0
19:36:23,5820.841,Fox,1338,88,20,14,21,8,17,8,1338,1318,1304,1053,430,393,41,47,677,661,99,769,382,0
19:36:23,5821.502,Fox,1340,89,22,14,20,8,17,8,1340,1318,1304,1053,430,393,42,47,679,661,99,770,382,0
19:36:24,5823.309,Fox,1340,89,22,12,22,8,17,8,1340,1318,1306,1053,430,393,42,47,679,661,99,770,382,0
19:36:24,5824.112,Fox,1340,89,22,12,21,9,17,8,1340,1318,1306,1054,430,393,42,47,679,661,99,770,382,0
19:36:25,5825.893,Fox,1342,91,24,12,21,9,17,8,1342,1318,1306,1054,430,393,44,47,681,661,99,770,382,0
19:36:25,5826.13,Fox,1342,90,24,12,21,9,17,7,1342,1318,1306,1054,430,393,44,46,681,661,99,770,383,0
19:36:25,5826.794,Fox,1344,92,26,12,21,9,17,7,1344,1318,1306,1054,430,393,44,48,681,663,99,770,383,0
19:36:25,5827.446,Fox,1346,94,28,12,21,9,17,7,1346,1318,1306,1054,430,393,46,48,683,663,99,770,383,0
19:36:26,5828.004,Fox,1346,94,28,12,19,11,17,7,1346,1318,1306,1056,430,393,46,48,683,663,99,770,383,0
19:36:26,5828.249,Fox,1346,94,28,12,17,13,17,7,1346,1318,1306,1058,430,393,46,48,683,663,99,770,383,0
19:36:26,5829.497,Fox,1346,94,28,10,19,13,17,7,1346,1318,1308,1058,430,393,46,48,683,663,99,770,383,0
19:36:27,5832.396,Fox,1346,94,26,12,19,13,17,7,1346,1320,1308,1058,430,393,46,48,683,663,99,770,383,0
19:36:28,5834.377,Fox,1346,94,24,14,19,13,17,7,1346,1322,1308,1058,430,393,46,48,683,663,99,770,383,0
19:36:28,5834.745,Fox,1346,92,24,14,19,12,17,6,1346,1322,1308,1058,430,393,46,46,683,663,99,771,384,0
19:36:28,5834.978,Fox,1346,92,24,12,21,12,17,6,1346,1322,1310,1058,430,393,46,46,683,663,99,771,384,0
19:36:28,5835.713,Fox,1346,92,24,12,21,12,15,8,1346,1322,1310,1058,430,395,46,46,683,663,99,771,384,0
19:36:28,5836.063,Fox,1348,94,26,12,15,18,15,8,1348,1322,1310,1064,430,395,46,48,683,665,99,771,384,0
19:36:29,5838.008,Fox,1348,94,24,14,15,18,15,8,1348,1324,1310,1064,430,395,46,48,683,665,99,771,384,0
19:36:29,5838.48,Fox,1348,92,24,14,15,16,15,8,1348,1324,1310,1064,430,395,46,46,683,665,101,771,384,0
19:36:29,5839.655,Fox,1348,92,24,14,15,16,13,10,1348,1324,1310,1064,430,397,46,46,683,665,101,771,384,0
19:36:30,5840.907,Fox,1350,94,26,14,15,16,13,10,1350,1324,1310,1064,430,397,47,47,684,666,101,771,384,0
19:36:30,5842.588,Fox,1350,94,26,14,13,18,13,10,1350,1324,1310,1066,430,397,47,47,684,666,101,771,384,0
19:36:31,5843.228,Fox,1350,94,26,14,12,19,13,10,1350,1324,1310,1067,430,397,47,47,684,666,101,771,384,0
19:36:31,5844.269,Fox,1350,94,26,14,12,19,9,14,1350,1324,1310,1067,430,401,47,47,684,666,101,771,384,0
19:36:31,5845.334,Fox,1350,94,26,14,12,19,8,15,1350,1324,1310,1067,430,402,47,47,684,666,101,771,384,0
19:36:32,5846.524,Fox,1350,93,26,14,10,20,8,15,1350,1324,1310,1069,430,402,46,47,684,666,101,772,384,0
19:36:32,5848.133,Fox,1352,95,28,14,10,20,8,15,1352,1324,1310,1069,430,402,48,47,686,666,101,772,384,0
19:36:33,5848.94,Fox,1352,95,28,12,12,20,8,15,1352,1324,1312,1069,430,402,48,47,686,666,101,772,384,0
19:36:33,5850.454,Fox,1352,94,28,12,12,20,8,14,1352,1324,1312,1069,430,402,48,46,686,666,101,772,385,0
19:36:34,5852.941,Fox,1352,93,28,12,12,20,8,13,1352,1324,1312,1069,430,402,47,46,686,666,101,772,386,0
19:36:34,5853.35,Fox,1354,94,28,12,12,19,8,13,1352,1324,1312,1069,430,402,48,46,687,667,101,773,386,0
19:36:34,5853.5,Fox,1354,94,30,12,12,19,8,13,1354,1324,1312,1069,430,402,48,46,687,667,101,773,386,0
19:36:34,5854.313,Fox,1354,93,30,12,12,19,8,12,1354,1324,1312,1069,430,402,47,46,687,667,101,773,387,0
19:36:35,5856.282,Fox,1354,92,30,12,12,19,8,11,1354,1324,1312,1069,430,402,47,45,687,667,101,773,388,0
19:36:35,5856.91,Fox,1354,91,30,12,12,18,8,11,1354,1324,1312,1069,430,402,47,44,687,667,101,774,388,0
19:36:35,5857.584,Fox,1354,91,30,10,14,18,8,11,1354,1324,1314,1069,430,402,47,44,687,667,101,774,388,0
19:36:36,5859.369,Fox,1354,91,30,6,18,18,8,11,1354,1324,1318,1069,430,402,47,44,687,667,101,774,388,0
19:36:36,5859.672,Fox,1354,91,30,6,18,16,10,11,1354,1324,1318,1069,432,402,47,44,687,667,101,774,388,0
19:36:37,5861.262,Fox,1356,93,32,6,18,16,10,11,1356,1324,1318,1069,432,402,48,45,688,668,101,774,388,0
19:36:37,5861.823,Fox,1358,94,34,6,17,16,10,11,1358,1324,1318,1069,432,402,48,46,689,669,101,775,388,0
19:36:38,5864.745,Fox,1358,94,32,8,17,14,12,11,1358,1326,1318,1069,434,402,48,46,689,669,101,775,388,0
19:36:38,5865.563,Fox,1358,94,32,8,15,16,12,11,1358,1326,1318,1071,434,402,48,46,689,669,101,775,388,0
19:36:39,5866.833,Fox,1358,94,32,8,15,14,14,11,1358,1326,1318,1071,436,402,48,46,689,669,101,775,388,0
19:36:39,5867.509,Fox,1360,96,34,8,15,14,14,11,1360,1326,1318,1071,436,402,49,47,690,670,101,775,388,0
19:36:39,5869.311,Fox,1362,98,36,8,15,14,14,11,1362,1326,1318,1071,436,402,50,48,691,671,101,775,388,0
19:36:40,5870.493,Fox,1362,97,36,8,15,14,14,10,1362,1326,1318,1071,436,402,50,47,691,671,101,775,389,0
19:36:40,5870.913,Fox,1362,97,34,8,17,14,14,10,1362,1328,1320,1071,436,402,50,47,691,671,101,775,389,0
19:36:40,5871.428,Fox,1364,99,36,8,17,14,14,10,1364,1328,1320,1071,436,402,52,47,693,671,101,775,389,0
19:36:41,5872.872,Fox,1364,99,36,6,19,14,14,10,1364,1328,1322,1071,436,402,52,47,693,671,101,775,389,0
19:36:41,5874.544,Fox,1366,101,38,6,19,14,14,10,1366,1328,1322,1071,436,402,52,49,693,673,101,775,389,0
19:36:42,5876.094,Fox,1366,100,38,6,17,16,14,9,1366,1328,1322,1073,436,402,52,48,693,673,101,775,390,0
19:36:42,5876.651,Fox,1366,100,38,4,19,16,14,9,1366,1328,1324,1073,436,402,52,48,693,673,101,775,390,0
19:36:43,5879.973,Fox,1366,99,38,4,19,16,14,8,1366,1328,1324,1073,436,402,52,47,693,673,101,775,391,0
19:36:43,5880.274,Fox,1366,98,38,4,19,16,14,7,1366,1328,1324,1073,436,402,51,47,693,673,101,775,392,0
19:36:43,5880.776,Fox,1366,98,38,4,19,14,16,7,1366,1328,1324,1073,438,402,51,47,693,673,101,775,392,0
19:36:44,5882.464,Fox,1366,98,36,6,19,14,16,7,1366,1330,1324,1073,438,402,51,47,693,673,101,775,392,0
19:36:44,5883.363,Fox,1366,98,34,8,19,14,16,7,1366,1332,1324,1073,438,402,51,47,693,673,101,775,392,0
19:36:44,5883.758,Fox,1366,98,34,8,18,15,16,7,1366,1332,1324,1074,438,402,51,47,693,673,101,775,392,0
19:36:44,5884.404,Fox,1366,97,34,8,18,15,16,6,1366,1332,1324,1074,438,402,50,47,693,673,101,775,393,0
19:36:45,5886.11,Fox,1366,96,34,8,18,15,16,5,1366,1332,1324,1074,438,402,50,46,693,673,101,775,394,0
19:36:45,5886.622,Fox,1366,95,34,8,18,14,16,5,1366,1332,1324,1074,438,402,50,45,693,673,101,776,394,0
19:36:46,5888.919,Fox,1366,95,32,10,18,14,16,5,1366,1334,1324,1074,438,402,50,45,693,673,101,776,394,0
19:36:46,5889.819,Fox,1368,97,34,10,18,14,16,5,1368,1334,1324,1074,438,402,52,45,695,673,101,776,394,0
19:36:46,5889.971,Fox,1368,97,34,10,16,16,16,5,1368,1334,1324,1076,438,402,52,45,695,673,101,776,394,0
19:36:46,5890.242,Fox,1368,97,32,12,16,16,16,5,1368,1336,1324,1076,438,402,52,45,695,673,101,776,394,0
19:36:48,5894.317,Fox,1368,96,32,12,16,15,16,5,1368,1336,1324,1076,438,402,52,44,695,673,101,777,394,0
19:36:48,5894.747,Fox,1370,97,34,12,15,15,16,5,1370,1336,1324,1076,438,402,51,46,695,675,101,778,394,0
19:36:48,5895.567,Fox,1370,96,34,12,13,17,16,4,1370,1336,1324,1078,438,402,50,46,695,675,101,778,395,0
19:36:49,5897.106,Fox,1372,97,36,12,12,17,16,4,1372,1336,1324,1078,438,402,50,47,696,676,101,779,395,0
19:36:50,5900.171,Fox,1372,96,36,12,12,17,16,3,1372,1336,1324,1078,438,402,49,47,696,676,101,779,396,0
19:36:50,5900.472,Fox,1372,96,36,12,12,17,15,4,1372,1336,1324,1078,438,403,49,47,696,676,101,779,396,0
19:36:50,5902.546,Fox,1372,96,34,14,12,17,15,4,1372,1338,1324,1078,438,403,49,47,696,676,101,779,396,0
19:36:51,5903.105,Fox,1372,96,34,12,14,17,15,4,1372,1338,1326,1078,438,403,49,47,696,676,101,779,396,0
19:36:51,5904.075,Fox,1372,96,32,14,14,17,15,4,1372,1340,1326,1078,438,403,49,47,696,676,101,779,396,0
19:36:51,5904.646,Fox,1374,97,34,14,14,17,15,3,1374,1340,1326,1078,438,403,50,47,697,677,101,779,397,0
19:36:52,5906.362,Fox,1376,99,36,14,14,17,15,3,1376,1340,1326,1078,438,403,51,48,698,678,101,779,397,0
19:36:52,5908.43,Fox,1376,99,34,16,14,17,15,3,1376,1342,1326,1078,438,403,51,48,698,678,101,779,397,0
19:36:53,5909.228,Fox,1380,103,34,16,14,17,13,5,1376,1342,1326,1078,438,405,53,50,700,680,101,779,397,0
19:36:53,5909.376,Fox,1380,103,36,16,14,19,13,5,1380,1344,1328,1080,438,405,53,50,700,680,101,779,397,0
19:36:53,5909.837,Fox,1382,104,38,16,13,19,13,5,1382,1344,1328,1080,438,405,54,50,702,680,101,780,397,0
19:36:53,5909.995,Fox,1382,104,36,18,13,19,13,5,1382,1346,1328,1080,438,405,54,50,702,680,101,780,397,0
19:36:53,5910.577,Fox,1382,103,36,18,13,19,12,5,1382,1346,1328,1080,438,405,53,50,702,680,101,781,397,0
19:36:53,5911.557,Fox,1384,105,38,18,13,19,12,5,1384,1346,1328,1080,438,405,54,51,703,681,101,781,397,0
19:36:54,5913.367,Fox,1386,107,40,18,13,19,12,5,1386,1346,1328,1080,438,405,55,52,704,682,101,781,397,0
19:36:55,5914.913,Fox,1388,109,42,18,13,19,12,5,1388,1346,1328,1080,438,405,57,52,706,682,101,781,397,0
19:36:55,5917.519,Fox,1388,109,42,18,13,19,9,8,1388,1346,1328,1080,438,408,57,52,706,682,101,781,397,0
19:36:56,5918.064,Fox,1388,109,42,18,12,20,9,8,1388,1346,1328,1081,438,408,57,52,706,682,101,781,397,0
19:36:56,5918.658,Fox,1388,109,40,20,12,20,9,8,1388,1348,1328,1081,438,408,57,52,706,682,101,781,397,0
19:36:56,5919.767,Fox,1388,109,40,20,9,23,9,8,1388,1348,1328,1084,438,408,57,52,706,682,101,781,397,0
19:36:57,5921.081,Fox,1388,109,40,18,11,23,9,8,1388,1348,1330,1084,438,408,57,52,706,682,101,781,397,0
19:36:57,5921.903,Fox,1388,109,40,16,13,21,11,8,1388,1348,1332,1084,440,408,57,52,706,682,101,781,397,0
19:36:57,5923.503,Fox,1388,109,38,18,13,21,11,8,1388,1350,1332,1084,440,408,57,52,706,682,101,781,397,0
19:36:58,5924.728,Fox,1390,110,40,18,13,21,11,7,1390,1350,1332,1084,440,408,58,52,708,682,101,781,398,0
19:36:59,5927.354,Fox,1390,110,40,16,15,21,11,7,1390,1350,1334,1084,440,408,58,52,708,682,101,781,398,0
19:36:59,5928.718,Fox,1390,109,40,14,17,20,11,7,1390,1350,1336,1084,440,408,58,51,708,682,101,782,398,0
19:36:59,5929.404,Fox,1390,109,40,14,17,15,16,7,1390,1350,1336,1084,445,408,58,51,708,682,101,782,398,0
19:37:00,5930.446,Fox,1390,106,40,14,17,12,16,7,1390,1350,1336,1084,445,408,56,50,708,682,101,785,398,0
19:37:00,5930.699,Fox,1390,105,38,16,17,12,16,6,1390,1352,1336,1084,445,408,55,50,708,682,101,785,399,0
19:37:00,5931.4,Fox,1390,105,38,16,16,13,16,6,1390,1352,1336,1085,445,408,55,50,708,682,101,785,399,0
19:37:01,5933.437,Fox,1390,105,38,16,14,15,16,6,1390,1352,1336,1087,445,408,55,50,708,682,101,785,399,0
19:37:02,5936.097,Fox,1390,105,36,18,14,14,17,6,1390,1354,1336,1087,446,408,55,50,708,682,101,785,399,0
19:37:02,5936.771,Fox,1390,105,36,18,14,13,18,6,1390,1354,1336,1087,447,408,55,50,708,682,101,785,399,0
19:37:02,5937.047,Fox,1390,105,36,18,12,15,18,6,1390,1354,1336,1089,447,408,55,50,708,682,101,785,399,0
19:37:03,5939.33,Fox,1390,103,36,18,12,15,18,4,1390,1354,1336,1089,447,408,55,48,708,682,101,785,401,0
19:37:03,5939.893,Fox,1390,103,36,18,12,14,19,4,1390,1354,1336,1089,448,408,55,48,708,682,101,785,401,0
19:37:03,5940.638,Fox,1392,104,38,18,11,14,19,4,1392,1354,1336,1089,448,408,54,50,708,684,101,786,401,0
19:37:03,5941.101,Fox,1392,104,38,16,13,14,19,4,1392,1354,1338,1089,448,408,54,50,708,684,101,786,401,0
19:37:04,5942.01,Fox,1392,103,38,16,13,13,19,4,1392,1354,1338,1089,448,408,54,49,708,684,101,787,401,0
19:37:04,5942.666,Fox,1392,103,38,14,15,13,19,4,1392,1354,1340,1089,448,408,54,49,708,684,101,787,401,0
19:37:04,5943.974,Fox,1394,104,36,16,15,12,19,4,1392,1356,1340,1089,448,408,53,51,708,686,101,788,401,0
19:37:04,5944.135,Fox,1394,104,38,16,15,12,19,4,1394,1356,1340,1089,448,408,53,51,708,686,101,788,401,0
19:37:04,5944.448,Fox,1394,104,36,18,15,12,19,4,1394,1358,1340,1089,448,408,53,51,708,686,101,788,401,0
19:37:05,5945.376,Fox,1396,105,38,18,14,12,19,4,1396,1358,1340,1089,448,408,54,51,710,686,101,789,401,0
19:37:05,5946.95,Fox,1396,105,38,16,16,12,19,4,1396,1358,1342,1089,448,408,54,51,710,686,101,789,401,0
19:37:06,5947.895,Fox,1396,104,38,14,18,12,19,3,1396,1358,1344,1089,448,408,54,50,710,686,101,789,402,0
19:37:06,5948.765,Fox,1398,106,38,12,20,12,17,5,1396,1358,1346,1089,448,410,54,52,710,688,101,789,402,0
19:37:06,5948.931,Fox,1398,106,40,12,20,12,17,5,1398,1358,1346,1089,448,410,54,52,710,688,101,789,402,0
19:37:06,5950.003,Fox,1398,106,38,14,20,12,17,5,1398,1360,1346,1089,448,410,54,52,710,688,101,789,402,0
19:37:07,5951.855,Fox,1398,106,36,16,20,12,17,5,1398,1362,1346,1089,448,410,54,52,710,688,101,789,402,0
19:37:08,5954.042,Fox,1398,106,34,18,20,12,17,5,1398,1364,1346,1089,448,410,54,52,710,688,101,789,402,0
19:37:09,5957.236,Fox,1398,106,32,18,22,12,17,5,1398,1366,1348,1089,448,410,54,52,710,688,101,789,402,0
19:37:09,5958.1,Fox,1400,107,34,18,21,12,17,5,1400,1366,1348,1089,448,410,54,53,711,689,101,790,402,0
19:37:09,5959.115,Fox,1402,109,36,18,21,10,19,5,1402,1366,1348,1089,450,410,55,54,712,690,101,790,402,0
19:37:10,5961.912,Fox,1402,109,36,16,23,10,19,5,1402,1366,1350,1089,450,410,55,54,712,690,101,790,402,0
19:37:11,5963.586,Fox,1402,109,36,16,22,11,19,5,1402,1366,1350,1090,450,410,55,54,712,690,101,790,402,0
19:37:12,5966.132,Fox,1404,111,38,16,22,11,19,5,1404,1366,1350,1090,450,410,56,55,713,691,101,790,402,0
19:37:12,5966.458,Fox,1406,113,40,16,22,11,19,5,1406,1366,1350,1090,450,410,56,57,713,693,101,790,402,0
19:37:13,5969.177,Fox,1406,113,40,14,24,11,19,5,1406,1366,1352,1090,450,410,56,57,713,693,101,790,402,0
19:37:13,5969.636,Fox,1406,113,40,14,24,10,20,5,1406,1366,1352,1090,451,410,56,57,713,693,101,790,402,0
19:37:13,5969.95,Fox,1406,113,40,14,23,11,20,5,1406,1366,1352,1091,451,410,56,57,713,693,101,790,402,0
19:37:14,5972.366,Fox,1406,113,38,16,23,11,20,5,1406,1368,1352,1091,451,410,56,57,713,693,101,790,402,0
19:37:14,5974.137,Fox,1406,112,38,16,23,10,20,5,1406,1368,1352,1091,451,410,56,56,713,693,101,791,402,0
19:37:14,5974.586,Fox,1406,112,38,14,25,10,20,5,1406,1368,1354,1091,451,410,56,56,713,693,101,791,402,0
19:37:15,5977.311,Fox,1406,112,36,16,25,10,20,5,1406,1370,1354,1091,451,410,56,56,713,693,101,791,402,0
19:37:16,5978.123,Fox,1406,111,36,16,25,10,20,4,1406,1370,1354,1091,451,410,55,56,713,693,101,791,403,0
19:37:16,5979.248,Fox,1408,112,38,16,24,10,20,4,1408,1370,1354,1091,451,410,54,58,713,695,101,792,403,0
19:37:16,5979.71,Fox,1408,112,36,18,24,10,20,4,1408,1372,1354,1091,451,410,54,58,713,695,101,792,403,0
19:37:16,5980.429,Fox,1408,111,36,18,24,9,20,4,1408,1372,1354,1091,451,410,54,57,713,695,101,793,403,0
19:37:17,5981.04,Fox,1412,113,40,18,23,9,20,3,1412,1372,1354,1091,451,410,56,57,716,696,101,794,404,0
19:37:17,5981.533,Fox,1412,113,40,18,21,11,20,3,1412,1372,1354,1093,451,410,56,57,716,696,101,794,404,0
19:37:17,5982.414,Fox,1412,113,40,16,22,12,20,3,1412,1372,1356,1094,451,410,56,57,716,696,101,794,404,0
19:37:17,5982.86,Fox,1412,113,40,14,24,12,20,3,1412,1372,1358,1094,451,410,56,57,716,696,101,794,404,0
19:37:17,5983.546,Fox,1412,113,40,14,24,10,22,3,1412,1372,1358,1094,453,410,56,57,716,696,101,794,404,0
19:37:18,5984.682,Fox,1414,115,42,14,24,10,22,3,1414,1372,1358,1094,453,410,57,58,717,697,101,794,404,0
19:37:19,5987.215,Fox,1414,115,40,16,24,10,22,3,1414,1374,1358,1094,453,410,57,58,717,697,101,794,404,0
19:37:19,5987.858,Fox,1414,115,40,16,22,12,22,3,1414,1374,1358,1096,453,410,57,58,717,697,101,794,404,0
19:37:19,5988.191,Fox,1414,114,40,16,22,12,22,2,1414,1374,1358,1096,453,410,57,57,717,697,101,794,405,0
19:37:19,5988.695,Fox,1416,116,42,14,24,12,22,2,1416,1374,1360,1096,453,410,58,58,718,698,101,794,405,0
19:37:19,5989.015,Fox,1416,115,40,16,24,10,24,1,1416,1376,1360,1096,455,410,58,57,718,698,101,794,406,0
19:37:19,5989.399,Fox,1416,115,40,16,22,12,24,1,1416,1376,1360,1098,455,410,58,57,718,698,101,794,406,0
19:37:20,5990.383,Fox,1416,115,40,14,24,12,24,1,1416,1376,1362,1098,455,410,58,57,718,698,101,794,406,0
19:37:20,5991.958,Fox,1418,117,38,18,24,12,24,1,1418,1380,1362,1098,455,410,59,58,719,699,101,794,406,0
19:37:20,5992.116,Fox,1418,116,38,18,24,11,24,1,1418,1380,1362,1098,455,410,59,57,719,699,101,795,406,0
19:37:21,5992.579,Fox,1418,116,36,18,26,11,24,1,1418,1382,1364,1098,455,410,59,57,719,699,101,795,406,0
19:37:21,5994.162,Fox,1418,116,34,20,26,11,24,1,1418,1384,1364,1098,455,410,59,57,719,699,101,795,406,0
19:37:22,5995.624,Fox,1418,116,34,18,28,11,24,1,1418,1384,1366,1098,455,410,59,57,719,699,101,795,406,0
19:37:22,5995.912,Fox,1418,116,32,20,28,11,24,1,1418,1386,1366,1098,455,410,59,57,719,699,101,795,406,0
19:37:22,5997.06,Fox,1418,116,32,20,28,11,23,2,1418,1386,1366,1098,455,411,59,57,719,699,101,795,406,0
19:37:22,5997.549,Fox,1418,116,30,22,28,11,23,2,1418,1388,1366,1098,455,411,59,57,719,699,101,795,406,0
19:37:23,6000.004,Fox,1420,118,32,22,28,11,23,2,1420,1388,1366,1098,455,411,60,58,720,700,101,795,406,0
19:37:23,6000.649,Fox,1422,120,34,22,28,11,23,2,1422,1388,1366,1098,455,411,61,59,721,701,101,795,406,0
19:37:24,6001.941,Fox,1424,121,36,22,27,11,23,2,1424,1388,1366,1098,455,411,60,61,721,703,101,796,406,0
19:37:24,6002.26,Fox,1424,121,36,22,27,11,21,4,1424,1388,1366,1098,455,413,60,61,721,703,101,796,406,0
19:37:24,6003.078,Fox,1424,121,36,22,25,11,23,4,1424,1388,1366,1100,457,413,60,61,721,703,101,796,406,0
19:37:24,6004.474,Fox,1424,121,36,22,25,11,21,6,1424,1388,1366,1100,457,415,60,61,721,703,101,796,406,0
19:37:25,6005.25,Fox,1426,123,38,22,25,11,21,6,1426,1388,1366,1100,457,415,61,62,722,704,101,796,406,0
19:37:26,6007.497,Fox,1426,123,36,24,23,13,21,6,1426,1390,1366,1102,457,415,61,62,722,704,101,796,406,0
19:37:26,6008.103,Fox,1428,125,38,24,23,13,21,6,1428,1390,1366,1102,457,415,62,63,723,705,101,796,406,0
19:37:26,6008.393,Fox,1428,125,38,24,21,15,21,6,1428,1390,1366,1104,457,415,62,63,723,705,101,796,406,0
19:37:26,6009.025,Fox,1428,125,38,24,19,17,21,6,1428,1390,1366,1106,457,415,62,63,723,705,101,796,406,0
19:37:27,6010.875,Fox,1430,127,40,22,21,17,21,6,1430,1390,1368,1106,457,415,63,64,724,706,101,796,406,0
19:37:28,6013.576,Fox,1430,125,40,22,21,15,21,6,1430,1390,1368,1106,457,415,61,64,724,706,101,798,406,0
19:37:28,6015.802,Fox,1430,125,40,20,23,15,21,6,1430,1390,1370,1106,457,415,61,64,724,706,101,798,406,0
19:37:29,6017.272,Fox,1430,124,40,20,23,15,21,5,1430,1390,1370,1106,457,415,61,63,724,706,101,798,407,0
19:37:29,6017.877,Fox,1432,126,40,20,21,17,21,5,1430,1390,1370,1108,457,415,62,64,725,707,101,798,407,0
19:37:29,6018.172,Fox,1432,126,42,18,23,17,21,5,1432,1390,1372,1108,457,415,62,64,725,707,101,798,407,0
19:37:29,6018.338,Fox,1432,126,42,18,23,17,19,7,1432,1390,1372,1108,457,417,62,64,725,707,101,798,407,0
19:37:29,6018.965,Fox,1432,125,42,18,23,16,19,7,1432,1390,1372,1108,457,417,62,63,725,707,101,799,407,0
19:37:29,6019.255,Fox,1432,124,42,18,23,16,19,6,1432,1390,1372,1108,457,417,62,62,725,707,101,799,408,0
19:37:30,6020.438,Fox,1434,126,44,18,23,16,19,6,1434,1390,1372,1108,457,417,64,62,727,707,101,799,408,0
19:37:30,6020.931,Fox,1436,127,46,18,22,16,19,6,1436,1390,1372,1108,457,417,63,64,727,709,101,800,408,0
19:37:30,6022.429,Fox,1436,127,46,18,21,17,19,6,1436,1390,1372,1109,457,417,63,64,727,709,101,800,408,0
19:37:31,6023.295,Fox,1436,127,44,20,21,17,19,6,1436,1392,1372,1109,457,417,63,64,727,709,101,800,408,0
19:37:31,6023.934,Fox,1438,129,46,20,21,17,19,6,1438,1392,1372,1109,457,417,64,65,728,710,101,800,408,0
19:37:32,6025.595,Fox,1440,130,48,20,20,17,19,6,1440,1392,1372,1109,457,417,64,66,729,711,101,801,408,0
19:37:32,6025.772,Fox,1440,130,48,18,22,17,19,6,1440,1392,1374,1109,457,417,64,66,729,711,101,801,408,0
19:37:32,6026.892,Fox,1440,130,46,20,22,16,20,6,1440,1394,1374,1109,458,417,64,66,729,711,101,801,408,0
19:37:32,6027.479,Fox,1440,130,46,18,24,16,20,6,1440,1394,1376,1109,458,417,64,66,729,711,101,801,408,0
19:37:32,6027.918,Fox,1440,130,44,20,24,16,20,6,1440,1396,1376,1109,458,417,64,66,729,711,101,801,408,0
19:37:33,6029.721,Fox,1440,130,44,20,23,17,20,6,1440,1396,1376,1110,458,417,64,66,729,711,101,801,408,0
19:37:33,6030.712,Fox,1440,130,44,16,27,15,22,6,1440,1396,1380,1110,460,417,64,66,729,711,101,801,408,0
19:37:33,6030.867,Fox,1440,130,44,14,29,15,22,6,1440,1396,1382,1110,460,417,64,66,729,711,101,801,408,0
19:37:34,6031.461,Fox,1440,130,42,16,29,15,22,6,1440,1398,1382,1110,460,417,64,66,729,711,101,801,408,0
19:37:34,6032.773,Fox,1440,130,42,14,31,15,22,6,1440,1398,1384,1110,460,417,64,66,729,711,101,801,408,0
19:37:34,6033.094,Fox,1440,129,42,14,31,14,22,6,1440,1398,1384,1110,460,417,64,65,729,711,101,802,408,0
19:37:34,6034.393,Fox,1440,129,42,12,33,14,22,6,1440,1398,1386,1110,460,417,64,65,729,711,101,802,408,0
19:37:35,6035.04,Fox,1440,129,42,12,31,16,22,6,1440,1398,1386,1112,460,417,64,65,729,711,101,802,408,0
19:37:35,6035.977,Fox,1440,129,42,10,33,16,22,6,1440,1398,1388,1112,460,417,64,65,729,711,101,802,408,0
19:37:36,6038.477,Fox,1442,130,44,10,33,15,22,6,1442,1398,1388,1112,460,417,65,65,731,711,101,803,408,0
19:37:36,6040.274,Fox,1442,129,44,10,33,14,22,6,1442,1398,1388,1112,460,417,64,65,731,711,101,804,408,0
19:37:37,6040.769,Fox,1442,129,42,12,33,14,22,6,1442,1400,1388,1112,460,417,64,65,731,711,101,804,408,0
19:37:37,6041.237,Fox,1444,131,44,12,33,14,22,6,1444,1400,1388,1112,460,417,66,65,733,711,101,804,408,0
19:37:37,6041.71,Fox,1444,131,42,14,33,14,22,6,1444,1402,1388,1112,460,417,66,65,733,711,101,804,408,0
19:37:37,6042.852,Fox,1444,131,42,14,31,16,22,6,1444,1402,1388,1114,460,417,66,65,733,711,101,804,408,0
19:37:37,6043.444,Fox,1444,131,42,14,30,17,22,6,1444,1402,1388,1115,460,417,66,65,733,711,101,804,408,0
19:37:38,6045.85,Fox,1444,129,42,12,32,15,22,6,1444,1402,1390,1115,460,417,65,64,733,711,101,806,408,0
19:37:39,6048.683,Fox,1444,129,40,14,32,15,22,6,1444,1404,1390,1115,460,417,65,64,733,711,101,806,408,0
19:37:39,6049.013,Fox,1444,129,38,16,30,17,22,6,1444,1406,1390,1117,460,417,65,64,733,711,101,806,408,0
19:37:40,6049.51,Fox,1446,130,40,16,29,17,22,6,1446,1406,1390,1117,460,417,66,64,735,711,101,807,408,0
19:37:40,6050.933,Fox,1446,130,40,16,27,19,22,6,1446,1406,1390,1119,460,417,66,64,735,711,101,807,408,0
19:37:41,6053.025,Fox,1446,130,40,16,25,21,22,6,1446,1406,1390,1121,460,417,66,64,735,711,101,807,408,0
19:37:41,6053.32,Fox,1446,128,40,16,25,19,22,6,1446,1406,1390,1121,460,417,65,63,735,711,101,809,408,0
19:37:41,6053.922,Fox,1446,127,40,16,25,18,22,6,1446,1406,1390,1121,460,417,65,62,735,711,101,810,408,0
19:37:41,6055.133,Fox,1448,129,42,16,25,18,22,6,1448,1406,1390,1121,460,417,66,63,736,712,101,810,408,0
19:37:42,6056.189,Fox,1448,129,42,16,23,20,22,6,1448,1406,1390,1123,460,417,66,63,736,712,101,810,408,0
19:37:43,6059.328,Fox,1448,129,42,16,23,20,20,8,1448,1406,1390,1123,460,419,66,63,736,712,101,810,408,0
19:37:43,6059.604,Fox,1448,127,42,16,23,18,20,8,1448,1406,1390,1123,460,419,65,62,736,712,101,812,408,0
19:37:44,6061.867,Fox,1450,128,40,16,24,18,20,8,1448,1408,1392,1123,460,419,65,63,737,713,101,813,408,0
19:37:44,6062.019,Fox,1450,128,42,16,24,18,20,8,1450,1408,1392,1123,460,419,65,63,737,713,101,813,408,0
19:37:44,6062.778,Fox,1450,126,42,16,24,18,20,6,1450,1408,1392,1123,460,419,63,63,737,713,101,813,410,0
19:37:44,6063.651,Fox,1450,126,38,20,24,18,20,6,1450,1412,1392,1123,460,419,63,63,737,713,101,813,410,0
19:37:45,6064.915,Fox,1454,129,40,20,23,18,20,6,1452,1412,1392,1123,460,419,65,64,740,714,101,814,410,0
19:37:45,6065.229,Fox,1454,129,42,18,25,18,20,6,1454,1412,1394,1123,460,419,65,64,740,714,101,814,410,0
19:37:45,6066.637,Fox,1454,127,42,16,27,16,20,6,1454,1412,1396,1123,460,419,65,62,740,714,101,816,410,0
19:37:45,6066.963,Fox,1456,129,44,16,27,16,15,11,1456,1412,1396,1123,460,424,67,62,742,714,101,816,410,0
19:37:45,6067.261,Fox,1456,129,42,18,27,16,15,11,1456,1414,1396,1123,460,424,67,62,742,714,101,816,410,0
19:37:46,6068.409,Fox,1458,131,44,18,27,16,15,11,1458,1414,1396,1123,460,424,67,64,742,716,101,816,410,0
19:37:46,6069.137,Fox,1460,132,46,18,26,16,15,11,1460,1414,1396,1123,460,424,67,65,743,717,101,817,410,0
19:37:46,6069.501,Fox,1464,135,48,18,25,16,15,11,1462,1414,1396,1123,460,424,68,67,745,719,101,818,410,0
19:37:46,6069.688,Fox,1464,135,50,18,25,16,15,11,1464,1414,1396,1123,460,424,68,67,745,719,101,818,410,0
19:37:46,6070.033,Fox,1464,135,50,16,27,16,15,11,1464,1414,1398,1123,460,424,68,67,745,719,101,818,410,0
19:37:47,6070.857,Fox,1466,137,52,16,27,16,15,11,1466,1414,1398,1123,460,424,69,68,746,720,101,818,410,0
19:37:47,6071.21,Fox,1466,137,50,18,27,16,15,11,1466,1416,1398,1123,460,424,69,68,746,720,101,818,410,0
19:37:48,6073.627,Fox,1466,137,50,18,27,16,14,12,1466,1416,1398,1123,460,425,69,68,746,720,101,818,410,0
19:37:48,6074.363,Fox,1468,138,50,18,26,16,13,13,1466,1416,1398,1123,460,426,69,69,747,721,101,819,410,0
19:37:48,6074.541,Fox,1468,138,50,20,26,16,13,13,1468,1418,1398,1123,460,426,69,69,747,721,101,819,410,0
19:37:48,6075.95,Fox,1468,138,50,20,26,15,14,13,1468,1418,1398,1123,461,426,69,69,747,721,101,819,410,0
19:37:48,6076.289,Fox,1468,138,50,20,24,17,14,13,1468,1418,1398,1125,461,426,69,69,747,721,101,819,410,0
19:37:49,6077.422,Fox,1468,138,50,20,24,17,13,14,1468,1418,1398,1125,461,427,69,69,747,721,101,819,410,0
19:37:49,6078.517,Fox,1470,139,52,20,23,17,13,14,1470,1418,1398,1125,461,427,70,69,749,721,101,820,410,0
19:37:49,6078.7,Fox,1470,139,52,20,21,19,13,14,1470,1418,1398,1127,461,427,70,69,749,721,101,820,410,0
19:37:49,6079.198,Fox,1470,139,52,18,23,19,13,14,1470,1418,1400,1127,461,427,70,69,749,721,101,820,410,0
19:37:50,6079.506,Fox,1470,138,52,18,23,19,13,13,1470,1418,1400,1127,461,427,69,69,749,721,101,820,411,0
19:37:50,6080.312,Fox,1470,138,52,16,25,19,13,13,1470,1418,1402,1127,461,427,69,69,749,721,101,820,411,0
19:37:50,6081.383,Fox,1470,138,52,16,25,17,15,13,1470,1418,1402,1127,463,427,69,69,749,721,101,820,411,0
19:37:51,6082.749,Fox,1472,139,50,18,24,17,15,13,1470,1420,1402,1127,463,427,68,71,749,723,101,821,411,0
19:37:51,6083.117,Fox,1474,140,52,18,23,15,17,13,1472,1420,1402,1127,465,427,68,72,750,724,101,822,411,0
19:37:51,6083.477,Fox,1476,142,54,20,23,15,17,13,1476,1422,1402,1127,465,427,70,72,752,724,101,822,411,0
19:37:51,6084.466,Fox,1476,142,52,22,23,15,17,13,1476,1424,1402,1127,465,427,70,72,752,724,101,822,411,0
19:37:52,6086.201,Fox,1476,142,52,22,22,16,17,13,1476,1424,1402,1128,465,427,70,72,752,724,101,822,411,0
19:37:52,6086.945,Fox,1476,140,52,22,22,14,17,13,1476,1424,1402,1128,465,427,70,70,752,724,101,824,411,0
19:37:52,6087.283,Fox,1476,140,52,20,24,14,17,13,1476,1424,1404,1128,465,427,70,70,752,724,101,824,411,0
19:37:52,6087.758,Fox,1476,140,50,20,26,14,17,13,1476,1426,1406,1128,465,427,70,70,752,724,101,824,411,0
19:37:52,6087.905,Fox,1476,140,50,20,25,15,17,13,1476,1426,1406,1129,465,427,70,70,752,724,101,824,411,0
19:37:53,6088.814,Fox,1476,139,50,20,25,15,17,12,1476,1426,1406,1129,465,427,69,70,752,724,101,824,412,0
19:37:53,6089.292,Fox,1476,137,50,20,25,13,17,12,1476,1426,1406,1129,465,427,68,69,752,724,101,826,412,0
19:37:53,6090.701,Fox,1476,137,48,22,25,13,17,12,1476,1428,1406,1129,465,427,68,69,752,724,101,826,412,0
19:37:53,6091.017,Fox,1476,137,48,22,22,16,17,12,1476,1428,1406,1132,465,427,68,69,752,724,101,826,412,0
19:37:54,6091.617,Fox,1478,139,50,22,20,18,17,12,1478,1428,1406,1134,465,427,69,70,753,725,101,826,412,0
19:37:54,6093.146,Fox,1478,139,50,22,18,20,17,12,1478,1428,1406,1136,465,427,69,70,753,725,101,826,412,0
19:37:54,6093.659,Fox,1478,138,48,24,18,20,17,11,1478,1430,1406,1136,465,427,68,70,753,725,101,826,413,0
19:37:55,6094.647,Fox,1480,140,50,24,18,20,17,11,1480,1430,1406,1136,465,427,68,72,753,727,101,826,413,0
19:37:55,6094.963,Fox,1480,140,50,24,17,21,17,11,1480,1430,1406,1137,465,427,68,72,753,727,101,826,413,0
19:37:55,6096.348,Fox,1482,142,52,24,17,21,17,11,1482,1430,1406,1137,465,427,69,73,754,728,101,826,413,0
19:37:55,6096.498,Fox,1482,142,52,24,16,22,15,13,1482,1430,1406,1138,465,429,69,73,754,728,101,826,413,0
19:37:55,6096.833,Fox,1482,141,52,24,16,21,15,13,1482,1430,1406,1138,465,429,69,72,754,728,101,827,413,0
19:37:56,6098.611,Fox,1482,140,52,24,16,20,15,13,1482,1430,1406,1138,465,429,69,71,754,728,101,828,413,0
19:37:56,6100.319,Fox,1482,140,52,22,18,20,15,13,1482,1430,1408,1138,465,429,69,71,754,728,101,828,413,0
19:37:57,6100.604,Fox,1482,140,50,24,18,20,15,13,1482,1432,1408,1138,465,429,69,71,754,728,101,828,413,0
19:37:57,6101.073,Fox,1482,140,50,24,18,18,17,13,1482,1432,1408,1138,467,429,69,71,754,728,101,828,413,0
19:37:57,6101.503,Fox,1482,139,50,24,18,17,17,13,1482,1432,1408,1138,467,429,69,70,754,728,101,829,413,0
19:37:57,6101.991,Fox,1482,137,50,24,18,14,18,13,1482,1432,1408,1138,468,429,67,70,754,728,101,831,413,0
19:37:57,6102.169,Fox,1482,137,50,20,22,14,18,13,1482,1432,1412,1138,468,429,67,70,754,728,101,831,413,0
19:37:57,6102.55,Fox,1482,137,50,20,22,12,20,13,1482,1432,1412,1138,470,429,67,70,754,728,101,831,413,0
19:37:57,6102.999,Fox,1482,137,48,22,22,12,20,13,1482,1434,1412,1138,470,429,67,70,754,728,101,831,413,0
19:37:58,6103.436,Fox,1482,137,46,24,22,12,20,13,1482,1436,1412,1138,470,429,67,70,754,728,101,831,413,0
19:37:58,6104.362,Fox,1482,136,46,24,22,12,20,12,1482,1436,1412,1138,470,429,67,69,754,728,101,831,414,0
19:37:58,6105.104,Fox,1486,140,50,24,22,12,20,12,1486,1436,1412,1138,470,429,70,70,757,729,101,831,414,0
19:37:58,6105.747,Fox,1486,139,50,22,24,11,20,12,1486,1436,1414,1138,470,429,70,69,757,729,101,832,414,0
19:37:59,6106.551,Fox,1486,139,48,24,24,11,20,12,1486,1438,1414,1138,470,429,70,69,757,729,101,832,414,0
19:37:59,6107.15,Fox,1486,138,48,24,24,10,19,13,1486,1438,1414,1138,470,430,69,69,757,729,101,833,414,0
19:37:59,6108.181,Fox,1486,138,46,26,24,10,19,13,1486,1440,1414,1138,470,430,69,69,757,729,101,833,414,0
19:37:59,6109.041,Fox,1486,137,46,26,24,10,19,12,1486,1440,1414,1138,470,430,69,68,757,729,101,833,415,0
19:38:00,6109.75,Fox,1486,137,46,24,26,10,19,12,1486,1440,1416,1138,470,430,69,68,757,729,101,833,415,0
19:38:00,6111.234,Fox,1486,137,46,24,26,8,21,12,1486,1440,1416,1138,472,430,69,68,757,729,101,833,415,0
19:38:01,6113.277,Fox,1488,139,48,22,28,8,21,12,1488,1440,1418,1138,472,430,70,69,758,730,101,833,415,0
19:38:02,6116.799,Fox,1490,140,50,22,27,8,21,12,1490,1440,1418,1138,472,430,69,71,758,732,101,834,415,0
19:38:02,6117.393,Fox,1490,139,50,22,27,8,21,11,1490,1440,1418,1138,472,430,68,71,758,732,101,834,416,0
19:38:02,6117.72,Fox,1490,138,50,22,27,8,21,10,1490,1440,1418,1138,472,430,68,70,758,732,101,834,417,0
19:38:03,6121.105,Fox,1490,138,48,22,29,8,19,12,1490,1442,1420,1138,472,432,68,70,758,732,101,834,417,0
19:38:04,6121.672,Fox,1490,138,48,20,31,8,19,12,1490,1442,1422,1138,472,432,68,70,758,732,101,834,417,0
19:38:04,6122.101,Fox,1492,140,50,20,31,8,19,12,1492,1442,1422,1138,472,432,69,71,759,733,101,834,417,0
19:38:04,6122.243,Fox,1492,140,50,20,29,10,19,12,1492,1442,1422,1140,472,432,69,71,759,733,101,834,417,0
19:38:04,6122.982,Fox,1492,140,50,18,31,10,19,12,1492,1442,1424,1140,472,432,69,71,759,733,101,834,417,0
19:38:04,6123.813,Fox,1492,140,48,20,31,10,19,12,1492,1444,1424,1140,472,432,69,71,759,733,101,834,417,0
19:38:05,6125.65,Fox,1492,139,48,20,29,12,19,11,1492,1444,1424,1142,472,432,69,70,759,733,101,834,418,0
19:38:05,6126.283,Fox,1492,139,48,18,31,12,19,11,1492,1444,1426,1142,472,432,69,70,759,733,101,834,418,0
19:38:05,6126.592,Fox,1492,139,48,18,31,12,17,13,1492,1444,1426,1142,472,434,69,70,759,733,101,834,418,0
19:38:05,6126.916,Fox,1492,139,48,18,29,14,17,13,1492,1444,1426,1144,472,434,69,70,759,733,101,834,418,0
19:38:06,6128.786,Fox,1494,141,50,18,29,14,17,13,1494,1444,1426,1144,472,434,70,71,760,734,101,834,418,0
19:38:06,6129.303,Fox,1494,141,50,16,31,14,17,13,1494,1444,1428,1144,472,434,70,71,760,734,101,834,418,0
19:38:07,6130.439,Fox,1494,141,50,16,29,16,17,13,1494,1444,1428,1146,472,434,70,71,760,734,101,834,418,0
19:38:07,6132.165,Fox,1494,141,48,16,31,16,17,13,1494,1446,1430,1146,472,434,70,71,760,734,101,834,418,0
19:38:07,6132.689,Fox,1494,139,48,16,31,14,17,13,1494,1446,1430,1146,472,434,70,69,760,734,101,836,418,0
19:38:08,6135.73,Fox,1494,138,48,16,31,14,17,12,1494,1446,1430,1146,472,434,70,68,760,734,101,836,419,0
19:38:08,6136.323,Fox,1494,136,48,16,31,12,17,12,1494,1446,1430,1146,472,434,70,66,760,734,101,838,419,0
19:38:09,6137.582,Fox,1494,134,48,16,31,11,17,11,1494,1446,1430,1146,472,434,69,65,760,734,101,839,420,0
19:38:09,6137.743,Fox,1494,134,46,18,31,11,17,11,1494,1448,1430,1146,472,434,69,65,760,734,101,839,420,0
19:38:09,6138.523,Fox,1496,135,48,18,30,11,17,11,1496,1448,1430,1146,472,434,69,66,761,735,101,840,420,0
19:38:09,6139.002,Fox,1498,136,50,18,29,11,17,11,1498,1448,1430,1146,472,434,69,67,762,736,101,841,420,0
19:38:09,6139.186,Fox,1498,136,50,16,31,11,17,11,1498,1448,1432,1146,472,434,69,67,762,736,101,841,420,0
19:38:10,6139.679,Fox,1498,136,50,16,30,12,17,11,1498,1448,1432,1147,472,434,69,67,762,736,101,841,420,0
19:38:10,6140.452,Fox,1498,136,50,16,30,12,15,13,1498,1448,1432,1147,472,436,69,67,762,736,101,841,420,0
19:38:10,6140.774,Fox,1498,136,50,16,29,13,15,13,1498,1448,1432,1148,472,436,69,67,762,736,101,841,420,0
19:38:10,6141.298,Fox,1500,136,52,16,29,11,15,13,1500,1448,1432,1148,472,436,69,67,762,738,103,841,420,0
19:38:10,6141.45,Fox,1500,136,52,14,31,11,15,13,1500,1448,1434,1148,472,436,69,67,762,738,103,841,420,0
19:38:10,6142.059,Fox,1500,136,52,12,33,11,15,13,1500,1448,1436,1148,472,436,69,67,762,738,103,841,420,0
19:38:11,6144.536,Fox,1500,136,50,14,33,9,17,13,1500,1450,1436,1148,474,436,69,67,762,738,103,841,420,0
19:38:11,6144.861,Fox,1502,138,52,14,33,9,17,13,1502,1450,1436,1148,474,436,69,69,762,740,103,841,420,0
19:38:11,6145.024,Fox,1502,138,52,12,35,9,17,13,1502,1450,1438,1148,474,436,69,69,762,740,103,841,420,0
19:38:12,6146.637,Fox,1502,138,52,10,37,7,19,13,1502,1450,1440,1148,476,436,69,69,762,740,103,841,420,0
19:38:12,6146.907,Fox,1502,136,52,10,37,7,19,11,1502,1450,1440,1148,476,436,69,67,762,740,103,841,422,0
19:38:12,6147.655,Fox,1502,135,48,14,35,9,19,10,1502,1454,1440,1150,476,436,69,66,762,740,103,841,423,0
19:38:12,6147.995,Fox,1504,136,50,14,32,11,19,10,1504,1454,1440,1152,476,436,69,67,763,741,103,842,423,0
19:38:13,6148.347,Fox,1506,137,52,14,31,11,19,10,1506,1454,1440,1152,476,436,70,67,765,741,103,843,423,0
19:38:13,6149.626,Fox,1508,139,52,16,31,11,19,10,1508,1456,1440,1152,476,436,71,68,766,742,103,843,423,0
19:38:13,6149.947,Fox,1508,138,52,16,31,11,19,9,1508,1456,1440,1152,476,436,70,68,766,742,103,843,424,0
19:38:13,6150.265,Fox,1508,137,52,16,31,10,19,9,1508,1456,1440,1152,476,436,70,67,766,742,103,844,424,0
19:38:13,6150.894,Fox,1508,137,50,18,31,10,19,9,1508,1458,1440,1152,476,436,70,67,766,742,103,844,424,0
19:38:13,6151.196,Fox,1508,136,50,18,31,9,19,9,1508,1458,1440,1152,476,436,70,66,766,742,103,845,424,0
19:38:14,6151.667,Fox,1508,136,48,20,31,9,19,9,1508,1460,1440,1152,476,436,70,66,766,742,103,845,424,0
19:38:14,6151.958,Fox,1508,136,46,22,31,9,19,9,1508,1462,1440,1152,476,436,70,66,766,742,103,845,424,0
19:38:14,6152.233,Fox,1508,136,44,24,31,9,19,9,1508,1464,1440,1152,476,436,70,66,766,742,103,845,424,0
19:38:14,6153.469,Fox,1508,136,42,26,31,9,19,9,1508,1466,1440,1152,476,436,70,66,766,742,103,845,424,0
19:38:15,6157.001,Fox,1508,136,40,28,31,9,19,9,1508,1468,1440,1152,476,436,70,66,766,742,103,845,424,0
19:38:16,6157.667,Fox,1508,135,40,28,31,9,19,8,1508,1468,1440,1152,476,436,70,65,766,742,103,845,425,0
19:38:16,6158.227,Fox,1510,137,42,28,31,9,19,8,1510,1468,1440,1152,476,436,72,65,768,742,103,845,425,0
19:38:16,6158.538,Fox,1510,135,42,28,31,7,19,8,1510,1468,1440,1152,476,436,72,63,768,742,103,847,425,0
19:38:16,6159.575,Fox,1512,136,44,26,32,7,19,8,1512,1468,1442,1152,476,436,71,65,768,744,103,848,425,0
19:38:17,6160.845,Fox,1512,136,44,26,30,9,19,8,1512,1468,1442,1154,476,436,71,65,768,744,103,848,425,0
19:38:17,6161.267,Fox,1514,136,44,28,29,9,19,7,1514,1470,1442,1154,476,436,70,66,768,746,103,849,426,0
19:38:17,6162.335,Fox,1514,136,44,26,31,9,19,7,1514,1470,1444,1154,476,436,70,66,768,746,103,849,426,0
19:38:17,6162.663,Fox,1514,136,44,26,28,12,19,7,1514,1470,1444,1157,476,436,70,66,768,746,103,849,426,0
19:38:18,6163.986,Fox,1516,138,46,26,28,12,19,7,1516,1470,1444,1157,476,436,70,68,768,748,103,849,426,0
19:38:18,6164.593,Fox,1518,140,46,26,28,12,18,8,1516,1470,1444,1157,476,437,71,69,769,749,103,849,426,0
19:38:18,6164.741,Fox,1518,140,48,26,28,12,18,8,1518,1470,1444,1157,476,437,71,69,769,749,103,849,426,0
19:38:18,6165.505,Fox,1518,140,46,28,28,12,18,8,1518,1472,1444,1157,476,437,71,69,769,749,103,849,426,0
19:38:18,6165.787,Fox,1518,140,44,30,28,12,18,8,1518,1474,1444,1157,476,437,71,69,769,749,103,849,426,0
19:38:18,6166.214,Fox,1518,140,42,32,27,13,18,8,1518,1476,1444,1158,476,437,71,69,769,749,103,849,426,0
19:38:19,6166.991,Fox,1518,138,42,32,27,13,18,6,1518,1476,1444,1158,476,437,70,68,769,749,103,849,428,0
19:38:19,6167.494,Fox,1520,140,44,32,27,13,18,6,1520,1476,1444,1158,476,437,71,69,770,750,103,849,428,0
19:38:19,6168.124,Fox,1520,140,44,32,27,13,16,8,1520,1476,1444,1158,476,439,71,69,770,750,103,849,428,0
19:38:20,6170.166,Fox,1520,140,44,32,26,14,16,8,1520,1476,1444,1159,476,439,71,69,770,750,103,849,428,0
19:38:20,6170.793,Fox,1520,139,44,30,28,14,16,7,1520,1476,1446,1159,476,439,70,69,770,750,103,849,429,0
19:38:20,6171.406,Fox,1520,137,44,30,28,12,16,7,1520,1476,1446,1159,476,439,70,67,770,750,103,851,429,0
19:38:21,6173.167,Fox,1520,134,44,30,28,9,16,7,1520,1476,1446,1159,476,439,68,66,770,750,103,854,429,0
19:38:21,6173.455,Fox,1520,134,44,30,26,11,16,7,1520,1476,1446,1161,476,439,68,66,770,750,103,854,429,0
19:38:21,6174.181,Fox,1520,134,42,32,26,11,16,7,1520,1478,1446,1161,476,439,68,66,770,750,103,854,429,0
19:38:22,6176.237,Fox,1520,134,42,30,28,11,16,7,1520,1478,1448,1161,476,439,68,66,770,750,103,854,429,0
19:38:22,6176.965,Fox,1522,135,44,30,28,10,16,7,1522,1478,1448,1161,476,439,70,65,772,750,103,855,429,0
19:38:22,6177.13,Fox,1522,135,42,32,28,10,16,7,1522,1480,1448,1161,476,439,70,65,772,750,103,855,429,0
19:38:23,6178.927,Fox,1522,135,40,34,28,10,16,7,1522,1482,1448,1161,476,439,70,65,772,750,103,855,429,0
19:38:23,6180.838,Fox,1522,134,40,34,28,9,16,7,1522,1482,1448,1161,476,439,70,64,772,750,104,855,429,0
19:38:24,6181.541,Fox,1522,134,40,34,27,10,16,7,1522,1482,1448,1162,476,439,70,64,772,750,104,855,429,0
19:38:24,6181.948,Fox,1524,135,42,34,26,10,16,7,1524,1482,1448,1162,476,439,71,64,774,750,105,855,429,0
19:38:24,6182.218,Fox,1524,135,42,34,25,11,16,7,1524,1482,1448,1163,476,439,71,64,774,750,105,855,429,0
19:38:24,6183.132,Fox,1524,135,42,32,27,11,16,7,1524,1482,1450,1163,476,439,71,64,774,750,105,855,429,0
19:38:24,6183.528,Fox,1524,135,42,32,25,13,16,7,1524,1482,1450,1165,476,439,71,64,774,750,105,855,429,0
19:38:25,6184.495,Fox,1524,135,42,32,25,11,18,7,1524,1482,1450,1165,478,439,71,64,774,750,105,855,429,0
19:38:25,6186.1,Fox,1524,135,42,28,29,11,18,7,1524,1482,1454,1165,478,439,71,64,774,750,105,855,429,0
19:38:25,6186.819,Fox,1524,135,42,28,27,11,20,7,1524,1482,1454,1167,480,439,71,64,774,750,105,855,429,0
19:38:26,6187.739,Fox,1524,134,38,32,27,11,20,6,1524,1486,1454,1167,480,439,71,63,774,750,105,855,430,0
19:38:26,6188.007,Fox,1524,133,38,30,29,11,20,5,1524,1486,1456,1167,480,439,70,63,774,750,105,855,431,0
19:38:26,6189.555,Fox,1526,134,38,28,30,11,20,5,1524,1486,1458,1167,480,439,70,64,775,751,105,856,431,0
19:38:26,6189.699,Fox,1526,134,40,28,28,13,20,5,1526,1486,1458,1169,480,439,70,64,775,751,105,856,431,0
19:38:26,6190.15,Fox,1526,134,40,26,30,13,20,5,1526,1486,1460,1169,480,439,70,64,775,751,105,856,431,0
19:38:27,6190.693,Fox,1526,134,40,22,34,13,20,5,1526,1486,1464,1169,480,439,70,64,775,751,105,856,431,0
19:38:27,6190.958,Fox,1526,133,40,22,34,13,20,4,1526,1486,1464,1169,480,439,69,64,775,751,105,856,432,0
19:38:27,6192.125,Fox,1526,132,40,20,36,12,20,4,1526,1486,1466,1169,480,439,69,63,775,751,105,857,432,0
19:38:27,6192.414,Fox,1526,132,40,20,34,14,20,4,1526,1486,1466,1171,480,439,69,63,775,751,105,857,432,0
19:38:27,6192.697,Fox,1526,131,40,20,34,13,20,4,1526,1486,1466,1171,480,439,69,62,775,751,105,858,432,0
19:38:28,6194.057,Fox,1526,129,40,20,34,11,20,4,1526,1486,1466,1171,480,439,69,60,775,751,105,860,432,0
19:38:28,6195.155,Fox,1526,128,40,20,34,11,20,3,1526,1486,1466,1171,480,439,68,60,775,751,105,861,432,0
19:38:28,6195.542,Fox,1526,128,40,18,36,11,20,3,1526,1486,1468,1171,480,439,68,60,775,751,105,861,432,0
19:38:28,6195.84,Fox,1526,128,38,20,36,11,20,3,1526,1488,1468,1171,480,439,68,60,775,751,105,861,432,0
19:38:29,6197.305,Fox,1526,127,38,20,36,10,20,3,1526,1488,1468,1171,480,439,68,59,775,751,105,862,432,0
19:38:29,6198.045,Fox,1528,129,40,20,36,10,20,3,1528,1488,1468,1171,480,439,69,60,776,752,105,862,432,0
19:38:29,6198.826,Fox,1530,130,42,20,35,10,20,3,1530,1488,1468,1171,480,439,70,60,778,752,105,863,432,0
19:38:30,6199.584,Fox,1530,130,40,20,35,12,20,3,1530,1490,1470,1173,480,439,70,60,778,752,105,863,432,0
19:38:30,6201.95,Fox,1530,130,40,20,34,13,20,3,1530,1490,1470,1174,480,439,70,60,778,752,105,863,432,0
19:38:31,6202.477,Fox,1530,130,40,20,32,15,20,3,1530,1490,1470,1176,480,439,70,60,778,752,105,863,432,0
19:38:31,6202.971,Fox,1530,128,40,20,32,13,20,3,1530,1490,1470,1176,480,439,69,59,778,752,105,865,432,0
19:38:31,6204.023,Fox,1530,128,40,18,34,13,20,3,1530,1490,1472,1176,480,439,69,59,778,752,105,865,432,0
19:38:31,6204.467,Fox,1530,128,40,14,38,13,20,3,1530,1490,1476,1176,480,439,69,59,778,752,105,865,432,0
19:38:31,6204.592,Fox,1530,128,38,16,38,13,20,3,1530,1492,1476,1176,480,439,69,59,778,752,105,865,432,0
19:38:32,6205.387,Fox,1530,128,38,16,37,14,20,3,1530,1492,1476,1177,480,439,69,59,778,752,105,865,432,0
19:38:32,6207.057,Fox,1530,128,38,16,35,16,20,3,1530,1492,1476,1179,480,439,69,59,778,752,105,865,432,0
19:38:33,6210.118,Fox,1530,126,38,16,35,14,20,3,1530,1492,1476,1179,480,439,68,58,778,752,107,865,432,0
19:38:34,6211.298,Fox,1530,126,36,18,35,14,20,3,1530,1494,1476,1179,480,439,68,58,778,752,107,865,432,0
19:38:34,6212.117,Fox,1532,127,38,18,34,14,20,3,1532,1494,1476,1179,480,439,69,58,780,752,107,866,432,0
19:38:34,6212.666,Fox,1532,126,38,16,36,13,20,3,1532,1494,1478,1179,480,439,68,58,780,752,107,867,432,0
19:38:34,6213.084,Fox,1532,124,38,16,36,11,20,3,1532,1494,1478,1179,480,439,68,56,780,752,107,869,432,0
19:38:34,6213.357,Fox,1532,124,38,16,36,11,19,4,1532,1494,1478,1179,480,440,68,56,780,752,107,869,432,0
19:38:35,6214.755,Fox,1532,123,38,16,36,11,19,3,1532,1494,1478,1179,480,440,68,55,780,752,107,869,433,0
19:38:35,6215.618,Fox,1532,123,38,14,38,11,19,3,1532,1494,1480,1179,480,440,68,55,780,752,107,869,433,0
19:38:35,6216.11,Fox,1532,122,38,14,38,10,19,3,1532,1494,1480,1179,480,440,68,54,780,752,108,869,433,0
19:38:36,6217.396,Fox,1532,122,38,12,40,10,19,3,1532,1494,1482,1179,480,440,68,54,780,752,108,869,433,0
19:38:36,6218.628,Fox,1532,121,38,12,40,10,19,2,1532,1494,1482,1179,480,440,67,54,780,752,108,869,434,0
19:38:36,6218.857,Fox,1532,121,38,12,40,10,17,4,1532,1494,1482,1179,480,442,67,54,780,752,108,869,434,0
19:38:36,6219.929,Fox,1532,121,38,12,39,11,17,4,1532,1494,1482,1180,480,442,67,54,780,752,108,869,434,0
19:38:37,6220.382,Fox,1532,121,38,12,39,10,16,6,1532,1494,1482,1180,481,444,67,54,780,752,108,869,434,0
19:38:37,6221.247,Fox,1532,121,36,14,39,10,16,6,1532,1496,1482,1180,481,444,67,54,780,752,108,869,434,0
19:38:37,6221.506,Fox,1532,121,34,16,39,10,16,6,1532,1498,1482,1180,481,444,67,54,780,752,108,869,434,0
19:38:37,6222.838,Fox,1534,122,36,16,37,11,16,6,1534,1498,1482,1182,481,444,66,56,780,754,108,870,434,0
19:38:38,6223.839,Fox,1534,122,34,18,37,11,16,6,1534,1500,1482,1182,481,444,66,56,780,754,108,870,434,0
19:38:38,6224.232,Fox,1536,123,36,18,36,11,16,6,1536,1500,1482,1182,481,444,66,57,781,755,108,871,434,0
19:38:38,6226.05,Fox,1540,126,38,18,36,10,16,6,1538,1500,1482,1182,481,444,67,59,783,757,108,872,434,0
19:38:39,6226.18,Fox,1540,126,40,14,40,10,16,6,1540,1500,1486,1182,481,444,67,59,783,757,108,872,434,0
19:38:39,6227.219,Fox,1544,128,42,14,38,10,16,6,1542,1500,1486,1182,481,444,68,60,786,758,108,874,434,0
19:38:39,6227.509,Fox,1546,129,42,16,37,10,16,6,1544,1502,1486,1182,481,444,69,60,788,758,108,875,434,0
19:38:39,6227.671,Fox,1546,129,44,16,37,10,16,6,1546,1502,1486,1182,481,444,69,60,788,758,108,875,434,0
19:38:39,6228.599,Fox,1548,130,46,16,37,9,16,6,1548,1502,1486,1182,481,444,69,61,789,759,108,876,434,0
19:38:40,6230.06,Fox,1550,131,48,16,36,9,16,6,1550,1502,1486,1182,481,444,70,61,791,759,108,877,434,0
19:38:40,6230.468,Fox,1552,132,50,16,35,9,16,6,1552,1502,1486,1182,481,444,70,62,792,760,109,877,434,0
19:38:40,6230.636,Fox,1552,132,48,18,35,9,16,6,1552,1504,1486,1182,481,444,70,62,792,760,109,877,434,0
19:38:40,6230.923,Fox,1552,132,46,20,35,9,16,6,1552,1506,1486,1182,481,444,70,62,792,760,109,877,434,0
19:38:40,6231.32,Fox,1554,133,48,20,34,9,16,6,1554,1506,1486,1182,481,444,70,63,793,761,109,878,434,0
19:38:40,6232.096,Fox,1554,133,46,22,34,9,16,6,1554,1508,1486,1182,481,444,70,63,793,761,109,878,434,0
19:38:41,6234.253,Fox,1554,133,46,20,36,9,16,6,1554,1508,1488,1182,481,444,70,63,793,761,109,878,434,0
19:38:42,6236.59,Fox,1554,133,46,20,35,10,16,6,1554,1508,1488,1183,481,444,70,63,793,761,109,878,434,0
19:38:42,6237.875,Fox,1554,133,46,18,37,10,16,6,1554,1508,1490,1183,481,444,70,63,793,761,109,878,434,0
19:38:43,6238.46,Fox,1554,133,46,18,37,10,14,8,1554,1508,1490,1183,481,446,70,63,793,761,109,878,434,0
19:38:43,6239.398,Fox,1554,133,46,18,37,10,13,9,1554,1508,1490,1183,481,447,70,63,793,761,109,878,434,0
19:38:43,6240.026,Fox,1554,133,46,18,37,10,11,11,1554,1508,1490,1183,481,449,70,63,793,761,109,878,434,0
19:38:43,6240.753,Fox,1554,133,44,20,37,10,11,11,1554,1510,1490,1183,481,449,70,63,793,761,109,878,434,0
19:38:43,6241.141,Fox,1554,133,44,20,37,8,13,11,1554,1510,1490,1183,483,449,70,63,793,761,109,878,434,0
19:38:44,6242.067,Fox,1556,135,46,20,37,8,13,11,1556,1510,1490,1183,483,449,72,63,795,761,109,878,434,0
19:38:44,6242.42,Fox,1560,138,48,22,37,8,13,10,1560,1512,1490,1183,483,449,73,65,797,763,109,879,434,0
19:38:44,6242.721,Fox,1562,140,50,22,37,8,13,10,1562,1512,1490,1183,483,449,75,65,799,763,109,879,434,0
19:38:44,6243.134,Fox,1562,140,50,20,39,8,13,10,1562,1512,1492,1183,483,449,75,65,799,763,109,879,434,0
19:38:44,6243.563,Fox,1562,140,50,20,38,9,13,10,1562,1512,1492,1184,483,449,75,65,799,763,109,879,434,0
19:38:44,6243.832,Fox,1562,140,48,22,38,9,13,10,1562,1514,1492,1184,483,449,75,65,799,763,109,879,434,0
19:38:45,6246.568,Fox,1562,140,46,24,35,12,13,10,1562,1516,1492,1187,483,449,75,65,799,763,109,879,434,0
19:38:46,6247.244,Fox,1562,139,44,26,35,11,13,10,1562,1518,1492,1187,483,449,75,64,799,763,109,880,434,0
19:38:46,6248.182,Fox,1564,140,46,26,34,11,13,10,1564,1518,1492,1187,483,449,75,65,800,764,109,881,434,0
19:38:46,6248.595,Fox,1564,140,46,26,32,13,11,12,1564,1518,1492,1189,483,451,75,65,800,764,109,881,434,0
19:38:46,6248.866,Fox,1564,139,46,26,32,13,11,11,1564,1518,1492,1189,483,451,75,64,800,764,109,881,435,0
19:38:46,6249.884,Fox,1564,139,46,24,32,15,11,11,1564,1518,1494,1191,483,451,75,64,800,764,109,881,435,0
19:38:46,6250.006,Fox,1564,139,44,26,32,15,11,11,1564,1520,1494,1191,483,451,75,64,800,764,109,881,435,0
19:38:47,6250.612,Fox,1564,139,44,26,31,16,11,11,1564,1520,1494,1192,483,451,75,64,800,764,109,881,435,0
19:38:47,6250.978,Fox,1566,141,46,26,30,17,11,11,1566,1520,1494,1193,483,451,75,66,800,766,109,881,435,0
19:38:47,6251.271,Fox,1566,141,46,26,29,18,11,11,1566,1520,1494,1194,483,451,75,66,800,766,109,881,435,0
19:38:47,6252.322,Fox,1568,142,48,26,28,18,11,11,1568,1520,1494,1194,483,451,74,68,800,768,109,882,435,0
19:38:47,6252.566,Fox,1570,144,48,26,27,19,11,11,1568,1520,1494,1195,483,451,75,69,801,769,109,882,435,0
19:38:47,6252.72,Fox,1570,144,50,26,27,19,11,11,1570,1520,1494,1195,483,451,75,69,801,769,109,882,435,0
19:38:48,6253.265,Fox,1572,145,52,26,26,19,11,11,1572,1520,1494,1195,483,451,75,70,802,770,109,883,435,0
19:38:48,6253.546,Fox,1574,146,54,26,25,19,11,11,1574,1520,1494,1195,483,451,74,72,802,772,109,884,435,0
19:38:48,6253.678,Fox,1574,145,54,26,25,19,11,10,1574,1520,1494,1195,483,451,74,71,802,772,109,884,436,0
19:38:48,6254.238,Fox,1576,146,56,26,25,18,11,10,1576,1520,1494,1195,483,451,75,71,803,773,109,885,436,0
19:38:48,6256.092,Fox,1576,146,56,26,24,19,11,10,1576,1520,1494,1196,483,451,75,71,803,773,109,885,436,0
19:38:49,6257.206,Fox,1576,143,56,26,24,16,11,10,1576,1520,1494,1196,483,451,73,70,803,773,109,888,436,0
19:38:49,6259.074,Fox,1576,142,56,26,24,16,11,9,1576,1520,1494,1196,483,451,72,70,803,773,109,888,437,0
19:38:50,6259.527,Fox,1576,142,54,26,26,16,11,9,1576,1522,1496,1196,483,451,72,70,803,773,109,888,437,0
19:38:50,6260.125,Fox,1576,142,54,24,27,17,11,9,1576,1522,1498,1197,483,451,72,70,803,773,109,888,437,0
19:38:50,6260.526,Fox,1576,140,54,24,27,15,11,9,1576,1522,1498,1197,483,451,72,68,803,773,109,890,437,0
19:38:50,6261.239,Fox,1576,139,54,24,27,14,11,9,1576,1522,1498,1197,483,451,72,67,803,773,109,891,437,0
19:38:50,6261.524,Fox,1576,138,54,24,27,13,11,9,1576,1522,1498,1197,483,451,72,66,803,773,109,892,437,0
19:38:50,6261.789,Fox,1576,137,54,24,27,12,11,9,1576,1522,1498,1197,483,451,72,65,803,773,109,893,437,0
19:38:51,6262.321,Fox,1576,137,54,22,29,12,11,9,1576,1522,1500,1197,483,451,72,65,803,773,109,893,437,0
19:38:51,6264.509,Fox,1576,137,52,24,27,14,11,9,1576,1524,1500,1199,483,451,72,65,803,773,109,893,437,0
19:38:51,6264.749,Fox,1576,137,52,24,26,15,11,9,1576,1524,1500,1200,483,451,72,65,803,773,109,893,437,0
19:38:51,6264.989,Fox,1576,137,52,24,24,17,11,9,1576,1524,1500,1202,483,451,72,65,803,773,109,893,437,0
19:38:52,6265.957,Fox,1576,137,52,22,26,17,11,9,1576,1524,1502,1202,483,451,72,65,803,773,109,893,437,0
19:38:52,6266.583,Fox,1576,136,52,22,26,16,11,9,1576,1524,1502,1202,483,451,72,64,803,773,110,893,437,0
19:38:52,6266.961,Fox,1576,136,52,22,26,14,13,9,1576,1524,1502,1202,485,451,72,64,803,773,110,893,437,0
19:38:53,6268.978,Fox,1576,136,52,20,28,14,13,9,1576,1524,1504,1202,485,451,72,64,803,773,110,893,437,0
19:38:53,6269.373,Fox,1578,137,54,18,29,14,13,9,1578,1524,1506,1202,485,451,72,65,804,774,110,894,437,0
19:38:53,6269.651,Fox,1578,136,54,18,29,14,13,8,1578,1524,1506,1202,485,451,72,64,804,774,110,894,438,0
19:38:53,6270.646,Fox,1578,135,54,16,31,13,13,8,1578,1524,1508,1202,485,451,71,64,804,774,110,895,438,0
19:38:54,6272.307,Fox,1580,137,54,18,31,13,13,8,1580,1526,1508,1202,485,451,72,65,805,775,110,895,438,0
19:38:54,6273.236,Fox,1580,137,54,18,29,15,13,8,1580,1526,1508,1204,485,451,72,65,805,775,110,895,438,0
19:38:55,6275.236,Fox,1582,137,54,18,29,13,13,8,1580,1526,1508,1204,485,451,73,64,806,776,110,897,438,0
19:38:55,6275.38,Fox,1582,136,56,18,29,12,13,8,1582,1526,1508,1204,485,451,73,63,806,776,110,898,438,0
19:38:55,6276.237,Fox,1584,137,56,18,26,14,13,8,1582,1526,1508,1206,485,451,73,64,807,777,110,899,438,0
19:38:55,6276.363,Fox,1584,137,58,18,26,14,13,8,1584,1526,1508,1206,485,451,73,64,807,777,110,899,438,0
19:38:56,6277.951,Fox,1586,138,60,18,23,16,13,8,1586,1526,1508,1208,485,451,73,65,808,778,110,900,438,0
19:38:56,6278.817,Fox,1586,137,60,18,23,16,13,7,1586,1526,1508,1208,485,451,73,64,808,778,110,900,439,0
19:38:56,6279.265,Fox,1586,137,60,16,25,16,13,7,1586,1526,1510,1208,485,451,73,64,808,778,110,900,439,0
19:38:57,6280.302,Fox,1586,137,60,16,25,15,14,7,1586,1526,1510,1208,486,451,73,64,808,778,110,900,439,0
19:38:57,6280.65,Fox,1586,137,58,16,27,15,14,7,1586,1528,1512,1208,486,451,73,64,808,778,110,900,439,0
19:38:57,6281.339,Fox,1586,137,56,18,27,15,14,7,1586,1530,1512,1208,486,451,73,64,808,778,110,900,439,0
19:38:57,6281.797,Fox,1586,137,56,18,27,15,12,9,1586,1530,1512,1208,486,453,73,64,808,778,110,900,439,0
19:38:57,6282.292,Fox,1586,137,56,16,29,15,12,9,1586,1530,1514,1208,486,453,73,64,808,778,110,900,439,0
19:38:57,6283.077,Fox,1586,137,56,16,29,13,14,9,1586,1530,1514,1208,488,453,73,64,808,778,110,900,439,0
19:38:58,6283.749,Fox,1586,135,56,16,29,11,14,9,1586,1530,1514,1208,488,453,72,63,808,778,110,902,439,0
19:38:58,6283.973,Fox,1586,135,56,16,29,11,12,11,1586,1530,1514,1208,488,455,72,63,808,778,110,902,439,0
19:38:58,6285.027,Fox,1586,135,56,14,31,11,12,11,1586,1530,1516,1208,488,455,72,63,808,778,110,902,439,0
19:38:58,6285.531,Fox,1588,136,58,14,30,11,12,11,1588,1530,1516,1208,488,455,72,64,809,779,110,903,439,0
19:38:58,6285.779,Fox,1588,136,58,12,32,11,12,11,1588,1530,1518,1208,488,455,72,64,809,779,110,903,439,0
19:38:59,6286.681,Fox,1588,136,58,12,29,14,12,11,1588,1530,1518,1211,488,455,72,64,809,779,110,903,439,0
19:38:59,6288.455,Fox,1588,136,58,10,31,14,12,11,1588,1530,1520,1211,488,455,72,64,809,779,110,903,439,0
19:38:59,6288.938,Fox,1588,135,58,10,31,14,12,10,1588,1530,1520,1211,488,455,71,64,809,779,110,903,440,0
19:39:00,6290.472,Fox,1588,134,58,10,31,14,12,9,1588,1530,1520,1211,488,455,71,63,809,779,110,903,441,0
19:39:00,6291.908,Fox,1588,133,58,10,31,14,12,8,1588,1530,1520,1211,488,455,71,62,809,779,110,903,442,0
19:39:01,6293.818,Fox,1590,135,60,10,31,14,12,8,1590,1530,1520,1211,488,455,72,63,810,780,110,903,442,0
19:39:01,6294.766,Fox,1590,135,58,12,30,15,12,8,1590,1532,1520,1212,488,455,72,63,810,780,110,903,442,0
19:39:02,6295.708,Fox,1592,136,60,12,29,15,12,8,1592,1532,1520,1212,488,455,72,64,811,781,110,904,442,0
19:39:02,6296.761,Fox,1594,138,62,12,29,15,12,8,1594,1532,1520,1212,488,455,73,65,812,782,110,904,442,0
19:39:02,6297.129,Fox,1594,137,62,12,29,14,12,8,1594,1532,1520,1212,488,455,73,64,812,782,110,905,442,0
19:39:02,6297.977,Fox,1594,137,62,10,31,14,12,8,1594,1532,1522,1212,488,455,73,64,812,782,110,905,442,0
19:39:03,6298.303,Fox,1594,137,62,10,29,16,12,8,1594,1532,1522,1214,488,455,73,64,812,782,110,905,442,0
19:39:03,6300.542,Fox,1594,137,62,10,29,14,14,8,1594,1532,1522,1214,490,455,73,64,812,782,110,905,442,0
19:39:04,6302.803,Fox,1596,138,64,10,28,14,14,8,1596,1532,1522,1214,490,455,72,66,812,784,110,906,442,0
19:39:04,6303.05,Fox,1596,138,64,8,30,14,14,8,1596,1532,1524,1214,490,455,72,66,812,784,110,906,442,0
19:39:04,6303.573,Fox,1596,138,64,8,29,15,14,8,1596,1532,1524,1215,490,455,72,66,812,784,110,906,442,0
19:39:05,6305.407,Fox,1596,138,62,10,29,15,14,8,1596,1534,1524,1215,490,455,72,66,812,784,110,906,442,0
19:39:05,6306.348,Fox,1598,139,64,10,28,15,14,8,1598,1534,1524,1215,490,455,72,67,813,785,110,907,442,0
19:39:05,6306.773,Fox,1598,139,62,12,28,15,14,8,1598,1536,1524,1215,490,455,72,67,813,785,110,907,442,0
19:39:06,6307.945,Fox,1600,141,64,12,28,15,14,8,1600,1536,1524,1215,490,455,73,68,814,786,110,907,442,0
19:39:06,6308.773,Fox,1600,141,60,16,28,15,14,8,1600,1540,1524,1215,490,455,73,68,814,786,110,907,442,0
19:39:06,6308.922,Fox,1600,139,60,16,28,13,14,8,1600,1540,1524,1215,490,455,73,66,814,786,110,909,442,0
19:39:06,6309.976,Fox,1600,139,56,20,28,13,14,8,1600,1544,1524,1215,490,455,73,66,814,786,110,909,442,0
19:39:07,6310.405,Fox,1600,139,54,22,27,14,14,8,1600,1546,1524,1216,490,455,73,66,814,786,110,909,442,0
19:39:07,6310.793,Fox,1600,138,54,20,29,14,14,7,1600,1546,1526,1216,490,455,72,66,814,786,110,909,443,0
19:39:07,6311.188,Fox,1600,138,52,22,29,14,14,7,1600,1548,1526,1216,490,455,72,66,814,786,110,909,443,0
19:39:07,6312.604,Fox,1600,138,50,24,29,14,14,7,1600,1550,1526,1216,490,455,72,66,814,786,110,909,443,0
19:39:07,6312.957,Fox,1600,138,48,26,29,14,14,7,1600,1552,1526,1216,490,455,72,66,814,786,110,909,443,0
19:39:08,6313.83,Fox,1600,138,46,28,29,14,14,7,1600,1554,1526,1216,490,455,72,66,814,786,110,909,443,0
19:39:08,6314.197,Fox,1600,137,46,28,29,13,14,7,1600,1554,1526,1216,490,455,72,65,814,786,110,910,443,0
19:39:09,6319.122,Fox,1600,136,46,26,31,13,14,6,1600,1554,1528,1216,490,455,72,64,814,786,110,910,444,0
19:39:10,6319.873,Fox,1600,136,46,24,33,13,14,6,1600,1554,1530,1216,490,455,72,64,814,786,110,910,444,0
19:39:10,6320.106,Fox,1600,136,46,24,32,14,14,6,1600,1554,1530,1217,490,455,72,64,814,786,110,910,444,0
19:39:10,6320.496,Fox,1600,136,46,24,31,15,14,6,1600,1554,1530,1218,490,455,72,64,814,786,110,910,444,0
19:39:10,6320.866,Fox,1600,135,46,24,31,14,14,6,1600,1554,1530,1218,490,455,72,63,814,786,110,911,444,0
19:39:10,6322.011,Fox,1602,136,48,24,30,14,12,8,1602,1554,1530,1218,490,457,72,64,815,787,110,912,444,0
19:39:11,6322.733,Fox,1602,136,48,24,28,16,12,8,1602,1554,1530,1220,490,457,72,64,815,787,110,912,444,0
19:39:11,6323.442,Fox,1604,138,50,24,28,16,12,8,1604,1554,1530,1220,490,457,73,65,816,788,110,912,444,0
19:39:11,6324.116,Fox,1604,138,50,24,28,16,10,10,1604,1554,1530,1220,490,459,73,65,816,788,110,912,444,0
19:39:11,6324.342,Fox,1604,137,50,24,28,16,10,9,1604,1554,1530,1220,490,459,72,65,816,788,110,912,445,0
19:39:11,6324.567,Fox,1604,137,48,26,28,16,10,9,1604,1556,1530,1220,490,459,72,65,816,788,110,912,445,0
19:39:11,6324.929,Fox,1604,137,44,30,28,16,10,9,1604,1560,1530,1220,490,459,72,65,816,788,110,912,445,0
19:39:12,6325.197,Fox,1604,137,42,32,28,16,10,9,1604,1562,1530,1220,490,459,72,65,816,788,110,912,445,0
19:39:12,6326.334,Fox,1604,137,42,32,26,18,10,9,1604,1562,1530,1222,490,459,72,65,816,788,110,912,445,0
19:39:13,6329.153,Fox,1604,136,42,32,26,18,10,8,1604,1562,1530,1222,490,459,71,65,816,788,110,912,446,0
19:39:13,6329.572,Fox,1604,135,42,32,24,20,10,7,1604,1562,1530,1224,490,459,70,65,816,788,110,912,447,0
19:39:13,6329.851,Fox,1604,135,42,32,23,21,10,7,1604,1562,1530,1225,490,459,70,65,816,788,110,912,447,0
19:39:13,6330.778,Fox,1604,134,40,34,23,20,10,7,1604,1564,1530,1225,490,459,70,64,816,788,110,913,447,0
19:39:14,6331.165,Fox,1604,133,40,34,21,21,10,7,1604,1564,1530,1227,490,459,70,63,816,788,110,914,447,0
19:39:14,6331.606,Fox,1606,135,42,34,21,21,10,7,1606,1564,1530,1227,490,459,71,64,817,789,110,914,447,0
19:39:14,6332.412,Fox,1608,136,44,34,20,21,10,7,1608,1564,1530,1227,490,459,71,65,818,790,110,915,447,0
19:39:14,6332.958,Fox,1610,138,46,34,20,21,10,7,1610,1564,1530,1227,490,459,72,66,819,791,110,915,447,0
19:39:14,6333.219,Fox,1610,138,46,32,22,21,10,7,1610,1564,1532,1227,490,459,72,66,819,791,110,915,447,0
19:39:14,6333.473,Fox,1610,138,44,34,22,21,10,7,1610,1566,1532,1227,490,459,72,66,819,791,110,915,447,0
19:39:14,6334.145,Fox,1610,137,44,34,22,21,10,6,1610,1566,1532,1227,490,459,71,66,819,791,110,915,448,0
19:39:15,6334.995,Fox,1610,137,42,36,22,21,10,6,1610,1568,1532,1227,490,459,71,66,819,791,110,915,448,0
19:39:15,6335.272,Fox,1610,137,40,38,22,21,10,6,1610,1570,1532,1227,490,459,71,66,819,791,110,915,448,0
19:39:15,6335.753,Fox,1610,137,38,40,22,21,10,6,1610,1572,1532,1227,490,459,71,66,819,791,110,915,448,0
19:39:15,6336.139,Fox,1610,137,36,42,22,21,10,6,1610,1574,1532,1227,490,459,71,66,819,791,110,915,448,0
19:39:15,6336.719,Fox,1610,137,34,44,22,21,10,6,1610,1576,1532,1227,490,459,71,66,819,791,110,915,448,0
19:39:15,6336.974,Fox,1610,135,34,44,22,19,10,6,1610,1576,1532,1227,490,459,71,64,819,791,110,917,448,0
19:39:16,6337.669,Fox,1612,137,36,44,22,19,10,6,1612,1576,1532,1227,490,459,72,65,820,792,110,917,448,0
19:39:16,6339.887,Fox,1614,139,36,44,21,20,10,6,1612,1576,1532,1228,490,459,73,66,821,793,110,917,448,0
19:39:17,6340.156,Fox,1614,138,38,44,21,19,10,6,1614,1576,1532,1228,490,459,73,65,821,793,110,918,448,0
19:39:17,6340.476,Fox,1614,137,38,44,21,18,10,6,1614,1576,1532,1228,490,459,72,65,821,793,110,919,448,0
19:39:17,6341.093,Fox,1614,137,38,44,19,20,10,6,1614,1576,1532,1230,490,459,72,65,821,793,110,919,448,0
19:39:17,6342.04,Fox,1614,137,38,44,19,18,12,6,1614,1576,1532,1230,492,459,72,65,821,793,110,919,448,0
19:39:17,6342.977,Fox,1616,139,38,44,17,20,12,6,1614,1576,1532,1232,492,459,73,66,822,794,110,919,448,0
19:39:18,6343.113,Fox,1616,139,40,44,17,20,12,6,1616,1576,1532,1232,492,459,73,66,822,794,110,919,448,0
19:39:18,6343.834,Fox,1616,139,40,42,19,20,12,6,1616,1576,1534,1232,492,459,73,66,822,794,110,919,448,0
19:39:18,6344.462,Fox,1616,138,40,42,19,20,12,5,1616,1576,1534,1232,492,459,72,66,822,794,110,919,449,0
19:39:18,6345.184,Fox,1618,140,42,42,19,20,12,5,1618,1576,1534,1232,492,459,74,66,824,794,110,919,449,0
19:39:18,6345.328,Fox,1618,140,42,40,21,20,12,5,1618,1576,1536,1232,492,459,74,66,824,794,110,919,449,0
19:39:18,6345.648,Fox,1618,140,42,40,19,22,12,5,1618,1576,1536,1234,492,459,74,66,824,794,110,919,449,0
19:39:18,6345.986,Fox,1618,140,42,40,19,21,13,5,1618,1576,1536,1234,493,459,74,66,824,794,110,919,449,0
19:39:19,6346.244,Fox,1618,140,42,40,18,22,13,5,1618,1576,1536,1235,493,459,74,66,824,794,110,919,449,0
19:39:19,6347.198,Fox,1618,140,42,36,22,22,13,5,1618,1576,1540,1235,493,459,74,66,824,794,110,919,449,0
19:39:19,6347.932,Fox,1620,141,44,36,21,22,13,5,1620,1576,1540,1235,493,459,75,66,826,794,110,920,449,0
19:39:19,6348.441,Fox,1620,141,44,32,25,22,13,5,1620,1576,1544,1235,493,459,75,66,826,794,110,920,449,0
19:39:19,6348.739,Fox,1620,141,44,30,27,22,13,5,1620,1576,1546,1235,493,459,75,66,826,794,110,920,449,0
19:39:19,6349.02,Fox,1620,141,44,30,25,24,13,5,1620,1576,1546,1237,493,459,75,66,826,794,110,920,449,0
19:39:20,6349.675,Fox,1620,141,44,28,27,24,13,5,1620,1576,1548,1237,493,459,75,66,826,794,110,920,449,0
19:39:20,6350.311,Fox,1620,140,44,28,27,23,13,5,1620,1576,1548,1237,493,459,74,66,826,794,110,921,449,0
19:39:20,6350.85,Fox,1620,139,44,28,27,23,13,4,1620,1576,1548,1237,493,459,73,66,826,794,110,921,450,0
19:39:20,6351.266,Fox,1622,141,46,26,29,23,13,4,1622,1576,1550,1237,493,459,74,67,827,795,110,921,450,0
19:39:20,6351.669,Fox,1622,139,46,24,31,21,13,4,1622,1576,1552,1237,493,459,74,65,827,795,110,923,450,0
19:39:20,6352.082,Fox,1622,138,44,26,31,21,13,3,1622,1578,1552,1237,493,459,74,64,827,795,110,923,451,0
19:39:21,6352.381,Fox,1622,138,44,24,33,21,13,3,1622,1578,1554,1237,493,459,74,64,827,795,110,923,451,0
19:39:21,6353.397,Fox,1622,136,44,24,33,19,13,3,1622,1578,1554,1237,493,459,74,62,827,795,110,925,451,0
19:39:21,6354.264,Fox,1622,135,44,24,33,19,13,2,1622,1578,1554,1237,493,459,74,61,827,795,110,925,452,0
19:39:21,6354.896,Fox,1622,135,42,26,33,19,13,2,1622,1580,1554,1237,493,459,74,61,827,795,110,925,452,0
19:39:22,6356.833,Fox,1622,134,42,26,33,18,13,2,1622,1580,1554,1237,493,459,74,60,827,795,110,926,452,0
19:39:23,6358.13,Fox,1626,136,44,28,31,18,12,3,1626,1582,1554,1237,493,460,75,61,830,796,110,928,452,0
19:39:23,6358.537,Fox,1626,136,44,28,29,18,14,3,1626,1582,1554,1239,495,460,75,61,830,796,110,928,452,0
19:39:23,6358.899,Fox,1626,136,42,30,29,18,14,3,1626,1584,1554,1239,495,460,75,61,830,796,110,928,452,0
19:39:23,6360.504,Fox,1626,136,40,32,29,18,14,3,1626,1586,1554,1239,495,460,75,61,830,796,110,928,452,0
19:39:24,6363.096,Fox,1626,136,40,30,31,18,14,3,1626,1586,1556,1239,495,460,75,61,830,796,110,928,452,0
19:39:24,6363.481,Fox,1626,136,40,26,33,20,14,3,1626,1586,1560,1241,495,460,75,61,830,796,110,928,452,0
19:39:24,6363.712,Fox,1626,136,40,24,35,20,14,3,1626,1586,1562,1241,495,460,75,61,830,796,110,928,452,0
19:39:26,6368.067,Fox,1626,136,38,26,35,20,14,3,1626,1588,1562,1241,495,460,75,61,830,796,110,928,452,0
19:39:26,6369.393,Fox,1628,138,38,24,37,20,14,3,1626,1588,1564,1241,495,460,75,63,830,798,110,928,452,0
19:39:26,6369.652,Fox,1628,138,40,24,37,18,16,3,1628,1588,1564,1241,497,460,75,63,830,798,110,928,452,0
19:39:27,6371.279,Fox,1628,138,40,24,36,17,18,3,1628,1588,1564,1242,499,460,75,63,830,798,110,928,452,0
19:39:27,6371.978,Fox,1628,138,40,22,38,17,18,3,1628,1588,1566,1242,499,460,75,63,830,798,110,928,452,0
19:39:27,6372.371,Fox,1628,137,40,22,38,17,18,2,1628,1588,1566,1242,499,460,74,63,830,798,110,928,453,0
19:39:28,6373.367,Fox,1628,137,40,20,40,17,18,2,1628,1588,1568,1242,499,460,74,63,830,798,110,928,453,0
19:39:28,6373.714,Fox,1628,137,40,18,42,17,18,2,1628,1588,1570,1242,499,460,74,63,830,798,110,928,453,0
19:39:28,6374.073,Fox,1628,135,40,18,42,15,18,2,1628,1588,1570,1242,499,460,72,63,830,798,110,930,453,0
19:39:28,6374.314,Fox,1628,135,40,16,44,15,18,2,1628,1588,1572,1242,499,460,72,63,830,798,110,930,453,0
19:39:28,6374.706,Fox,1630,137,40,14,46,15,18,2,1628,1588,1574,1242,499,460,74,63,832,798,110,930,453,0
19:39:28,6374.832,Fox,1630,137,42,14,46,15,18,2,1630,1588,1574,1242,499,460,74,63,832,798,110,930,453,0
19:39:28,6375.231,Fox,1630,137,42,12,48,15,18,2,1630,1588,1576,1242,499,460,74,63,832,798,110,930,453,0
19:39:29,6376.415,Fox,1630,137,40,14,48,15,18,2,1630,1590,1576,1242,499,460,74,63,832,798,110,930,453,0
19:39:29,6378.278,Fox,1630,137,38,16,48,15,18,2,1630,1592,1576,1242,499,460,74,63,832,798,110,930,453,0
19:39:29,6378.635,Fox,1630,137,38,16,48,15,16,4,1630,1592,1576,1242,499,462,74,63,832,798,110,930,453,0
19:39:30,6379.27,Fox,1630,137,36,18,48,15,16,4,1630,1594,1576,1242,499,462,74,63,832,798,110,930,453,0
19:39:30,6379.51,Fox,1630,137,36,18,46,17,16,4,1630,1594,1576,1244,499,462,74,63,832,798,110,930,453,0
19:39:30,6380.071,Fox,1630,137,36,18,46,15,18,4,1630,1594,1576,1244,501,462,74,63,832,798,110,930,453,0
19:39:30,6380.988,Fox,1632,139,38,18,46,15,18,4,1632,1594,1576,1244,501,462,75,64,833,799,110,930,453,0
19:39:30,6381.816,Fox,1632,138,38,18,46,14,18,4,1632,1594,1576,1244,501,462,75,63,833,799,110,931,453,0
19:39:31,6384.82,Fox,1634,140,40,18,46,14,18,4,1634,1594,1576,1244,501,462,76,64,834,800,110,931,453,0
19:39:32,6385.321,Fox,1634,140,38,20,46,14,18,4,1634,1596,1576,1244,501,462,76,64,834,800,110,931,453,0
19:39:32,6386.401,Fox,1636,141,40,20,45,14,18,4,1636,1596,1576,1244,501,462,77,64,836,800,110,932,453,0
19:39:33,6388.283,Fox,1638,143,42,20,45,13,19,4,1638,1596,1576,1244,502,462,79,64,838,800,110,932,453,0
19:39:33,6388.896,Fox,1638,143,40,22,45,13,19,4,1638,1598,1576,1244,502,462,79,64,838,800,110,932,453,0
19:39:33,6390.123,Fox,1638,142,40,22,45,12,19,4,1638,1598,1576,1244,502,462,79,63,838,800,110,933,453,0
19:39:33,6390.456,Fox,1638,142,38,22,47,12,19,4,1638,1600,1578,1244,502,462,79,63,838,800,110,933,453,0
19:39:34,6393.432,Fox,1638,142,38,20,49,12,19,4,1638,1600,1580,1244,502,462,79,63,838,800,110,933,453,0
19:39:34,6393.665,Fox,1638,142,38,20,47,14,19,4,1638,1600,1580,1246,502,462,79,63,838,800,110,933,453,0
19:39:35,6396.457,Fox,1638,142,38,18,49,14,19,4,1638,1600,1582,1246,502,462,79,63,838,800,110,933,453,0
19:39:35,6396.92,Fox,1640,143,40,18,48,14,19,4,1640,1600,1582,1246,502,462,80,63,840,800,110,934,453,0
19:39:36,6397.429,Fox,1640,143,40,16,50,14,19,4,1640,1600,1584,1246,502,462,80,63,840,800,110,934,453,0
19:39:36,6398.403,Fox,1642,144,42,16,49,14,19,4,1642,1600,1584,1246,502,462,79,65,840,802,110,935,453,0
19:39:36,6398.963,Fox,1642,144,42,14,51,14,19,4,1642,1600,1586,1246,502,462,79,65,840,802,110,935,453,0
19:39:36,6399.465,Fox,1644,146,44,14,51,14,19,4,1644,1600,1586,1246,502,462,79,67,840,804,110,935,453,0
19:39:37,6402.289,Fox,1646,148,46,14,51,14,19,4,1646,1600,1586,1246,502,462,80,68,841,805,110,935,453,0
19:39:37,6402.984,Fox,1648,149,48,14,50,14,19,4,1648,1600,1586,1246,502,462,79,70,841,807,110,936,453,0
19:39:38,6404.192,Fox,1648,147,48,14,50,12,19,4,1648,1600,1586,1246,502,462,77,70,841,807,110,938,453,0
19:39:38,6404.567,Fox,1648,147,46,16,48,14,17,6,1648,1602,1586,1248,502,464,77,70,841,807,110,938,453,0
19:39:38,6405.729,Fox,1648,147,46,16,46,16,17,6,1648,1602,1586,1250,502,464,77,70,841,807,110,938,453,0
19:39:38,6405.967,Fox,1648,147,44,18,46,16,17,6,1648,1604,1586,1250,502,464,77,70,841,807,110,938,453,0
19:39:39,6406.696,Fox,1648,147,44,16,48,16,17,6,1648,1604,1588,1250,502,464,77,70,841,807,110,938,453,0
19:39:39,6407.743,Fox,1648,147,44,16,44,20,17,6,1648,1604,1588,1254,502,464,77,70,841,807,110,938,453,0
19:39:39,6408.892,Fox,1648,147,44,16,42,22,17,6,1648,1604,1588,1256,502,464,77,70,841,807,110,938,453,0
19:39:40,6409.129,Fox,1648,147,44,16,40,24,17,6,1648,1604,1588,1258,502,464,77,70,841,807,110,938,453,0
19:39:40,6409.5,Fox,1650,148,46,16,39,24,17,6,1650,1604,1588,1258,502,464,77,71,842,808,110,939,453,0
19:39:40,6410.28,Fox,1652,150,46,16,38,25,17,6,1650,1604,1588,1259,502,464,79,71,844,808,110,939,453,0
19:39:40,6410.418,Fox,1652,150,48,16,38,25,17,6,1652,1604,1588,1259,502,464,79,71,844,808,110,939,453,0
19:39:40,6411.696,Fox,1654,152,48,16,37,26,17,6,1652,1604,1588,1260,502,464,81,71,846,808,110,939,453,0
19:39:40,6411.979,Fox,1654,152,50,16,35,28,17,6,1654,1604,1588,1262,502,464,81,71,846,808,110,939,453,0
19:39:41,6412.821,Fox,1654,152,50,16,33,30,17,6,1654,1604,1588,1264,502,464,81,71,846,808,110,939,453,0
19:39:41,6414.182,Fox,1654,152,48,18,33,30,17,6,1654,1606,1588,1264,502,464,81,71,846,808,110,939,453,0
19:39:41,6414.613,Fox,1656,154,50,18,33,30,17,6,1656,1606,1588,1264,502,464,82,72,847,809,110,939,453,0
19:39:41,6415.038,Fox,1656,152,48,18,35,28,17,6,1656,1608,1590,1264,502,464,82,70,847,809,110,941,453,0
19:39:42,6415.736,Fox,1658,153,48,20,34,28,17,6,1658,1610,1590,1264,502,464,83,70,849,809,110,942,453,0
19:39:42,6416.336,Fox,1658,151,48,20,34,24,19,6,1658,1610,1590,1264,504,464,82,69,849,809,110,944,453,0
19:39:42,6416.8,Fox,1658,151,48,18,36,24,19,6,1658,1610,1592,1264,504,464,82,69,849,809,110,944,453,0
19:39:42,6417.913,Fox,1658,151,48,16,38,24,18,7,1658,1610,1594,1264,504,465,82,69,849,809,110,944,453,0
19:39:43,6418.294,Fox,1658,150,48,16,38,24,18,6,1658,1610,1594,1264,504,465,81,69,849,809,110,944,454,0
19:39:43,6419.478,Fox,1658,148,48,16,38,22,18,6,1658,1610,1594,1264,504,465,80,68,849,809,110,946,454,0
19:39:43,6419.846,Fox,1660,147,48,16,38,19,18,6,1658,1610,1594,1264,504,465,78,69,850,810,110,949,454,0
19:39:43,6420.009,Fox,1660,147,50,16,38,19,18,6,1660,1610,1594,1264,504,465,78,69,850,810,110,949,454,0
19:39:43,6420.261,Fox,1660,147,48,18,38,19,18,6,1660,1612,1594,1264,504,465,78,69,850,810,110,949,454,0
19:39:43,6420.663,Fox,1660,147,48,18,38,19,16,8,1660,1612,1594,1264,504,467,78,69,850,810,110,949,454,0
19:39:44,6421.258,Fox,1662,149,50,18,38,19,16,8,1662,1612,1594,1264,504,467,79,70,851,811,110,949,454,0
19:39:44,6422.602,Fox,1662,148,48,20,38,19,16,7,1662,1614,1594,1264,504,467,78,70,851,811,110,949,455,0
19:39:44,6422.988,Fox,1662,148,48,20,38,18,17,7,1662,1614,1594,1264,505,467,78,70,851,811,110,949,455,0
19:39:44,6423.391,Fox,1662,146,48,20,38,16,17,7,1662,1614,1594,1264,505,467,77,69,851,811,110,951,455,0
19:39:44,6423.799,Fox,1662,146,48,18,38,18,17,7,1662,1614,1596,1266,505,467,77,69,851,811,110,951,455,0
19:39:44,6423.925,Fox,1662,146,48,18,35,21,17,7,1662,1614,1596,1269,505,467,77,69,851,811,110,951,455,0
19:39:45,6424.208,Fox,1662,146,48,18,34,22,17,7,1662,1614,1596,1270,505,467,77,69,851,811,110,951,455,0
19:39:45,6424.73,Fox,1662,146,48,18,34,20,19,7,1662,1614,1596,1270,507,467,77,69,851,811,110,951,455,0
19:39:45,6425.373,Fox,1664,148,50,18,34,20,19,7,1664,1614,1596,1270,507,467,77,71,851,813,110,951,455,0
19:39:45,6425.646,Fox,1664,148,48,20,34,20,19,7,1664,1616,1596,1270,507,467,77,71,851,813,110,951,455,0
19:39:45,6426.35,Fox,1666,149,50,20,34,19,19,7,1666,1616,1596,1270,507,467,76,73,851,815,110,952,455,0
19:39:46,6427.468,Fox,1666,149,50,18,36,19,19,7,1666,1616,1598,1270,507,467,76,73,851,815,110,952,455,0
19:39:46,6427.733,Fox,1666,149,48,20,36,19,19,7,1666,1618,1598,1270,507,467,76,73,851,815,110,952,455,0
19:39:46,6429.042,Fox,1666,147,48,18,38,19,19,5,1666,1618,1600,1270,507,467,75,72,851,815,110,952,457,0
19:39:46,6429.667,Fox,1666,147,48,18,36,21,19,5,1666,1618,1600,1272,507,467,75,72,851,815,110,952,457,0
19:39:47,6430.408,Fox,1666,147,46,20,36,21,19,5,1666,1620,1600,1272,507,467,75,72,851,815,110,952,457,0
19:39:47,6431.959,Fox,1668,149,48,20,36,21,19,5,1668,1620,1600,1272,507,467,76,73,852,816,110,952,457,0
19:39:47,6432.583,Fox,1668,149,48,20,34,23,19,5,1668,1620,1600,1274,507,467,76,73,852,816,110,952,457,0
19:39:48,6433.408,Fox,1670,151,50,20,34,23,19,5,1670,1620,1600,1274,507,467,77,74,853,817,110,952,457,0
19:39:48,6433.527,Fox,1670,150,50,20,34,22,19,5,1670,1620,1600,1274,507,467,77,73,853,817,110,953,457,0
19:39:48,6433.919,Fox,1670,150,48,22,32,24,19,5,1670,1622,1600,1276,507,467,77,73,853,817,110,953,457,0
19:39:48,6434.323,Fox,1670,150,48,22,30,26,19,5,1670,1622,1600,1278,507,467,77,73,853,817,110,953,457,0
19:39:48,6434.696,Fox,1672,150,48,22,29,25,19,5,1670,1622,1600,1278,507,467,78,72,855,817,110,955,457,0
19:39:48,6434.829,Fox,1672,149,50,22,27,26,19,5,1672,1622,1600,1280,507,467,77,72,855,817,110,956,457,0
19:39:48,6435.075,Fox,1672,149,50,22,25,28,19,5,1672,1622,1600,1282,507,467,77,72,855,817,110,956,457,0
19:39:48,6435.758,Fox,1672,149,50,22,23,30,19,5,1672,1622,1600,1284,507,467,77,72,855,817,110,956,457,0
19:39:49,6438.059,Fox,1672,149,50,22,23,30,17,7,1672,1622,1600,1284,507,469,77,72,855,817,110,956,457,0
19:39:49,6439.023,Fox,1672,149,50,22,23,28,19,7,1672,1622,1600,1284,509,469,77,72,855,817,110,956,457,0
19:39:50,6440.854,Fox,1672,148,46,26,23,28,19,6,1672,1626,1600,1284,509,469,76,72,855,817,110,956,458,0
19:39:51,6442.547,Fox,1672,148,46,26,23,26,21,6,1672,1626,1600,1284,511,469,76,72,855,817,110,956,458,0
19:39:51,6443.137,Fox,1672,147,46,24,25,25,21,6,1672,1626,1602,1284,511,469,76,71,855,817,110,957,458,0
19:39:51,6444.492,Fox,1672,145,46,22,27,23,21,6,1672,1626,1604,1284,511,469,76,69,855,817,110,959,458,0
19:39:51,6444.771,Fox,1672,143,46,22,27,22,21,5,1672,1626,1604,1284,511,469,74,69,855,817,110,960,459,0
19:39:52,6445.337,Fox,1672,141,46,22,27,20,21,5,1672,1626,1604,1284,511,469,73,68,855,817,110,962,459,0
19:39:52,6445.694,Fox,1672,139,46,22,27,18,21,5,1672,1626,1604,1284,511,469,73,66,855,817,110,964,459,0
19:39:52,6446.347,Fox,1672,137,46,22,27,16,21,5,1672,1626,1604,1284,511,469,72,65,855,817,112,964,459,0
19:39:53,6450.229,Fox,1674,139,48,22,27,16,21,5,1674,1626,1604,1284,511,469,74,65,857,817,112,964,459,0
19:39:54,6451.033,Fox,1676,141,48,22,25,18,21,5,1674,1626,1604,1286,511,469,76,65,859,817,112,964,459,0
19:39:54,6451.157,Fox,1676,141,50,22,25,18,21,5,1676,1626,1604,1286,511,469,76,65,859,817,112,964,459,0
19:39:54,6452.055,Fox,1676,141,48,24,25,16,23,5,1676,1628,1604,1286,513,469,76,65,859,817,112,964,459,0
19:39:54,6452.63,Fox,1676,141,48,22,27,16,23,5,1676,1628,1606,1286,513,469,76,65,859,817,112,964,459,0
19:39:54,6453.458,Fox,1676,141,48,20,29,16,23,5,1676,1628,1608,1286,513,469,76,65,859,817,112,964,459,0
19:39:54,6453.967,Fox,1676,141,48,18,29,18,23,5,1676,1628,1610,1288,513,469,76,65,859,817,112,964,459,0
19:39:55,6456.212,Fox,1678,143,50,18,29,18,23,5,1678,1628,1610,1288,513,469,77,66,860,818,112,964,459,0
19:39:56,6457.02,Fox,1680,145,52,18,28,19,23,5,1680,1628,1610,1289,513,469,78,67,861,819,112,964,459,0
19:39:56,6457.409,Fox,1680,145,50,20,28,19,23,5,1680,1630,1610,1289,513,469,78,67,861,819,112,964,459,0
19:39:56,6457.787,Fox,1682,147,52,20,28,19,23,5,1682,1630,1610,1289,513,469,80,67,863,819,112,964,459,0
19:39:56,6458.089,Fox,1684,149,54,20,26,21,23,5,1684,1630,1610,1291,513,469,80,69,863,821,112,964,459,0
19:39:56,6458.743,Fox,1684,149,54,18,28,21,23,5,1684,1630,1612,1291,513,469,80,69,863,821,112,964,459,0
19:39:56,6459.527,Fox,1684,149,54,18,26,23,23,5,1684,1630,1612,1293,513,469,80,69,863,821,112,964,459,0
19:39:57,6461.101,Fox,1686,151,56,16,28,23,23,5,1686,1630,1614,1293,513,469,80,71,863,823,112,964,459,0
19:39:57,6461.499,Fox,1686,150,56,16,28,22,23,5,1686,1630,1614,1293,513,469,80,70,863,823,112,965,459,0
19:39:58,6463.042,Fox,1688,151,58,16,27,22,23,5,1688,1630,1614,1293,513,469,80,71,864,824,112,966,459,0
19:39:58,6463.531,Fox,1688,151,56,18,27,22,23,5,1688,1632,1614,1293,513,469,80,71,864,824,112,966,459,0
19:39:58,6464.137,Fox,1688,151,56,16,29,22,23,5,1688,1632,1616,1293,513,469,80,71,864,824,112,966,459,0
19:39:59,6466.274,Fox,1688,151,56,14,31,22,23,5,1688,1632,1618,1293,513,469,80,71,864,824,112,966,459,0
19:39:59,6467.105,Fox,1688,151,56,14,29,24,23,5,1688,1632,1618,1295,513,469,80,71,864,824,112,966,459,0
19:39:59,6467.354,Fox,1688,151,54,16,29,24,23,5,1688,1634,1618,1295,513,469,80,71,864,824,112,966,459,0
19:39:59,6468.572,Fox,1688,150,54,16,29,23,23,5,1688,1634,1618,1295,513,469,80,70,864,824,112,967,459,0
19:39:59,6468.958,Fox,1688,150,52,16,31,23,23,5,1688,1636,1620,1295,513,469,80,70,864,824,112,967,459,0
19:40:00,6470.052,Fox,1688,148,52,16,31,21,23,5,1688,1636,1620,1295,513,469,79,69,864,824,112,969,459,0
19:40:00,6470.789,Fox,1688,148,50,18,31,21,23,5,1688,1638,1620,1295,513,469,79,69,864,824,112,969,459,0
19:40:01,6472.266,Fox,1688,148,50,16,33,21,23,5,1688,1638,1622,1295,513,469,79,69,864,824,112,969,459,0
19:40:01,6473.014,Fox,1688,148,50,16,33,20,24,5,1688,1638,1622,1295,514,469,79,69,864,824,112,969,459,0
19:40:01,6474.605,Fox,1690,150,52,16,33,20,24,5,1690,1638,1622,1295,514,469,79,71,864,826,112,969,459,0
19:40:02,6475.47,Fox,1692,152,54,16,31,22,24,5,1692,1638,1622,1297,514,469,80,72,865,827,112,969,459,0
19:40:02,6477.2,Fox,1692,152,54,16,29,24,24,5,1692,1638,1622,1299,514,469,80,72,865,827,112,969,459,0
19:40:02,6477.6,Fox,1692,150,54,16,29,22,24,5,1692,1638,1622,1299,514,469,79,71,865,827,112,971,459,0
19:40:03,6478.423,Fox,1692,150,54,16,27,24,24,5,1692,1638,1622,1301,514,469,79,71,865,827,112,971,459,0
19:40:03,6479.324,Fox,1694,151,56,12,30,24,24,5,1694,1638,1626,1301,514,469,79,72,866,828,112,972,459,0
19:40:03,6479.485,Fox,1694,151,54,14,30,24,22,7,1694,1640,1626,1301,514,471,79,72,866,828,112,972,459,0
19:40:03,6480.916,Fox,1694,151,52,16,30,24,22,7,1694,1642,1626,1301,514,471,79,72,866,828,112,972,459,0
19:40:04,6482.044,Fox,1694,151,50,18,30,24,22,7,1694,1644,1626,1301,514,471,79,72,866,828,112,972,459,0
19:40:04,6483.335,Fox,1694,151,50,18,30,24,21,8,1694,1644,1626,1301,514,472,79,72,866,828,112,972,459,0
19:40:05,6484.391,Fox,1694,151,50,18,28,26,21,8,1694,1644,1626,1303,514,472,79,72,866,828,112,972,459,0
19:40:05,6484.865,Fox,1694,151,48,20,28,26,21,8,1694,1646,1626,1303,514,472,79,72,866,828,112,972,459,0
19:40:05,6485.548,Fox,1694,151,46,22,28,26,21,8,1694,1648,1626,1303,514,472,79,72,866,828,112,972,459,0
19:40:05,6485.943,Fox,1694,149,46,22,28,24,21,8,1694,1648,1626,1303,514,472,78,71,866,828,112,974,459,0
19:40:06,6487.908,Fox,1694,147,46,22,27,23,21,8,1694,1648,1626,1304,514,472,77,70,866,828,112,976,459,0
19:40:06,6488.324,Fox,1696,149,48,22,27,23,21,8,1696,1648,1626,1304,514,472,77,72,866,830,112,976,459,0
19:40:06,6489.094,Fox,1698,151,50,22,27,23,21,8,1698,1648,1626,1304,514,472,78,73,867,831,112,976,459,0
19:40:06,6489.506,Fox,1698,150,50,22,25,25,21,7,1698,1648,1626,1306,514,472,77,73,867,831,112,976,460,0
19:40:07,6490.624,Fox,1698,150,50,20,27,25,21,7,1698,1648,1628,1306,514,472,77,73,867,831,112,976,460,0
19:40:07,6491.147,Fox,1702,153,52,20,26,25,21,7,1700,1648,1628,1306,514,472,79,74,870,832,112,977,460,0
19:40:07,6491.321,Fox,1702,153,54,20,26,25,21,7,1702,1648,1628,1306,514,472,79,74,870,832,112,977,460,0
19:40:07,6491.778,Fox,1704,155,56,20,26,25,21,7,1704,1648,1628,1306,514,472,79,76,870,834,112,977,460,0
19:40:07,6492.087,Fox,1704,155,54,22,26,25,21,7,1704,1650,1628,1306,514,472,79,76,870,834,112,977,460,0
19:40:07,6492.917,Fox,1704,155,52,24,26,25,21,7,1704,1652,1628,1306,514,472,79,76,870,834,112,977,460,0
19:40:08,6494.402,Fox,1704,155,50,26,26,25,21,7,1704,1654,1628,1306,514,472,79,76,870,834,112,977,460,0
19:40:08,6495.096,Fox,1704,153,50,26,26,24,21,6,1704,1654,1628,1306,514,472,79,74,870,834,112,978,461,0
19:40:08,6495.368,Fox,1706,155,52,26,26,24,21,6,1706,1654,1628,1306,514,472,81,74,872,834,112,978,461,0
19:40:08,6495.935,Fox,1706,155,52,24,28,24,19,8,1706,1654,1630,1306,514,474,81,74,872,834,112,978,461,0
19:40:09,6497.171,Fox,1706,155,50,26,28,24,19,8,1706,1656,1630,1306,514,474,81,74,872,834,112,978,461,0
19:40:09,6498.266,Fox,1706,155,48,28,28,24,19,8,1706,1658,1630,1306,514,474,81,74,872,834,112,978,461,0
19:40:09,6498.557,Fox,1706,154,48,28,28,23,19,8,1706,1658,1630,1306,514,474,81,73,872,834,112,979,461,0
19:40:10,6500.027,Fox,1706,152,48,28,28,21,19,8,1706,1658,1630,1306,514,474,80,72,872,834,112,981,461,0
19:40:10,6501.346,Fox,1706,151,48,28,28,17,23,7,1706,1658,1630,1306,518,474,80,71,872,834,112,981,462,0
19:40:11,6502.083,Fox,1706,151,48,26,30,17,23,7,1706,1658,1632,1306,518,474,80,71,872,834,112,981,462,0
19:40:11,6502.669,Fox,1708,152,46,28,29,17,23,7,1706,1660,1632,1306,518,474,80,72,873,835,112,982,462,0
19:40:11,6502.974,Fox,1710,153,48,28,28,17,23,7,1708,1660,1632,1306,518,474,80,73,874,836,112,983,462,0
19:40:11,6503.138,Fox,1710,153,50,28,28,17,23,7,1710,1660,1632,1306,518,474,80,73,874,836,112,983,462,0
19:40:11,6503.598,Fox,1710,153,50,28,26,19,23,7,1710,1660,1632,1308,518,474,80,73,874,836,112,983,462,0
19:40:11,6503.864,Fox,1710,153,48,30,26,19,23,7,1710,1662,1632,1308,518,474,80,73,874,836,112,983,462,0
19:40:11,6504.943,Fox,1710,153,48,30,25,20,23,7,1710,1662,1632,1309,518,474,80,73,874,836,112,983,462,0
19:40:12,6505.448,Fox,1710,153,48,30,25,18,25,7,1710,1662,1632,1309,520,474,80,73,874,836,112,983,462,0
19:40:12,6505.949,Fox,1710,153,48,28,27,18,25,7,1710,1662,1634,1309,520,474,80,73,874,836,112,983,462,0
19:40:12,6507.112,Fox,1710,153,48,28,27,18,23,9,1710,1662,1634,1309,520,476,80,73,874,836,112,983,462,0
19:40:12,6507.636,Fox,1712,155,48,26,29,18,23,9,1710,1662,1636,1309,520,476,80,75,874,838,112,983,462,0
19:40:13,6507.93,Fox,1714,156,48,28,28,18,23,9,1712,1664,1636,1309,520,476,79,77,874,840,112,984,462,0
19:40:13,6508.081,Fox,1714,156,50,28,28,18,23,9,1714,1664,1636,1309,520,476,79,77,874,840,112,984,462,0
19:40:13,6508.514,Fox,1714,155,50,28,28,18,23,8,1714,1664,1636,1309,520,476,78,77,874,840,112,984,463,0
19:40:13,6508.946,Fox,1714,155,48,30,28,18,21,10,1714,1666,1636,1309,520,478,78,77,874,840,112,984,463,0
19:40:13,6509.332,Fox,1714,155,48,28,30,18,21,10,1714,1666,1638,1309,520,478,78,77,874,840,112,984,463,0
19:40:14,6510.905,Fox,1716,156,50,28,29,18,21,10,1716,1666,1638,1309,520,478,78,78,875,841,112,985,463,0
19:40:14,6513.235,Fox,1716,156,50,28,27,20,21,10,1716,1666,1638,1311,520,478,78,78,875,841,112,985,463,0
19:40:14,6513.634,Fox,1718,158,52,28,27,20,21,10,1718,1666,1638,1311,520,478,78,80,875,843,112,985,463,0
19:40:15,6514.16,Fox,1718,156,52,28,26,19,21,10,1718,1666,1638,1312,520,478,77,79,875,843,112,987,463,0
19:40:15,6514.589,Fox,1718,156,50,30,24,21,21,10,1718,1668,1638,1314,520,478,77,79,875,843,112,987,463,0
19:40:15,6515.515,Fox,1718,155,50,30,24,20,21,10,1718,1668,1638,1314,520,478,77,78,875,843,112,988,463,0
19:40:15,6515.978,Fox,1720,156,50,32,23,20,21,10,1720,1670,1638,1314,520,478,76,80,875,845,112,989,463,0
19:40:16,6517.052,Fox,1720,156,50,32,23,18,23,10,1720,1670,1638,1314,522,478,76,80,875,845,112,989,463,0
19:40:16,6517.558,Fox,1720,156,48,34,23,17,22,12,1720,1672,1638,1314,523,480,76,80,875,845,112,989,463,0
19:40:16,6517.985,Fox,1720,156,48,32,25,17,22,12,1720,1672,1640,1314,523,480,76,80,875,845,112,989,463,0
19:40:16,6519.381,Fox,1720,156,48,30,25,19,22,12,1720,1672,1642,1316,523,480,76,80,875,845,112,989,463,0
19:40:16,6519.634,Fox,1720,155,48,30,25,19,22,11,1720,1672,1642,1316,523,480,75,80,875,845,112,989,464,0
19:40:17,6520.551,Fox,1720,155,48,28,27,19,22,11,1720,1672,1644,1316,523,480,75,80,875,845,112,989,464,0
19:40:17,6521.601,Fox,1720,155,48,28,26,20,22,11,1720,1672,1644,1317,523,480,75,80,875,845,112,989,464,0
19:40:18,6523.29,Fox,1720,155,48,26,28,18,24,11,1720,1672,1646,1317,525,480,75,80,875,845,112,989,464,0
19:40:18,6524.067,Fox,1720,155,48,24,30,18,24,11,1720,1672,1648,1317,525,480,75,80,875,845,112,989,464,0
19:40:18,6524.682,Fox,1720,155,48,24,29,19,24,11,1720,1672,1648,1318,525,480,75,80,875,845,112,989,464,0
19:40:18,6525.824,Fox,1720,155,48,24,29,19,23,12,1720,1672,1648,1318,525,481,75,80,875,845,112,989,464,0
19:40:19,6526.108,Fox,1720,155,48,24,29,18,24,12,1720,1672,1648,1318,526,481,75,80,875,845,112,989,464,0
19:40:19,6526.721,Fox,1720,155,48,24,28,19,24,12,1720,1672,1648,1319,526,481,75,80,875,845,112,989,464,0
19:40:19,6527.96,Fox,1722,156,50,24,28,17,25,12,1722,1672,1648,1319,527,481,75,81,876,846,112,990,464,0
19:40:20,6529.445,Fox,1722,156,50,24,27,18,25,12,1722,1672,1648,1320,527,481,75,81,876,846,112,990,464,0
19:40:20,6529.826,Fox,1722,154,50,24,27,16,25,12,1722,1672,1648,1320,527,481,74,80,876,846,112,992,464,0
19:40:20,6530.427,Fox,1724,156,52,24,27,16,25,12,1724,1672,1648,1320,527,481,75,81,877,847,112,992,464,0
19:40:20,6530.565,Fox,1724,156,52,22,29,16,25,12,1724,1672,1650,1320,527,481,75,81,877,847,112,992,464,0
19:40:20,6531.389,Fox,1728,160,54,22,29,16,25,12,1726,1672,1650,1320,527,481,76,84,878,850,112,992,464,0
19:40:20,6531.53,Fox,1728,160,56,20,31,16,25,12,1728,1672,1652,1320,527,481,76,84,878,850,112,992,464,0
19:40:21,6532.182,Fox,1730,161,58,20,31,15,25,12,1730,1672,1652,1320,527,481,77,84,879,851,112,993,464,0
19:40:21,6532.761,Fox,1736,167,58,22,31,15,25,12,1732,1674,1652,1320,527,481,80,87,882,854,112,993,464,0
19:40:21,6532.942,Fox,1736,167,62,20,31,17,25,12,1736,1674,1654,1322,527,481,80,87,882,854,112,993,464,0
19:40:21,6533.714,Fox,1736,167,60,22,31,17,25,12,1736,1676,1654,1322,527,481,80,87,882,854,112,993,464,0
19:40:22,6535.175,Fox,1736,166,60,22,31,16,25,12,1736,1676,1654,1322,527,481,80,86,882,854,112,994,464,0
19:40:22,6535.679,Fox,1736,166,60,20,33,16,25,12,1736,1676,1656,1322,527,481,80,86,882,854,112,994,464,0
19:40:22,6536.846,Fox,1736,166,60,18,35,16,25,12,1736,1676,1658,1322,527,481,80,86,882,854,112,994,464,0
19:40:22,6537.605,Fox,1738,167,62,18,34,16,25,12,1738,1676,1658,1322,527,481,79,88,882,856,112,995,464,0
19:40:22,6537.779,Fox,1738,166,62,18,34,16,25,11,1738,1676,1658,1322,527,481,78,88,882,856,112,995,465,0
19:40:23,6538.923,Fox,1738,165,60,20,34,16,25,10,1738,1678,1658,1322,527,481,77,88,882,856,112,995,466,0
19:40:23,6539.763,Fox,1738,165,58,22,31,19,25,10,1738,1680,1658,1325,527,481,77,88,882,856,112,995,466,0
19:40:23,6540.238,Fox,1740,166,60,22,31,18,25,10,1740,1680,1658,1325,527,481,77,89,883,857,112,996,466,0
19:40:23,6540.432,Fox,1740,166,58,24,31,18,25,10,1740,1682,1658,1325,527,481,77,89,883,857,112,996,466,0
19:40:23,6540.779,Fox,1740,166,56,26,31,18,25,10,1740,1684,1658,1325,527,481,77,89,883,857,112,996,466,0
19:40:24,6541.104,Fox,1740,166,56,24,33,18,25,10,1740,1684,1660,1325,527,481,77,89,883,857,112,996,466,0
19:40:24,6541.979,Fox,1744,168,58,24,32,17,25,10,1742,1684,1660,1325,527,481,75,93,883,861,112,998,466,0
19:40:24,6542.131,Fox,1744,168,60,24,32,17,25,10,1744,1684,1660,1325,527,481,75,93,883,861,112,998,466,0
19:40:24,6542.411,Fox,1744,168,60,22,34,17,25,10,1744,1684,1662,1325,527,481,75,93,883,861,112,998,466,0
19:40:24,6543.756,Fox,1744,168,58,24,34,17,25,10,1744,1686,1662,1325,527,481,75,93,883,861,112,998,466,0
19:40:25,6544.442,Fox,1744,168,58,24,34,16,26,10,1744,1686,1662,1325,528,481,75,93,883,861,112,998,466,0
19:40:25,6545.533,Fox,1748,170,60,24,32,16,26,10,1746,1686,1662,1325,528,481,75,95,885,863,112,1000,466,0
19:40:25,6545.681,Fox,1748,170,60,26,32,16,26,10,1748,1688,1662,1325,528,481,75,95,885,863,112,1000,466,0
19:40:25,6546.151,Fox,1748,169,60,26,32,16,26,9,1748,1688,1662,1325,528,481,74,95,885,863,112,1000,467,0
19:40:25,6546.436,Fox,1748,169,60,24,34,16,26,9,1748,1688,1664,1325,528,481,74,95,885,863,112,1000,467,0
19:40:26,6547.041,Fox,1750,170,62,24,33,16,26,9,1750,1688,1664,1325,528,481,74,96,886,864,112,1001,467,0
19:40:26,6547.362,Fox,1750,169,62,22,35,14,28,8,1750,1688,1666,1325,530,481,74,95,886,864,112,1001,468,0
19:40:26,6547.831,Fox,1750,168,62,22,35,14,28,7,1750,1688,1666,1325,530,481,73,95,886,864,112,1001,469,0
19:40:26,6548.775,Fox,1750,167,62,22,35,14,28,6,1750,1688,1666,1325,530,481,73,94,886,864,112,1001,470,0
19:40:27,6550.18,Fox,1750,165,62,22,35,12,28,6,1750,1688,1666,1325,530,481,72,93,886,864,112,1003,470,0
19:40:27,6550.446,Fox,1750,165,62,22,35,11,29,6,1750,1688,1666,1325,531,481,72,93,886,864,112,1003,470,0
19:40:27,6551.166,Fox,1750,165,62,22,33,13,29,6,1750,1688,1666,1327,531,481,72,93,886,864,112,1003,470,0
19:40:27,6551.43,Fox,1750,165,62,22,33,12,30,6,1750,1688,1666,1327,532,481,72,93,886,864,112,1003,470,0
19:40:28,6553.042,Fox,1750,165,62,20,35,12,30,6,1750,1688,1668,1327,532,481,72,93,886,864,112,1003,470,0
19:40:28,6553.979,Fox,1752,166,62,20,35,12,27,8,1750,1688,1668,1327,532,483,72,94,887,865,112,1004,470,0
19:40:28,6554.265,Fox,1754,167,66,20,34,12,27,8,1754,1688,1668,1327,532,483,73,94,889,865,112,1005,470,0
19:40:28,6554.549,Fox,1754,167,66,18,36,12,27,8,1754,1688,1670,1327,532,483,73,94,889,865,112,1005,470,0
19:40:28,6555.875,Fox,1754,167,66,16,38,12,27,8,1754,1688,1672,1327,532,483,73,94,889,865,112,1005,470,0
19:40:29,6556.445,Fox,1754,167,66,16,36,14,27,8,1754,1688,1672,1329,532,483,73,94,889,865,112,1005,470,0
19:40:29,6557.168,Fox,1754,167,64,18,36,14,27,8,1754,1690,1672,1329,532,483,73,94,889,865,112,1005,470,0
19:40:29,6557.432,Fox,1754,166,64,18,36,14,27,7,1754,1690,1672,1329,532,483,73,93,889,865,112,1005,471,0
19:40:29,6558.009,Fox,1754,166,62,20,36,14,27,7,1754,1692,1672,1329,532,483,73,93,889,865,112,1005,471,0
19:40:29,6558.725,Fox,1756,168,64,20,36,14,27,7,1756,1692,1672,1329,532,483,73,95,889,867,112,1005,471,0
19:40:30,6559.189,Fox,1756,167,64,20,36,14,27,6,1756,1692,1672,1329,532,483,72,95,889,867,112,1005,472,0
19:40:30,6560.497,Fox,1756,167,64,20,36,14,26,7,1756,1692,1672,1329,532,484,72,95,889,867,112,1005,472,0
19:40:30,6560.9,Fox,1756,166,64,20,36,14,25,7,1756,1692,1672,1329,532,484,72,94,889,867,112,1006,472,0
19:40:30,6561.76,Fox,1758,166,64,20,36,12,25,7,1756,1692,1672,1329,532,484,73,93,890,868,112,1008,472,0
19:40:31,6561.927,Fox,1758,166,64,22,36,12,25,7,1758,1694,1672,1329,532,484,73,93,890,868,112,1008,472,0
19:40:31,6562.237,Fox,1758,166,64,22,36,12,23,9,1758,1694,1672,1329,532,486,73,93,890,868,112,1008,472,0
19:40:31,6562.556,Fox,1758,166,64,22,35,13,23,9,1758,1694,1672,1330,532,486,73,93,890,868,112,1008,472,0
19:40:32,6566.388,Fox,1758,166,64,22,34,14,23,9,1758,1694,1672,1331,532,486,73,93,890,868,112,1008,472,0
19:40:32,6566.918,Fox,1758,164,64,22,34,12,23,9,1758,1694,1672,1331,532,486,71,93,890,868,112,1010,472,0
19:40:32,6567.511,Fox,1760,166,66,22,34,12,23,9,1760,1694,1672,1331,532,486,72,94,891,869,112,1010,472,0
19:40:33,6567.955,Fox,1760,166,66,22,33,13,23,9,1760,1694,1672,1332,532,486,72,94,891,869,112,1010,472,0
19:40:34,6570.898,Fox,1760,166,64,24,33,13,23,9,1760,1696,1672,1332,532,486,72,94,891,869,112,1010,472,0
19:40:34,6571.33,Fox,1760,166,64,22,35,13,23,9,1760,1696,1674,1332,532,486,72,94,891,869,112,1010,472,0
19:40:34,6571.593,Fox,1760,166,62,24,35,13,23,9,1760,1698,1674,1332,532,486,72,94,891,869,112,1010,472,0
19:40:34,6571.86,Fox,1760,166,62,24,35,11,25,9,1760,1698,1674,1332,534,486,72,94,891,869,112,1010,472,0
19:40:34,6572.304,Fox,1760,166,62,22,37,11,25,9,1760,1698,1676,1332,534,486,72,94,891,869,112,1010,472,0
19:40:34,6573.19,Fox,1760,165,62,22,37,10,25,9,1760,1698,1676,1332,534,486,72,93,891,869,112,1011,472,0
19:40:35,6573.919,Fox,1760,164,58,26,37,10,25,8,1760,1702,1676,1332,534,486,72,92,891,869,112,1011,473,0
19:40:35,6574.346,Fox,1760,164,56,28,37,10,25,8,1760,1704,1676,1332,534,486,72,92,891,869,112,1011,473,0
19:40:35,6574.874,Fox,1762,166,58,28,37,10,25,8,1762,1704,1676,1332,534,486,73,93,892,870,112,1011,473,0
19:40:35,6576.464,Fox,1762,166,58,28,37,10,23,10,1762,1704,1676,1332,534,488,73,93,892,870,112,1011,473,0
19:40:36,6577.105,Fox,1764,167,58,28,37,9,23,10,1762,1704,1676,1332,534,488,75,92,894,870,112,1012,473,0
19:40:36,6577.243,Fox,1764,167,60,26,39,9,23,10,1764,1704,1678,1332,534,488,75,92,894,870,112,1012,473,0
19:40:36,6577.955,Fox,1766,168,60,28,38,8,24,10,1766,1706,1678,1332,535,488,76,92,896,870,112,1013,473,0
19:40:36,6578.114,Fox,1766,168,60,26,40,8,24,10,1766,1706,1680,1332,535,488,76,92,896,870,112,1013,473,0
19:40:36,6578.542,Fox,1766,167,60,26,39,8,24,10,1766,1706,1680,1333,535,488,75,92,896,870,112,1014,473,0
19:40:36,6578.855,Fox,1766,167,60,24,41,8,24,10,1766,1706,1682,1333,535,488,75,92,896,870,112,1014,473,0
19:40:36,6579.306,Fox,1766,166,60,22,43,8,24,9,1766,1706,1684,1333,535,488,75,91,896,870,112,1014,474,0
19:40:37,6580.068,Fox,1766,166,60,22,41,10,22,11,1766,1706,1684,1335,535,490,75,91,896,870,112,1014,474,0
19:40:37,6580.342,Fox,1768,167,62,22,40,10,22,11,1768,1706,1684,1335,535,490,76,91,898,870,112,1015,474,0
19:40:37,6581.074,Fox,1768,167,62,22,38,12,22,11,1768,1706,1684,1337,535,490,76,91,898,870,112,1015,474,0
19:40:37,6581.856,Fox,1770,169,64,22,38,12,22,11,1770,1706,1684,1337,535,490,78,91,900,870,112,1015,474,0
19:40:37,6582.166,Fox,1770,169,64,20,40,12,22,11,1770,1706,1686,1337,535,490,78,91,900,870,112,1015,474,0
19:40:38,6583.808,Fox,1772,171,66,20,40,12,22,11,1772,1706,1686,1337,535,490,79,92,901,871,112,1015,474,0
19:40:38,6584.131,Fox,1774,173,66,18,41,13,22,11,1772,1706,1688,1338,535,490,80,93,902,872,112,1015,474,0
19:40:38,6584.296,Fox,1774,173,68,18,41,13,22,11,1774,1706,1688,1338,535,490,80,93,902,872,112,1015,474,0
19:40:38,6584.593,Fox,1774,173,68,18,39,15,22,11,1774,1706,1688,1340,535,490,80,93,902,872,112,1015,474,0
19:40:38,6585.427,Fox,1774,173,66,20,39,15,22,11,1774,1708,1688,1340,535,490,80,93,902,872,112,1015,474,0
19:40:38,6585.741,Fox,1774,173,64,22,39,15,22,11,1774,1710,1688,1340,535,490,80,93,902,872,112,1015,474,0
19:40:39,6588.083,Fox,1776,174,66,22,38,15,22,11,1776,1710,1688,1340,535,490,80,94,903,873,113,1015,474,0
19:40:40,6589.567,Fox,1776,174,66,22,38,15,20,13,1776,1710,1688,1340,535,492,80,94,903,873,113,1015,474,0
19:40:40,6590.396,Fox,1776,174,64,24,38,15,20,13,1776,1712,1688,1340,535,492,80,94,903,873,113,1015,474,0
19:40:40,6590.705,Fox,1776,174,62,26,38,15,20,13,1776,1714,1688,1340,535,492,80,94,903,873,113,1015,474,0
19:40:40,6591.117,Fox,1776,174,62,26,36,17,20,13,1776,1714,1688,1342,535,492,80,94,903,873,113,1015,474,0
19:40:40,6591.559,Fox,1776,172,62,26,36,15,20,13,1776,1714,1688,1342,535,492,80,92,903,873,113,1017,474,0
19:40:41,6592.008,Fox,1776,172,62,26,34,17,20,13,1776,1714,1688,1344,535,492,80,92,903,873,113,1017,474,0
19:40:41,6592.454,Fox,1780,175,64,26,33,17,20,13,1778,1714,1688,1344,535,492,83,92,907,873,113,1018,474,0
19:40:41,6592.602,Fox,1780,175,66,26,33,17,20,13,1780,1714,1688,1344,535,492,83,92,907,873,113,1018,474,0
19:40:41,6593.475,Fox,1780,175,64,28,31,19,20,13,1780,1716,1688,1346,535,492,83,92,907,873,113,1018,474,0
19:40:41,6594.276,Fox,1782,176,66,28,31,19,20,12,1782,1716,1688,1346,535,492,83,93,907,875,113,1018,475,0
19:40:41,6594.632,Fox,1784,176,68,28,30,18,20,12,1784,1716,1688,1346,535,492,83,93,908,876,113,1020,475,0
19:40:42,6595.117,Fox,1784,174,68,28,30,16,20,12,1784,1716,1688,1346,535,492,83,91,908,876,113,1022,475,0
19:40:42,6595.649,Fox,1784,174,68,26,32,16,20,12,1784,1716,1690,1346,535,492,83,91,908,876,113,1022,475,0
19:40:42,6596.263,Fox,1784,174,66,28,30,18,20,12,1784,1718,1690,1348,535,492,83,91,908,876,113,1022,475,0
19:40:42,6596.588,Fox,1784,174,66,26,32,18,20,12,1784,1718,1692,1348,535,492,83,91,908,876,113,1022,475,0
19:40:42,6597.372,Fox,1784,174,66,26,31,19,20,12,1784,1718,1692,1349,535,492,83,91,908,876,113,1022,475,0
19:40:43,6598.521,Fox,1784,174,64,28,31,19,20,12,1784,1720,1692,1349,535,492,83,91,908,876,113,1022,475,0
19:40:43,6599.583,Fox,1784,173,64,28,31,19,20,11,1784,1720,1692,1349,535,492,82,91,908,876,113,1022,476,0
19:40:43,6600.47,Fox,1784,173,64,26,33,19,20,11,1784,1720,1694,1349,535,492,82,91,908,876,113,1022,476,0
19:40:44,6601.586,Fox,1784,171,64,26,31,19,20,11,1784,1720,1694,1351,535,492,81,90,908,876,113,1024,476,0
19:40:44,6602.541,Fox,1784,169,64,26,31,17,20,11,1784,1720,1694,1351,535,492,79,90,908,876,113,1026,476,0
19:40:44,6602.838,Fox,1784,169,64,26,30,18,20,11,1784,1720,1694,1352,535,492,79,90,908,876,113,1026,476,0
19:40:45,6604.032,Fox,1784,167,64,26,30,16,20,11,1784,1720,1694,1352,535,492,77,90,908,876,115,1026,476,0
19:40:45,6606.271,Fox,1784,166,64,26,30,16,20,10,1784,1720,1694,1352,535,492,77,89,908,876,115,1026,477,0
19:40:46,6606.938,Fox,1784,164,64,26,28,14,22,10,1784,1720,1694,1354,537,492,76,88,908,876,115,1028,477,0
19:40:46,6607.458,Fox,1784,164,64,26,28,13,23,10,1784,1720,1694,1354,538,492,76,88,908,876,115,1028,477,0
19:40:46,6608.064,Fox,1784,164,64,26,26,13,25,10,1784,1720,1694,1356,540,492,76,88,908,876,115,1028,477,0
19:40:46,6609.498,Fox,1784,164,64,24,28,13,25,10,1784,1720,1696,1356,540,492,76,88,908,876,115,1028,477,0
19:40:47,6610.222,Fox,1784,163,64,22,30,13,25,9,1784,1720,1698,1356,540,492,76,87,908,876,115,1028,478,0
19:40:47,6610.519,Fox,1784,163,62,24,30,13,24,10,1784,1722,1698,1356,540,493,76,87,908,876,115,1028,478,0
19:40:47,6612.372,Fox,1786,165,64,20,34,13,24,10,1786,1722,1702,1356,540,493,77,88,909,877,115,1028,478,0
19:40:48,6613.024,Fox,1786,165,62,20,36,13,24,10,1786,1724,1704,1356,540,493,77,88,909,877,115,1028,478,0
19:40:48,6613.503,Fox,1786,164,62,20,35,13,24,10,1786,1724,1704,1357,540,493,77,87,909,877,115,1029,478,0
19:40:48,6614.168,Fox,1786,164,58,24,35,13,24,10,1786,1728,1704,1357,540,493,77,87,909,877,115,1029,478,0
19:40:48,6614.631,Fox,1788,165,60,24,34,13,24,10,1788,1728,1704,1357,540,493,77,88,910,878,115,1030,478,0
19:40:48,6614.777,Fox,1788,165,58,26,34,13,24,10,1788,1730,1704,1357,540,493,77,88,910,878,115,1030,478,0
19:40:48,6615.065,Fox,1788,165,58,26,32,15,24,10,1788,1730,1704,1359,540,493,77,88,910,878,115,1030,478,0
19:40:48,6615.55,Fox,1788,165,52,32,32,15,24,10,1788,1736,1704,1359,540,493,77,88,910,878,115,1030,478,0
19:40:49,6616.439,Fox,1788,165,52,30,34,15,24,10,1788,1736,1706,1359,540,493,77,88,910,878,115,1030,478,0
19:40:49,6617.502,Fox,1788,163,52,30,34,13,24,10,1788,1736,1706,1359,540,493,77,86,910,878,115,1032,478,0
19:40:49,6618.479,Fox,1788,161,52,30,34,11,24,10,1788,1736,1706,1359,540,493,77,84,910,878,115,1034,478,0
19:40:50,6619.16,Fox,1790,162,54,30,34,11,23,10,1790,1736,1706,1359,540,493,78,84,912,878,115,1035,478,0
19:40:50,6620.047,Fox,1792,164,56,30,34,11,23,10,1792,1736,1706,1359,540,493,78,86,912,880,115,1035,478,0
19:40:50,6620.367,Fox,1794,166,54,32,34,11,23,10,1792,1738,1706,1359,540,493,79,87,913,881,115,1035,478,0
19:40:50,6620.552,Fox,1794,166,56,32,34,11,23,10,1794,1738,1706,1359,540,493,79,87,913,881,115,1035,478,0
19:40:50,6621.212,Fox,1796,167,58,32,33,11,23,10,1796,1738,1706,1359,540,493,80,87,915,881,115,1036,478,0
19:40:51,6622.738,Fox,1796,166,56,34,33,11,23,9,1796,1740,1706,1359,540,493,80,86,915,881,115,1036,479,0
19:40:51,6623.479,Fox,1798,168,58,34,33,11,23,9,1798,1740,1706,1359,540,493,81,87,916,882,115,1036,479,0
19:40:51,6624.123,Fox,1800,169,58,32,34,11,23,9,1798,1740,1708,1359,540,493,82,87,918,882,115,1037,479,0
19:40:51,6624.279,Fox,1800,169,60,30,36,11,23,9,1800,1740,1710,1359,540,493,82,87,918,882,115,1037,479,0
19:40:52,6624.791,Fox,1800,169,56,34,36,11,23,9,1800,1744,1710,1359,540,493,82,87,918,882,115,1037,479,0
19:40:52,6625.393,Fox,1802,170,58,34,35,11,23,9,1802,1744,1710,1359,540,493,83,87,920,882,115,1038,479,0
19:40:52,6625.541,Fox,1802,168,58,34,35,9,23,9,1802,1744,1710,1359,540,493,82,86,920,882,115,1040,479,0
19:40:52,6626.288,Fox,1802,168,58,34,35,8,24,9,1802,1744,1710,1359,541,493,82,86,920,882,115,1040,479,0
19:40:52,6626.889,Fox,1802,167,58,34,35,8,24,8,1802,1744,1710,1359,541,493,82,85,920,882,115,1040,480,0
19:40:52,6627.628,Fox,1806,168,58,34,33,8,24,7,1802,1744,1710,1359,541,493,81,87,922,884,117,1041,480,0
19:40:53,6627.81,Fox,1806,168,62,34,33,8,24,7,1806,1744,1710,1359,541,493,81,87,922,884,117,1041,480,0
19:40:53,6628.281,Fox,1806,168,58,38,33,8,24,7,1806,1748,1710,1359,541,493,81,87,922,884,117,1041,480,0
19:40:53,6628.882,Fox,1806,168,58,36,35,8,24,7,1806,1748,1712,1359,541,493,81,87,922,884,117,1041,480,0
19:40:53,6629.177,Fox,1806,168,58,34,37,8,24,7,1806,1748,1714,1359,541,493,81,87,922,884,117,1041,480,0
19:40:53,6629.66,Fox,1806,168,56,36,37,8,24,7,1806,1750,1714,1359,541,493,81,87,922,884,117,1041,480,0
19:40:54,6631.742,Fox,1806,168,56,36,35,10,24,7,1806,1750,1714,1361,541,493,81,87,922,884,117,1041,480,0
19:40:54,6632.036,Fox,1806,168,56,34,37,10,24,7,1806,1750,1716,1361,541,493,81,87,922,884,117,1041,480,0
19:40:54,6633.192,Fox,1806,168,56,34,37,9,25,7,1806,1750,1716,1361,542,493,81,87,922,884,117,1041,480,0
19:40:55,6633.943,Fox,1808,170,58,34,37,9,25,7,1808,1750,1716,1361,542,493,83,87,924,884,117,1041,480,0
19:40:55,6634.685,Fox,1808,169,58,32,39,9,25,6,1808,1750,1718,1361,542,493,83,86,924,884,117,1041,481,0
19:40:56,6636.831,Fox,1810,171,54,36,39,9,25,6,1808,1754,1718,1361,542,493,84,87,925,885,117,1041,481,0
19:40:56,6636.978,Fox,1810,171,56,34,41,9,25,6,1810,1754,1720,1361,542,493,84,87,925,885,117,1041,481,0
19:40:56,6637.863,Fox,1810,171,56,34,39,11,25,6,1810,1754,1720,1363,542,493,84,87,925,885,117,1041,481,0
19:40:56,6638.697,Fox,1810,171,56,34,37,13,21,10,1810,1754,1720,1365,542,497,84,87,925,885,117,1041,481,0
19:40:56,6639.705,Fox,1810,171,56,34,35,15,21,10,1810,1754,1720,1367,542,497,84,87,925,885,117,1041,481,0
19:40:57,6641.245,Fox,1810,171,54,36,35,15,21,10,1810,1756,1720,1367,542,497,84,87,925,885,117,1041,481,0
19:40:57,6642.383,Fox,1810,169,54,36,35,13,21,10,1810,1756,1720,1367,542,497,82,87,925,885,117,1043,481,0
19:40:57,6642.684,Fox,1810,169,54,36,33,15,21,10,1810,1756,1720,1369,542,497,82,87,925,885,117,1043,481,0
19:40:58,6643.172,Fox,1812,171,56,36,33,15,20,11,1812,1756,1720,1369,542,498,84,87,927,885,117,1043,481,0
19:40:58,6644.665,Fox,1812,171,54,38,32,16,20,11,1812,1758,1720,1370,542,498,84,87,927,885,117,1043,481,0
19:40:59,6646.844,Fox,1814,173,56,38,32,16,20,11,1814,1758,1720,1370,542,498,85,88,928,886,117,1043,481,0
19:40:59,6648.368,Fox,1816,175,58,38,32,16,20,11,1816,1758,1720,1370,542,498,85,90,928,888,117,1043,481,0
19:40:59,6648.704,Fox,1816,174,58,38,32,16,20,10,1816,1758,1720,1370,542,498,84,90,928,888,117,1043,482,0
19:41:00,6649.051,Fox,1816,174,58,36,34,16,20,10,1816,1758,1722,1370,542,498,84,90,928,888,117,1043,482,0
19:41:00,6650.066,Fox,1816,173,56,38,34,16,20,9,1816,1760,1722,1370,542,498,83,90,928,888,117,1043,483,0
19:41:00,6650.234,Fox,1816,171,56,38,34,14,20,9,1816,1760,1722,1370,542,498,83,88,928,888,117,1045,483,0
19:41:00,6650.567,Fox,1816,170,56,38,34,14,20,8,1816,1760,1722,1370,542,498,82,88,928,888,117,1045,484,0
19:41:00,6651.5,Fox,1816,170,56,36,36,14,20,8,1816,1760,1724,1370,542,498,82,88,928,888,117,1045,484,0
19:41:01,6652.644,Fox,1816,170,56,32,40,14,20,8,1816,1760,1728,1370,542,498,82,88,928,888,117,1045,484,0
19:41:01,6653.22,Fox,1816,168,56,30,42,12,20,8,1816,1760,1730,1370,542,498,82,86,928,888,117,1047,484,0
19:41:01,6654.026,Fox,1816,168,56,24,48,12,20,8,1816,1760,1736,1370,542,498,82,86,928,888,117,1047,484,0
19:41:01,6654.611,Fox,1816,168,56,24,48,12,18,10,1816,1760,1736,1370,542,500,82,86,928,888,117,1047,484,0
19:41:02,6655.159,Fox,1816,167,56,24,48,11,17,11,1816,1760,1736,1370,542,501,82,85,928,888,117,1048,484,0
19:41:02,6656.174,Fox,1816,167,56,24,46,13,17,11,1816,1760,1736,1372,542,501,82,85,928,888,117,1048,484,0
19:41:02,6657.046,Fox,1816,167,56,24,44,15,17,11,1816,1760,1736,1374,542,501,82,85,928,888,117,1048,484,0
19:41:02,6657.506,Fox,1816,167,54,26,44,15,17,11,1816,1762,1736,1374,542,501,82,85,928,888,117,1048,484,0
19:41:03,6658.376,Fox,1818,167,54,26,43,15,16,11,1816,1762,1736,1374,542,501,81,86,928,890,117,1050,484,0
19:41:03,6658.712,Fox,1818,166,56,24,45,15,16,10,1818,1762,1738,1374,542,501,80,86,928,890,117,1050,485,0
19:41:03,6659.219,Fox,1820,168,58,24,45,15,16,10,1820,1762,1738,1374,542,501,81,87,929,891,117,1050,485,0
19:41:03,6660.185,Fox,1822,170,58,26,45,15,16,10,1822,1764,1738,1374,542,501,82,88,930,892,117,1050,485,0
19:41:03,6660.481,Fox,1822,170,56,28,45,15,16,10,1822,1766,1738,1374,542,501,82,88,930,892,117,1050,485,0
19:41:04,6660.978,Fox,1822,170,56,28,44,16,14,12,1822,1766,1738,1375,542,503,82,88,930,892,117,1050,485,0
19:41:04,6661.312,Fox,1822,170,56,26,46,16,14,12,1822,1766,1740,1375,542,503,82,88,930,892,117,1050,485,0
19:41:04,6662.963,Fox,1824,172,56,28,46,16,14,12,1824,1768,1740,1375,542,503,84,88,932,892,117,1050,485,0
19:41:04,6663.311,Fox,1824,172,56,24,50,16,14,12,1824,1768,1744,1375,542,503,84,88,932,892,117,1050,485,0
19:41:05,6664.433,Fox,1824,172,54,26,50,16,14,12,1824,1770,1744,1375,542,503,84,88,932,892,117,1050,485,0
19:41:05,6665.351,Fox,1824,172,54,26,50,16,13,13,1824,1770,1744,1375,542,504,84,88,932,892,117,1050,485,0
19:41:05,6666.575,Fox,1824,172,52,26,52,16,13,13,1824,1772,1746,1375,542,504,84,88,932,892,117,1050,485,0
19:41:06,6666.902,Fox,1824,170,50,26,54,14,13,13,1824,1774,1748,1375,542,504,84,86,932,892,117,1052,485,0
19:41:06,6668.158,Fox,1824,170,50,24,56,14,13,13,1824,1774,1750,1375,542,504,84,86,932,892,117,1052,485,0
19:41:07,6669.878,Fox,1824,170,50,24,54,16,13,13,1824,1774,1750,1377,542,504,84,86,932,892,117,1052,485,0
19:41:07,6670.711,Fox,1826,171,50,26,51,18,13,13,1826,1776,1750,1379,542,504,83,88,932,894,117,1053,485,0
19:41:07,6671.517,Fox,1826,170,50,26,51,17,13,13,1826,1776,1750,1379,542,504,83,87,932,894,117,1054,485,0
19:41:07,6671.963,Fox,1826,170,50,26,51,16,14,13,1826,1776,1750,1379,543,504,83,87,932,894,117,1054,485,0
19:41:08,6672.895,Fox,1826,170,50,26,47,20,14,13,1826,1776,1750,1383,543,504,83,87,932,894,117,1054,485,0
19:41:08,6673.488,Fox,1826,170,50,26,45,20,16,13,1826,1776,1750,1385,545,504,83,87,932,894,117,1054,485,0
19:41:08,6675.216,Fox,1826,170,46,28,47,20,16,13,1826,1780,1752,1385,545,504,83,87,932,894,117,1054,485,0
19:41:08,6675.392,Fox,1826,170,46,26,49,20,16,13,1826,1780,1754,1385,545,504,83,87,932,894,117,1054,485,0
19:41:09,6676.999,Fox,1826,170,44,28,47,22,16,13,1826,1782,1754,1387,545,504,83,87,932,894,117,1054,485,0
19:41:09,6677.151,Fox,1826,169,42,30,47,22,16,12,1826,1784,1754,1387,545,504,83,86,932,894,117,1054,486,0
19:41:10,6679.051,Fox,1828,171,44,30,47,22,16,12,1828,1784,1754,1387,545,504,84,87,933,895,117,1054,486,0
19:41:10,6679.887,Fox,1828,171,44,28,49,22,16,12,1828,1784,1756,1387,545,504,84,87,933,895,117,1054,486,0
19:41:10,6680.519,Fox,1828,169,44,28,49,20,16,12,1828,1784,1756,1387,545,504,84,85,933,895,117,1056,486,0
19:41:10,6680.963,Fox,1828,168,44,28,49,20,16,11,1828,1784,1756,1387,545,504,83,85,933,895,117,1056,487,0
19:41:10,6681.277,Fox,1828,166,44,28,49,18,16,11,1828,1784,1756,1387,545,504,82,84,933,895,117,1058,487,0
19:41:11,6681.944,Fox,1828,166,44,28,49,18,15,12,1828,1784,1756,1387,545,505,82,84,933,895,117,1058,487,0
19:41:11,6682.999,Fox,1828,166,44,26,51,18,15,12,1828,1784,1758,1387,545,505,82,84,933,895,117,1058,487,0
19:41:11,6683.308,Fox,1828,165,44,26,51,18,15,11,1828,1784,1758,1387,545,505,82,83,933,895,117,1058,488,0
19:41:11,6683.958,Fox,1828,163,44,26,51,16,15,11,1828,1784,1758,1387,545,505,82,81,933,895,117,1060,488,0
19:41:11,6684.427,Fox,1828,163,44,26,49,18,15,11,1828,1784,1758,1389,545,505,82,81,933,895,117,1060,488,0
19:41:12,6684.892,Fox,1828,163,44,26,47,20,13,13,1828,1784,1758,1391,545,507,82,81,933,895,117,1060,488,0
19:41:12,6686.266,Fox,1830,164,46,26,46,20,13,13,1830,1784,1758,1391,545,507,83,81,935,895,117,1061,488,0
19:41:12,6687.578,Fox,1830,162,46,26,46,18,13,13,1830,1784,1758,1391,545,507,81,81,935,895,117,1063,488,0
19:41:13,6688.38,Fox,1834,164,50,26,45,17,13,13,1834,1784,1758,1391,545,507,79,85,935,899,117,1065,488,0
19:41:13,6688.549,Fox,1834,164,50,24,47,17,13,13,1834,1784,1760,1391,545,507,79,85,935,899,117,1065,488,0
19:41:13,6689.045,Fox,1834,163,50,24,47,17,12,13,1834,1784,1760,1391,545,508,79,84,935,899,117,1065,489,0
19:41:13,6689.519,Fox,1836,165,52,24,45,19,12,13,1836,1784,1760,1393,545,508,79,86,935,901,117,1065,489,0
19:41:13,6689.724,Fox,1836,165,52,24,43,21,12,13,1836,1784,1760,1395,545,508,79,86,935,901,117,1065,489,0
19:41:13,6690.403,Fox,1838,167,54,24,43,21,12,13,1838,1784,1760,1395,545,508,80,87,936,902,117,1065,489,0
19:41:14,6690.889,Fox,1838,167,54,24,43,20,13,13,1838,1784,1760,1395,546,508,80,87,936,902,117,1065,489,0
19:41:14,6691.709,Fox,1838,166,54,24,43,20,13,12,1838,1784,1760,1395,546,508,79,87,936,902,117,1065,490,0
19:41:14,6692.35,Fox,1840,167,56,24,42,20,13,12,1840,1784,1760,1395,546,508,78,89,936,904,117,1066,490,0
19:41:14,6692.524,Fox,1840,167,56,24,41,21,13,12,1840,1784,1760,1396,546,508,78,89,936,904,117,1066,490,0
19:41:14,6693.186,Fox,1840,166,56,24,41,21,13,11,1840,1784,1760,1396,546,508,77,89,936,904,117,1066,491,0
19:41:15,6695.069,Fox,1840,163,54,26,41,17,15,10,1840,1786,1760,1396,548,508,75,88,936,904,117,1068,492,0
19:41:15,6695.22,Fox,1840,162,54,26,39,18,15,10,1840,1786,1760,1398,548,508,75,87,936,904,117,1069,492,0
19:41:15,6695.901,Fox,1840,162,54,24,41,18,15,10,1840,1786,1762,1398,548,508,75,87,936,904,117,1069,492,0
19:41:16,6697.258,Fox,1842,163,54,26,40,18,15,10,1842,1788,1762,1398,548,508,75,88,937,905,117,1070,492,0
19:41:16,6697.584,Fox,1842,163,54,26,38,20,15,10,1842,1788,1762,1400,548,508,75,88,937,905,117,1070,492,0
19:41:16,6698.38,Fox,1842,163,54,24,40,20,15,10,1842,1788,1764,1400,548,508,75,88,937,905,117,1070,492,0
19:41:16,6698.822,Fox,1844,165,56,24,40,20,15,10,1844,1788,1764,1400,548,508,75,90,937,907,117,1070,492,0
19:41:16,6699.136,Fox,1846,167,56,22,42,20,15,10,1844,1788,1766,1400,548,508,76,91,938,908,117,1070,492,0
19:41:16,6699.313,Fox,1846,167,58,22,42,20,15,10,1846,1788,1766,1400,548,508,76,91,938,908,117,1070,492,0
19:41:17,6699.947,Fox,1846,166,58,22,42,19,15,10,1846,1788,1766,1400,548,508,76,90,938,908,118,1070,492,0
19:41:17,6700.276,Fox,1846,164,58,22,42,17,15,10,1846,1788,1766,1400,548,508,76,88,938,908,118,1072,492,0
19:41:17,6701.649,Fox,1846,164,56,22,44,17,15,10,1846,1790,1768,1400,548,508,76,88,938,908,118,1072,492,0
19:41:17,6702.249,Fox,1848,166,58,22,44,17,15,10,1848,1790,1768,1400,548,508,76,90,938,910,118,1072,492,0
19:41:17,6702.541,Fox,1848,166,56,24,44,17,15,10,1848,1792,1768,1400,548,508,76,90,938,910,118,1072,492,0
19:41:18,6703.016,Fox,1848,165,54,24,46,16,15,10,1848,1794,1770,1400,548,508,76,89,938,910,118,1073,492,0
19:41:18,6703.742,Fox,1848,165,52,26,46,16,15,10,1848,1796,1770,1400,548,508,76,89,938,910,118,1073,492,0
19:41:18,6704.184,Fox,1850,166,54,26,45,16,15,10,1850,1796,1770,1400,548,508,77,89,940,910,118,1074,492,0
19:41:18,6704.948,Fox,1850,166,54,24,47,16,15,10,1850,1796,1772,1400,548,508,77,89,940,910,118,1074,492,0
19:41:18,6705.529,Fox,1850,165,54,22,49,16,15,9,1850,1796,1774,1400,548,508,77,88,940,910,118,1074,493,0
19:41:19,6706.025,Fox,1850,163,52,24,49,14,15,9,1850,1798,1774,1400,548,508,77,86,940,910,118,1076,493,0
19:41:19,6707.047,Fox,1850,163,50,26,49,13,16,9,1850,1800,1774,1400,549,508,77,86,940,910,118,1076,493,0
19:41:19,6708.122,Fox,1850,161,48,28,49,11,16,9,1850,1802,1774,1400,549,508,77,84,940,910,118,1078,493,0
19:41:20,6709.1,Fox,1850,161,48,26,51,11,16,9,1850,1802,1776,1400,549,508,77,84,940,910,118,1078,493,0
19:41:20,6709.696,Fox,1850,161,48,26,50,12,14,11,1850,1802,1776,1401,549,510,77,84,940,910,118,1078,493,0
19:41:20,6710.45,Fox,1850,161,44,30,50,12,14,11,1850,1806,1776,1401,549,510,77,84,940,910,118,1078,493,0
19:41:20,6711.264,Fox,1850,160,44,30,50,12,14,10,1850,1806,1776,1401,549,510,76,84,940,910,118,1078,494,0
19:41:21,6712.221,Fox,1850,159,44,30,48,14,14,9,1850,1806,1776,1403,549,510,75,84,940,910,118,1078,495,0
19:41:21,6713.066,Fox,1850,159,44,30,45,17,14,9,1850,1806,1776,1406,549,510,75,84,940,910,118,1078,495,0
19:41:21,6713.666,Fox,1850,159,44,26,47,19,14,9,1850,1806,1780,1408,549,510,75,84,940,910,118,1078,495,0
19:41:21,6714.114,Fox,1852,160,46,26,46,19,14,9,1852,1806,1780,1408,549,510,76,84,942,910,118,1079,495,0
19:41:21,6714.444,Fox,1852,160,46,26,41,24,14,9,1852,1806,1780,1413,549,510,76,84,942,910,118,1079,495,0
19:41:22,6715.264,Fox,1852,158,46,24,43,24,14,7,1852,1806,1782,1413,549,510,75,83,942,910,118,1079,497,0
19:41:22,6715.436,Fox,1852,158,46,24,43,24,13,8,1852,1806,1782,1413,549,511,75,83,942,910,118,1079,497,0
19:41:22,6715.761,Fox,1852,158,46,22,45,24,13,8,1852,1806,1784,1413,549,511,75,83,942,910,118,1079,497,0
19:41:22,6716.567,Fox,1852,158,44,24,45,24,13,8,1852,1808,1784,1413,549,511,75,83,942,910,118,1079,497,0
19:41:23,6719.026,Fox,1854,159,46,24,44,24,13,8,1854,1808,1784,1413,549,511,74,85,942,912,118,1080,497,0
19:41:23,6719.175,Fox,1854,159,46,24,42,26,13,8,1854,1808,1784,1415,549,511,74,85,942,912,118,1080,497,0
19:41:23,6719.898,Fox,1856,159,44,26,41,26,13,7,1854,1810,1784,1415,549,511,73,86,943,913,118,1081,498,0
19:41:23,6720.247,Fox,1860,162,46,26,41,25,13,7,1856,1810,1784,1415,549,511,76,86,946,914,118,1082,498,0
19:41:23,6720.433,Fox,1860,162,50,26,41,25,13,7,1860,1810,1784,1415,549,511,76,86,946,914,118,1082,498,0
19:41:24,6721.386,Fox,1860,161,50,26,41,25,13,6,1860,1810,1784,1415,549,511,76,85,946,914,118,1082,499,0
19:41:24,6721.849,Fox,1860,161,50,26,40,26,13,6,1860,1810,1784,1416,549,511,76,85,946,914,118,1082,499,0
19:41:24,6722.177,Fox,1860,160,50,26,40,26,12,6,1860,1810,1784,1416,549,511,76,84,946,914,118,1083,499,0
19:41:25,6723.763,Fox,1860,157,50,26,36,27,12,6,1860,1810,1784,1420,549,511,76,81,946,914,118,1086,499,0
19:41:25,6724.4,Fox,1862,159,52,26,36,27,12,6,1862,1810,1784,1420,549,511,76,83,946,916,118,1086,499,0
19:41:25,6725.013,Fox,1862,154,52,26,36,22,12,6,1862,1810,1784,1420,549,511,74,80,946,916,118,1091,499,0
19:41:25,6725.156,Fox,1862,153,52,26,36,22,12,5,1862,1810,1784,1420,549,511,73,80,946,916,118,1091,500,0
19:41:25,6725.764,Fox,1862,153,50,28,36,22,12,5,1862,1812,1784,1420,549,511,73,80,946,916,118,1091,500,0
19:41:26,6727.043,Fox,1864,154,52,28,35,22,12,5,1864,1812,1784,1420,549,511,73,81,947,917,118,1092,500,0
19:41:26,6727.208,Fox,1864,154,52,28,32,25,12,5,1864,1812,1784,1423,549,511,73,81,947,917,118,1092,500,0
19:41:26,6728.575,Fox,1864,154,52,28,31,26,12,5,1864,1812,1784,1424,549,511,73,81,947,917,118,1092,500,0
19:41:26,6729.491,Fox,1864,152,50,30,31,26,12,3,1864,1814,1784,1424,549,511,72,80,947,917,118,1092,502,0
19:41:27,6729.973,Fox,1866,152,50,30,31,24,12,3,1864,1814,1784,1424,549,511,74,78,949,917,118,1094,502,0
19:41:27,6730.157,Fox,1866,152,52,30,31,24,12,3,1866,1814,1784,1424,549,511,74,78,949,917,118,1094,502,0
19:41:27,6730.979,Fox,1866,152,50,32,31,24,12,3,1866,1816,1784,1424,549,511,74,78,949,917,118,1094,502,0
19:41:27,6731.266,Fox,1866,152,50,32,31,22,14,3,1866,1816,1784,1424,551,511,74,78,949,917,118,1094,502,0
19:41:27,6732.31,Fox,1866,151,50,32,31,19,16,3,1866,1816,1784,1424,553,511,74,77,949,917,118,1095,502,0
19:41:28,6733.489,Fox,1868,152,52,30,32,19,16,3,1868,1816,1786,1424,553,511,75,77,951,917,118,1096,502,0
19:41:28,6734.252,Fox,1868,149,52,30,32,16,16,3,1868,1816,1786,1424,553,511,75,74,951,917,119,1098,502,0
19:41:28,6735.562,Fox,1870,149,54,30,31,16,16,2,1870,1816,1786,1424,553,511,75,74,952,918,119,1099,503,0
19:41:29,6735.888,Fox,1870,149,54,28,30,19,16,2,1870,1816,1788,1427,553,511,75,74,952,918,119,1099,503,0
19:41:29,6737.119,Fox,1872,151,56,28,30,19,16,2,1872,1816,1788,1427,553,511,75,76,952,920,119,1099,503,0
19:41:29,6737.754,Fox,1872,148,56,28,30,16,16,2,1872,1816,1788,1427,553,511,74,74,952,920,119,1102,503,0
19:41:30,6739.182,Fox,1872,147,56,28,30,15,16,2,1872,1816,1788,1427,553,511,74,73,952,920,119,1103,503,0
19:41:30,6740.378,Fox,1872,147,56,26,30,17,16,2,1872,1816,1790,1429,553,511,74,73,952,920,119,1103,503,0
19:41:30,6741.136,Fox,1872,147,54,26,32,17,16,2,1872,1818,1792,1429,553,511,74,73,952,920,119,1103,503,0
19:41:31,6741.759,Fox,1876,149,56,26,32,17,16,2,1876,1820,1794,1429,553,511,74,75,954,922,119,1105,503,0
19:41:31,6742.275,Fox,1878,151,58,24,34,17,16,2,1878,1820,1796,1429,553,511,75,76,955,923,119,1105,503,0
19:41:31,6742.809,Fox,1880,152,58,26,33,17,16,2,1880,1822,1796,1429,553,511,75,77,956,924,119,1106,503,0
19:41:31,6743.512,Fox,1880,152,58,26,32,18,16,2,1880,1822,1796,1430,553,511,75,77,956,924,119,1106,503,0
19:41:31,6744.16,Fox,1880,152,58,26,32,18,15,3,1880,1822,1796,1430,553,512,75,77,956,924,119,1106,503,0
19:41:31,6744.455,Fox,1880,152,58,24,34,18,15,3,1880,1822,1798,1430,553,512,75,77,956,924,119,1106,503,0
19:41:32,6745.088,Fox,1880,152,58,24,34,18,14,4,1880,1822,1798,1430,553,513,75,77,956,924,119,1106,503,0
19:41:32,6745.533,Fox,1880,152,56,24,36,18,12,6,1880,1824,1800,1430,553,515,75,77,956,924,119,1106,503,0
19:41:32,6746.503,Fox,1880,151,56,22,38,17,12,6,1880,1824,1802,1430,553,515,75,76,956,924,119,1107,503,0
19:41:33,6748.778,Fox,1880,151,56,18,42,17,12,6,1880,1824,1806,1430,553,515,75,76,956,924,119,1107,503,0
19:41:33,6749.108,Fox,1880,151,56,18,41,18,12,6,1880,1824,1806,1431,553,515,75,76,956,924,119,1107,503,0
19:41:33,6750.546,Fox,1880,151,56,18,41,16,14,6,1880,1824,1806,1431,555,515,75,76,956,924,119,1107,503,0
19:41:34,6750.861,Fox,1880,149,56,18,41,14,14,6,1880,1824,1806,1431,555,515,75,74,956,924,119,1109,503,0
19:41:34,6752.264,Fox,1882,150,58,18,40,14,14,6,1882,1824,1806,1431,555,515,74,76,956,926,119,1110,503,0
19:41:34,6753.238,Fox,1882,150,56,20,40,14,14,6,1882,1826,1806,1431,555,515,74,76,956,926,119,1110,503,0
19:41:35,6754.034,Fox,1882,149,56,20,40,13,14,6,1882,1826,1806,1431,555,515,74,75,956,926,119,1111,503,0
19:41:35,6755.225,Fox,1884,151,58,18,42,13,14,6,1884,1826,1808,1431,555,515,76,75,958,926,119,1111,503,0
19:41:35,6756.396,Fox,1884,151,58,18,41,14,14,6,1884,1826,1808,1432,555,515,76,75,958,926,119,1111,503,0
19:41:36,6758.092,Fox,1884,151,58,16,43,14,14,6,1884,1826,1810,1432,555,515,76,75,958,926,119,1111,503,0
19:41:36,6758.883,Fox,1884,151,58,16,41,16,14,6,1884,1826,1810,1434,555,515,76,75,958,926,119,1111,503,0
19:41:37,6759.577,Fox,1884,150,58,16,41,15,14,6,1884,1826,1810,1434,555,515,76,74,958,926,119,1112,503,0
19:41:37,6760.512,Fox,1886,152,60,16,41,15,14,6,1886,1826,1810,1434,555,515,76,76,958,928,119,1112,503,0
19:41:37,6761.589,Fox,1886,152,58,18,41,15,14,6,1886,1828,1810,1434,555,515,76,76,958,928,119,1112,503,0
19:41:37,6761.876,Fox,1886,152,58,18,40,16,14,6,1886,1828,1810,1435,555,515,76,76,958,928,119,1112,503,0
19:41:38,6763.446,Fox,1886,152,58,18,38,18,14,6,1886,1828,1810,1437,555,515,76,76,958,928,119,1112,503,0
19:41:38,6764.261,Fox,1886,152,58,16,40,18,14,6,1886,1828,1812,1437,555,515,76,76,958,928,119,1112,503,0
19:41:39,6765.423,Fox,1886,152,58,16,38,20,14,6,1886,1828,1812,1439,555,515,76,76,958,928,119,1112,503,0
19:41:39,6765.91,Fox,1886,152,58,16,37,21,14,6,1886,1828,1812,1440,555,515,76,76,958,928,119,1112,503,0
19:41:39,6766.375,Fox,1886,152,58,16,37,17,18,6,1886,1828,1812,1440,559,515,76,76,958,928,119,1112,503,0
19:41:39,6767.091,Fox,1888,153,58,16,37,16,18,6,1886,1828,1812,1440,559,515,77,76,959,929,119,1113,503,0
19:41:39,6767.242,Fox,1888,153,60,16,37,16,18,6,1888,1828,1812,1440,559,515,77,76,959,929,119,1113,503,0
19:41:39,6767.843,Fox,1888,153,60,14,39,16,18,6,1888,1828,1814,1440,559,515,77,76,959,929,119,1113,503,0
19:41:40,6768.874,Fox,1888,153,58,16,39,16,18,6,1888,1830,1814,1440,559,515,77,76,959,929,119,1113,503,0
19:41:40,6769.628,Fox,1890,155,60,14,39,18,18,6,1890,1830,1816,1442,559,515,79,76,961,929,119,1113,503,0
19:41:40,6770.909,Fox,1890,155,56,18,39,18,17,7,1890,1834,1816,1442,559,516,79,76,961,929,119,1113,503,0
19:41:41,6772.038,Fox,1890,155,54,20,39,18,17,7,1890,1836,1816,1442,559,516,79,76,961,929,119,1113,503,0
19:41:41,6772.546,Fox,1892,155,56,20,38,17,17,7,1892,1836,1816,1442,559,516,77,78,961,931,119,1115,503,0
19:41:41,6773.038,Fox,1892,155,54,22,38,17,17,7,1892,1838,1816,1442,559,516,77,78,961,931,119,1115,503,0
19:41:42,6774.182,Fox,1892,155,54,22,35,20,17,7,1892,1838,1816,1445,559,516,77,78,961,931,119,1115,503,0
19:41:42,6774.954,Fox,1892,155,52,24,35,20,17,7,1892,1840,1816,1445,559,516,77,78,961,931,119,1115,503,0
19:41:42,6775.855,Fox,1892,152,52,24,33,20,17,6,1892,1840,1816,1447,559,516,75,77,961,931,119,1117,504,0
19:41:42,6776.366,Fox,1892,150,52,24,32,20,17,5,1892,1840,1816,1448,559,516,75,75,961,931,119,1118,505,0
19:41:43,6777.772,Fox,1892,149,52,24,32,20,17,4,1892,1840,1816,1448,559,516,75,74,961,931,119,1119,505,0
19:41:43,6779.421,Fox,1896,152,54,24,31,20,17,4,1894,1840,1816,1448,559,516,76,76,963,933,119,1120,505,0
19:41:43,6779.594,Fox,1896,152,56,22,33,20,17,4,1896,1840,1818,1448,559,516,76,76,963,933,119,1120,505,0
19:41:43,6779.917,Fox,1896,152,54,24,33,20,17,4,1896,1842,1818,1448,559,516,76,76,963,933,119,1120,505,0
19:41:44,6780.415,Fox,1898,153,56,22,35,20,17,3,1898,1842,1820,1448,559,516,78,75,965,933,119,1120,506,0
19:41:44,6780.926,Fox,1900,154,58,22,35,19,17,3,1900,1842,1820,1448,559,516,78,76,966,934,119,1121,506,0
19:41:44,6781.41,Fox,1900,154,56,22,37,19,17,3,1900,1844,1822,1448,559,516,78,76,966,934,119,1121,506,0
19:41:44,6781.861,Fox,1900,154,54,24,37,19,17,3,1900,1846,1822,1448,559,516,78,76,966,934,119,1121,506,0
19:41:44,6782.862,Fox,1900,154,54,24,37,18,18,3,1900,1846,1822,1448,560,516,78,76,966,934,119,1121,506,0
19:41:45,6784.061,Fox,1900,154,54,22,39,18,18,3,1900,1846,1824,1448,560,516,78,76,966,934,119,1121,506,0
19:41:45,6784.859,Fox,1900,153,52,24,39,17,18,3,1900,1848,1824,1448,560,516,77,76,966,934,119,1122,506,0
19:41:45,6786.072,Fox,1902,154,54,24,38,17,18,3,1902,1848,1824,1448,560,516,76,78,966,936,119,1123,506,0
19:41:46,6786.421,Fox,1902,153,54,24,38,16,18,3,1902,1848,1824,1448,560,516,76,77,966,936,119,1124,506,0
19:41:46,6786.756,Fox,1902,152,52,26,38,15,18,3,1902,1850,1824,1448,560,516,76,76,966,936,119,1125,506,0
19:41:47,6790.82,Fox,1902,151,52,26,38,15,18,2,1902,1850,1824,1448,560,516,75,76,966,936,119,1125,507,0
19:41:47,6791.791,Fox,1902,151,52,24,40,15,18,2,1902,1850,1826,1448,560,516,75,76,966,936,119,1125,507,0
19:41:48,6793.302,Fox,1904,153,54,24,40,15,18,2,1904,1850,1826,1448,560,516,77,76,968,936,119,1125,507,0
19:41:48,6793.665,Fox,1906,155,56,24,40,15,18,2,1906,1850,1826,1448,560,516,78,77,969,937,119,1125,507,0
19:41:48,6794.011,Fox,1908,156,58,24,37,17,18,2,1908,1850,1826,1450,560,516,78,78,970,938,119,1126,507,0
19:41:49,6795.81,Fox,1910,158,60,24,37,17,18,2,1910,1850,1826,1450,560,516,78,80,970,940,119,1126,507,0
19:41:49,6796.191,Fox,1910,158,60,24,35,19,18,2,1910,1850,1826,1452,560,516,78,80,970,940,119,1126,507,0
19:41:49,6796.642,Fox,1910,158,58,26,35,19,18,2,1910,1852,1826,1452,560,516,78,80,970,940,119,1126,507,0
19:41:50,6799.985,Fox,1912,160,60,26,35,19,18,2,1912,1852,1826,1452,560,516,80,80,972,940,119,1126,507,0
19:41:50,6800.171,Fox,1912,160,60,24,37,19,18,2,1912,1852,1828,1452,560,516,80,80,972,940,119,1126,507,0
19:41:50,6800.657,Fox,1912,160,60,24,35,21,18,2,1912,1852,1828,1454,560,516,80,80,972,940,119,1126,507,0
19:41:51,6801.824,Fox,1912,160,58,26,33,23,18,2,1912,1854,1828,1456,560,516,80,80,972,940,119,1126,507,0
19:41:51,6802.307,Fox,1912,160,58,26,32,24,18,2,1912,1854,1828,1457,560,516,80,80,972,940,119,1126,507,0
19:41:51,6803.171,Fox,1912,160,52,32,31,25,18,2,1912,1860,1828,1458,560,516,80,80,972,940,119,1126,507,0
19:41:52,6804.949,Fox,1914,161,54,32,30,25,18,2,1914,1860,1828,1458,560,516,81,80,974,940,119,1127,507,0
19:41:52,6805.249,Fox,1914,161,54,32,28,27,18,2,1914,1860,1828,1460,560,516,81,80,974,940,119,1127,507,0
19:41:52,6805.946,Fox,1914,160,54,32,26,27,20,1,1914,1860,1828,1462,562,516,81,79,974,940,119,1127,508,0
19:41:53,6806.545,Fox,1916,162,56,32,26,27,20,1,1916,1860,1828,1462,562,516,81,81,974,942,119,1127,508,0
19:41:53,6806.741,Fox,1916,160,56,32,26,25,20,1,1916,1860,1828,1462,562,516,80,80,974,942,119,1129,508,0
19:41:53,6807.433,Fox,1916,160,54,32,26,25,22,1,1916,1862,1830,1464,564,516,80,80,974,942,119,1129,508,0
19:41:54,6809.588,Fox,1916,160,52,30,26,29,21,2,1916,1864,1834,1468,564,517,80,80,974,942,119,1129,508,0
19:41:54,6810.702,Fox,1916,160,52,28,28,29,21,2,1916,1864,1836,1468,564,517,80,80,974,942,119,1129,508,0
19:41:54,6811.333,Fox,1916,157,52,28,28,27,19,3,1916,1864,1836,1468,564,519,78,79,974,942,119,1131,509,0
19:41:54,6811.602,Fox,1916,157,52,26,30,27,19,3,1916,1864,1838,1468,564,519,78,79,974,942,119,1131,509,0
19:41:54,6812.123,Fox,1916,155,52,26,30,25,19,3,1916,1864,1838,1468,564,519,78,77,974,942,119,1133,509,0
19:41:55,6812.989,Fox,1916,154,50,28,30,24,19,3,1916,1866,1838,1468,564,519,78,76,974,942,119,1134,509,0
19:41:55,6813.501,Fox,1916,153,50,26,32,23,19,3,1916,1866,1840,1468,564,519,77,76,974,942,119,1135,509,0
19:41:56,6815.789,Fox,1916,151,50,26,30,23,19,3,1916,1866,1840,1470,564,519,76,75,974,942,119,1137,509,0
19:41:56,6816.48,Fox,1916,149,48,28,30,21,19,3,1916,1868,1840,1470,564,519,74,75,974,942,119,1139,509,0
19:41:56,6817.38,Fox,1918,150,50,28,29,20,20,3,1918,1868,1840,1470,565,519,73,77,974,944,119,1140,509,0
19:41:57,6817.643,Fox,1918,148,50,28,29,18,20,3,1918,1868,1840,1470,565,519,71,77,974,944,119,1142,509,0
19:41:57,6818.704,Fox,1918,148,48,28,30,19,20,3,1918,1870,1842,1471,565,519,71,77,974,944,119,1142,509,0
19:41:58,6820.142,Fox,1920,150,48,28,32,19,20,3,1920,1872,1844,1471,565,519,73,77,976,944,119,1142,509,0
19:41:58,6820.328,Fox,1920,150,48,26,34,19,20,3,1920,1872,1846,1471,565,519,73,77,976,944,119,1142,509,0
19:41:59,6823.379,Fox,1920,150,48,24,36,19,20,3,1920,1872,1848,1471,565,519,73,77,976,944,119,1142,509,0
19:41:59,6824.375,Fox,1920,150,44,28,36,19,20,3,1920,1876,1848,1471,565,519,73,77,976,944,119,1142,509,0
19:41:59,6824.964,Fox,1920,150,42,30,34,21,20,3,1920,1878,1848,1473,565,519,73,77,976,944,119,1142,509,0
19:41:59,6825.283,Fox,1920,150,40,30,36,21,20,3,1920,1880,1850,1473,565,519,73,77,976,944,119,1142,509,0
19:42:00,6826.085,Fox,1920,148,40,30,36,19,20,3,1920,1880,1850,1473,565,519,71,77,976,944,119,1144,509,0
19:42:00,6828.34,Fox,1920,148,40,30,35,20,19,4,1920,1880,1850,1474,565,520,71,77,976,944,119,1144,509,0
19:42:01,6829.104,Fox,1920,147,40,30,35,19,19,4,1920,1880,1850,1474,565,520,71,76,976,944,119,1145,509,0
19:42:01,6829.419,Fox,1920,147,40,30,35,17,21,4,1920,1880,1850,1474,567,520,71,76,976,944,119,1145,509,0
19:42:01,6829.879,Fox,1920,147,40,30,33,19,21,4,1920,1880,1850,1476,567,520,71,76,976,944,119,1145,509,0
19:42:02,6832.583,Fox,1920,147,40,30,33,19,19,6,1920,1880,1850,1476,567,522,71,76,976,944,119,1145,509,0
19:42:02,6833.168,Fox,1922,149,42,30,33,19,19,6,1922,1880,1850,1476,567,522,72,77,977,945,119,1145,509,0
19:42:02,6834.827,Fox,1922,149,40,32,33,19,19,6,1922,1882,1850,1476,567,522,72,77,977,945,119,1145,509,0
19:42:03,6835.275,Fox,1922,147,40,30,35,17,19,6,1922,1882,1852,1476,567,522,70,77,977,945,119,1147,509,0
19:42:03,6837.818,Fox,1922,147,38,32,35,17,19,6,1922,1884,1852,1476,567,522,70,77,977,945,119,1147,509,0
19:42:04,6838.989,Fox,1922,146,38,32,35,16,19,6,1922,1884,1852,1476,567,522,70,76,977,945,119,1148,509,0
19:42:04,6840.118,Fox,1922,146,38,30,35,18,19,6,1922,1884,1854,1478,567,522,70,76,977,945,119,1148,509,0
19:42:04,6840.405,Fox,1922,144,38,30,35,16,19,6,1922,1884,1854,1478,567,522,70,74,977,945,119,1150,509,0
19:42:04,6840.697,Fox,1922,144,38,30,33,18,19,6,1922,1884,1854,1480,567,522,70,74,977,945,119,1150,509,0
19:42:05,6841.314,Fox,1924,145,38,28,34,18,19,6,1922,1884,1856,1480,567,522,70,75,978,946,119,1151,509,0
19:42:05,6841.485,Fox,1924,145,40,24,38,18,19,6,1924,1884,1860,1480,567,522,70,75,978,946,119,1151,509,0
19:42:05,6841.792,Fox,1924,145,40,24,37,19,19,6,1924,1884,1860,1481,567,522,70,75,978,946,119,1151,509,0
19:42:05,6843.216,Fox,1926,147,40,26,37,19,19,6,1926,1886,1860,1481,567,522,72,75,980,946,119,1151,509,0
19:42:06,6844.664,Fox,1926,147,40,26,35,21,18,7,1926,1886,1860,1483,567,523,72,75,980,946,119,1151,509,0
19:42:06,6845.119,Fox,1928,149,42,26,35,21,18,7,1928,1886,1860,1483,567,523,73,76,981,947,119,1151,509,0
19:42:06,6845.394,Fox,1928,149,42,24,37,21,18,7,1928,1886,1862,1483,567,523,73,76,981,947,119,1151,509,0
19:42:06,6846.979,Fox,1930,151,44,24,37,21,18,7,1930,1886,1862,1483,567,523,73,78,981,949,119,1151,509,0
19:42:07,6848.107,Fox,1930,151,44,22,39,21,18,7,1930,1886,1864,1483,567,523,73,78,981,949,119,1151,509,0
19:42:08,6850.036,Fox,1930,150,42,24,39,21,18,6,1930,1888,1864,1483,567,523,72,78,981,949,119,1151,510,0
19:42:08,6850.75,Fox,1932,149,42,24,38,19,18,6,1930,1888,1864,1483,567,523,73,76,983,949,119,1154,510,0
19:42:08,6850.918,Fox,1932,149,44,24,38,19,18,6,1932,1888,1864,1483,567,523,73,76,983,949,119,1154,510,0
19:42:08,6851.24,Fox,1932,147,44,22,40,17,18,6,1932,1888,1866,1483,567,523,72,75,983,949,119,1156,510,0
19:42:08,6852.328,Fox,1932,146,42,24,38,16,20,6,1932,1890,1866,1485,569,523,72,74,983,949,119,1157,510,0
19:42:09,6854.558,Fox,1934,148,44,22,40,16,20,6,1934,1890,1868,1485,569,523,73,75,984,950,119,1157,510,0
19:42:09,6855.151,Fox,1934,146,42,24,40,14,20,6,1934,1892,1868,1485,569,523,71,75,984,950,119,1159,510,0
19:42:10,6855.777,Fox,1936,147,44,24,39,14,20,6,1936,1892,1868,1485,569,523,71,76,985,951,119,1160,510,0
19:42:10,6856.651,Fox,1936,147,44,22,41,14,20,6,1936,1892,1870,1485,569,523,71,76,985,951,119,1160,510,0
19:42:10,6856.938,Fox,1936,147,44,22,41,12,22,6,1936,1892,1870,1485,571,523,71,76,985,951,119,1160,510,0
19:42:10,6857.896,Fox,1938,148,46,22,40,12,22,6,1938,1892,1870,1485,571,523,71,77,986,952,119,1161,510,0
19:42:10,6858.358,Fox,1940,149,48,20,41,12,22,6,1940,1892,1872,1485,571,523,71,78,987,953,119,1162,510,0
19:42:11,6860.634,Fox,1940,149,48,20,40,13,22,6,1940,1892,1872,1486,571,523,71,78,987,953,119,1162,510,0
19:42:12,6861.874,Fox,1942,150,50,20,39,13,22,6,1942,1892,1872,1486,571,523,72,78,989,953,119,1163,510,0
19:42:12,6862.197,Fox,1942,150,46,24,39,13,22,6,1942,1896,1872,1486,571,523,72,78,989,953,119,1163,510,0
19:42:12,6862.9,Fox,1942,148,44,22,43,11,22,6,1942,1898,1876,1486,571,523,72,76,989,953,119,1165,510,0
19:42:12,6863.36,Fox,1942,148,44,20,45,9,24,6,1942,1898,1878,1486,573,523,72,76,989,953,119,1165,510,0
19:42:12,6863.5,Fox,1942,148,42,22,45,9,24,6,1942,1900,1878,1486,573,523,72,76,989,953,119,1165,510,0
19:42:12,6863.921,Fox,1944,149,42,20,46,9,24,6,1942,1900,1880,1486,573,523,72,77,990,954,119,1166,510,0
19:42:12,6864.095,Fox,1944,149,44,20,46,9,24,6,1944,1900,1880,1486,573,523,72,77,990,954,119,1166,510,0
19:42:13,6867.478,Fox,1944,149,44,20,46,8,25,6,1944,1900,1880,1486,574,523,72,77,990,954,119,1166,510,0
19:42:14,6867.795,Fox,1944,149,44,20,45,9,25,6,1944,1900,1880,1487,574,523,72,77,990,954,119,1166,510,0
19:42:14,6868.835,Fox,1944,149,42,22,45,9,23,8,1944,1902,1880,1487,574,525,72,77,990,954,119,1166,510,0
19:42:14,6869.271,Fox,1944,149,42,22,45,8,24,8,1944,1902,1880,1487,575,525,72,77,990,954,119,1166,510,0
19:42:14,6869.57,Fox,1944,149,42,22,45,8,22,10,1944,1902,1880,1487,575,527,72,77,990,954,119,1166,510,0
19:42:14,6869.9,Fox,1944,149,42,22,41,12,22,10,1944,1902,1880,1491,575,527,72,77,990,954,119,1166,510,0
19:42:15,6871.027,Fox,1944,149,42,22,39,14,22,10,1944,1902,1880,1493,575,527,72,77,990,954,119,1166,510,0
19:42:15,6871.604,Fox,1946,151,44,22,39,14,22,10,1946,1902,1880,1493,575,527,72,79,990,956,119,1166,510,0
19:42:15,6871.938,Fox,1946,151,44,22,38,15,22,10,1946,1902,1880,1494,575,527,72,79,990,956,119,1166,510,0
19:42:15,6873.394,Fox,1946,151,44,20,40,15,22,10,1946,1902,1882,1494,575,527,72,79,990,956,119,1166,510,0
19:42:16,6874.06,Fox,1948,153,46,20,38,17,22,10,1948,1902,1882,1496,575,527,74,79,992,956,119,1166,510,0
19:42:16,6875.846,Fox,1948,153,44,22,38,17,22,10,1948,1904,1882,1496,575,527,74,79,992,956,119,1166,510,0
19:42:16,6876.286,Fox,1948,153,42,22,40,17,22,10,1948,1906,1884,1496,575,527,74,79,992,956,119,1166,510,0
19:42:17,6876.717,Fox,1950,154,40,24,39,17,22,10,1948,1908,1884,1496,575,527,75,79,994,956,120,1166,510,0
19:42:17,6876.873,Fox,1950,154,42,24,39,17,22,10,1950,1908,1884,1496,575,527,75,79,994,956,120,1166,510,0
19:42:17,6878.446,Fox,1952,154,42,26,38,16,22,10,1952,1910,1884,1496,575,527,74,80,995,957,120,1168,510,0
19:42:17,6878.928,Fox,1952,154,42,26,37,17,22,10,1952,1910,1884,1497,575,527,74,80,995,957,120,1168,510,0
19:42:18,6880.453,Fox,1952,152,42,26,35,17,22,10,1952,1910,1884,1499,575,527,74,78,995,957,120,1170,510,0
19:42:18,6880.837,Fox,1952,152,42,26,34,18,22,10,1952,1910,1884,1500,575,527,74,78,995,957,120,1170,510,0
19:42:18,6881.56,Fox,1956,153,46,24,35,16,22,10,1956,1910,1886,1500,575,527,75,78,997,959,121,1172,510,0
19:42:18,6882.462,Fox,1956,153,44,26,35,16,22,10,1956,1912,1886,1500,575,527,75,78,997,959,121,1172,510,0
19:42:19,6883.096,Fox,1958,155,46,26,35,16,22,10,1958,1912,1886,1500,575,527,75,80,997,961,121,1172,510,0
19:42:19,6883.941,Fox,1958,155,46,26,33,18,22,10,1958,1912,1886,1502,575,527,75,80,997,961,121,1172,510,0
19:42:19,6884.453,Fox,1958,154,46,26,33,17,22,10,1958,1912,1886,1502,575,527,75,79,997,961,121,1173,510,0
19:42:20,6887.47,Fox,1958,154,44,28,33,15,24,10,1958,1914,1886,1502,577,527,75,79,997,961,121,1173,510,0
19:42:20,6888.231,Fox,1960,155,44,28,32,15,22,12,1958,1914,1886,1502,577,529,74,81,997,963,121,1174,510,0
19:42:20,6888.401,Fox,1960,155,46,26,34,15,22,12,1960,1914,1888,1502,577,529,74,81,997,963,121,1174,510,0
19:42:21,6889.06,Fox,1960,155,44,28,34,15,22,12,1960,1916,1888,1502,577,529,74,81,997,963,121,1174,510,0
19:42:21,6889.369,Fox,1960,154,44,28,34,14,22,12,1960,1916,1888,1502,577,529,74,80,997,963,122,1174,510,0
19:42:21,6890.943,Fox,1960,153,44,26,36,13,22,12,1960,1916,1890,1502,577,529,74,79,997,963,122,1175,510,0
19:42:22,6893.079,Fox,1962,155,46,26,36,13,22,12,1962,1916,1890,1502,577,529,76,79,999,963,122,1175,510,0
19:42:22,6893.582,Fox,1962,155,46,24,38,13,22,12,1962,1916,1892,1502,577,529,76,79,999,963,122,1175,510,0
19:42:23,6896.421,Fox,1966,157,50,24,36,13,22,12,1966,1916,1892,1502,577,529,78,79,1003,963,122,1177,510,0
19:42:24,6899.811,Fox,1966,157,48,26,36,13,22,12,1966,1918,1892,1502,577,529,78,79,1003,963,122,1177,510,0
19:42:25,6900.592,Fox,1968,159,48,22,38,15,22,12,1966,1918,1896,1504,577,529,79,80,1004,964,122,1177,510,0
19:42:25,6900.92,Fox,1970,160,52,22,37,15,22,12,1970,1918,1896,1504,577,529,78,82,1004,966,122,1178,510,0
19:42:25,6901.628,Fox,1970,160,52,20,38,16,22,12,1970,1918,1898,1505,577,529,78,82,1004,966,122,1178,510,0
19:42:25,6901.989,Fox,1970,160,52,18,38,18,22,12,1970,1918,1900,1507,577,529,78,82,1004,966,122,1178,510,0
19:42:25,6902.906,Fox,1970,160,50,20,38,14,26,12,1970,1920,1900,1507,581,529,78,82,1004,966,122,1178,510,0
19:42:25,6903.547,Fox,1972,160,50,20,37,14,26,11,1970,1920,1900,1507,581,529,77,83,1005,967,122,1179,511,0
19:42:26,6903.919,Fox,1972,160,52,20,37,14,22,15,1972,1920,1900,1507,581,533,77,83,1005,967,122,1179,511,0
19:42:26,6905.831,Fox,1974,161,54,20,36,14,22,15,1974,1920,1900,1507,581,533,77,84,1006,968,122,1180,511,0
19:42:26,6905.999,Fox,1974,161,54,20,34,16,22,15,1974,1920,1900,1509,581,533,77,84,1006,968,122,1180,511,0
19:42:27,6907.088,Fox,1974,161,54,18,36,16,22,15,1974,1920,1902,1509,581,533,77,84,1006,968,122,1180,511,0
19:42:27,6908.697,Fox,1974,161,54,18,34,18,22,15,1974,1920,1902,1511,581,533,77,84,1006,968,122,1180,511,0
19:42:28,6911.276,Fox,1976,161,56,18,34,16,22,15,1976,1920,1902,1511,581,533,78,83,1007,969,122,1182,511,0
19:42:28,6911.77,Fox,1976,161,56,18,33,17,22,15,1976,1920,1902,1512,581,533,78,83,1007,969,122,1182,511,0
19:42:28,6912.122,Fox,1976,160,56,18,33,16,22,15,1976,1920,1902,1512,581,533,78,82,1007,969,122,1183,511,0
19:42:28,6912.481,Fox,1976,159,56,18,33,15,22,15,1976,1920,1902,1512,581,533,78,81,1007,969,122,1184,511,0
19:42:29,6913.654,Fox,1978,160,58,18,33,15,22,14,1978,1920,1902,1512,581,533,78,82,1007,971,122,1184,512,0
19:42:29,6914.158,Fox,1980,162,60,18,33,15,22,14,1980,1920,1902,1512,581,533,79,83,1008,972,122,1184,512,0
19:42:29,6914.349,Fox,1980,162,60,16,35,15,22,14,1980,1920,1904,1512,581,533,79,83,1008,972,122,1184,512,0
19:42:29,6914.7,Fox,1980,162,60,14,37,15,22,14,1980,1920,1906,1512,581,533,79,83,1008,972,122,1184,512,0
19:42:29,6915.249,Fox,1984,163,64,12,35,17,22,13,1984,1920,1908,1514,581,533,78,85,1009,975,122,1186,513,0
19:42:30,6915.757,Fox,1984,163,62,14,35,17,22,13,1984,1922,1908,1514,581,533,78,85,1009,975,122,1186,513,0
19:42:30,6916.534,Fox,1986,165,64,14,35,17,22,13,1986,1922,1908,1514,581,533,79,86,1010,976,122,1186,513,0
19:42:30,6916.862,Fox,1986,165,64,12,37,17,22,13,1986,1922,1910,1514,581,533,79,86,1010,976,122,1186,513,0
19:42:30,6917.208,Fox,1986,165,64,12,35,19,22,13,1986,1922,1910,1516,581,533,79,86,1010,976,122,1186,513,0
19:42:30,6918.425,Fox,1986,164,64,12,35,19,22,12,1986,1922,1910,1516,581,533,78,86,1010,976,122,1186,514,0
19:42:31,6918.743,Fox,1986,164,64,12,33,21,22,12,1986,1922,1910,1518,581,533,78,86,1010,976,122,1186,514,0
19:42:31,6920.125,Fox,1986,162,64,12,33,21,22,10,1986,1922,1910,1518,581,533,77,85,1010,976,122,1186,516,0
19:42:31,6920.466,Fox,1986,162,64,12,33,21,21,11,1986,1922,1910,1518,581,534,77,85,1010,976,122,1186,516,0
19:42:31,6921.09,Fox,1986,162,64,10,35,21,21,11,1986,1922,1912,1518,581,534,77,85,1010,976,122,1186,516,0
19:42:32,6922.314,Fox,1986,161,64,10,35,20,21,11,1986,1922,1912,1518,581,534,76,85,1010,976,122,1187,516,0
19:42:32,6922.992,Fox,1988,163,66,10,35,20,21,11,1988,1922,1912,1518,581,534,77,86,1011,977,122,1187,516,0
19:42:32,6923.336,Fox,1988,163,66,10,33,22,21,11,1988,1922,1912,1520,581,534,77,86,1011,977,122,1187,516,0
19:42:32,6924.022,Fox,1988,163,64,12,31,24,21,11,1988,1924,1912,1522,581,534,77,86,1011,977,122,1187,516,0
19:42:32,6924.363,Fox,1988,163,64,12,30,25,21,11,1988,1924,1912,1523,581,534,77,86,1011,977,122,1187,516,0
19:42:33,6925.55,Fox,1988,161,64,12,30,23,21,11,1988,1924,1912,1523,581,534,75,86,1011,977,122,1189,516,0
19:42:33,6925.87,Fox,1988,161,62,12,32,23,21,11,1988,1926,1914,1523,581,534,75,86,1011,977,122,1189,516,0
19:42:33,6926.425,Fox,1990,163,64,12,32,23,21,11,1990,1926,1914,1523,581,534,77,86,1013,977,122,1189,516,0
19:42:33,6926.931,Fox,1990,162,64,12,32,23,21,10,1990,1926,1914,1523,581,534,77,85,1013,977,122,1189,517,0
19:42:34,6927.799,Fox,1990,160,62,12,34,21,21,10,1990,1928,1916,1523,581,534,76,84,1013,977,122,1191,517,0
19:42:34,6928.475,Fox,1994,162,64,12,32,21,21,10,1992,1928,1916,1523,581,534,76,86,1015,979,122,1193,517,0
19:42:34,6928.646,Fox,1994,162,66,12,32,21,21,10,1994,1928,1916,1523,581,534,76,86,1015,979,122,1193,517,0
19:42:34,6929.3,Fox,1994,159,66,12,32,19,21,9,1994,1928,1916,1523,581,534,75,84,1015,979,122,1195,518,0
19:42:34,6929.606,Fox,1994,159,64,14,32,19,21,9,1994,1930,1916,1523,581,534,75,84,1015,979,122,1195,518,0
19:42:35,6933.19,Fox,1996,161,66,14,32,19,21,9,1996,1930,1916,1523,581,534,76,85,1016,980,122,1195,518,0
19:42:35,6933.538,Fox,1996,161,64,16,32,19,21,9,1996,1932,1916,1523,581,534,76,85,1016,980,122,1195,518,0
19:42:36,6933.859,Fox,1996,159,64,16,30,19,21,9,1996,1932,1916,1525,581,534,76,83,1016,980,122,1197,518,0
19:42:36,6934.381,Fox,1996,158,64,16,30,18,21,9,1996,1932,1916,1525,581,534,76,82,1016,980,122,1198,518,0
19:42:37,6937.103,Fox,1996,158,62,18,30,18,21,9,1996,1934,1916,1525,581,534,76,82,1016,980,122,1198,518,0
19:42:37,6938.284,Fox,1996,158,60,18,32,18,21,9,1996,1936,1918,1525,581,534,76,82,1016,980,122,1198,518,0
19:42:38,6939.529,Fox,1996,157,60,18,32,18,21,8,1996,1936,1918,1525,581,534,76,81,1016,980,122,1198,519,0
19:42:38,6940.515,Fox,1996,157,58,20,32,18,21,8,1996,1938,1918,1525,581,534,76,81,1016,980,122,1198,519,0
19:42:38,6941.107,Fox,1996,157,56,20,34,18,21,8,1996,1940,1920,1525,581,534,76,81,1016,980,122,1198,519,0
19:42:38,6941.583,Fox,1998,159,58,20,34,18,21,8,1998,1940,1920,1525,581,534,77,82,1017,981,122,1198,519,0
19:42:38,6942.063,Fox,1998,158,58,20,32,20,21,7,1998,1940,1920,1527,581,534,77,81,1017,981,122,1198,520,0
19:42:39,6943.025,Fox,1998,158,58,20,32,20,19,9,1998,1940,1920,1527,581,536,77,81,1017,981,122,1198,520,0
19:42:39,6944.4,Fox,1998,157,56,22,32,19,19,9,1998,1942,1920,1527,581,536,77,80,1017,981,122,1199,520,0
19:42:39,6944.752,Fox,1998,157,56,22,32,19,17,11,1998,1942,1920,1527,581,538,77,80,1017,981,122,1199,520,0
19:42:40,6946.397,Fox,2000,159,58,22,32,19,17,11,2000,1942,1920,1527,581,538,78,81,1018,982,122,1199,520,0
19:42:40,6946.888,Fox,2002,160,56,24,31,19,17,11,2000,1944,1920,1527,581,538,79,81,1020,982,122,1200,520,0
19:42:40,6947.191,Fox,2004,162,58,24,31,19,17,11,2002,1944,1920,1527,581,538,80,82,1021,983,122,1200,520,0
19:42:40,6947.363,Fox,2004,162,60,24,31,19,17,11,2004,1944,1920,1527,581,538,80,82,1021,983,122,1200,520,0
19:42:41,6948.777,Fox,2004,161,60,24,29,21,17,10,2004,1944,1920,1529,581,538,80,81,1021,983,122,1200,521,0
19:42:42,6951.823,Fox,2006,162,62,24,28,21,17,10,2006,1944,1920,1529,581,538,80,82,1022,984,122,1201,521,0
19:42:42,6952.676,Fox,2006,160,62,24,28,19,17,10,2006,1944,1920,1529,581,538,80,80,1022,984,124,1201,521,0
19:42:42,6954.111,Fox,2006,159,60,26,26,20,18,9,2006,1946,1920,1531,582,538,79,80,1022,984,124,1201,522,0
19:42:43,6954.452,Fox,2008,161,62,24,28,20,18,9,2008,1946,1922,1531,582,538,81,80,1024,984,124,1201,522,0
19:42:43,6954.78,Fox,2008,160,62,24,28,20,17,9,2008,1946,1922,1531,582,539,81,79,1024,984,124,1201,523,0
19:42:43,6956.602,Fox,2008,160,60,26,28,20,17,9,2008,1948,1922,1531,582,539,81,79,1024,984,124,1201,523,0
19:42:44,6958.813,Fox,2010,162,62,26,28,20,17,9,2010,1948,1922,1531,582,539,82,80,1025,985,124,1201,523,0
19:42:44,6959.479,Fox,2010,162,60,28,28,20,17,9,2010,1950,1922,1531,582,539,82,80,1025,985,124,1201,523,0
19:42:45,6961.157,Fox,2010,162,58,30,24,24,17,9,2010,1952,1922,1535,582,539,82,80,1025,985,124,1201,523,0
19:42:45,6961.907,Fox,2010,162,58,30,23,25,17,9,2010,1952,1922,1536,582,539,82,80,1025,985,124,1201,523,0
19:42:45,6962.563,Fox,2010,162,58,28,23,27,17,9,2010,1952,1924,1538,582,539,82,80,1025,985,124,1201,523,0
19:42:45,6963.41,Fox,2010,161,58,28,23,25,19,8,2010,1952,1924,1538,584,539,81,80,1025,985,124,1201,524,0
19:42:46,6963.771,Fox,2012,162,60,28,23,24,19,8,2012,1952,1924,1538,584,539,82,80,1027,985,124,1202,524,0
19:42:46,6964.412,Fox,2012,161,56,30,25,24,19,7,2012,1956,1926,1538,584,539,81,80,1027,985,124,1202,525,0
19:42:46,6964.588,Fox,2012,159,56,30,25,22,19,7,2012,1956,1926,1538,584,539,81,78,1027,985,124,1204,525,0
19:42:46,6965.589,Fox,2012,159,54,32,25,21,20,7,2012,1958,1926,1538,585,539,81,78,1027,985,124,1204,525,0
19:42:46,6966.379,Fox,2014,160,54,30,26,21,20,7,2012,1958,1928,1538,585,539,81,79,1028,986,124,1205,525,0
19:42:47,6966.734,Fox,2016,162,56,30,26,21,20,7,2014,1958,1928,1538,585,539,82,80,1029,987,124,1205,525,0
19:42:47,6966.926,Fox,2016,162,58,30,26,21,18,9,2016,1958,1928,1538,585,541,82,80,1029,987,124,1205,525,0
19:42:47,6967.598,Fox,2016,162,58,30,24,22,19,9,2016,1958,1928,1540,586,541,82,80,1029,987,124,1205,525,0
19:42:47,6968.097,Fox,2016,162,58,28,26,22,19,9,2016,1958,1930,1540,586,541,82,80,1029,987,124,1205,525,0
19:42:48,6969.703,Fox,2016,161,58,28,26,22,19,8,2016,1958,1930,1540,586,541,81,80,1029,987,124,1205,526,0
19:42:48,6970.959,Fox,2016,161,56,30,26,22,19,8,2016,1960,1930,1540,586,541,81,80,1029,987,124,1205,526,0
19:42:48,6971.602,Fox,2016,160,56,30,26,21,19,8,2016,1960,1930,1540,586,541,80,80,1029,987,125,1205,526,0
19:42:48,6971.949,Fox,2016,160,56,28,28,21,19,8,2016,1960,1932,1540,586,541,80,80,1029,987,125,1205,526,0
19:42:48,6972.464,Fox,2016,159,56,28,28,20,19,8,2016,1960,1932,1540,586,541,79,80,1029,987,125,1206,526,0
19:42:49,6973.951,Fox,2016,159,56,28,28,19,20,8,2016,1960,1932,1540,587,541,79,80,1029,987,125,1206,526,0
19:42:49,6974.414,Fox,2016,158,56,28,28,18,21,7,2016,1960,1932,1540,588,541,78,80,1029,987,125,1206,527,0
19:42:49,6974.904,Fox,2016,158,56,28,27,19,21,7,2016,1960,1932,1541,588,541,78,80,1029,987,125,1206,527,0
19:42:49,6975.247,Fox,2016,158,56,28,26,20,21,7,2016,1960,1932,1542,588,541,78,80,1029,987,125,1206,527,0
19:42:50,6975.593,Fox,2016,158,54,28,26,22,21,7,2016,1962,1934,1544,588,541,78,80,1029,987,125,1206,527,0
19:42:50,6976.759,Fox,2016,158,54,26,28,22,21,7,2016,1962,1936,1544,588,541,78,80,1029,987,125,1206,527,0
19:42:50,6977.357,Fox,2016,158,54,26,26,22,23,7,2016,1962,1936,1546,590,541,78,80,1029,987,125,1206,527,0
19:42:51,6979.014,Fox,2016,158,50,28,28,22,23,7,2016,1966,1938,1546,590,541,78,80,1029,987,125,1206,527,0
19:42:51,6979.462,Fox,2016,158,50,26,30,22,23,7,2016,1966,1940,1546,590,541,78,80,1029,987,125,1206,527,0
19:42:52,6981.626,Fox,2016,158,50,26,28,24,23,7,2016,1966,1940,1548,590,541,78,80,1029,987,125,1206,527,0
19:42:52,6982.916,Fox,2016,158,50,24,30,24,23,7,2016,1966,1942,1548,590,541,78,80,1029,987,125,1206,527,0
19:42:52,6983.436,Fox,2016,158,46,28,30,24,23,7,2016,1970,1942,1548,590,541,78,80,1029,987,125,1206,527,0
19:42:53,6985.424,Fox,2018,160,48,26,32,24,23,7,2018,1970,1944,1548,590,541,79,81,1030,988,125,1206,527,0
19:42:53,6985.792,Fox,2018,159,48,26,32,23,23,7,2018,1970,1944,1548,590,541,79,80,1030,988,125,1207,527,0
19:42:53,6986.325,Fox,2018,157,46,28,32,21,23,7,2018,1972,1944,1548,590,541,78,79,1030,988,125,1209,527,0
19:42:53,6986.507,Fox,2018,157,46,28,30,23,23,7,2018,1972,1944,1550,590,541,78,79,1030,988,125,1209,527,0
19:42:54,6988.064,Fox,2018,155,46,28,28,23,23,7,2018,1972,1944,1552,590,541,78,77,1030,988,125,1211,527,0
19:42:54,6988.57,Fox,2020,157,44,30,28,23,23,7,2018,1974,1944,1552,590,541,79,78,1031,989,125,1211,527,0
19:42:54,6988.749,Fox,2020,157,46,30,28,23,23,7,2020,1974,1944,1552,590,541,79,78,1031,989,125,1211,527,0
19:42:54,6990.053,Fox,2022,159,46,30,28,23,21,9,2020,1974,1944,1552,590,543,80,79,1032,990,125,1211,527,0
19:42:54,6990.209,Fox,2022,159,48,30,28,23,21,9,2022,1974,1944,1552,590,543,80,79,1032,990,125,1211,527,0
19:42:55,6992.033,Fox,2022,157,48,30,28,21,21,9,2022,1974,1944,1552,590,543,78,79,1032,990,125,1213,527,0
19:42:55,6992.604,Fox,2024,159,50,30,28,21,21,9,2024,1974,1944,1552,590,543,80,79,1034,990,125,1213,527,0
19:42:55,6992.776,Fox,2024,159,50,28,30,21,21,9,2024,1974,1946,1552,590,543,80,79,1034,990,125,1213,527,0
19:42:56,6993.907,Fox,2024,159,48,30,30,21,21,9,2024,1976,1946,1552,590,543,80,79,1034,990,125,1213,527,0
19:42:56,6994.375,Fox,2024,159,48,30,30,21,19,11,2024,1976,1946,1552,590,545,80,79,1034,990,125,1213,527,0
19:42:56,6995.036,Fox,2024,159,48,28,32,21,19,11,2024,1976,1948,1552,590,545,80,79,1034,990,125,1213,527,0
19:42:56,6995.516,Fox,2024,159,48,28,32,20,20,11,2024,1976,1948,1552,591,545,80,79,1034,990,125,1213,527,0
19:42:56,6996.189,Fox,2024,159,46,30,32,20,20,11,2024,1978,1948,1552,591,545,80,79,1034,990,125,1213,527,0
19:42:57,6996.688,Fox,2024,159,44,32,32,20,20,11,2024,1980,1948,1552,591,545,80,79,1034,990,125,1213,527,0
19:42:57,6998.021,Fox,2024,159,40,34,34,20,20,11,2024,1984,1950,1552,591,545,80,79,1034,990,125,1213,527,0
19:42:57,6998.787,Fox,2024,157,40,34,32,20,20,11,2024,1984,1950,1554,591,545,80,77,1034,990,125,1215,527,0
19:42:57,6999.106,Fox,2024,157,38,36,32,20,20,11,2024,1986,1950,1554,591,545,80,77,1034,990,125,1215,527,0
19:42:58,6999.609,Fox,2024,157,38,34,34,18,22,11,2024,1986,1952,1554,593,545,80,77,1034,990,125,1215,527,0
19:42:58,7000.871,Fox,2026,159,38,34,34,18,20,13,2024,1986,1952,1554,593,547,80,79,1034,992,125,1215,527,0
19:42:58,7001.203,Fox,2026,158,40,34,34,18,20,12,2026,1986,1952,1554,593,547,80,78,1034,992,125,1215,528,0
19:42:58,7001.709,Fox,2026,158,40,34,32,20,20,12,2026,1986,1952,1556,593,547,80,78,1034,992,125,1215,528,0
19:42:58,7002.174,Fox,2026,158,40,34,32,18,22,12,2026,1986,1952,1556,595,547,80,78,1034,992,125,1215,528,0
19:42:59,7002.637,Fox,2026,158,40,30,36,18,22,12,2026,1986,1956,1556,595,547,80,78,1034,992,125,1215,528,0
19:42:59,7004.165,Fox,2026,158,40,28,38,18,22,12,2026,1986,1958,1556,595,547,80,78,1034,992,125,1215,528,0
19:42:59,7005.081,Fox,2028,159,42,28,37,18,21,13,2028,1986,1958,1556,595,548,81,78,1036,992,125,1216,528,0
19:43:00,7005.566,Fox,2028,158,40,30,37,18,21,12,2028,1988,1958,1556,595,548,80,78,1036,992,125,1216,529,0
19:43:00,7006.725,Fox,2030,159,42,30,37,17,21,12,2030,1988,1958,1556,595,548,80,79,1037,993,125,1217,529,0
19:43:00,7006.871,Fox,2030,159,42,30,37,17,20,13,2030,1988,1958,1556,595,549,80,79,1037,993,125,1217,529,0
19:43:00,7007.673,Fox,2032,161,44,30,37,17,20,13,2032,1988,1958,1556,595,549,82,79,1039,993,125,1217,529,0
19:43:01,7008.915,Fox,2032,161,42,32,37,17,20,13,2032,1990,1958,1556,595,549,82,79,1039,993,125,1217,529,0
19:43:01,7009.53,Fox,2032,159,42,30,39,15,20,13,2032,1990,1960,1556,595,549,82,77,1039,993,125,1219,529,0
19:43:01,7009.997,Fox,2032,158,42,30,39,15,20,12,2032,1990,1960,1556,595,549,81,77,1039,993,125,1219,530,0
19:43:01,7011.136,Fox,2032,158,38,34,39,15,20,12,2032,1994,1960,1556,595,549,81,77,1039,993,125,1219,530,0
19:43:02,7011.979,Fox,2034,159,40,34,38,15,20,12,2034,1994,1960,1556,595,549,81,78,1040,994,125,1220,530,0
19:43:02,7012.154,Fox,2034,157,40,34,38,13,20,12,2034,1994,1960,1556,595,549,79,78,1040,994,125,1222,530,0
19:43:02,7013.389,Fox,2036,158,42,34,37,13,20,12,2036,1994,1960,1556,595,549,79,79,1041,995,126,1222,530,0
19:43:02,7014.257,Fox,2038,160,44,32,39,13,20,12,2038,1994,1962,1556,595,549,80,80,1042,996,126,1222,530,0
19:43:03,7014.768,Fox,2038,159,44,32,37,15,20,11,2038,1994,1962,1558,595,549,80,79,1042,996,126,1222,531,0
19:43:03,7015.471,Fox,2042,163,48,32,37,15,20,11,2042,1994,1962,1558,595,549,82,81,1044,998,126,1222,531,0
19:43:03,7015.835,Fox,2042,163,46,34,37,15,20,11,2042,1996,1962,1558,595,549,82,81,1044,998,126,1222,531,0
19:43:03,7017.191,Fox,2044,165,48,34,37,15,20,11,2044,1996,1962,1558,595,549,84,81,1046,998,126,1222,531,0
19:43:04,7017.504,Fox,2044,164,48,30,41,14,21,10,2044,1996,1966,1558,596,549,83,81,1046,998,126,1222,532,0
19:43:04,7017.848,Fox,2044,164,48,30,41,13,22,10,2044,1996,1966,1558,597,549,83,81,1046,998,126,1222,532,0
19:43:05,7020.975,Fox,2044,163,48,30,41,13,22,9,2044,1996,1966,1558,597,549,83,80,1046,998,126,1222,533,0
19:43:05,7021.971,Fox,2044,163,48,26,45,13,22,9,2044,1996,1970,1558,597,549,83,80,1046,998,126,1222,533,0
19:43:05,7023.025,Fox,2044,163,48,26,43,15,22,9,2044,1996,1970,1560,597,549,83,80,1046,998,126,1222,533,0
19:43:06,7024.169,Fox,2044,163,46,28,43,15,22,9,2044,1998,1970,1560,597,549,83,80,1046,998,126,1222,533,0
19:43:06,7024.916,Fox,2044,163,46,26,43,17,20,11,2044,1998,1972,1562,597,551,83,80,1046,998,126,1222,533,0
19:43:06,7025.219,Fox,2044,161,46,26,43,15,20,11,2044,1998,1972,1562,597,551,82,79,1046,998,126,1224,533,0
19:43:06,7025.838,Fox,2048,165,50,26,43,15,20,11,2048,1998,1972,1562,597,551,85,80,1049,999,126,1224,533,0
19:43:07,7026.638,Fox,2048,165,50,26,42,16,20,11,2048,1998,1972,1563,597,551,85,80,1049,999,126,1224,533,0
19:43:07,7026.942,Fox,2048,165,50,24,44,16,20,11,2048,1998,1974,1563,597,551,85,80,1049,999,126,1224,533,0
19:43:07,7027.416,Fox,2048,164,50,24,44,15,21,10,2048,1998,1974,1563,598,551,84,80,1049,999,126,1224,534,0
19:43:07,7028.617,Fox,2048,164,50,24,42,17,21,10,2048,1998,1974,1565,598,551,84,80,1049,999,126,1224,534,0
19:43:07,7028.916,Fox,2048,164,48,26,42,17,21,10,2048,2000,1974,1565,598,551,84,80,1049,999,126,1224,534,0
19:43:08,7029.679,Fox,2048,164,46,28,42,17,21,10,2048,2002,1974,1565,598,551,84,80,1049,999,126,1224,534,0
19:43:08,7030.009,Fox,2048,164,44,30,42,17,21,10,2048,2004,1974,1565,598,551,84,80,1049,999,126,1224,534,0
19:43:09,7032.549,Fox,2048,164,44,28,43,18,21,10,2048,2004,1976,1566,598,551,84,80,1049,999,126,1224,534,0
19:43:09,7034.375,Fox,2048,164,42,30,43,18,21,10,2048,2006,1976,1566,598,551,84,80,1049,999,126,1224,534,0
19:43:09,7034.665,Fox,2048,163,42,28,45,18,21,9,2048,2006,1978,1566,598,551,83,80,1049,999,126,1224,535,0
19:43:09,7035.269,Fox,2048,163,42,26,47,18,21,9,2048,2006,1980,1566,598,551,83,80,1049,999,126,1224,535,0
19:43:10,7035.999,Fox,2050,165,44,26,47,18,21,9,2050,2006,1980,1566,598,551,84,81,1050,1000,126,1224,535,0
19:43:10,7036.326,Fox,2050,165,44,22,49,20,21,9,2050,2006,1984,1568,598,551,84,81,1050,1000,126,1224,535,0
19:43:10,7037.205,Fox,2050,164,42,24,49,19,21,9,2050,2008,1984,1568,598,551,84,80,1050,1000,126,1225,535,0
19:43:10,7037.55,Fox,2050,164,42,22,50,20,21,9,2050,2008,1986,1569,598,551,84,80,1050,1000,126,1225,535,0
19:43:10,7037.883,Fox,2052,166,44,22,50,20,21,9,2052,2008,1986,1569,598,551,84,82,1050,1002,126,1225,535,0
19:43:11,7039.287,Fox,2052,163,44,22,50,18,20,9,2052,2008,1986,1569,598,551,84,79,1050,1002,126,1228,535,0
19:43:11,7039.444,Fox,2052,163,44,22,48,20,20,9,2052,2008,1986,1571,598,551,84,79,1050,1002,126,1228,535,0
19:43:11,7039.952,Fox,2052,163,44,22,46,22,20,9,2052,2008,1986,1573,598,551,84,79,1050,1002,126,1228,535,0
19:43:11,7040.306,Fox,2052,163,44,22,46,22,16,13,2052,2008,1986,1573,598,555,84,79,1050,1002,126,1228,535,0
19:43:12,7041.383,Fox,2052,163,42,24,46,22,16,13,2052,2010,1986,1573,598,555,84,79,1050,1002,126,1228,535,0
19:43:12,7042.292,Fox,2052,163,42,24,46,21,17,13,2052,2010,1986,1573,599,555,84,79,1050,1002,126,1228,535,0
19:43:12,7042.862,Fox,2054,165,44,24,46,21,17,13,2054,2010,1986,1573,599,555,84,81,1050,1004,126,1228,535,0
19:43:12,7043.55,Fox,2056,167,46,24,44,23,17,13,2056,2010,1986,1575,599,555,86,81,1052,1004,126,1228,535,0
19:43:12,7044.045,Fox,2056,166,46,22,46,23,17,12,2056,2010,1988,1575,599,555,86,80,1052,1004,126,1228,536,0
19:43:13,7044.743,Fox,2056,165,46,22,46,23,17,11,2056,2010,1988,1575,599,555,85,80,1052,1004,126,1228,537,0
19:43:13,7045.647,Fox,2056,165,46,22,44,25,17,11,2056,2010,1988,1577,599,555,85,80,1052,1004,126,1228,537,0
19:43:13,7046.288,Fox,2056,165,44,24,44,25,17,11,2056,2012,1988,1577,599,555,85,80,1052,1004,126,1228,537,0
19:43:13,7046.624,Fox,2056,164,44,24,44,24,17,11,2056,2012,1988,1577,599,555,85,79,1052,1004,126,1229,537,0
19:43:14,7047.45,Fox,2056,164,44,22,46,24,17,11,2056,2012,1990,1577,599,555,85,79,1052,1004,126,1229,537,0
19:43:14,7047.884,Fox,2056,163,44,22,46,23,17,11,2056,2012,1990,1577,599,555,85,78,1052,1004,126,1230,537,0
19:43:14,7049.142,Fox,2056,163,42,24,46,23,17,11,2056,2014,1990,1577,599,555,85,78,1052,1004,126,1230,537,0
19:43:14,7049.575,Fox,2056,163,40,24,48,23,17,11,2056,2016,1992,1577,599,555,85,78,1052,1004,126,1230,537,0
19:43:14,7049.743,Fox,2056,163,40,22,50,23,17,11,2056,2016,1994,1577,599,555,85,78,1052,1004,126,1230,537,0
19:43:15,7050.646,Fox,2058,162,40,22,50,21,17,10,2056,2016,1994,1577,599,555,83,79,1053,1005,126,1232,538,0
19:43:15,7050.836,Fox,2058,162,42,22,50,21,17,10,2058,2016,1994,1577,599,555,83,79,1053,1005,126,1232,538,0
19:43:15,7051.135,Fox,2058,161,42,22,50,21,17,9,2058,2016,1994,1577,599,555,82,79,1053,1005,126,1232,539,0
19:43:15,7053.197,Fox,2058,161,42,22,48,23,17,9,2058,2016,1994,1579,599,555,82,79,1053,1005,126,1232,539,0
19:43:16,7053.924,Fox,2058,160,42,22,48,22,17,9,2058,2016,1994,1579,599,555,81,79,1053,1005,126,1233,539,0
19:43:16,7054.23,Fox,2058,160,42,20,50,22,17,9,2058,2016,1996,1579,599,555,81,79,1053,1005,126,1233,539,0
19:43:16,7054.674,Fox,2058,160,42,20,50,20,19,9,2058,2016,1996,1579,601,555,81,79,1053,1005,126,1233,539,0
19:43:16,7055.54,Fox,2058,158,42,20,48,22,19,7,2058,2016,1996,1581,601,555,80,78,1053,1005,126,1233,541,0
19:43:16,7056.164,Fox,2058,156,42,20,48,18,21,7,2058,2016,1996,1581,603,555,79,77,1053,1005,126,1235,541,0
19:43:17,7056.858,Fox,2066,162,50,20,46,18,21,7,2066,2016,1996,1581,603,555,81,81,1057,1009,128,1235,541,0
19:43:17,7058.486,Fox,2066,162,50,20,44,20,21,7,2066,2016,1996,1583,603,555,81,81,1057,1009,128,1235,541,0
19:43:18,7059.925,Fox,2068,163,52,20,43,20,21,7,2068,2016,1996,1583,603,555,80,83,1057,1011,128,1236,541,0
19:43:18,7060.085,Fox,2068,163,52,20,41,22,21,7,2068,2016,1996,1585,603,555,80,83,1057,1011,128,1236,541,0
19:43:18,7061.174,Fox,2068,163,52,20,41,20,23,7,2068,2016,1996,1585,605,555,80,83,1057,1011,128,1236,541,0
19:43:18,7061.94,Fox,2070,165,54,20,41,20,23,7,2070,2016,1996,1585,605,555,81,84,1058,1012,128,1236,541,0
19:43:19,7062.609,Fox,2072,166,56,18,42,20,23,7,2072,2016,1998,1585,605,555,81,85,1059,1013,129,1236,541,0
19:43:19,7063.148,Fox,2072,166,56,18,38,24,23,7,2072,2016,1998,1589,605,555,81,85,1059,1013,129,1236,541,0
19:43:19,7063.673,Fox,2072,164,56,18,38,22,23,7,2072,2016,1998,1589,605,555,81,83,1059,1013,129,1238,541,0
19:43:19,7064.689,Fox,2072,164,56,18,36,24,23,7,2072,2016,1998,1591,605,555,81,83,1059,1013,129,1238,541,0
19:43:19,7065.142,Fox,2072,163,56,18,36,24,23,6,2072,2016,1998,1591,605,555,80,83,1059,1013,129,1238,542,0
19:43:20,7065.746,Fox,2074,165,58,18,36,24,23,6,2074,2016,1998,1591,605,555,82,83,1061,1013,129,1238,542,0
19:43:20,7067.44,Fox,2074,165,58,16,38,24,23,6,2074,2016,2000,1591,605,555,82,83,1061,1013,129,1238,542,0
19:43:20,7068.074,Fox,2074,165,56,16,40,24,23,6,2074,2018,2002,1591,605,555,82,83,1061,1013,129,1238,542,0
19:43:21,7068.561,Fox,2076,166,58,14,41,23,24,6,2076,2018,2004,1591,606,555,83,83,1063,1013,129,1239,542,0
19:43:21,7069.597,Fox,2078,168,60,14,41,23,24,6,2078,2018,2004,1591,606,555,84,84,1064,1014,129,1239,542,0
19:43:21,7070.091,Fox,2080,170,62,14,39,25,24,6,2080,2018,2004,1593,606,555,84,86,1064,1016,129,1239,542,0
19:43:21,7070.607,Fox,2080,167,62,14,39,23,24,5,2080,2018,2004,1593,606,555,83,84,1064,1016,129,1241,543,0
19:43:22,7071.361,Fox,2080,167,60,16,39,23,24,5,2080,2020,2004,1593,606,555,83,84,1064,1016,129,1241,543,0
19:43:22,7072.783,Fox,2080,167,58,16,41,23,24,5,2080,2022,2006,1593,606,555,83,84,1064,1016,129,1241,543,0
19:43:22,7073.269,Fox,2082,168,60,16,40,23,24,5,2082,2022,2006,1593,606,555,82,86,1064,1018,129,1242,543,0
19:43:22,7073.617,Fox,2082,167,60,16,40,22,24,5,2082,2022,2006,1593,606,555,81,86,1064,1018,129,1243,543,0
19:43:23,7075.188,Fox,2082,164,58,18,40,20,24,4,2082,2024,2006,1593,606,555,81,83,1064,1018,129,1245,544,0
19:43:23,7075.713,Fox,2084,165,58,16,41,20,24,4,2082,2024,2008,1593,606,555,82,83,1066,1018,129,1246,544,0
19:43:23,7076.118,Fox,2086,167,62,16,41,20,24,4,2086,2024,2008,1593,606,555,83,84,1067,1019,129,1246,544,0
19:43:23,7076.501,Fox,2088,169,64,16,41,20,24,4,2088,2024,2008,1593,606,555,84,85,1068,1020,129,1246,544,0
19:43:24,7077.369,Fox,2088,168,64,16,41,20,24,3,2088,2024,2008,1593,606,555,84,84,1068,1020,129,1246,545,0
19:43:24,7078.059,Fox,2088,168,64,16,37,24,24,3,2088,2024,2008,1597,606,555,84,84,1068,1020,129,1246,545,0
19:43:24,7079.884,Fox,2088,168,64,14,39,22,26,3,2088,2024,2010,1597,608,555,84,84,1068,1020,129,1246,545,0
19:43:25,7080.537,Fox,2088,166,64,14,39,20,26,3,2088,2024,2010,1597,608,555,84,82,1068,1020,129,1248,545,0
19:43:25,7082.569,Fox,2090,167,66,14,35,23,26,3,2090,2024,2010,1600,608,555,84,83,1069,1021,129,1249,545,0
19:43:26,7083.589,Fox,2090,167,64,16,35,23,26,3,2090,2026,2010,1600,608,555,84,83,1069,1021,129,1249,545,0
19:43:26,7084.745,Fox,2090,167,64,14,37,23,26,3,2090,2026,2012,1600,608,555,84,83,1069,1021,129,1249,545,0
19:43:26,7085.254,Fox,2090,167,64,14,35,25,26,3,2090,2026,2012,1602,608,555,84,83,1069,1021,129,1249,545,0
19:43:27,7087.321,Fox,2090,167,64,14,34,26,26,3,2090,2026,2012,1603,608,555,84,83,1069,1021,129,1249,545,0
19:43:27,7087.626,Fox,2090,167,62,14,36,26,26,3,2090,2028,2014,1603,608,555,84,83,1069,1021,129,1249,545,0
19:43:27,7087.93,Fox,2090,167,62,12,38,26,26,3,2090,2028,2016,1603,608,555,84,83,1069,1021,129,1249,545,0
19:43:27,7088.454,Fox,2090,165,62,12,38,24,26,3,2090,2028,2016,1603,608,555,82,83,1069,1021,129,1251,545,0
19:43:28,7089.368,Fox,2090,165,60,14,38,24,26,3,2090,2030,2016,1603,608,555,82,83,1069,1021,129,1251,545,0
19:43:28,7090.387,Fox,2092,167,58,16,38,24,26,3,2090,2032,2016,1603,608,555,82,85,1069,1023,129,1251,545,0
19:43:28,7090.561,Fox,2092,165,60,16,38,24,26,1,2092,2032,2016,1603,608,555,81,84,1069,1023,129,1251,547,0
19:43:28,7091.602,Fox,2092,165,60,16,38,24,25,2,2092,2032,2016,1603,608,556,81,84,1069,1023,129,1251,547,0
19:43:29,7093.046,Fox,2092,163,60,16,37,23,25,2,2092,2032,2016,1604,608,556,81,82,1069,1023,129,1253,547,0
19:43:29,7094.48,Fox,2092,163,58,18,37,23,25,2,2092,2034,2016,1604,608,556,81,82,1069,1023,129,1253,547,0
19:43:29,7095.26,Fox,2092,163,58,18,35,25,25,2,2092,2034,2016,1606,608,556,81,82,1069,1023,129,1253,547,0
19:43:30,7095.885,Fox,2092,161,56,20,33,25,25,2,2092,2036,2016,1608,608,556,80,81,1069,1023,130,1254,547,0
19:43:30,7096.244,Fox,2094,162,58,20,32,25,25,2,2094,2036,2016,1608,608,556,81,81,1071,1023,130,1255,547,0
19:43:30,7096.771,Fox,2094,162,56,22,29,28,25,2,2094,2038,2016,1611,608,556,81,81,1071,1023,130,1255,547,0
19:43:30,7098.146,Fox,2094,162,52,26,28,29,25,2,2094,2042,2016,1612,608,556,81,81,1071,1023,130,1255,547,0
19:43:31,7099.792,Fox,2094,162,50,28,28,29,25,2,2094,2044,2016,1612,608,556,81,81,1071,1023,130,1255,547,0
19:43:31,7100.334,Fox,2096,163,52,28,27,29,25,2,2096,2044,2016,1612,608,556,81,82,1072,1024,130,1256,547,0
19:43:31,7101.012,Fox,2096,163,52,28,27,29,23,4,2096,2044,2016,1612,608,558,81,82,1072,1024,130,1256,547,0
19:43:32,7102.269,Fox,2098,164,54,28,26,29,23,4,2098,2044,2016,1612,608,558,81,83,1073,1025,130,1257,547,0
19:43:32,7103.139,Fox,2100,166,56,28,26,29,22,5,2100,2044,2016,1612,608,559,82,84,1074,1026,130,1257,547,0
19:43:32,7104.048,Fox,2102,167,58,28,25,29,22,5,2102,2044,2016,1612,608,559,81,86,1074,1028,130,1258,547,0
19:43:33,7104.73,Fox,2104,168,58,28,24,29,22,5,2102,2044,2016,1613,608,559,80,88,1074,1030,130,1259,547,0
19:43:33,7104.923,Fox,2104,168,60,28,24,29,21,6,2104,2044,2016,1613,608,560,80,88,1074,1030,130,1259,547,0
19:43:33,7105.654,Fox,2106,169,62,28,23,29,21,6,2106,2044,2016,1613,608,560,80,89,1075,1031,130,1260,547,0
19:43:33,7106.442,Fox,2106,168,62,26,25,28,21,6,2106,2044,2018,1613,608,560,80,88,1075,1031,130,1261,547,0
19:43:34,7107.297,Fox,2106,165,62,26,25,25,21,6,2106,2044,2018,1613,608,560,80,85,1075,1031,130,1264,547,0
19:43:34,7108.191,Fox,2108,167,62,26,23,27,21,6,2106,2044,2018,1615,608,560,81,86,1076,1032,130,1264,547,0
19:43:34,7108.366,Fox,2108,167,60,30,23,27,21,6,2108,2048,2018,1615,608,560,81,86,1076,1032,130,1264,547,0
19:43:34,7108.916,Fox,2110,167,62,30,22,26,21,6,2110,2048,2018,1615,608,560,80,87,1076,1034,130,1266,547,0
19:43:34,7109.983,Fox,2112,168,62,28,21,28,21,6,2110,2048,2020,1617,608,560,80,88,1077,1035,130,1267,547,0
19:43:35,7110.19,Fox,2112,168,64,28,20,29,21,6,2112,2048,2020,1618,608,560,80,88,1077,1035,130,1267,547,0
19:43:35,7111.47,Fox,2112,168,64,26,22,29,20,7,2112,2048,2022,1618,608,561,80,88,1077,1035,130,1267,547,0
19:43:36,7113.724,Fox,2112,168,64,24,24,29,20,7,2112,2048,2024,1618,608,561,80,88,1077,1035,130,1267,547,0
19:43:36,7114.821,Fox,2112,168,64,24,23,30,18,9,2112,2048,2024,1619,608,563,80,88,1077,1035,130,1267,547,0
19:43:36,7115.15,Fox,2112,167,64,24,23,29,18,9,2112,2048,2024,1619,608,563,80,87,1077,1035,130,1268,547,0
19:43:37,7116.634,Fox,2112,167,64,24,23,27,20,9,2112,2048,2024,1619,610,563,80,87,1077,1035,130,1268,547,0
19:43:37,7117.194,Fox,2114,169,66,24,23,27,20,9,2114,2048,2024,1619,610,563,81,88,1078,1036,130,1268,547,0
19:43:37,7118.412,Fox,2116,169,66,24,23,23,22,9,2114,2048,2024,1619,612,563,80,89,1079,1037,130,1270,547,0
19:43:37,7118.771,Fox,2118,171,66,26,23,23,22,9,2116,2050,2024,1619,612,563,81,90,1080,1038,130,1270,547,0
19:43:37,7118.963,Fox,2118,171,68,26,23,23,22,9,2118,2050,2024,1619,612,563,81,90,1080,1038,130,1270,547,0
19:43:38,7120.747,Fox,2118,168,66,28,23,20,22,9,2118,2052,2024,1619,612,563,80,88,1080,1038,130,1273,547,0
19:43:38,7122.092,Fox,2118,168,66,26,25,20,22,9,2118,2052,2026,1619,612,563,80,88,1080,1038,130,1273,547,0
19:43:39,7123.253,Fox,2120,170,68,26,24,21,22,9,2120,2052,2026,1620,612,563,82,88,1082,1038,130,1273,547,0
19:43:39,7124.859,Fox,2122,171,70,26,23,21,22,9,2122,2052,2026,1620,612,563,81,90,1082,1040,130,1274,547,0
19:43:40,7125.528,Fox,2124,172,70,28,23,20,22,9,2124,2054,2026,1620,612,563,83,89,1084,1040,130,1275,547,0
19:43:40,7126.212,Fox,2124,172,68,28,25,19,23,9,2124,2056,2028,1620,613,563,83,89,1084,1040,130,1275,547,0
19:43:40,7127.944,Fox,2124,172,68,26,25,21,23,9,2124,2056,2030,1622,613,563,83,89,1084,1040,130,1275,547,0
19:43:41,7128.98,Fox,2124,172,68,24,26,22,23,9,2124,2056,2032,1623,613,563,83,89,1084,1040,130,1275,547,0
19:43:41,7129.637,Fox,2124,172,68,24,26,21,24,9,2124,2056,2032,1623,614,563,83,89,1084,1040,130,1275,547,0
19:43:41,7130.836,Fox,2124,171,68,24,26,21,24,8,2124,2056,2032,1623,614,563,82,89,1084,1040,130,1275,548,0
19:43:42,7131.345,Fox,2124,170,68,24,26,21,24,7,2124,2056,2032,1623,614,563,82,88,1084,1040,130,1275,549,0
19:43:42,7133.075,Fox,2124,170,68,22,28,19,25,8,2124,2056,2034,1623,616,564,82,88,1084,1040,130,1275,549,0
19:43:42,7133.572,Fox,2128,174,70,24,27,19,26,8,2128,2058,2034,1624,617,564,84,90,1086,1042,130,1275,549,0
19:43:42,7133.778,Fox,2128,173,70,24,27,18,26,8,2128,2058,2034,1624,617,564,84,89,1086,1042,130,1276,549,0
19:43:43,7134.485,Fox,2128,173,70,22,29,18,26,8,2128,2058,2036,1624,617,564,84,89,1086,1042,130,1276,549,0
19:43:43,7135.289,Fox,2128,173,70,20,31,18,26,8,2128,2058,2038,1624,617,564,84,89,1086,1042,130,1276,549,0
19:43:43,7136.001,Fox,2128,173,70,20,29,20,26,8,2128,2058,2038,1626,617,564,84,89,1086,1042,130,1276,549,0
19:43:43,7136.555,Fox,2128,173,70,16,33,20,26,8,2128,2058,2042,1626,617,564,84,89,1086,1042,130,1276,549,0
19:43:43,7137.123,Fox,2128,173,70,16,33,20,24,10,2128,2058,2042,1626,617,566,84,89,1086,1042,130,1276,549,0
19:43:44,7138.369,Fox,2128,173,70,14,35,20,24,10,2128,2058,2044,1626,617,566,84,89,1086,1042,130,1276,549,0
19:43:44,7139.557,Fox,2128,172,62,22,35,19,24,10,2128,2066,2044,1626,617,566,84,88,1086,1042,130,1277,549,0
19:43:44,7139.713,Fox,2128,172,62,22,35,19,22,12,2128,2066,2044,1626,617,568,84,88,1086,1042,130,1277,549,0
19:43:45,7140.413,Fox,2128,172,62,22,33,21,22,12,2128,2066,2044,1628,617,568,84,88,1086,1042,130,1277,549,0
19:43:45,7141.455,Fox,2130,173,64,22,33,21,22,11,2130,2066,2044,1628,617,568,85,88,1087,1043,130,1277,550,0
19:43:45,7142.042,Fox,2130,172,64,22,33,21,22,10,2130,2066,2044,1628,617,568,85,87,1087,1043,130,1277,551,0
19:43:45,7142.574,Fox,2130,172,62,24,33,21,22,10,2130,2068,2044,1628,617,568,85,87,1087,1043,130,1277,551,0
19:43:45,7143.157,Fox,2130,171,62,24,33,21,22,9,2130,2068,2044,1628,617,568,85,86,1087,1043,130,1277,552,0
19:43:46,7143.7,Fox,2132,172,64,24,32,21,22,9,2132,2068,2044,1628,617,568,86,86,1089,1043,130,1278,552,0
19:43:46,7144,Fox,2132,171,64,24,32,20,22,9,2132,2068,2044,1628,617,568,86,85,1089,1043,130,1279,552,0
19:43:46,7144.543,Fox,2134,173,64,26,32,20,22,9,2134,2070,2044,1628,617,568,86,87,1089,1045,130,1279,552,0
19:43:46,7145.296,Fox,2134,172,62,28,31,21,22,8,2134,2072,2044,1629,617,568,86,86,1089,1045,130,1279,553,0
19:43:47,7146.476,Fox,2134,170,62,28,31,19,22,8,2134,2072,2044,1629,617,568,84,86,1089,1045,130,1281,553,0
19:43:47,7147,Fox,2134,170,62,24,35,19,22,8,2134,2072,2048,1629,617,568,84,86,1089,1045,130,1281,553,0
19:43:47,7148.336,Fox,2134,170,60,26,33,21,22,8,2134,2074,2048,1631,617,568,84,86,1089,1045,130,1281,553,0
19:43:47,7148.505,Fox,2134,170,60,26,31,23,22,8,2134,2074,2048,1633,617,568,84,86,1089,1045,130,1281,553,0
19:43:48,7149.012,Fox,2136,171,62,26,30,23,22,8,2136,2074,2048,1633,617,568,85,86,1091,1045,130,1282,553,0
19:43:48,7149.187,Fox,2136,171,62,26,30,21,24,8,2136,2074,2048,1633,619,568,85,86,1091,1045,130,1282,553,0
19:43:48,7151.104,Fox,2136,171,60,28,30,21,24,8,2136,2076,2048,1633,619,568,85,86,1091,1045,130,1282,553,0
19:43:49,7152.182,Fox,2136,171,58,30,30,19,26,8,2136,2078,2048,1633,621,568,85,86,1091,1045,130,1282,553,0
19:43:49,7152.523,Fox,2138,173,60,30,30,19,26,8,2138,2078,2048,1633,621,568,86,87,1092,1046,130,1282,553,0
19:43:49,7152.687,Fox,2138,173,58,32,30,19,26,8,2138,2080,2048,1633,621,568,86,87,1092,1046,130,1282,553,0
19:43:49,7154.852,Fox,2138,173,58,32,30,19,25,9,2138,2080,2048,1633,621,569,86,87,1092,1046,130,1282,553,0
19:43:50,7155.412,Fox,2138,173,58,32,30,19,24,10,2138,2080,2048,1633,621,570,86,87,1092,1046,130,1282,553,0
19:43:50,7155.998,Fox,2138,172,56,34,30,18,24,10,2138,2082,2048,1633,621,570,85,87,1092,1046,130,1283,553,0
19:43:50,7156.574,Fox,2138,172,56,34,30,15,27,10,2138,2082,2048,1633,624,570,85,87,1092,1046,130,1283,553,0
19:43:50,7157.098,Fox,2138,172,56,32,32,15,27,10,2138,2082,2050,1633,624,570,85,87,1092,1046,130,1283,553,0
19:43:51,7158.606,Fox,2138,172,52,36,32,15,27,10,2138,2086,2050,1633,624,570,85,87,1092,1046,130,1283,553,0
19:43:51,7159.122,Fox,2138,170,50,36,34,13,27,10,2138,2088,2052,1633,624,570,84,86,1092,1046,130,1285,553,0
19:43:51,7160.742,Fox,2140,172,52,36,34,13,27,10,2140,2088,2052,1633,624,570,85,87,1093,1047,130,1285,553,0
19:43:52,7163.91,Fox,2140,172,52,34,36,13,27,10,2140,2088,2054,1633,624,570,85,87,1093,1047,130,1285,553,0
19:43:53,7164.458,Fox,2142,173,54,34,35,13,27,10,2142,2088,2054,1633,624,570,84,89,1093,1049,130,1286,553,0
19:43:53,7164.83,Fox,2142,173,54,32,37,13,26,11,2142,2088,2056,1633,624,571,84,89,1093,1049,130,1286,553,0
19:43:53,7165.373,Fox,2142,172,52,34,37,13,26,10,2142,2090,2056,1633,624,571,84,88,1093,1049,130,1286,554,0
19:43:54,7167.116,Fox,2146,176,56,34,36,14,26,10,2146,2090,2056,1634,624,571,88,88,1097,1049,130,1286,554,0
19:43:54,7168.047,Fox,2148,177,58,34,35,14,26,10,2148,2090,2056,1634,624,571,88,89,1098,1050,130,1287,554,0
19:43:55,7170.39,Fox,2148,177,58,34,33,16,26,10,2148,2090,2056,1636,624,571,88,89,1098,1050,130,1287,554,0
19:43:55,7170.972,Fox,2150,179,60,34,33,16,26,10,2150,2090,2056,1636,624,571,89,90,1099,1051,130,1287,554,0
19:43:55,7171.342,Fox,2154,182,62,34,32,16,26,10,2152,2090,2056,1636,624,571,91,91,1102,1052,130,1288,554,0
19:43:55,7171.758,Fox,2156,183,66,34,31,14,28,10,2156,2090,2056,1636,626,571,91,92,1103,1053,130,1289,554,0
19:43:55,7172.179,Fox,2158,184,68,32,31,15,28,10,2158,2090,2058,1637,626,571,91,93,1104,1054,130,1290,554,0
19:43:56,7173.118,Fox,2158,184,66,34,31,15,28,10,2158,2092,2058,1637,626,571,91,93,1104,1054,130,1290,554,0
19:43:56,7173.825,Fox,2160,185,68,34,30,15,28,10,2160,2092,2058,1637,626,571,92,93,1106,1054,130,1291,554,0
19:43:56,7175.923,Fox,2160,185,68,34,30,14,29,10,2160,2092,2058,1637,627,571,92,93,1106,1054,130,1291,554,0
19:43:57,7177.45,Fox,2160,183,68,34,30,13,29,9,2160,2092,2058,1637,627,571,92,91,1106,1054,130,1292,555,0
19:43:57,7178.015,Fox,2162,184,70,26,37,13,29,9,2162,2092,2066,1637,627,571,92,92,1107,1055,130,1293,555,0
19:43:57,7178.807,Fox,2162,184,68,28,37,13,29,9,2162,2094,2066,1637,627,571,92,92,1107,1055,130,1293,555,0
19:43:58,7179.934,Fox,2162,184,68,28,37,13,28,10,2162,2094,2066,1637,627,572,92,92,1107,1055,130,1293,555,0
19:43:58,7181.045,Fox,2162,182,68,26,39,10,29,10,2162,2094,2068,1637,628,572,91,91,1107,1055,130,1295,555,0
19:43:59,7182.317,Fox,2162,181,68,26,39,9,29,10,2162,2094,2068,1637,628,572,91,90,1107,1055,130,1296,555,0
19:43:59,7182.913,Fox,2162,181,66,28,37,11,29,10,2162,2096,2068,1639,628,572,91,90,1107,1055,130,1296,555,0
19:43:59,7183.096,Fox,2162,181,66,26,39,11,29,10,2162,2096,2070,1639,628,572,91,90,1107,1055,130,1296,555,0
19:43:59,7183.63,Fox,2162,181,66,24,41,11,29,10,2162,2096,2072,1639,628,572,91,90,1107,1055,130,1296,555,0
19:44:00,7184.99,Fox,2164,183,66,26,41,11,29,10,2164,2098,2072,1639,628,572,91,92,1107,1057,130,1296,555,0
19:44:00,7185.772,Fox,2164,182,64,28,41,11,29,9,2164,2100,2072,1639,628,572,91,91,1107,1057,130,1296,556,0
19:44:00,7186.565,Fox,2164,182,62,30,41,10,30,9,2164,2102,2072,1639,629,572,91,91,1107,1057,130,1296,556,0
19:44:00,7186.926,Fox,2164,182,62,28,43,10,30,9,2164,2102,2074,1639,629,572,91,91,1107,1057,130,1296,556,0
19:44:00,7187.521,Fox,2164,182,60,30,43,10,30,9,2164,2104,2074,1639,629,572,91,91,1107,1057,130,1296,556,0
19:44:01,7188.24,Fox,2166,184,60,32,43,10,30,9,2166,2106,2074,1639,629,572,91,93,1107,1059,130,1296,556,0
19:44:01,7188.443,Fox,2166,184,60,32,41,12,30,9,2166,2106,2074,1641,629,572,91,93,1107,1059,130,1296,556,0
19:44:01,7188.824,Fox,2166,184,60,32,41,10,32,9,2166,2106,2074,1641,631,572,91,93,1107,1059,130,1296,556,0
19:44:01,7189.228,Fox,2166,184,60,32,39,12,32,9,2166,2106,2074,1643,631,572,91,93,1107,1059,130,1296,556,0
19:44:01,7189.592,Fox,2166,184,60,30,41,12,32,9,2166,2106,2076,1643,631,572,91,93,1107,1059,130,1296,556,0
19:44:01,7190.357,Fox,2168,186,62,30,41,12,32,9,2168,2106,2076,1643,631,572,92,94,1108,1060,130,1296,556,0
19:44:01,7190.76,Fox,2170,187,64,28,42,12,32,9,2170,2106,2078,1643,631,572,92,95,1109,1061,130,1297,556,0
19:44:02,7191.167,Fox,2170,187,62,28,44,12,32,9,2170,2108,2080,1643,631,572,92,95,1109,1061,130,1297,556,0
19:44:02,7191.564,Fox,2170,187,60,30,44,12,32,9,2170,2110,2080,1643,631,572,92,95,1109,1061,130,1297,556,0
19:44:02,7192.341,Fox,2172,189,60,30,44,12,30,11,2170,2110,2080,1643,631,574,92,97,1109,1063,130,1297,556,0
19:44:02,7192.779,Fox,2172,189,60,32,44,12,30,11,2172,2112,2080,1643,631,574,92,97,1109,1063,130,1297,556,0
19:44:02,7193.598,Fox,2174,191,62,32,43,13,28,13,2174,2112,2080,1644,631,576,92,99,1109,1065,130,1297,556,0
19:44:03,7194.431,Fox,2174,191,62,30,45,13,28,13,2174,2112,2082,1644,631,576,92,99,1109,1065,130,1297,556,0
19:44:03,7195.046,Fox,2174,191,62,30,44,14,28,13,2174,2112,2082,1645,631,576,92,99,1109,1065,130,1297,556,0
19:44:03,7195.859,Fox,2174,191,62,30,42,16,28,13,2174,2112,2082,1647,631,576,92,99,1109,1065,130,1297,556,0
19:44:03,7196.647,Fox,2176,193,64,30,42,16,28,13,2176,2112,2082,1647,631,576,92,101,1109,1067,130,1297,556,0
19:44:04,7197.241,Fox,2178,195,66,26,44,18,28,13,2178,2112,2086,1649,631,576,94,101,1111,1067,130,1297,556,0
19:44:04,7197.674,Fox,2178,195,66,24,46,18,28,13,2178,2112,2088,1649,631,576,94,101,1111,1067,130,1297,556,0
19:44:04,7198.672,Fox,2180,197,68,24,46,18,26,15,2180,2112,2088,1649,631,578,94,103,1111,1069,130,1297,556,0
19:44:04,7198.862,Fox,2180,195,68,24,44,18,26,15,2180,2112,2088,1651,631,578,93,102,1111,1069,130,1299,556,0
19:44:04,7199.681,Fox,2180,195,66,26,44,18,26,15,2180,2114,2088,1651,631,578,93,102,1111,1069,130,1299,556,0
19:44:05,7200.087,Fox,2180,194,66,26,44,18,26,14,2180,2114,2088,1651,631,578,93,101,1111,1069,130,1299,557,0
19:44:05,7200.896,Fox,2182,196,68,26,44,18,26,14,2182,2114,2088,1651,631,578,95,101,1113,1069,130,1299,557,0
19:44:05,7201.321,Fox,2184,198,68,28,44,18,26,14,2184,2116,2088,1651,631,578,95,103,1113,1071,130,1299,557,0
19:44:05,7201.865,Fox,2186,200,68,30,44,18,26,14,2186,2118,2088,1651,631,578,95,105,1113,1073,130,1299,557,0
19:44:05,7202.474,Fox,2186,199,68,30,44,18,26,13,2186,2118,2088,1651,631,578,95,104,1113,1073,130,1299,558,0
19:44:06,7203.419,Fox,2188,201,70,30,44,18,26,13,2188,2118,2088,1651,631,578,96,105,1114,1074,130,1299,558,0
19:44:06,7203.595,Fox,2188,201,70,28,46,18,26,13,2188,2118,2090,1651,631,578,96,105,1114,1074,130,1299,558,0
19:44:06,7204.194,Fox,2188,200,70,28,46,17,26,13,2188,2118,2090,1651,631,578,96,104,1114,1074,130,1300,558,0
19:44:06,7205.417,Fox,2188,198,70,28,46,16,26,12,2188,2118,2090,1651,631,578,95,103,1114,1074,130,1301,559,0
19:44:07,7206.026,Fox,2188,197,68,30,46,16,25,12,2188,2120,2090,1651,631,579,95,102,1114,1074,130,1301,560,0
19:44:07,7207.573,Fox,2188,196,66,32,42,19,25,12,2188,2122,2090,1655,631,579,95,101,1114,1074,130,1302,560,0
19:44:07,7208.21,Fox,2188,196,64,34,42,19,25,12,2188,2124,2090,1655,631,579,95,101,1114,1074,130,1302,560,0
19:44:08,7209.354,Fox,2190,198,66,34,42,19,25,12,2190,2124,2090,1655,631,579,95,103,1114,1076,130,1302,560,0
19:44:08,7210.213,Fox,2194,199,70,34,42,18,25,10,2194,2124,2090,1655,631,579,95,104,1116,1078,130,1303,562,0
19:44:08,7211.574,Fox,2194,199,70,32,44,18,25,10,2194,2124,2092,1655,631,579,95,104,1116,1078,130,1303,562,0
19:44:09,7214.355,Fox,2196,200,72,32,43,18,25,10,2196,2124,2092,1655,631,579,95,105,1117,1079,130,1304,562,0
19:44:10,7216.209,Fox,2198,201,70,36,42,18,25,10,2198,2128,2092,1655,631,579,94,107,1117,1081,130,1305,562,0
19:44:10,7216.857,Fox,2202,203,72,36,40,18,25,10,2200,2128,2092,1655,631,579,94,109,1119,1083,130,1307,562,0
19:44:10,7217.314,Fox,2202,203,74,34,42,18,25,10,2202,2128,2094,1655,631,579,94,109,1119,1083,130,1307,562,0
19:44:10,7217.732,Fox,2202,203,74,34,40,20,23,12,2202,2128,2094,1657,631,581,94,109,1119,1083,130,1307,562,0
19:44:11,7218.109,Fox,2204,202,74,34,40,17,23,12,2202,2128,2094,1657,631,581,92,110,1119,1085,130,1310,562,0
19:44:11,7218.481,Fox,2206,203,76,34,39,17,23,12,2204,2128,2094,1657,631,581,92,111,1120,1086,130,1311,562,0
19:44:11,7218.924,Fox,2206,202,78,34,39,17,23,11,2206,2128,2094,1657,631,581,92,110,1120,1086,130,1311,563,0
19:44:11,7219.576,Fox,2206,202,78,34,37,19,23,11,2206,2128,2094,1659,631,581,92,110,1120,1086,130,1311,563,0
19:44:12,7221.395,Fox,2208,204,80,32,39,19,23,11,2208,2128,2096,1659,631,581,93,111,1121,1087,130,1311,563,0
19:44:12,7221.84,Fox,2210,206,82,32,39,17,25,11,2210,2128,2096,1659,633,581,94,112,1122,1088,130,1311,563,0
19:44:12,7222.316,Fox,2212,208,84,32,39,17,25,11,2212,2128,2096,1659,633,581,95,113,1123,1089,130,1311,563,0
19:44:12,7223.388,Fox,2212,208,84,30,41,17,25,11,2212,2128,2098,1659,633,581,95,113,1123,1089,130,1311,563,0
19:44:13,7224.193,Fox,2212,208,82,30,43,17,25,11,2212,2130,2100,1659,633,581,95,113,1123,1089,130,1311,563,0
19:44:13,7224.391,Fox,2212,208,82,30,41,19,25,11,2212,2130,2100,1661,633,581,95,113,1123,1089,130,1311,563,0
19:44:13,7225.499,Fox,2212,207,82,28,41,21,25,10,2212,2130,2102,1663,633,581,95,112,1123,1089,130,1311,564,0
19:44:13,7226.347,Fox,2212,207,80,28,43,21,25,10,2212,2132,2104,1663,633,581,95,112,1123,1089,130,1311,564,0
19:44:14,7226.991,Fox,2214,208,80,26,44,21,25,10,2212,2132,2106,1663,633,581,96,112,1125,1089,130,1312,564,0
19:44:14,7227.235,Fox,2214,208,80,28,44,21,25,10,2214,2134,2106,1663,633,581,96,112,1125,1089,130,1312,564,0
19:44:14,7228.179,Fox,2214,207,80,28,44,21,25,9,2214,2134,2106,1663,633,581,96,111,1125,1089,130,1312,565,0
19:44:14,7229.423,Fox,2214,207,80,26,46,21,25,9,2214,2134,2108,1663,633,581,96,111,1125,1089,130,1312,565,0
19:44:15,7230.261,Fox,2216,208,82,24,48,20,25,9,2216,2134,2110,1663,633,581,96,112,1126,1090,130,1313,565,0
19:44:15,7231.283,Fox,2218,209,84,22,49,20,25,9,2218,2134,2112,1663,633,581,95,114,1126,1092,130,1314,565,0
19:44:15,7231.707,Fox,2218,209,82,24,49,20,25,9,2218,2136,2112,1663,633,581,95,114,1126,1092,130,1314,565,0
19:44:16,7232.664,Fox,2222,212,82,24,48,21,25,8,2218,2136,2112,1664,633,581,98,114,1129,1093,130,1314,566,0
19:44:16,7232.901,Fox,2222,212,86,24,48,21,25,8,2222,2136,2112,1664,633,581,98,114,1129,1093,130,1314,566,0
19:44:16,7233.921,Fox,2222,212,86,24,48,19,27,8,2222,2136,2112,1664,635,581,98,114,1129,1093,130,1314,566,0
19:44:16,7235.069,Fox,2222,210,84,26,48,17,27,8,2222,2138,2112,1664,635,581,98,112,1129,1093,130,1316,566,0
19:44:17,7235.873,Fox,2224,211,86,26,47,17,27,8,2224,2138,2112,1664,635,581,98,113,1130,1094,130,1317,566,0
19:44:17,7238.464,Fox,2224,211,86,24,44,22,27,8,2224,2138,2114,1669,635,581,98,113,1130,1094,130,1317,566,0
19:44:18,7239.692,Fox,2224,211,86,22,46,22,27,8,2224,2138,2116,1669,635,581,98,113,1130,1094,130,1317,566,0
19:44:18,7240.073,Fox,2224,211,86,20,48,22,27,8,2224,2138,2118,1669,635,581,98,113,1130,1094,130,1317,566,0
19:44:18,7241.207,Fox,2226,212,88,20,47,22,27,8,2226,2138,2118,1669,635,581,98,114,1131,1095,130,1318,566,0
19:44:19,7241.631,Fox,2226,212,88,20,45,22,29,8,2226,2138,2118,1671,637,581,98,114,1131,1095,130,1318,566,0
19:44:19,7243.022,Fox,2226,211,88,20,45,21,29,8,2226,2138,2118,1671,637,581,98,113,1131,1095,130,1319,566,0
19:44:19,7243.661,Fox,2230,213,90,22,42,22,29,8,2230,2140,2118,1672,637,581,98,115,1133,1097,130,1321,566,0
19:44:19,7244.351,Fox,2230,212,90,20,43,23,29,7,2230,2140,2120,1673,637,581,98,114,1133,1097,130,1321,567,0
19:44:20,7244.828,Fox,2232,214,92,20,43,23,29,7,2232,2140,2120,1673,637,581,100,114,1135,1097,130,1321,567,0
19:44:20,7245.981,Fox,2232,214,92,18,45,23,29,7,2232,2140,2122,1673,637,581,100,114,1135,1097,130,1321,567,0
19:44:20,7246.752,Fox,2232,214,92,16,47,23,29,7,2232,2140,2124,1673,637,581,100,114,1135,1097,130,1321,567,0
19:44:20,7247.171,Fox,2232,214,90,18,47,23,29,7,2232,2142,2124,1673,637,581,100,114,1135,1097,130,1321,567,0
19:44:21,7249.029,Fox,2232,209,90,18,47,18,29,7,2232,2142,2124,1673,637,581,99,110,1135,1097,130,1326,567,0
19:44:21,7249.733,Fox,2232,209,86,22,47,18,29,7,2232,2146,2124,1673,637,581,99,110,1135,1097,130,1326,567,0
19:44:22,7250.546,Fox,2236,212,90,22,44,20,29,7,2236,2146,2124,1675,637,581,101,111,1138,1098,130,1327,567,0
19:44:22,7250.846,Fox,2236,212,88,24,44,20,29,7,2236,2148,2124,1675,637,581,101,111,1138,1098,130,1327,567,0
19:44:22,7251.265,Fox,2236,212,88,24,43,21,29,7,2236,2148,2124,1676,637,581,101,111,1138,1098,130,1327,567,0
19:44:22,7251.689,Fox,2236,212,88,24,41,23,29,7,2236,2148,2124,1678,637,581,101,111,1138,1098,130,1327,567,0
19:44:22,7252.146,Fox,2236,211,88,24,41,22,29,7,2236,2148,2124,1678,637,581,101,110,1138,1098,130,1328,567,0
19:44:23,7253.588,Fox,2236,211,86,26,41,22,29,7,2236,2150,2124,1678,637,581,101,110,1138,1098,130,1328,567,0
19:44:23,7254.221,Fox,2236,208,82,30,41,21,27,7,2236,2154,2124,1678,637,583,99,109,1138,1098,130,1329,569,0
19:44:23,7254.698,Fox,2238,208,82,28,44,20,27,7,2238,2156,2128,1678,637,583,99,109,1139,1099,130,1331,569,0
19:44:23,7254.921,Fox,2238,208,80,30,42,22,27,7,2238,2158,2128,1680,637,583,99,109,1139,1099,130,1331,569,0
19:44:23,7255.878,Fox,2238,208,80,30,42,22,25,9,2238,2158,2128,1680,637,585,99,109,1139,1099,130,1331,569,0
19:44:24,7256.529,Fox,2238,208,78,32,42,22,25,9,2238,2160,2128,1680,637,585,99,109,1139,1099,130,1331,569,0
19:44:24,7257.386,Fox,2238,208,78,32,40,24,25,9,2238,2160,2128,1682,637,585,99,109,1139,1099,130,1331,569,0
19:44:24,7257.725,Fox,2238,208,78,32,39,25,25,9,2238,2160,2128,1683,637,585,99,109,1139,1099,130,1331,569,0
19:44:24,7258.09,Fox,2238,207,78,32,38,26,25,8,2238,2160,2128,1684,637,585,98,109,1139,1099,130,1331,570,0
19:44:25,7258.85,Fox,2240,208,80,32,37,26,25,8,2240,2160,2128,1684,637,585,97,111,1139,1101,130,1332,570,0
19:44:25,7260.11,Fox,2242,210,82,32,37,26,25,8,2242,2160,2128,1684,637,585,97,113,1139,1103,130,1332,570,0
19:44:25,7260.688,Fox,2242,210,80,34,37,26,25,8,2242,2162,2128,1684,637,585,97,113,1139,1103,130,1332,570,0
19:44:26,7261.922,Fox,2244,210,80,34,36,25,25,8,2242,2162,2128,1684,637,585,97,113,1140,1104,130,1334,570,0
19:44:26,7262.107,Fox,2244,208,82,34,36,23,25,8,2244,2162,2128,1684,637,585,97,111,1140,1104,130,1336,570,0
19:44:26,7262.474,Fox,2244,208,82,32,38,23,25,8,2244,2162,2130,1684,637,585,97,111,1140,1104,130,1336,570,0
19:44:26,7263.619,Fox,2244,208,82,32,38,23,24,9,2244,2162,2130,1684,637,586,97,111,1140,1104,130,1336,570,0
19:44:26,7264.202,Fox,2244,208,82,32,37,24,24,9,2244,2162,2130,1685,637,586,97,111,1140,1104,130,1336,570,0
19:44:27,7264.975,Fox,2246,210,82,30,39,24,24,9,2244,2162,2132,1685,637,586,98,112,1141,1105,130,1336,570,0
19:44:27,7265.369,Fox,2246,208,84,30,39,22,24,9,2246,2162,2132,1685,637,586,98,110,1141,1105,130,1338,570,0
19:44:27,7265.964,Fox,2248,210,86,28,41,22,24,9,2248,2162,2134,1685,637,586,99,111,1142,1106,130,1338,570,0
19:44:27,7266.533,Fox,2248,209,86,28,41,22,24,8,2248,2162,2134,1685,637,586,98,111,1142,1106,130,1338,571,0
19:44:27,7267.331,Fox,2250,210,88,28,40,22,23,9,2250,2162,2134,1685,637,587,98,112,1143,1107,130,1339,571,0
19:44:27,7267.526,Fox,2250,210,86,30,40,22,23,9,2250,2164,2134,1685,637,587,98,112,1143,1107,130,1339,571,0
19:44:28,7267.915,Fox,2250,209,86,30,40,21,23,9,2250,2164,2134,1685,637,587,97,112,1143,1107,130,1340,571,0
19:44:28,7268.292,Fox,2250,208,86,30,40,20,23,9,2250,2164,2134,1685,637,587,97,111,1143,1107,130,1341,571,0
19:44:28,7268.679,Fox,2250,207,86,30,40,19,23,9,2250,2164,2134,1685,637,587,97,110,1143,1107,130,1342,571,0
19:44:28,7270.203,Fox,2250,207,86,28,42,19,23,9,2250,2164,2136,1685,637,587,97,110,1143,1107,130,1342,571,0
19:44:28,7270.742,Fox,2252,208,86,28,41,19,21,11,2250,2164,2136,1685,637,589,97,111,1144,1108,130,1343,571,0
19:44:29,7271.108,Fox,2254,210,86,30,41,19,20,12,2252,2166,2136,1685,637,590,99,111,1146,1108,130,1343,571,0
19:44:29,7271.307,Fox,2254,210,88,30,41,19,20,12,2254,2166,2136,1685,637,590,99,111,1146,1108,130,1343,571,0
19:44:29,7272.18,Fox,2254,210,88,30,39,21,20,12,2254,2166,2136,1687,637,590,99,111,1146,1108,130,1343,571,0
19:44:29,7272.846,Fox,2254,209,86,32,39,21,20,11,2254,2168,2136,1687,637,590,99,110,1146,1108,130,1343,572,0
19:44:29,7273.203,Fox,2256,211,88,32,39,21,20,11,2256,2168,2136,1687,637,590,100,111,1147,1109,130,1343,572,0
19:44:29,7273.554,Fox,2256,211,86,32,41,21,20,11,2256,2170,2138,1687,637,590,100,111,1147,1109,130,1343,572,0
19:44:30,7274.737,Fox,2258,212,88,32,41,20,20,11,2258,2170,2138,1687,637,590,101,111,1148,1110,130,1344,572,0
19:44:30,7275.076,Fox,2258,212,86,34,41,20,20,11,2258,2172,2138,1687,637,590,101,111,1148,1110,130,1344,572,0
19:44:30,7276.152,Fox,2258,212,84,36,41,18,22,11,2258,2174,2138,1687,639,590,101,111,1148,1110,130,1344,572,0
19:44:31,7277.89,Fox,2260,214,86,36,40,19,22,11,2260,2174,2138,1688,639,590,101,113,1148,1112,130,1344,572,0
19:44:31,7278.429,Fox,2266,218,90,36,38,19,22,11,2264,2174,2138,1688,639,590,104,114,1153,1113,130,1346,572,0
19:44:31,7278.628,Fox,2266,218,92,36,38,19,22,11,2266,2174,2138,1688,639,590,104,114,1153,1113,130,1346,572,0
19:44:31,7279.186,Fox,2266,218,90,38,38,19,22,11,2266,2176,2138,1688,639,590,104,114,1153,1113,130,1346,572,0
19:44:31,7279.741,Fox,2266,218,88,40,38,19,22,11,2266,2178,2138,1688,639,590,104,114,1153,1113,130,1346,572,0
19:44:32,7280.635,Fox,2268,220,90,40,38,19,22,11,2268,2178,2138,1688,639,590,104,116,1153,1115,130,1346,572,0
19:44:32,7281.206,Fox,2270,222,90,42,38,19,22,11,2270,2180,2138,1688,639,590,106,116,1155,1115,130,1346,572,0
19:44:32,7281.951,Fox,2270,222,90,40,39,20,22,11,2270,2180,2140,1689,639,590,106,116,1155,1115,130,1346,572,0
19:44:32,7282.823,Fox,2270,222,90,40,39,18,24,11,2270,2180,2140,1689,641,590,106,116,1155,1115,130,1346,572,0
19:44:33,7283.482,Fox,2270,222,88,42,39,18,24,11,2270,2182,2140,1689,641,590,106,116,1155,1115,130,1346,572,0
19:44:33,7283.988,Fox,2272,223,86,44,37,19,24,11,2270,2184,2140,1690,641,590,106,117,1156,1116,130,1347,572,0
19:44:33,7284.376,Fox,2274,224,88,46,36,19,24,11,2274,2186,2140,1690,641,590,107,117,1158,1116,130,1348,572,0
19:44:33,7284.741,Fox,2274,224,88,46,35,20,24,11,2274,2186,2140,1691,641,590,107,117,1158,1116,130,1348,572,0
19:44:33,7285.305,Fox,2276,225,90,46,34,20,24,11,2276,2186,2140,1691,641,590,108,117,1160,1116,130,1349,572,0
19:44:33,7285.686,Fox,2276,225,90,44,34,22,24,11,2276,2186,2142,1693,641,590,108,117,1160,1116,130,1349,572,0
19:44:34,7286.025,Fox,2276,225,88,46,34,22,24,11,2276,2188,2142,1693,641,590,108,117,1160,1116,130,1349,572,0
19:44:34,7286.789,Fox,2276,225,88,46,32,24,22,13,2276,2188,2142,1695,641,592,108,117,1160,1116,130,1349,572,0
19:44:34,7287.16,Fox,2276,225,88,46,31,25,22,13,2276,2188,2142,1696,641,592,108,117,1160,1116,130,1349,572,0
19:44:34,7288.28,Fox,2276,224,88,42,35,24,22,13,2276,2188,2146,1696,641,592,107,117,1160,1116,130,1350,572,0
19:44:35,7289.369,Fox,2276,224,88,40,37,22,24,13,2276,2188,2148,1696,643,592,107,117,1160,1116,130,1350,572,0
19:44:35,7289.551,Fox,2276,224,88,40,37,22,22,15,2276,2188,2148,1696,643,594,107,117,1160,1116,130,1350,572,0
19:44:35,7289.889,Fox,2276,224,88,40,36,23,22,15,2276,2188,2148,1697,643,594,107,117,1160,1116,130,1350,572,0
19:44:35,7290.561,Fox,2276,224,88,40,34,24,23,15,2276,2188,2148,1699,644,594,107,117,1160,1116,130,1350,572,0
19:44:35,7291.066,Fox,2276,223,88,40,34,24,23,14,2276,2188,2148,1699,644,594,107,116,1160,1116,130,1350,573,0
19:44:36,7291.948,Fox,2276,223,86,40,35,25,23,14,2276,2190,2150,1700,644,594,107,116,1160,1116,130,1350,573,0
19:44:36,7292.298,Fox,2278,224,88,40,34,23,25,14,2278,2190,2150,1700,646,594,106,118,1160,1118,130,1351,573,0
19:44:36,7292.678,Fox,2278,223,84,40,38,22,25,14,2278,2194,2154,1700,646,594,106,117,1160,1118,130,1352,573,0
19:44:36,7292.872,Fox,2278,223,84,38,40,22,25,14,2278,2194,2156,1700,646,594,106,117,1160,1118,130,1352,573,0
19:44:36,7293.252,Fox,2278,223,84,36,42,22,25,14,2278,2194,2158,1700,646,594,106,117,1160,1118,130,1352,573,0
19:44:36,7294.024,Fox,2278,223,84,36,42,22,22,17,2278,2194,2158,1700,646,597,106,117,1160,1118,130,1352,573,0
19:44:36,7294.449,Fox,2278,222,84,36,42,21,22,17,2278,2194,2158,1700,646,597,106,116,1160,1118,130,1353,573,0
19:44:37,7295.184,Fox,2278,221,84,34,44,20,22,17,2278,2194,2160,1700,646,597,106,115,1160,1118,130,1354,573,0
19:44:37,7295.694,Fox,2280,223,86,34,44,20,22,17,2280,2194,2160,1700,646,597,106,117,1160,1120,130,1354,573,0
19:44:37,7296.076,Fox,2280,222,86,34,44,19,22,17,2280,2194,2160,1700,646,597,106,116,1160,1120,130,1355,573,0
19:44:37,7296.978,Fox,2280,220,84,36,44,17,22,17,2280,2196,2160,1700,646,597,106,114,1160,1120,130,1357,573,0
19:44:37,7297.738,Fox,2282,221,86,36,44,16,22,17,2282,2196,2160,1700,646,597,107,114,1161,1121,130,1358,573,0
19:44:38,7299.008,Fox,2282,221,84,36,45,17,22,17,2282,2198,2162,1701,646,597,107,114,1161,1121,130,1358,573,0
19:44:38,7299.557,Fox,2282,221,80,40,45,17,22,17,2282,2202,2162,1701,646,597,107,114,1161,1121,130,1358,573,0
19:44:38,7300.45,Fox,2282,220,80,40,43,18,22,17,2282,2202,2162,1703,646,597,107,113,1161,1121,130,1359,573,0
19:44:39,7300.828,Fox,2282,220,78,42,41,20,22,17,2282,2204,2162,1705,646,597,107,113,1161,1121,130,1359,573,0
19:44:39,7301.192,Fox,2282,218,76,44,41,18,22,17,2282,2206,2162,1705,646,597,107,111,1161,1121,130,1361,573,0
19:44:39,7302.314,Fox,2282,217,76,44,41,17,22,17,2282,2206,2162,1705,646,597,107,110,1161,1121,130,1362,573,0
19:44:39,7303.187,Fox,2284,218,78,44,41,17,21,17,2284,2206,2162,1705,646,597,108,110,1163,1121,130,1363,573,0
19:44:40,7303.771,Fox,2286,219,80,44,40,17,21,17,2286,2206,2162,1705,646,597,108,111,1164,1122,130,1364,573,0
19:44:40,7304.161,Fox,2286,218,78,46,40,17,21,16,2286,2208,2162,1705,646,597,107,111,1164,1122,130,1364,574,0
19:44:40,7304.354,Fox,2286,218,76,48,40,17,21,16,2286,2210,2162,1705,646,597,107,111,1164,1122,130,1364,574,0
19:44:40,7304.923,Fox,2286,218,74,50,38,19,21,16,2286,2212,2162,1707,646,597,107,111,1164,1122,130,1364,574,0
19:44:40,7305.995,Fox,2286,218,74,48,40,19,21,16,2286,2212,2164,1707,646,597,107,111,1164,1122,130,1364,574,0
19:44:40,7306.538,Fox,2286,218,74,48,38,21,21,16,2286,2212,2164,1709,646,597,107,111,1164,1122,130,1364,574,0
19:44:41,7307.34,Fox,2290,221,76,48,38,21,20,16,2288,2212,2164,1709,646,597,107,114,1165,1125,130,1365,574,0
19:44:41,7307.543,Fox,2290,220,78,48,38,21,20,15,2290,2212,2164,1709,646,597,106,114,1165,1125,130,1365,575,0
19:44:41,7308.143,Fox,2292,221,80,48,38,20,20,15,2292,2212,2164,1709,646,597,107,114,1167,1125,130,1366,575,0
19:44:41,7309.288,Fox,2292,221,80,46,40,20,20,15,2292,2212,2166,1709,646,597,107,114,1167,1125,130,1366,575,0
19:44:42,7309.854,Fox,2292,220,78,48,40,20,20,14,2292,2214,2166,1709,646,597,107,113,1167,1125,130,1366,576,0
19:44:42,7310.786,Fox,2294,220,80,48,39,19,20,14,2294,2214,2166,1709,646,597,107,113,1168,1126,130,1368,576,0
19:44:42,7311.181,Fox,2294,219,80,48,39,16,22,14,2294,2214,2166,1709,648,597,107,112,1168,1126,130,1369,576,0
19:44:42,7311.376,Fox,2294,219,80,46,41,16,22,14,2294,2214,2168,1709,648,597,107,112,1168,1126,130,1369,576,0
19:44:42,7311.758,Fox,2294,219,80,44,43,16,22,14,2294,2214,2170,1709,648,597,107,112,1168,1126,130,1369,576,0
19:44:43,7312.894,Fox,2296,221,80,46,43,16,22,14,2296,2216,2170,1709,648,597,108,113,1169,1127,130,1369,576,0
19:44:43,7313.066,Fox,2296,221,80,46,43,14,24,14,2296,2216,2170,1709,650,597,108,113,1169,1127,130,1369,576,0
19:44:43,7313.622,Fox,2296,221,80,44,45,14,23,15,2296,2216,2172,1709,650,598,108,113,1169,1127,130,1369,576,0
19:44:43,7313.825,Fox,2296,221,78,46,45,14,23,15,2296,2218,2172,1709,650,598,108,113,1169,1127,130,1369,576,0
19:44:43,7314.886,Fox,2296,219,78,44,47,14,23,13,2296,2218,2174,1709,650,598,107,112,1169,1127,130,1369,578,0
19:44:43,7315.444,Fox,2296,217,74,48,44,15,23,13,2296,2222,2174,1712,650,598,105,112,1169,1127,130,1371,578,0
19:44:44,7316.184,Fox,2296,215,74,48,44,15,23,11,2296,2222,2174,1712,650,598,103,112,1169,1127,130,1371,580,0
19:44:44,7316.891,Fox,2296,213,74,48,44,13,23,11,2296,2222,2174,1712,650,598,103,110,1169,1127,130,1373,580,0
19:44:44,7317.757,Fox,2296,213,74,46,46,13,23,11,2296,2222,2176,1712,650,598,103,110,1169,1127,130,1373,580,0
19:44:44,7318.404,Fox,2296,212,72,46,48,13,22,11,2296,2224,2178,1712,650,599,102,110,1169,1127,130,1373,581,0
19:44:44,7318.567,Fox,2296,212,72,46,48,12,23,11,2296,2224,2178,1712,651,599,102,110,1169,1127,130,1373,581,0
19:44:45,7319.723,Fox,2296,212,72,44,50,12,23,11,2296,2224,2180,1712,651,599,102,110,1169,1127,130,1373,581,0
19:44:45,7320.696,Fox,2298,213,74,44,49,12,23,11,2298,2224,2180,1712,651,599,101,112,1169,1129,130,1374,581,0
19:44:45,7321.055,Fox,2298,212,74,44,49,12,23,10,2298,2224,2180,1712,651,599,101,111,1169,1129,130,1374,582,0
19:44:46,7321.812,Fox,2300,214,76,44,49,12,23,10,2300,2224,2180,1712,651,599,102,112,1170,1130,130,1374,582,0
19:44:46,7321.983,Fox,2300,214,76,42,51,12,23,10,2300,2224,2182,1712,651,599,102,112,1170,1130,130,1374,582,0
19:44:46,7322.486,Fox,2300,214,76,40,53,12,23,10,2300,2224,2184,1712,651,599,102,112,1170,1130,130,1374,582,0
19:44:46,7323.115,Fox,2300,214,76,38,53,14,23,10,2300,2224,2186,1714,651,599,102,112,1170,1130,130,1374,582,0
19:44:46,7323.87,Fox,2300,214,74,40,53,14,22,11,2300,2226,2186,1714,651,600,102,112,1170,1130,130,1374,582,0
19:44:47,7324.444,Fox,2300,214,74,38,55,14,22,11,2300,2226,2188,1714,651,600,102,112,1170,1130,130,1374,582,0
19:44:47,7325.339,Fox,2300,214,74,38,54,15,22,11,2300,2226,2188,1715,651,600,102,112,1170,1130,130,1374,582,0
19:44:47,7325.7,Fox,2300,211,74,38,54,12,22,11,2300,2226,2188,1715,651,600,101,110,1170,1130,130,1377,582,0
19:44:47,7326.321,Fox,2300,211,70,42,52,14,20,13,2300,2230,2188,1717,651,602,101,110,1170,1130,130,1377,582,0
19:44:47,7326.742,Fox,2302,212,72,42,51,14,20,13,2302,2230,2188,1717,651,602,101,111,1171,1131,130,1378,582,0
19:44:47,7327.174,Fox,2306,214,74,42,49,14,20,13,2304,2230,2188,1717,651,602,100,114,1172,1134,130,1380,582,0
19:44:48,7327.403,Fox,2306,214,74,44,49,14,20,13,2306,2232,2188,1717,651,602,100,114,1172,1134,130,1380,582,0
19:44:48,7328.042,Fox,2310,218,78,44,49,14,20,13,2310,2232,2188,1717,651,602,101,117,1173,1137,130,1380,582,0
19:44:48,7329.78,Fox,2310,217,78,44,49,14,20,12,2310,2232,2188,1717,651,602,100,117,1173,1137,130,1380,583,0
19:44:49,7330.565,Fox,2310,217,78,42,49,16,20,12,2310,2232,2190,1719,651,602,100,117,1173,1137,130,1380,583,0
19:44:49,7331.135,Fox,2312,219,80,42,49,16,20,12,2312,2232,2190,1719,651,602,100,119,1173,1139,130,1380,583,0
19:44:49,7331.591,Fox,2314,220,82,38,52,16,20,12,2314,2232,2194,1719,651,602,100,120,1174,1140,130,1381,583,0
19:44:49,7333.003,Fox,2314,220,78,42,52,16,20,12,2314,2236,2194,1719,651,602,100,120,1174,1140,130,1381,583,0
19:44:50,7333.566,Fox,2314,217,78,42,52,14,20,11,2314,2236,2194,1719,651,602,99,118,1174,1140,130,1383,584,0
19:44:50,7334.359,Fox,2314,216,78,42,51,15,20,10,2314,2236,2194,1720,651,602,99,117,1174,1140,130,1383,585,0
19:44:50,7334.76,Fox,2316,217,80,42,51,14,20,10,2316,2236,2194,1720,651,602,98,119,1174,1142,130,1384,585,0
19:44:50,7335.43,Fox,2316,217,80,40,53,13,21,10,2316,2236,2196,1720,652,602,98,119,1174,1142,130,1384,585,0
19:44:51,7336.735,Fox,2316,215,80,40,53,11,21,10,2316,2236,2196,1720,652,602,98,117,1174,1142,130,1386,585,0
19:44:51,7337.333,Fox,2316,215,78,40,55,11,21,10,2316,2238,2198,1720,652,602,98,117,1174,1142,130,1386,585,0
19:44:51,7338.121,Fox,2316,215,78,36,59,11,21,10,2316,2238,2202,1720,652,602,98,117,1174,1142,130,1386,585,0
19:44:52,7339.421,Fox,2316,215,78,34,61,11,21,10,2316,2238,2204,1720,652,602,98,117,1174,1142,130,1386,585,0
19:44:52,7339.766,Fox,2316,215,78,32,63,11,21,10,2316,2238,2206,1720,652,602,98,117,1174,1142,130,1386,585,0
19:44:52,7341.383,Fox,2316,213,76,34,63,9,21,10,2316,2240,2206,1720,652,602,96,117,1174,1142,130,1388,585,0
19:44:53,7342.48,Fox,2316,213,76,32,64,10,21,10,2316,2240,2208,1721,652,602,96,117,1174,1142,130,1388,585,0
19:44:53,7342.858,Fox,2316,213,74,32,66,10,21,10,2316,2242,2210,1721,652,602,96,117,1174,1142,130,1388,585,0
19:44:53,7343.623,Fox,2316,213,74,30,68,8,23,10,2316,2242,2212,1721,654,602,96,117,1174,1142,130,1388,585,0
19:44:53,7344.693,Fox,2316,212,72,32,68,7,23,10,2316,2244,2212,1721,654,602,96,116,1174,1142,130,1389,585,0
19:44:54,7345.972,Fox,2316,212,72,32,66,9,23,10,2316,2244,2212,1723,654,602,96,116,1174,1142,130,1389,585,0
19:44:54,7347.491,Fox,2318,212,74,32,65,9,23,9,2318,2244,2212,1723,654,602,94,118,1174,1144,130,1390,586,0
19:44:54,7347.677,Fox,2318,212,72,34,65,9,23,9,2318,2246,2212,1723,654,602,94,118,1174,1144,130,1390,586,0
19:44:55,7348.475,Fox,2318,212,70,34,67,9,23,9,2318,2248,2214,1723,654,602,94,118,1174,1144,130,1390,586,0
19:44:55,7348.886,Fox,2324,218,76,34,65,11,23,9,2324,2248,2214,1725,654,602,97,121,1177,1147,130,1390,586,0
19:44:55,7349.836,Fox,2324,218,74,36,64,12,23,9,2324,2250,2214,1726,654,602,97,121,1177,1147,130,1390,586,0
19:44:55,7350.985,Fox,2324,218,74,36,64,11,24,9,2324,2250,2214,1726,655,602,97,121,1177,1147,130,1390,586,0
19:44:55,7351.349,Fox,2324,218,74,34,66,11,24,9,2324,2250,2216,1726,655,602,97,121,1177,1147,130,1390,586,0
19:44:56,7351.887,Fox,2326,220,76,34,66,11,24,9,2326,2250,2216,1726,655,602,99,121,1179,1147,130,1390,586,0
19:44:56,7352.758,Fox,2326,219,76,32,66,12,24,9,2326,2250,2218,1728,655,602,99,120,1179,1147,130,1391,586,0
19:44:56,7353.188,Fox,2326,219,76,32,62,16,24,9,2326,2250,2218,1732,655,602,99,120,1179,1147,130,1391,586,0
19:44:56,7353.577,Fox,2326,219,74,34,60,18,24,9,2326,2252,2218,1734,655,602,99,120,1179,1147,130,1391,586,0
19:44:56,7353.978,Fox,2326,219,72,32,63,19,24,9,2326,2254,2222,1735,655,602,99,120,1179,1147,130,1391,586,0
19:44:57,7354.531,Fox,2328,220,74,32,63,19,24,8,2328,2254,2222,1735,655,602,98,122,1179,1149,130,1392,586,0
19:44:57,7354.974,Fox,2330,221,76,32,63,18,24,8,2330,2254,2222,1735,655,602,99,122,1181,1149,130,1393,586,0
19:44:57,7355.391,Fox,2330,221,76,32,61,20,24,8,2330,2254,2222,1737,655,602,99,122,1181,1149,130,1393,586,0
19:44:57,7355.799,Fox,2330,221,74,34,61,20,24,8,2330,2256,2222,1737,655,602,99,122,1181,1149,130,1393,586,0
19:44:57,7356.428,Fox,2332,222,76,34,60,20,24,8,2332,2256,2222,1737,655,602,100,122,1183,1149,130,1394,586,0
19:44:57,7356.631,Fox,2332,219,76,34,60,18,24,7,2332,2256,2222,1737,655,602,100,119,1183,1149,130,1396,587,0
19:44:57,7357.052,Fox,2332,219,76,32,62,18,24,7,2332,2256,2224,1737,655,602,100,119,1183,1149,130,1396,587,0
19:44:58,7357.627,Fox,2332,218,74,34,62,18,24,6,2332,2258,2224,1737,655,602,99,119,1183,1149,130,1396,588,0
19:44:58,7358.769,Fox,2334,220,76,34,62,18,24,6,2334,2258,2224,1737,655,602,100,120,1184,1150,130,1396,588,0
19:44:58,7358.986,Fox,2334,220,76,34,62,18,22,8,2334,2258,2224,1737,655,604,100,120,1184,1150,130,1396,588,0
19:44:58,7359.546,Fox,2334,220,76,34,61,19,22,8,2334,2258,2224,1738,655,604,100,120,1184,1150,130,1396,588,0
19:44:58,7360.137,Fox,2336,220,78,34,60,18,22,8,2336,2258,2224,1738,655,604,100,120,1185,1151,130,1398,588,0
19:44:59,7360.538,Fox,2336,220,76,36,60,18,22,8,2336,2260,2224,1738,655,604,100,120,1185,1151,130,1398,588,0
19:44:59,7361.131,Fox,2338,221,72,42,59,18,22,8,2338,2266,2224,1738,655,604,100,121,1186,1152,130,1399,588,0
19:44:59,7361.545,Fox,2338,220,72,42,59,18,22,7,2338,2266,2224,1738,655,604,99,121,1186,1152,130,1399,589,0
19:44:59,7362.537,Fox,2340,222,72,40,61,18,22,7,2338,2266,2226,1738,655,604,99,123,1186,1154,130,1399,589,0
19:44:59,7362.749,Fox,2340,222,74,40,61,18,22,7,2340,2266,2226,1738,655,604,99,123,1186,1154,130,1399,589,0
19:45:00,7363.335,Fox,2340,221,72,42,61,17,22,7,2340,2268,2226,1738,655,604,99,122,1186,1154,130,1400,589,0
19:45:00,7363.75,Fox,2340,218,70,44,61,14,22,7,2340,2270,2226,1738,655,604,97,121,1186,1154,130,1403,589,0
19:45:00,7364.375,Fox,2340,217,70,44,61,13,22,7,2340,2270,2226,1738,655,604,97,120,1186,1154,130,1404,589,0
19:45:00,7364.772,Fox,2340,217,70,40,65,13,22,7,2340,2270,2230,1738,655,604,97,120,1186,1154,130,1404,589,0
19:45:00,7365.965,Fox,2340,215,70,38,67,9,24,7,2340,2270,2232,1738,657,604,95,120,1186,1154,130,1406,589,0
19:45:01,7366.741,Fox,2340,215,68,40,65,11,24,7,2340,2272,2232,1740,657,604,95,120,1186,1154,130,1406,589,0
19:45:01,7366.941,Fox,2340,215,66,42,65,11,24,7,2340,2274,2232,1740,657,604,95,120,1186,1154,130,1406,589,0
19:45:01,7367.868,Fox,2340,215,64,44,65,11,24,7,2340,2276,2232,1740,657,604,95,120,1186,1154,130,1406,589,0
19:45:01,7368.708,Fox,2342,216,66,44,64,11,24,7,2342,2276,2232,1740,657,604,94,122,1186,1156,130,1407,589,0
19:45:02,7370.05,Fox,2342,215,66,44,62,12,24,7,2342,2276,2232,1742,657,604,94,121,1186,1156,130,1408,589,0
19:45:02,7371.174,Fox,2344,216,68,44,61,12,24,7,2344,2276,2232,1742,657,604,95,121,1188,1156,130,1409,589,0
19:45:02,7371.578,Fox,2344,215,68,40,65,11,22,9,2344,2276,2236,1742,657,606,95,120,1188,1156,130,1410,589,0
19:45:02,7371.973,Fox,2344,215,68,40,64,12,22,9,2344,2276,2236,1743,657,606,95,120,1188,1156,130,1410,589,0
19:45:03,7372.349,Fox,2344,215,68,40,63,13,22,9,2344,2276,2236,1744,657,606,95,120,1188,1156,130,1410,589,0
19:45:03,7374.226,Fox,2346,216,68,40,60,15,22,9,2344,2276,2236,1746,657,606,96,120,1190,1156,130,1411,589,0
19:45:03,7374.415,Fox,2346,216,70,40,60,15,22,9,2346,2276,2236,1746,657,606,96,120,1190,1156,130,1411,589,0
19:45:03,7375.185,Fox,2346,216,68,42,58,17,22,9,2346,2278,2236,1748,657,606,96,120,1190,1156,130,1411,589,0
19:45:04,7375.77,Fox,2346,216,68,40,60,17,22,9,2346,2278,2238,1748,657,606,96,120,1190,1156,130,1411,589,0
19:45:04,7376.371,Fox,2348,217,70,40,59,17,22,9,2348,2278,2238,1748,657,606,96,121,1191,1157,130,1412,589,0
19:45:05,7378.262,Fox,2350,218,70,42,56,19,22,9,2350,2280,2238,1750,657,606,96,122,1192,1158,130,1413,589,0
19:45:05,7378.86,Fox,2352,220,72,42,54,21,22,9,2352,2280,2238,1752,657,606,97,123,1193,1159,130,1413,589,0
19:45:05,7379.272,Fox,2354,222,74,42,54,21,20,11,2354,2280,2238,1752,657,608,99,123,1195,1159,130,1413,589,0
19:45:05,7380.26,Fox,2354,222,72,42,54,23,20,11,2354,2282,2240,1754,657,608,99,123,1195,1159,130,1413,589,0
19:45:05,7380.457,Fox,2354,220,72,42,54,21,20,11,2354,2282,2240,1754,657,608,99,121,1195,1159,130,1415,589,0
19:45:06,7381.473,Fox,2356,221,74,40,55,21,20,11,2356,2282,2242,1754,657,608,99,122,1196,1160,130,1416,589,0
19:45:06,7382.487,Fox,2356,220,74,40,53,22,20,11,2356,2282,2242,1756,657,608,99,121,1196,1160,130,1417,589,0
19:45:06,7382.885,Fox,2356,219,74,40,51,23,20,11,2356,2282,2242,1758,657,608,99,120,1196,1160,130,1418,589,0
19:45:06,7383.507,Fox,2356,219,74,38,51,25,20,11,2356,2282,2244,1760,657,608,99,120,1196,1160,130,1418,589,0
19:45:07,7384.624,Fox,2356,216,74,38,51,23,20,10,2356,2282,2244,1760,657,608,99,117,1196,1160,130,1420,590,0
19:45:07,7384.982,Fox,2356,216,74,38,50,24,20,10,2356,2282,2244,1761,657,608,99,117,1196,1160,130,1420,590,0
19:45:07,7385.794,Fox,2356,214,72,40,50,22,20,10,2356,2284,2244,1761,657,608,99,115,1196,1160,130,1422,590,0
19:45:07,7386.433,Fox,2356,214,70,40,52,22,20,10,2356,2286,2246,1761,657,608,99,115,1196,1160,130,1422,590,0
19:45:07,7386.823,Fox,2358,215,72,40,52,21,20,10,2358,2286,2246,1761,657,608,98,117,1196,1162,130,1423,590,0
19:45:07,7387.016,Fox,2358,215,72,38,54,21,20,10,2358,2286,2248,1761,657,608,98,117,1196,1162,130,1423,590,0
19:45:08,7388.654,Fox,2358,213,72,36,56,19,20,10,2358,2286,2250,1761,657,608,98,115,1196,1162,130,1425,590,0
19:45:08,7389.416,Fox,2360,212,74,36,55,18,20,9,2360,2286,2250,1761,657,608,97,115,1197,1163,130,1427,591,0
19:45:08,7390.17,Fox,2360,212,70,40,55,18,20,9,2360,2290,2250,1761,657,608,97,115,1197,1163,130,1427,591,0
19:45:09,7390.34,Fox,2360,211,70,40,55,18,20,8,2360,2290,2250,1761,657,608,96,115,1197,1163,130,1427,592,0
19:45:09,7390.958,Fox,2360,210,68,42,53,19,20,8,2360,2292,2250,1763,657,608,96,114,1197,1163,130,1428,592,0
19:45:09,7391.712,Fox,2360,210,68,42,51,21,20,8,2360,2292,2250,1765,657,608,96,114,1197,1163,130,1428,592,0
19:45:09,7392.277,Fox,2364,212,68,40,51,20,21,8,2360,2292,2252,1765,658,608,95,117,1198,1166,130,1430,592,0
19:45:09,7392.49,Fox,2364,212,72,38,53,20,21,8,2364,2292,2254,1765,658,608,95,117,1198,1166,130,1430,592,0
19:45:09,7393.083,Fox,2364,211,72,38,53,19,21,8,2364,2292,2254,1765,658,608,94,117,1198,1166,130,1431,592,0
19:45:10,7393.663,Fox,2364,209,70,40,53,16,22,8,2364,2294,2254,1765,659,608,94,115,1198,1166,130,1433,592,0
19:45:10,7394.06,Fox,2366,208,72,40,52,14,22,8,2366,2294,2254,1765,659,608,93,115,1198,1168,130,1436,592,0
19:45:10,7394.253,Fox,2366,208,72,38,54,14,22,8,2366,2294,2256,1765,659,608,93,115,1198,1168,130,1436,592,0
19:45:10,7394.834,Fox,2368,209,74,38,53,14,22,8,2368,2294,2256,1765,659,608,94,115,1200,1168,130,1437,592,0
19:45:10,7395.389,Fox,2368,209,72,40,53,14,22,8,2368,2296,2256,1765,659,608,94,115,1200,1168,130,1437,592,0
19:45:10,7395.929,Fox,2368,209,72,38,54,15,22,8,2368,2296,2258,1766,659,608,94,115,1200,1168,130,1437,592,0
19:45:11,7396.669,Fox,2370,210,74,38,53,15,22,8,2370,2296,2258,1766,659,608,93,117,1200,1170,130,1438,592,0
19:45:11,7396.875,Fox,2370,209,74,38,53,15,22,7,2370,2296,2258,1766,659,608,93,116,1200,1170,130,1438,593,0
19:45:11,7397.845,Fox,2370,209,74,38,51,17,22,7,2370,2296,2258,1768,659,608,93,116,1200,1170,130,1438,593,0
19:45:11,7398.54,Fox,2370,209,74,38,49,19,22,7,2370,2296,2258,1770,659,608,93,116,1200,1170,130,1438,593,0
19:45:11,7399.081,Fox,2372,210,76,36,50,19,22,7,2372,2296,2260,1770,659,608,93,117,1201,1171,130,1439,593,0
19:45:12,7399.693,Fox,2372,210,76,30,56,19,22,7,2372,2296,2266,1770,659,608,93,117,1201,1171,130,1439,593,0
19:45:12,7399.896,Fox,2372,210,76,30,54,21,22,7,2372,2296,2266,1772,659,608,93,117,1201,1171,130,1439,593,0
19:45:12,7400.307,Fox,2372,210,76,30,53,22,22,7,2372,2296,2266,1773,659,608,93,117,1201,1171,130,1439,593,0
19:45:12,7401.663,Fox,2372,208,76,28,55,20,22,7,2372,2296,2268,1773,659,608,93,115,1201,1171,130,1441,593,0
19:45:12,7402.203,Fox,2372,206,76,26,57,18,22,7,2372,2296,2270,1773,659,608,93,113,1201,1171,130,1443,593,0
19:45:13,7402.992,Fox,2372,206,76,26,56,19,22,7,2372,2296,2270,1774,659,608,93,113,1201,1171,130,1443,593,0
19:45:13,7403.362,Fox,2372,206,74,28,54,21,22,7,2372,2298,2270,1776,659,608,93,113,1201,1171,130,1443,593,0
19:45:13,7403.91,Fox,2372,206,74,28,52,23,22,7,2372,2298,2270,1778,659,608,93,113,1201,1171,130,1443,593,0
19:45:13,7404.499,Fox,2372,205,72,30,52,23,22,6,2372,2300,2270,1778,659,608,93,112,1201,1171,130,1443,594,0
19:45:14,7405.437,Fox,2372,205,72,26,56,23,22,6,2372,2300,2274,1778,659,608,93,112,1201,1171,130,1443,594,0
19:45:14,7406.486,Fox,2372,204,72,24,58,22,22,6,2372,2300,2276,1778,659,608,93,111,1201,1171,130,1444,594,0
19:45:15,7408.365,Fox,2372,202,72,24,58,20,22,6,2372,2300,2276,1778,659,608,93,109,1201,1171,130,1446,594,0
19:45:15,7408.739,Fox,2372,202,72,24,56,22,22,6,2372,2300,2276,1780,659,608,93,109,1201,1171,130,1446,594,0
19:45:15,7409.289,Fox,2372,200,70,26,56,20,22,6,2372,2302,2276,1780,659,608,93,107,1201,1171,130,1448,594,0
19:45:15,7409.627,Fox,2372,200,68,28,56,20,22,6,2372,2304,2276,1780,659,608,93,107,1201,1171,130,1448,594,0
19:45:15,7410.204,Fox,2374,201,66,30,56,19,22,6,2372,2306,2276,1780,659,608,92,109,1201,1173,130,1449,594,0
19:45:15,7410.623,Fox,2374,199,64,34,56,17,22,6,2374,2310,2276,1780,659,608,92,107,1201,1173,130,1451,594,0
19:45:15,7410.825,Fox,2374,198,64,34,56,16,22,6,2374,2310,2276,1780,659,608,92,106,1201,1173,130,1452,594,0
19:45:16,7411.795,Fox,2374,198,64,34,55,17,22,6,2374,2310,2276,1781,659,608,92,106,1201,1173,130,1452,594,0
19:45:16,7412.888,Fox,2374,198,64,34,53,19,22,6,2374,2310,2276,1783,659,608,92,106,1201,1173,130,1452,594,0
19:45:16,7413.653,Fox,2374,197,62,34,55,18,20,8,2374,2312,2278,1783,659,610,92,105,1201,1173,130,1453,594,0
19:45:17,7414.071,Fox,2378,198,64,36,53,17,20,8,2378,2314,2278,1783,659,610,91,107,1203,1175,130,1456,594,0
19:45:17,7414.675,Fox,2380,199,64,36,52,17,20,8,2378,2314,2278,1784,659,610,91,108,1203,1177,130,1457,594,0
19:45:17,7414.884,Fox,2380,199,66,36,52,17,20,8,2380,2314,2278,1784,659,610,91,108,1203,1177,130,1457,594,0
19:45:17,7416.719,Fox,2380,199,66,34,54,17,20,8,2380,2314,2280,1784,659,610,91,108,1203,1177,130,1457,594,0
19:45:18,7417.467,Fox,2380,199,64,36,53,18,20,8,2380,2316,2280,1785,659,610,91,108,1203,1177,130,1457,594,0
19:45:18,7418.559,Fox,2382,200,66,36,52,18,20,8,2382,2316,2280,1785,659,610,90,110,1203,1179,130,1458,594,0
19:45:18,7418.748,Fox,2382,200,66,34,54,18,20,8,2382,2316,2282,1785,659,610,90,110,1203,1179,130,1458,594,0
19:45:18,7419.302,Fox,2382,198,66,34,54,16,20,8,2382,2316,2282,1785,659,610,88,110,1203,1179,130,1460,594,0
19:45:19,7420.38,Fox,2384,200,68,34,54,16,18,10,2384,2316,2282,1785,659,612,88,112,1203,1181,130,1460,594,0
19:45:19,7422.06,Fox,2386,201,70,34,53,16,18,10,2386,2316,2282,1785,659,612,88,113,1204,1182,130,1461,594,0
19:45:19,7422.256,Fox,2386,200,70,34,53,15,18,10,2386,2316,2282,1785,659,612,88,112,1204,1182,130,1462,594,0
19:45:19,7422.839,Fox,2386,200,70,34,52,16,18,10,2386,2316,2282,1786,659,612,88,112,1204,1182,130,1462,594,0
19:45:20,7423.375,Fox,2386,198,70,34,52,14,18,10,2386,2316,2282,1786,659,612,88,110,1204,1182,130,1464,594,0
19:45:20,7424.139,Fox,2388,200,72,34,52,14,18,10,2388,2316,2282,1786,659,612,88,112,1204,1184,130,1464,594,0
19:45:20,7424.516,Fox,2390,201,74,32,53,14,18,10,2390,2316,2284,1786,659,612,89,112,1206,1184,130,1465,594,0
19:45:20,7424.905,Fox,2394,203,76,30,54,13,18,10,2392,2316,2286,1786,659,612,89,114,1207,1187,130,1467,594,0
19:45:20,7425.34,Fox,2396,204,78,30,49,17,18,10,2394,2316,2286,1790,659,612,88,116,1207,1189,130,1468,594,0
19:45:20,7425.56,Fox,2396,204,80,30,49,17,18,10,2396,2316,2286,1790,659,612,88,116,1207,1189,130,1468,594,0
19:45:21,7426.372,Fox,2396,204,80,30,47,19,18,10,2396,2316,2286,1792,659,612,88,116,1207,1189,130,1468,594,0
19:45:21,7426.789,Fox,2396,204,80,30,47,19,16,12,2396,2316,2286,1792,659,614,88,116,1207,1189,130,1468,594,0
19:45:21,7428.15,Fox,2396,203,80,30,47,18,15,13,2396,2316,2286,1792,659,615,88,115,1207,1189,130,1469,594,0
19:45:21,7428.523,Fox,2396,203,80,26,51,18,15,13,2396,2316,2290,1792,659,615,88,115,1207,1189,130,1469,594,0
19:45:22,7429.288,Fox,2396,203,80,24,53,18,15,13,2396,2316,2292,1792,659,615,88,115,1207,1189,130,1469,594,0
19:45:22,7429.857,Fox,2396,201,80,24,53,18,13,13,2396,2316,2292,1792,659,617,87,114,1207,1189,130,1469,596,0
19:45:22,7430.058,Fox,2396,201,78,26,53,18,13,13,2396,2318,2292,1792,659,617,87,114,1207,1189,130,1469,596,0
19:45:22,7431.278,Fox,2398,202,80,26,52,18,13,13,2398,2318,2292,1792,659,617,87,115,1208,1190,130,1470,596,0
19:45:22,7431.478,Fox,2398,202,74,32,52,18,13,13,2398,2324,2292,1792,659,617,87,115,1208,1190,130,1470,596,0
19:45:22,7432.074,Fox,2398,202,74,30,52,20,13,13,2398,2324,2294,1794,659,617,87,115,1208,1190,130,1470,596,0
19:45:23,7432.446,Fox,2400,204,76,30,52,20,13,13,2400,2324,2294,1794,659,617,89,115,1210,1190,130,1470,596,0
19:45:23,7433.214,Fox,2400,203,76,30,52,19,13,13,2400,2324,2294,1794,659,617,89,114,1210,1190,130,1471,596,0
19:45:23,7433.996,Fox,2400,203,76,28,54,19,13,13,2400,2324,2296,1794,659,617,89,114,1210,1190,130,1471,596,0
19:45:23,7434.534,Fox,2400,203,74,30,54,19,13,13,2400,2326,2296,1794,659,617,89,114,1210,1190,130,1471,596,0
19:45:24,7435.756,Fox,2400,200,74,30,54,16,13,13,2400,2326,2296,1794,659,617,88,112,1210,1190,130,1474,596,0
19:45:24,7436.327,Fox,2402,201,76,30,52,17,13,13,2402,2326,2296,1795,659,617,89,112,1212,1190,130,1475,596,0
19:45:24,7437.095,Fox,2402,201,74,32,52,17,13,13,2402,2328,2296,1795,659,617,89,112,1212,1190,130,1475,596,0
19:45:24,7437.493,Fox,2402,201,72,34,52,17,13,13,2402,2330,2296,1795,659,617,89,112,1212,1190,130,1475,596,0
19:45:25,7439.06,Fox,2402,201,70,36,52,17,13,13,2402,2332,2296,1795,659,617,89,112,1212,1190,130,1475,596,0
19:45:25,7439.789,Fox,2402,200,70,36,52,17,13,12,2402,2332,2296,1795,659,617,88,112,1212,1190,130,1475,597,0
19:45:25,7440.588,Fox,2402,199,70,36,50,19,13,11,2402,2332,2296,1797,659,617,87,112,1212,1190,130,1475,598,0
19:45:26,7441.561,Fox,2404,200,68,38,49,19,13,11,2402,2334,2296,1797,659,617,87,113,1213,1191,130,1476,598,0
19:45:26,7441.744,Fox,2404,200,70,36,49,21,13,11,2404,2334,2298,1799,659,617,87,113,1213,1191,130,1476,598,0
19:45:26,7442.486,Fox,2404,198,70,36,49,17,15,11,2404,2334,2298,1799,661,617,86,112,1213,1191,130,1478,598,0
19:45:26,7442.879,Fox,2404,198,68,36,51,17,15,11,2404,2336,2300,1799,661,617,86,112,1213,1191,130,1478,598,0
19:45:26,7443.658,Fox,2408,201,70,38,49,18,15,11,2408,2338,2300,1800,661,617,87,114,1215,1193,130,1479,598,0
19:45:27,7445.391,Fox,2408,201,68,40,49,18,15,11,2408,2340,2300,1800,661,617,87,114,1215,1193,130,1479,598,0
19:45:27,7446.545,Fox,2410,202,68,40,48,17,16,11,2408,2340,2300,1800,662,617,88,114,1217,1193,130,1480,598,0
19:45:27,7446.744,Fox,2410,201,70,40,47,15,18,11,2410,2340,2300,1801,664,617,88,113,1217,1193,130,1481,598,0
19:45:28,7447.771,Fox,2410,201,70,38,48,16,18,11,2410,2340,2302,1802,664,617,88,113,1217,1193,130,1481,598,0
19:45:28,7448.167,Fox,2410,201,70,36,50,16,18,11,2410,2340,2304,1802,664,617,88,113,1217,1193,130,1481,598,0
19:45:28,7448.544,Fox,2410,201,70,34,52,16,16,13,2410,2340,2306,1802,664,619,88,113,1217,1193,130,1481,598,0
19:45:28,7449.089,Fox,2410,201,70,30,54,18,16,13,2410,2340,2310,1804,664,619,88,113,1217,1193,130,1481,598,0
19:45:28,7449.792,Fox,2410,200,70,30,54,18,16,12,2410,2340,2310,1804,664,619,88,112,1217,1193,130,1481,599,0
19:45:29,7450.516,Fox,2410,200,70,30,54,18,14,14,2410,2340,2310,1804,664,621,88,112,1217,1193,130,1481,599,0
19:45:29,7450.863,Fox,2410,198,70,30,54,16,14,14,2410,2340,2310,1804,664,621,88,110,1217,1193,130,1483,599,0
19:45:29,7451.218,Fox,2410,198,68,32,54,16,14,14,2410,2342,2310,1804,664,621,88,110,1217,1193,130,1483,599,0
19:45:29,7452.166,Fox,2410,196,68,30,56,15,14,13,2410,2342,2312,1804,664,621,87,109,1217,1193,130,1484,600,0
19:45:29,7452.537,Fox,2410,196,68,28,56,17,14,13,2410,2342,2314,1806,664,621,87,109,1217,1193,130,1484,600,0
19:45:29,7452.925,Fox,2410,196,68,28,54,19,14,13,2410,2342,2314,1808,664,621,87,109,1217,1193,130,1484,600,0
19:45:30,7453.856,Fox,2410,196,66,30,54,19,14,13,2410,2344,2314,1808,664,621,87,109,1217,1193,130,1484,600,0
19:45:30,7454.268,Fox,2410,195,66,30,54,18,14,13,2410,2344,2314,1808,664,621,87,108,1217,1193,130,1485,600,0
19:45:30,7454.872,Fox,2410,195,66,30,53,19,14,13,2410,2344,2314,1809,664,621,87,108,1217,1193,130,1485,600,0
19:45:30,7455.671,Fox,2412,197,68,30,53,19,14,13,2412,2344,2314,1809,664,621,88,109,1218,1194,130,1485,600,0
19:45:30,7455.881,Fox,2412,197,68,28,55,19,14,13,2412,2344,2316,1809,664,621,88,109,1218,1194,130,1485,600,0
19:45:31,7456.295,Fox,2412,197,68,28,53,21,13,14,2412,2344,2316,1811,664,622,88,109,1218,1194,130,1485,600,0
19:45:31,7457.119,Fox,2414,197,68,30,52,21,13,13,2414,2346,2316,1811,664,622,87,110,1219,1195,130,1486,601,0
19:45:31,7457.292,Fox,2414,196,68,30,52,20,13,13,2414,2346,2316,1811,664,622,87,109,1219,1195,130,1487,601,0
19:45:31,7458.042,Fox,2414,195,68,30,52,19,13,13,2414,2346,2316,1811,664,622,87,108,1219,1195,130,1488,601,0
19:45:32,7458.974,Fox,2414,195,66,32,52,19,13,13,2414,2348,2316,1811,664,622,87,108,1219,1195,130,1488,601,0
19:45:32,7459.559,Fox,2414,193,66,32,50,19,13,13,2414,2348,2316,1813,664,622,86,107,1219,1195,130,1490,601,0
19:45:32,7460.15,Fox,2414,193,66,32,45,22,15,13,2414,2348,2316,1818,666,622,86,107,1219,1195,130,1490,601,0
19:45:32,7460.507,Fox,2416,194,68,32,44,22,15,13,2416,2348,2316,1818,666,622,87,107,1221,1195,130,1491,601,0
19:45:32,7460.866,Fox,2416,193,66,34,44,22,15,12,2416,2350,2316,1818,666,622,86,107,1221,1195,130,1491,602,0
19:45:32,7461.63,Fox,2418,194,64,36,44,21,15,12,2416,2352,2316,1818,666,622,86,108,1222,1196,130,1492,602,0
19:45:33,7462.047,Fox,2418,193,64,38,44,21,15,11,2418,2354,2316,1818,666,622,86,107,1222,1196,130,1492,603,0
19:45:33,7462.446,Fox,2420,194,66,38,41,23,15,11,2420,2354,2316,1820,666,622,86,108,1223,1197,130,1493,603,0
19:45:33,7463.042,Fox,2420,192,66,38,40,22,15,11,2420,2354,2316,1821,666,622,85,107,1223,1197,130,1495,603,0
19:45:33,7464.074,Fox,2420,191,64,40,40,22,15,10,2420,2356,2316,1821,666,622,85,106,1223,1197,130,1495,604,0
19:45:34,7465.354,Fox,2420,190,64,40,40,21,15,10,2420,2356,2316,1821,666,622,85,105,1223,1197,130,1496,604,0
19:45:34,7466.027,Fox,2422,191,66,40,36,24,15,10,2422,2356,2316,1824,666,622,84,107,1223,1199,130,1497,604,0
19:45:35,7468.155,Fox,2424,192,68,40,35,24,15,10,2424,2356,2316,1824,666,622,85,107,1225,1199,130,1498,604,0
19:45:35,7468.535,Fox,2424,192,68,38,37,24,15,10,2424,2356,2318,1824,666,622,85,107,1225,1199,130,1498,604,0
19:45:35,7469.454,Fox,2424,192,66,40,37,24,15,10,2424,2358,2318,1824,666,622,85,107,1225,1199,130,1498,604,0
19:45:35,7470.222,Fox,2426,191,68,34,42,22,15,10,2426,2358,2324,1824,666,622,84,107,1225,1201,130,1501,604,0
19:45:35,7470.786,Fox,2426,189,68,34,42,20,15,10,2426,2358,2324,1824,666,622,83,106,1225,1201,130,1503,604,0
19:45:36,7471.894,Fox,2426,189,66,36,42,20,15,10,2426,2360,2324,1824,666,622,83,106,1225,1201,130,1503,604,0
19:45:36,7472.769,Fox,2426,187,66,36,42,18,14,11,2426,2360,2324,1824,666,623,83,104,1225,1201,130,1505,604,0
19:45:36,7472.942,Fox,2426,187,66,34,44,18,14,11,2426,2360,2326,1824,666,623,83,104,1225,1201,130,1505,604,0
19:45:36,7473.292,Fox,2426,186,66,34,44,17,14,11,2426,2360,2326,1824,666,623,82,104,1225,1201,130,1506,604,0
19:45:36,7473.89,Fox,2426,185,66,34,42,18,15,10,2426,2360,2326,1826,667,623,82,103,1225,1201,130,1506,605,0
19:45:37,7475.204,Fox,2428,187,62,38,42,18,15,10,2426,2364,2326,1826,667,623,83,104,1226,1202,130,1506,605,0
19:45:37,7475.571,Fox,2428,187,64,36,44,18,15,10,2428,2364,2328,1826,667,623,83,104,1226,1202,130,1506,605,0
19:45:37,7476.097,Fox,2428,187,64,34,46,17,16,10,2428,2364,2330,1826,668,623,83,104,1226,1202,130,1506,605,0
19:45:37,7476.434,Fox,2428,184,64,34,46,14,16,10,2428,2364,2330,1826,668,623,81,103,1226,1202,130,1509,605,0
19:45:37,7476.628,Fox,2428,184,62,36,46,14,16,10,2428,2366,2330,1826,668,623,81,103,1226,1202,130,1509,605,0
19:45:38,7477.534,Fox,2428,184,60,36,46,16,16,10,2428,2368,2332,1828,668,623,81,103,1226,1202,130,1509,605,0
19:45:38,7478.512,Fox,2428,184,60,36,46,15,17,10,2428,2368,2332,1828,669,623,81,103,1226,1202,130,1509,605,0
19:45:38,7479.376,Fox,2428,184,58,38,45,16,17,10,2428,2370,2332,1829,669,623,81,103,1226,1202,130,1509,605,0
19:45:39,7480.106,Fox,2430,185,60,36,46,16,17,10,2430,2370,2334,1829,669,623,80,105,1226,1204,130,1510,605,0
19:45:39,7481.124,Fox,2430,185,60,34,48,16,15,12,2430,2370,2336,1829,669,625,80,105,1226,1204,130,1510,605,0
19:45:39,7481.609,Fox,2430,185,58,36,48,16,15,12,2430,2372,2336,1829,669,625,80,105,1226,1204,130,1510,605,0
19:45:39,7482.173,Fox,2430,185,58,34,50,16,15,12,2430,2372,2338,1829,669,625,80,105,1226,1204,130,1510,605,0
19:45:40,7483.854,Fox,2430,185,58,32,52,16,15,12,2430,2372,2340,1829,669,625,80,105,1226,1204,130,1510,605,0
19:45:40,7484.38,Fox,2430,183,58,32,52,14,15,12,2430,2372,2340,1829,669,625,80,103,1226,1204,130,1512,605,0
19:45:40,7484.774,Fox,2430,183,58,32,51,15,15,12,2430,2372,2340,1830,669,625,80,103,1226,1204,130,1512,605,0
19:45:40,7485.301,Fox,2430,183,58,32,50,16,15,12,2430,2372,2340,1831,669,625,80,103,1226,1204,130,1512,605,0
19:45:40,7485.787,Fox,2432,184,60,32,49,16,15,12,2432,2372,2340,1831,669,625,80,104,1227,1205,130,1513,605,0
19:45:41,7487.348,Fox,2434,186,62,32,49,16,15,12,2434,2372,2340,1831,669,625,81,105,1228,1206,130,1513,605,0
19:45:41,7487.735,Fox,2434,183,62,32,49,14,15,11,2434,2372,2340,1831,669,625,81,102,1228,1206,130,1515,606,0
19:45:41,7488.336,Fox,2436,184,64,32,48,14,15,11,2436,2372,2340,1831,669,625,81,103,1229,1207,130,1516,606,0
19:45:41,7488.714,Fox,2438,185,64,32,47,14,14,12,2436,2372,2340,1831,669,626,82,103,1231,1207,130,1517,606,0
19:45:42,7489.103,Fox,2438,185,66,32,44,17,14,12,2438,2372,2340,1834,669,626,82,103,1231,1207,130,1517,606,0
19:45:42,7489.816,Fox,2438,184,66,30,44,18,14,12,2438,2372,2342,1836,669,626,82,102,1231,1207,130,1518,606,0
19:45:42,7490.604,Fox,2440,185,68,30,43,18,14,12,2440,2372,2342,1836,669,626,82,103,1232,1208,130,1519,606,0
19:45:43,7492.362,Fox,2440,185,68,28,44,19,14,12,2440,2372,2344,1837,669,626,82,103,1232,1208,130,1519,606,0
19:45:43,7493.013,Fox,2440,185,66,30,44,19,14,12,2440,2374,2344,1837,669,626,82,103,1232,1208,130,1519,606,0
19:45:43,7494.512,Fox,2440,185,66,30,42,21,14,12,2440,2374,2344,1839,669,626,82,103,1232,1208,130,1519,606,0
19:45:44,7495.492,Fox,2440,184,66,28,44,20,14,12,2440,2374,2346,1839,669,626,81,103,1232,1208,130,1520,606,0
19:45:44,7495.858,Fox,2440,183,66,28,44,19,14,12,2440,2374,2346,1839,669,626,81,102,1232,1208,130,1521,606,0
19:45:44,7496.563,Fox,2440,183,62,32,44,19,14,12,2440,2378,2346,1839,669,626,81,102,1232,1208,130,1521,606,0
19:45:44,7496.884,Fox,2440,183,62,32,44,18,15,12,2440,2378,2346,1839,670,626,81,102,1232,1208,130,1521,606,0
19:45:44,7497.413,Fox,2440,183,60,32,46,18,15,12,2440,2380,2348,1839,670,626,81,102,1232,1208,130,1521,606,0
19:45:45,7497.938,Fox,2442,185,62,32,46,18,15,12,2442,2380,2348,1839,670,626,82,103,1233,1209,130,1521,606,0
19:45:45,7499.466,Fox,2442,184,62,30,48,17,15,12,2442,2380,2350,1839,670,626,82,102,1233,1209,130,1522,606,0
19:45:45,7499.646,Fox,2442,182,62,30,48,15,15,12,2442,2380,2350,1839,670,626,82,100,1233,1209,130,1524,606,0
19:45:45,7500.193,Fox,2442,180,62,28,50,13,15,12,2442,2380,2352,1839,670,626,80,100,1233,1209,130,1526,606,0
19:45:45,7500.359,Fox,2442,180,62,26,52,13,15,12,2442,2380,2354,1839,670,626,80,100,1233,1209,130,1526,606,0
19:45:46,7501.022,Fox,2442,180,60,28,52,13,15,12,2442,2382,2354,1839,670,626,80,100,1233,1209,130,1526,606,0
19:45:46,7502.508,Fox,2442,180,60,26,52,15,15,12,2442,2382,2356,1841,670,626,80,100,1233,1209,130,1526,606,0
19:45:46,7502.974,Fox,2442,179,58,28,52,14,15,12,2442,2384,2356,1841,670,626,80,99,1233,1209,130,1527,606,0
19:45:46,7503.28,Fox,2442,179,58,28,51,15,13,14,2442,2384,2356,1842,670,628,80,99,1233,1209,130,1527,606,0
19:45:47,7504.555,Fox,2442,179,56,30,51,15,13,14,2442,2386,2356,1842,670,628,80,99,1233,1209,130,1527,606,0
19:45:47,7505.007,Fox,2442,177,56,30,51,13,13,14,2442,2386,2356,1842,670,628,79,98,1233,1209,130,1529,606,0
19:45:48,7506.943,Fox,2444,179,56,32,51,13,13,14,2444,2388,2356,1842,670,628,81,98,1235,1209,130,1529,606,0
19:45:48,7507.127,Fox,2444,179,54,34,51,13,13,14,2444,2390,2356,1842,670,628,81,98,1235,1209,130,1529,606,0
19:45:48,7507.677,Fox,2444,179,50,38,51,13,13,14,2444,2394,2356,1842,670,628,81,98,1235,1209,130,1529,606,0
19:45:48,7508.048,Fox,2444,179,48,38,53,13,13,14,2444,2396,2358,1842,670,628,81,98,1235,1209,130,1529,606,0
19:45:48,7508.423,Fox,2446,180,48,38,51,14,13,14,2444,2396,2358,1843,670,628,81,99,1236,1210,130,1530,606,0
19:45:48,7508.819,Fox,2446,180,50,38,50,15,13,14,2446,2396,2358,1844,670,628,81,99,1236,1210,130,1530,606,0
19:45:48,7508.998,Fox,2446,180,50,38,48,17,13,14,2446,2396,2358,1846,670,628,81,99,1236,1210,130,1530,606,0
19:45:48,7509.625,Fox,2446,180,50,38,45,20,13,14,2446,2396,2358,1849,670,628,81,99,1236,1210,130,1530,606,0
19:45:49,7510.311,Fox,2450,183,54,38,44,20,13,14,2450,2396,2358,1849,670,628,82,101,1238,1212,130,1531,606,0
19:45:49,7510.511,Fox,2450,183,54,36,46,20,13,14,2450,2396,2360,1849,670,628,82,101,1238,1212,130,1531,606,0
19:45:49,7512.747,Fox,2450,181,54,36,44,20,13,14,2450,2396,2360,1851,670,628,82,99,1238,1212,130,1533,606,0
19:45:50,7513.282,Fox,2450,180,54,36,43,21,13,13,2450,2396,2360,1852,670,628,82,98,1238,1212,130,1533,607,0
19:45:50,7513.452,Fox,2450,180,54,32,47,21,13,13,2450,2396,2364,1852,670,628,82,98,1238,1212,130,1533,607,0
19:45:50,7513.987,Fox,2450,179,52,34,47,20,13,13,2450,2398,2364,1852,670,628,82,97,1238,1212,130,1534,607,0
19:45:50,7515.178,Fox,2450,179,50,34,49,20,13,13,2450,2400,2366,1852,670,628,82,97,1238,1212,130,1534,607,0
19:45:51,7515.841,Fox,2450,179,50,32,51,20,13,13,2450,2400,2368,1852,670,628,82,97,1238,1212,130,1534,607,0
19:45:51,7516.364,Fox,2450,179,50,32,49,22,13,13,2450,2400,2368,1854,670,628,82,97,1238,1212,130,1534,607,0
19:45:51,7516.908,Fox,2450,178,50,32,49,22,13,12,2450,2400,2368,1854,670,628,81,97,1238,1212,130,1534,608,0
19:45:51,7517.797,Fox,2450,178,50,30,51,22,13,12,2450,2400,2370,1854,670,628,81,97,1238,1212,130,1534,608,0
19:45:52,7518.938,Fox,2450,177,48,32,51,21,13,12,2450,2402,2370,1854,670,628,81,96,1238,1212,130,1535,608,0
19:45:52,7519.519,Fox,2450,174,48,32,51,18,13,12,2450,2402,2370,1854,670,628,81,93,1238,1212,130,1538,608,0
19:45:52,7520.09,Fox,2450,173,48,30,53,15,15,12,2450,2402,2372,1854,672,628,81,92,1238,1212,130,1539,608,0
19:45:53,7523.139,Fox,2450,172,48,30,53,14,15,12,2450,2402,2372,1854,672,628,81,91,1238,1212,130,1540,608,0
19:45:53,7523.655,Fox,2450,171,48,30,53,13,15,12,2450,2402,2372,1854,672,628,81,90,1238,1212,130,1541,608,0
19:45:53,7524.374,Fox,2450,171,46,32,53,13,15,12,2450,2404,2372,1854,672,628,81,90,1238,1212,130,1541,608,0
19:45:54,7526.41,Fox,2452,173,42,36,53,13,15,12,2450,2408,2372,1854,672,628,81,92,1238,1214,130,1541,608,0
19:45:54,7526.791,Fox,2452,171,44,36,53,11,15,12,2452,2408,2372,1854,672,628,81,90,1238,1214,130,1543,608,0
19:45:55,7528.322,Fox,2454,173,46,36,53,11,15,12,2454,2408,2372,1854,672,628,82,91,1239,1215,130,1543,608,0
19:45:55,7529.038,Fox,2454,172,46,36,51,13,15,11,2454,2408,2372,1856,672,628,82,90,1239,1215,130,1543,609,0
19:45:55,7529.411,Fox,2454,171,44,38,51,13,15,10,2454,2410,2372,1856,672,628,82,89,1239,1215,130,1543,610,0
19:45:55,7529.779,Fox,2454,171,44,38,51,13,14,11,2454,2410,2372,1856,672,629,82,89,1239,1215,130,1543,610,0
19:45:56,7530.756,Fox,2458,173,44,38,45,17,14,11,2454,2410,2372,1860,672,629,82,91,1241,1217,130,1545,610,0
19:45:56,7531.168,Fox,2458,172,48,38,45,17,13,11,2458,2410,2372,1860,672,630,81,91,1241,1217,130,1545,611,0
19:45:56,7531.548,Fox,2460,172,48,36,46,17,13,10,2458,2410,2374,1860,672,630,81,91,1242,1218,130,1546,612,0
19:45:56,7531.747,Fox,2460,172,50,36,46,17,13,10,2460,2410,2374,1860,672,630,81,91,1242,1218,130,1546,612,0
19:45:56,7533.687,Fox,2462,173,52,36,43,19,13,10,2462,2410,2374,1862,672,630,81,92,1243,1219,130,1547,612,0
19:45:57,7535.03,Fox,2464,175,54,36,43,19,13,10,2464,2410,2374,1862,672,630,83,92,1245,1219,130,1547,612,0
19:45:57,7535.213,Fox,2464,175,54,32,47,18,14,10,2464,2410,2378,1862,673,630,83,92,1245,1219,130,1547,612,0
19:45:57,7536.086,Fox,2464,175,54,30,47,20,14,10,2464,2410,2380,1864,673,630,83,92,1245,1219,130,1547,612,0
19:45:57,7536.556,Fox,2464,175,54,30,45,22,14,10,2464,2410,2380,1866,673,630,83,92,1245,1219,130,1547,612,0
19:45:58,7537.701,Fox,2468,177,56,30,43,22,14,10,2466,2410,2380,1866,673,630,82,95,1246,1222,130,1549,612,0
19:45:58,7538.111,Fox,2468,177,58,30,41,24,14,10,2468,2410,2380,1868,673,630,82,95,1246,1222,130,1549,612,0
19:45:58,7538.283,Fox,2468,177,56,32,41,24,14,10,2468,2412,2380,1868,673,630,82,95,1246,1222,130,1549,612,0
19:45:58,7539.764,Fox,2468,174,54,32,43,22,14,9,2468,2414,2382,1868,673,630,81,93,1246,1222,130,1551,613,0
19:45:59,7540.367,Fox,2468,174,54,32,42,23,14,9,2468,2414,2382,1869,673,630,81,93,1246,1222,130,1551,613,0
19:45:59,7540.92,Fox,2468,172,54,32,42,21,14,9,2468,2414,2382,1869,673,630,81,91,1246,1222,130,1553,613,0
19:45:59,7541.641,Fox,2468,172,54,30,42,23,14,9,2468,2414,2384,1871,673,630,81,91,1246,1222,130,1553,613,0
19:45:59,7542.704,Fox,2468,172,54,30,40,25,14,9,2468,2414,2384,1873,673,630,81,91,1246,1222,130,1553,613,0
19:46:00,7543.21,Fox,2470,173,52,30,41,25,14,9,2468,2416,2386,1873,673,630,81,92,1247,1223,130,1554,613,0
19:46:00,7543.395,Fox,2470,173,54,30,41,25,14,9,2470,2416,2386,1873,673,630,81,92,1247,1223,130,1554,613,0
19:46:00,7543.909,Fox,2470,171,54,30,41,23,14,9,2470,2416,2386,1873,673,630,79,92,1247,1223,130,1556,613,0
19:46:00,7544.478,Fox,2470,171,52,32,39,25,14,9,2470,2418,2386,1875,673,630,79,92,1247,1223,130,1556,613,0
19:46:00,7545.245,Fox,2470,171,50,32,41,25,14,9,2470,2420,2388,1875,673,630,79,92,1247,1223,130,1556,613,0
19:46:00,7545.578,Fox,2470,171,50,30,43,25,14,9,2470,2420,2390,1875,673,630,79,92,1247,1223,130,1556,613,0
19:46:01,7545.9,Fox,2470,171,50,28,45,25,14,9,2470,2420,2392,1875,673,630,79,92,1247,1223,130,1556,613,0
19:46:01,7546.393,Fox,2470,171,50,26,47,23,16,9,2470,2420,2394,1875,675,630,79,92,1247,1223,130,1556,613,0
19:46:01,7546.554,Fox,2470,169,50,24,49,21,16,9,2470,2420,2396,1875,675,630,79,90,1247,1223,130,1558,613,0
19:46:01,7547.068,Fox,2470,167,50,24,49,19,16,9,2470,2420,2396,1875,675,630,77,90,1247,1223,130,1560,613,0
19:46:01,7548.588,Fox,2470,165,48,26,49,17,16,9,2470,2422,2396,1875,675,630,75,90,1247,1223,130,1562,613,0
19:46:02,7549.859,Fox,2470,165,48,26,49,15,18,9,2470,2422,2396,1875,677,630,75,90,1247,1223,130,1562,613,0
19:46:02,7550.207,Fox,2470,165,48,26,47,17,18,9,2470,2422,2396,1877,677,630,75,90,1247,1223,130,1562,613,0
19:46:02,7550.867,Fox,2470,164,46,28,47,16,18,9,2470,2424,2396,1877,677,630,75,89,1247,1223,130,1563,613,0
19:46:02,7551.194,Fox,2470,163,46,28,47,16,18,8,2470,2424,2396,1877,677,630,74,89,1247,1223,130,1563,614,0
19:46:03,7551.93,Fox,2470,162,46,28,47,16,18,7,2470,2424,2396,1877,677,630,73,89,1247,1223,130,1563,615,0
19:46:03,7552.315,Fox,2470,162,46,26,49,16,18,7,2470,2424,2398,1877,677,630,73,89,1247,1223,130,1563,615,0
19:46:03,7552.841,Fox,2470,162,44,28,49,16,18,7,2470,2426,2398,1877,677,630,73,89,1247,1223,130,1563,615,0
19:46:03,7553.219,Fox,2470,160,44,28,49,14,18,7,2470,2426,2398,1877,677,630,72,88,1247,1223,130,1565,615,0
19:46:03,7553.581,Fox,2470,160,44,26,51,12,20,7,2470,2426,2400,1877,679,630,72,88,1247,1223,130,1565,615,0
19:46:04,7554.892,Fox,2470,158,44,26,51,10,20,7,2470,2426,2400,1877,679,630,72,86,1247,1223,130,1567,615,0
19:46:04,7557.126,Fox,2472,160,46,26,51,10,20,7,2472,2426,2400,1877,679,630,72,88,1247,1225,130,1567,615,0
19:46:04,7557.466,Fox,2474,161,46,24,52,10,20,7,2472,2426,2402,1877,679,630,72,89,1248,1226,130,1568,615,0
19:46:05,7557.886,Fox,2476,162,48,24,49,12,20,7,2474,2426,2402,1879,679,630,73,89,1250,1226,130,1569,615,0
19:46:05,7558.09,Fox,2476,162,48,26,49,12,20,7,2476,2428,2402,1879,679,630,73,89,1250,1226,130,1569,615,0
19:46:05,7559.576,Fox,2478,163,50,26,48,12,20,7,2478,2428,2402,1879,679,630,73,90,1251,1227,130,1570,615,0
19:46:05,7559.78,Fox,2478,163,50,26,47,13,20,7,2478,2428,2402,1880,679,630,73,90,1251,1227,130,1570,615,0
19:46:05,7560.344,Fox,2478,163,50,26,45,15,20,7,2478,2428,2402,1882,679,630,73,90,1251,1227,130,1570,615,0
19:46:06,7560.908,Fox,2478,161,50,26,43,15,20,7,2478,2428,2402,1884,679,630,73,88,1251,1227,130,1572,615,0
19:46:06,7562.926,Fox,2478,161,48,26,44,16,20,7,2478,2430,2404,1885,679,630,73,88,1251,1227,130,1572,615,0
19:46:06,7563.26,Fox,2478,160,48,26,44,16,20,6,2478,2430,2404,1885,679,630,73,87,1251,1227,130,1572,616,0
19:46:07,7564.677,Fox,2478,160,48,22,48,16,20,6,2478,2430,2408,1885,679,630,73,87,1251,1227,130,1572,616,0
19:46:08,7567.199,Fox,2482,163,50,22,47,16,20,6,2480,2430,2408,1885,679,630,74,89,1253,1229,130,1573,616,0
19:46:08,7567.383,Fox,2482,163,52,22,47,16,20,6,2482,2430,2408,1885,679,630,74,89,1253,1229,130,1573,616,0
19:46:08,7567.778,Fox,2482,163,52,20,49,16,20,6,2482,2430,2410,1885,679,630,74,89,1253,1229,130,1573,616,0
19:46:08,7568.36,Fox,2482,161,50,22,47,16,20,6,2482,2432,2410,1887,679,630,73,88,1253,1229,130,1575,616,0
19:46:09,7569.862,Fox,2482,161,48,24,47,16,20,6,2482,2434,2410,1887,679,630,73,88,1253,1229,130,1575,616,0
19:46:09,7570.339,Fox,2482,160,48,24,47,15,20,6,2482,2434,2410,1887,679,630,73,87,1253,1229,130,1576,616,0
19:46:09,7571.04,Fox,2482,160,46,26,45,17,20,6,2482,2436,2410,1889,679,630,73,87,1253,1229,130,1576,616,0
19:46:09,7571.41,Fox,2482,158,44,28,45,15,20,6,2482,2438,2410,1889,679,630,71,87,1253,1229,130,1578,616,0
19:46:09,7572.124,Fox,2486,160,44,28,45,14,20,5,2482,2438,2410,1889,679,630,73,87,1256,1230,130,1579,617,0
19:46:09,7572.349,Fox,2486,160,48,28,45,14,20,5,2486,2438,2410,1889,679,630,73,87,1256,1230,130,1579,617,0
19:46:10,7573.104,Fox,2486,160,46,30,45,14,20,5,2486,2440,2410,1889,679,630,73,87,1256,1230,130,1579,617,0
19:46:10,7573.786,Fox,2486,158,46,30,45,13,20,4,2486,2440,2410,1889,679,630,73,85,1256,1230,130,1580,618,0
19:46:10,7573.978,Fox,2486,158,46,30,42,16,20,4,2486,2440,2410,1892,679,630,73,85,1256,1230,130,1580,618,0
19:46:10,7575.531,Fox,2486,158,46,30,40,18,20,4,2486,2440,2410,1894,679,630,73,85,1256,1230,130,1580,618,0
19:46:11,7576.664,Fox,2486,158,46,28,42,18,20,4,2486,2440,2412,1894,679,630,73,85,1256,1230,130,1580,618,0
19:46:11,7578.176,Fox,2486,158,46,26,42,20,20,4,2486,2440,2414,1896,679,630,73,85,1256,1230,130,1580,618,0
19:46:12,7579.038,Fox,2488,158,46,26,42,18,20,4,2486,2440,2414,1896,679,630,75,83,1258,1230,130,1582,618,0
19:46:12,7579.212,Fox,2488,158,48,26,42,18,20,4,2488,2440,2414,1896,679,630,75,83,1258,1230,130,1582,618,0
19:46:12,7579.766,Fox,2488,158,48,26,42,18,18,6,2488,2440,2414,1896,679,632,75,83,1258,1230,130,1582,618,0
19:46:12,7580.682,Fox,2490,160,48,28,41,19,18,6,2490,2442,2414,1897,679,632,76,84,1259,1231,130,1582,618,0
19:46:12,7581.582,Fox,2490,159,48,26,43,18,18,6,2490,2442,2416,1897,679,632,76,83,1259,1231,130,1583,618,0
19:46:13,7582.146,Fox,2490,158,48,26,43,18,18,5,2490,2442,2416,1897,679,632,75,83,1259,1231,130,1583,619,0
19:46:13,7582.886,Fox,2490,158,48,24,45,18,18,5,2490,2442,2418,1897,679,632,75,83,1259,1231,130,1583,619,0
19:46:13,7583.594,Fox,2490,158,48,22,47,18,18,5,2490,2442,2420,1897,679,632,75,83,1259,1231,130,1583,619,0
19:46:13,7583.917,Fox,2490,158,48,22,47,18,17,6,2490,2442,2420,1897,679,633,75,83,1259,1231,130,1583,619,0
19:46:13,7584.441,Fox,2492,159,48,22,46,18,15,8,2490,2442,2420,1897,679,635,76,83,1261,1231,130,1584,619,0
19:46:14,7584.651,Fox,2492,156,50,22,46,15,15,8,2492,2442,2420,1897,679,635,76,80,1261,1231,130,1587,619,0
19:46:14,7586.107,Fox,2492,154,50,22,46,13,15,8,2492,2442,2420,1897,679,635,76,78,1261,1231,130,1589,619,0
19:46:14,7586.973,Fox,2492,154,50,20,48,13,15,8,2492,2442,2422,1897,679,635,76,78,1261,1231,130,1589,619,0
19:46:15,7588.729,Fox,2492,152,50,20,48,11,15,8,2492,2442,2422,1897,679,635,76,76,1261,1231,130,1591,619,0
19:46:15,7589.274,Fox,2496,154,52,18,48,11,15,8,2494,2442,2424,1897,679,635,76,78,1263,1233,130,1593,619,0
19:46:15,7589.501,Fox,2496,154,52,20,48,11,15,8,2496,2444,2424,1897,679,635,76,78,1263,1233,130,1593,619,0
19:46:16,7591.223,Fox,2496,153,50,20,50,10,15,8,2496,2446,2426,1897,679,635,76,77,1263,1233,130,1594,619,0
19:46:16,7592.069,Fox,2498,154,50,20,47,12,15,8,2496,2446,2426,1899,679,635,77,77,1265,1233,130,1595,619,0
19:46:16,7592.235,Fox,2498,154,52,20,47,12,15,8,2498,2446,2426,1899,679,635,77,77,1265,1233,130,1595,619,0
19:46:16,7592.916,Fox,2498,154,48,24,47,12,15,8,2498,2450,2426,1899,679,635,77,77,1265,1233,130,1595,619,0
19:46:17,7595.679,Fox,2498,154,48,24,45,14,15,8,2498,2450,2426,1901,679,635,77,77,1265,1233,130,1595,619,0
19:46:17,7596.395,Fox,2498,154,48,22,45,16,15,8,2498,2450,2428,1903,679,635,77,77,1265,1233,130,1595,619,0
19:46:18,7597.546,Fox,2498,154,48,22,45,16,13,10,2498,2450,2428,1903,679,637,77,77,1265,1233,130,1595,619,0
19:46:18,7599.587,Fox,2498,153,48,22,45,16,13,9,2498,2450,2428,1903,679,637,76,77,1265,1233,130,1595,620,0
19:46:19,7600.047,Fox,2498,153,48,22,43,18,13,9,2498,2450,2428,1905,679,637,76,77,1265,1233,130,1595,620,0
19:46:19,7601.209,Fox,2498,153,48,20,45,18,13,9,2498,2450,2430,1905,679,637,76,77,1265,1233,130,1595,620,0
19:46:19,7601.979,Fox,2498,153,48,20,43,20,13,9,2498,2450,2430,1907,679,637,76,77,1265,1233,130,1595,620,0
19:46:19,7602.502,Fox,2500,153,50,20,43,18,13,9,2500,2450,2430,1907,679,637,77,76,1266,1234,130,1597,620,0
19:46:20,7603.188,Fox,2502,154,52,20,42,16,15,9,2502,2450,2430,1907,681,637,77,77,1267,1235,130,1598,620,0
19:46:20,7603.688,Fox,2502,154,52,20,40,18,15,9,2502,2450,2430,1909,681,637,77,77,1267,1235,130,1598,620,0
19:46:20,7605.591,Fox,2502,154,52,20,38,20,15,9,2502,2450,2430,1911,681,637,77,77,1267,1235,130,1598,620,0
19:46:21,7606.177,Fox,2502,152,52,20,36,19,16,9,2502,2450,2430,1913,682,637,77,75,1267,1235,130,1600,620,0
19:46:21,7606.658,Fox,2502,152,52,20,33,22,16,9,2502,2450,2430,1916,682,637,77,75,1267,1235,130,1600,620,0
19:46:21,7606.982,Fox,2502,150,52,18,35,20,16,9,2502,2450,2432,1916,682,637,77,73,1267,1235,130,1602,620,0
19:46:21,7607.13,Fox,2502,150,52,18,33,22,16,9,2502,2450,2432,1918,682,637,77,73,1267,1235,130,1602,620,0
19:46:21,7608.411,Fox,2502,150,52,16,35,22,16,9,2502,2450,2434,1918,682,637,77,73,1267,1235,130,1602,620,0
19:46:22,7609.332,Fox,2502,150,50,16,37,22,16,9,2502,2452,2436,1918,682,637,77,73,1267,1235,130,1602,620,0
19:46:22,7610.041,Fox,2502,150,50,14,39,22,16,9,2502,2452,2438,1918,682,637,77,73,1267,1235,130,1602,620,0
19:46:22,7610.805,Fox,2502,147,48,16,39,20,16,8,2502,2454,2438,1918,682,637,77,70,1267,1235,130,1604,621,0
19:46:22,7611.288,Fox,2502,147,48,16,39,20,15,9,2502,2454,2438,1918,682,638,77,70,1267,1235,130,1604,621,0
19:46:23,7611.624,Fox,2502,147,48,14,41,20,15,9,2502,2454,2440,1918,682,638,77,70,1267,1235,130,1604,621,0
19:46:23,7612.727,Fox,2502,147,48,14,40,21,15,9,2502,2454,2440,1919,682,638,77,70,1267,1235,130,1604,621,0
19:46:23,7613.579,Fox,2502,147,44,18,40,21,14,10,2502,2458,2440,1919,682,639,77,70,1267,1235,130,1604,621,0
19:46:23,7614.266,Fox,2502,146,42,20,38,22,14,10,2502,2460,2440,1921,682,639,77,69,1267,1235,131,1604,621,0
19:46:24,7616.132,Fox,2502,144,42,20,38,20,13,11,2502,2460,2440,1921,682,640,77,67,1267,1235,131,1606,621,0
19:46:24,7616.292,Fox,2502,144,40,22,38,20,13,11,2502,2462,2440,1921,682,640,77,67,1267,1235,131,1606,621,0
19:46:24,7616.64,Fox,2502,142,40,22,38,18,13,11,2502,2462,2440,1921,682,640,75,67,1267,1235,131,1608,621,0
19:46:24,7617.151,Fox,2502,139,40,22,38,15,13,11,2502,2462,2440,1921,682,640,75,64,1267,1235,131,1611,621,0
19:46:25,7617.825,Fox,2502,137,38,24,36,15,13,11,2502,2464,2440,1923,682,640,75,62,1267,1235,131,1613,621,0
19:46:25,7618.929,Fox,2502,137,38,22,38,15,13,11,2502,2464,2442,1923,682,640,75,62,1267,1235,131,1613,621,0
19:46:25,7619.535,Fox,2504,138,40,22,37,15,13,11,2504,2464,2442,1923,682,640,75,63,1268,1236,131,1614,621,0
19:46:25,7620.357,Fox,2506,138,40,24,36,15,13,10,2506,2466,2442,1923,682,640,73,65,1268,1238,131,1615,622,0
19:46:26,7620.528,Fox,2506,138,38,26,36,15,13,10,2506,2468,2442,1923,682,640,73,65,1268,1238,131,1615,622,0
19:46:26,7623.337,Fox,2506,137,38,26,34,16,13,10,2506,2468,2442,1925,682,640,73,64,1268,1238,131,1616,622,0
19:46:27,7623.999,Fox,2506,137,38,26,34,14,15,10,2506,2468,2442,1925,684,640,73,64,1268,1238,131,1616,622,0
19:46:27,7624.448,Fox,2506,135,38,26,34,12,15,10,2506,2468,2442,1925,684,640,71,64,1268,1238,131,1618,622,0
19:46:27,7625.23,Fox,2506,135,38,26,32,14,15,10,2506,2468,2442,1927,684,640,71,64,1268,1238,131,1618,622,0
19:46:27,7625.991,Fox,2506,135,36,28,32,14,15,10,2506,2470,2442,1927,684,640,71,64,1268,1238,131,1618,622,0
19:46:28,7627.153,Fox,2508,136,38,28,31,14,15,10,2508,2470,2442,1927,684,640,71,65,1269,1239,131,1619,622,0
19:46:28,7627.917,Fox,2508,136,38,26,33,14,15,10,2508,2470,2444,1927,684,640,71,65,1269,1239,131,1619,622,0
19:46:28,7628.425,Fox,2508,134,38,26,31,14,15,10,2508,2470,2444,1929,684,640,69,65,1269,1239,131,1621,622,0
19:46:29,7629.752,Fox,2510,135,40,24,32,14,15,10,2510,2470,2446,1929,684,640,68,67,1269,1241,131,1622,622,0
19:46:29,7631.271,Fox,2510,135,40,20,36,14,15,10,2510,2470,2450,1929,684,640,68,67,1269,1241,131,1622,622,0
19:46:30,7632.472,Fox,2512,136,40,20,36,14,15,9,2510,2470,2450,1929,684,640,67,69,1269,1243,131,1622,623,0
19:46:30,7632.637,Fox,2512,136,42,20,36,14,15,9,2512,2470,2450,1929,684,640,67,69,1269,1243,131,1622,623,0
19:46:30,7633.892,Fox,2512,134,42,20,36,12,15,9,2512,2470,2450,1929,684,640,66,68,1269,1243,131,1624,623,0
19:46:30,7634.375,Fox,2512,133,42,20,36,12,14,9,2512,2470,2450,1929,684,641,65,68,1269,1243,131,1624,624,0
19:46:30,7634.888,Fox,2512,132,42,20,36,12,14,8,2512,2470,2450,1929,684,641,65,67,1269,1243,131,1624,625,0
19:46:31,7635.395,Fox,2514,133,42,20,35,10,16,8,2512,2470,2450,1929,686,641,65,68,1270,1244,131,1625,625,0
19:46:31,7635.755,Fox,2514,131,44,20,35,8,16,8,2514,2470,2450,1929,686,641,65,66,1270,1244,131,1627,625,0
19:46:31,7637.398,Fox,2516,133,44,20,33,10,16,8,2514,2470,2450,1931,686,641,67,66,1272,1244,131,1627,625,0
19:46:31,7637.553,Fox,2516,133,46,20,33,10,16,8,2516,2470,2450,1931,686,641,67,66,1272,1244,131,1627,625,0
19:46:32,7638.896,Fox,2516,131,46,20,31,10,16,8,2516,2470,2450,1933,686,641,65,66,1272,1244,131,1629,625,0
19:46:32,7639.732,Fox,2516,131,44,22,31,10,16,8,2516,2472,2450,1933,686,641,65,66,1272,1244,131,1629,625,0
19:46:32,7640.241,Fox,2516,130,42,24,31,10,16,7,2516,2474,2450,1933,686,641,64,66,1272,1244,131,1629,626,0
19:46:32,7640.591,Fox,2516,130,40,26,31,10,16,7,2516,2476,2450,1933,686,641,64,66,1272,1244,131,1629,626,0
19:46:33,7642.183,Fox,2516,130,38,28,30,11,16,7,2516,2478,2450,1934,686,641,64,66,1272,1244,131,1629,626,0
19:46:33,7643.369,Fox,2516,130,38,28,29,12,16,7,2516,2478,2450,1935,686,641,64,66,1272,1244,131,1629,626,0
19:46:33,7643.964,Fox,2516,129,38,28,27,14,16,6,2516,2478,2450,1937,686,641,63,66,1272,1244,131,1629,627,0
19:46:34,7645.036,Fox,2520,131,40,28,25,14,16,6,2518,2478,2450,1937,686,641,63,68,1274,1246,131,1631,627,0
19:46:34,7645.203,Fox,2520,131,42,28,25,14,16,6,2520,2478,2450,1937,686,641,63,68,1274,1246,131,1631,627,0
19:46:34,7647.369,Fox,2522,132,44,28,24,14,16,6,2522,2478,2450,1937,686,641,62,70,1274,1248,131,1632,627,0
19:46:35,7647.701,Fox,2522,130,44,26,24,14,16,6,2522,2478,2452,1939,686,641,61,69,1274,1248,131,1634,627,0
19:46:35,7649.354,Fox,2522,128,44,24,26,12,16,6,2522,2478,2454,1939,686,641,60,68,1274,1248,131,1636,627,0
19:46:35,7649.965,Fox,2522,128,40,28,26,12,16,6,2522,2482,2454,1939,686,641,60,68,1274,1248,131,1636,627,0
19:46:36,7651.938,Fox,2522,128,40,24,28,14,16,6,2522,2482,2458,1941,686,641,60,68,1274,1248,131,1636,627,0
19:46:36,7652.739,Fox,2522,127,40,22,30,13,16,6,2522,2482,2460,1941,686,641,59,68,1274,1248,131,1637,627,0
19:46:37,7653.92,Fox,2522,126,40,22,30,10,18,6,2522,2482,2460,1941,688,641,59,67,1274,1248,131,1638,627,0
19:46:37,7654.732,Fox,2524,126,42,20,32,8,18,6,2524,2482,2462,1941,688,641,58,68,1274,1250,131,1640,627,0
19:46:37,7654.882,Fox,2524,126,38,24,32,8,18,6,2524,2486,2462,1941,688,641,58,68,1274,1250,131,1640,627,0
19:46:37,7655.984,Fox,2524,126,38,22,34,8,18,6,2524,2486,2464,1941,688,641,58,68,1274,1250,131,1640,627,0
19:46:38,7656.974,Fox,2524,126,38,22,32,10,18,6,2524,2486,2464,1943,688,641,58,68,1274,1250,131,1640,627,0
19:46:38,7657.269,Fox,2524,126,38,22,32,10,16,8,2524,2486,2464,1943,688,643,58,68,1274,1250,131,1640,627,0
19:46:38,7658.078,Fox,2526,123,40,22,31,8,16,6,2526,2486,2464,1943,688,643,57,66,1274,1252,131,1643,629,0
19:46:38,7658.962,Fox,2526,123,40,18,35,8,16,6,2526,2486,2468,1943,688,643,57,66,1274,1252,131,1643,629,0
19:46:39,7660.453,Fox,2528,124,42,18,35,7,16,6,2528,2486,2468,1943,688,643,58,66,1276,1252,131,1644,629,0
19:46:39,7661.77,Fox,2528,124,40,20,33,9,16,6,2528,2488,2468,1945,688,643,58,66,1276,1252,131,1644,629,0
19:46:39,7662.387,Fox,2528,122,40,20,33,7,16,6,2528,2488,2468,1945,688,643,58,64,1276,1252,131,1646,629,0
19:46:40,7663.165,Fox,2528,122,38,22,33,7,16,6,2528,2490,2468,1945,688,643,58,64,1276,1252,131,1646,629,0
19:46:40,7664.389,Fox,2528,122,38,20,35,7,16,6,2528,2490,2470,1945,688,643,58,64,1276,1252,131,1646,629,0
19:46:40,7664.827,Fox,2530,123,40,20,34,7,16,6,2530,2490,2470,1945,688,643,59,64,1278,1252,131,1647,629,0
19:46:40,7665.112,Fox,2530,122,40,20,34,7,16,5,2530,2490,2470,1945,688,643,58,64,1278,1252,131,1647,630,0
19:46:41,7667.271,Fox,2530,122,38,22,33,8,16,5,2530,2492,2470,1946,688,643,58,64,1278,1252,131,1647,630,0
19:46:41,7667.553,Fox,2532,122,38,22,32,7,16,5,2530,2492,2470,1946,688,643,57,65,1278,1254,131,1649,630,0
19:46:41,7667.882,Fox,2534,123,40,22,31,7,16,5,2532,2492,2470,1946,688,643,56,67,1278,1256,131,1650,630,0
19:46:41,7668.073,Fox,2534,123,42,22,31,7,16,5,2534,2492,2470,1946,688,643,56,67,1278,1256,131,1650,630,0
19:46:42,7668.852,Fox,2534,123,42,22,30,8,16,5,2534,2492,2470,1947,688,643,56,67,1278,1256,131,1650,630,0
19:46:42,7669.863,Fox,2534,123,42,22,29,9,16,5,2534,2492,2470,1948,688,643,56,67,1278,1256,131,1650,630,0
19:46:42,7670.488,Fox,2534,123,42,22,28,10,16,5,2534,2492,2470,1949,688,643,56,67,1278,1256,131,1650,630,0
19:46:43,7671.73,Fox,2534,123,40,24,28,10,16,5,2534,2494,2470,1949,688,643,56,67,1278,1256,131,1650,630,0
19:46:43,7672.151,Fox,2534,121,38,26,26,10,16,5,2534,2496,2470,1951,688,643,56,65,1278,1256,131,1652,630,0
19:46:43,7672.63,Fox,2534,121,38,26,26,10,15,6,2534,2496,2470,1951,688,644,56,65,1278,1256,131,1652,630,0
19:46:44,7674.836,Fox,2534,121,36,28,26,10,15,6,2534,2498,2470,1951,688,644,56,65,1278,1256,131,1652,630,0
19:46:44,7676.495,Fox,2534,120,36,28,26,10,15,5,2534,2498,2470,1951,688,644,56,64,1278,1256,131,1652,631,0
19:46:45,7677.917,Fox,2534,119,36,28,26,9,15,5,2534,2498,2470,1951,688,644,56,63,1278,1256,131,1653,631,0
19:46:45,7678.194,Fox,2534,119,36,26,28,9,15,5,2534,2498,2472,1951,688,644,56,63,1278,1256,131,1653,631,0
19:46:45,7678.647,Fox,2534,119,36,24,30,9,15,5,2534,2498,2474,1951,688,644,56,63,1278,1256,131,1653,631,0
19:46:45,7679.355,Fox,2534,118,36,22,32,8,15,5,2534,2498,2476,1951,688,644,56,62,1278,1256,131,1654,631,0
19:46:45,7679.521,Fox,2534,118,36,22,30,10,15,5,2534,2498,2476,1953,688,644,56,62,1278,1256,131,1654,631,0
19:46:46,7680.627,Fox,2534,117,36,20,32,9,15,5,2534,2498,2478,1953,688,644,56,61,1278,1256,131,1655,631,0
19:46:46,7680.94,Fox,2534,116,36,20,32,8,15,5,2534,2498,2478,1953,688,644,55,61,1278,1256,131,1656,631,0
19:46:46,7682.622,Fox,2534,114,36,20,32,6,15,5,2534,2498,2478,1953,688,644,54,60,1278,1256,131,1658,631,0
19:46:47,7683.91,Fox,2534,114,36,20,32,6,13,7,2534,2498,2478,1953,688,646,54,60,1278,1256,131,1658,631,0
19:46:47,7685.066,Fox,2534,114,34,22,32,6,13,7,2534,2500,2478,1953,688,646,54,60,1278,1256,131,1658,631,0
19:46:47,7685.807,Fox,2534,114,32,24,32,6,13,7,2534,2502,2478,1953,688,646,54,60,1278,1256,131,1658,631,0
19:46:48,7686.276,Fox,2536,116,34,24,32,6,13,7,2536,2502,2478,1953,688,646,54,62,1278,1258,131,1658,631,0
19:46:48,7687.233,Fox,2536,116,34,24,32,6,11,9,2536,2502,2478,1953,688,648,54,62,1278,1258,131,1658,631,0
19:46:48,7688.414,Fox,2536,116,34,20,34,8,11,9,2536,2502,2482,1955,688,648,54,62,1278,1258,131,1658,631,0
19:46:48,7689.014,Fox,2538,118,36,20,34,8,11,9,2538,2502,2482,1955,688,648,55,63,1279,1259,131,1658,631,0
19:46:49,7690.086,Fox,2538,116,36,20,33,7,11,9,2538,2502,2482,1956,688,648,54,62,1279,1259,131,1660,631,0
19:46:49,7691.226,Fox,2540,117,36,20,32,7,9,11,2538,2502,2482,1956,688,650,54,63,1280,1260,131,1661,631,0
19:46:49,7691.388,Fox,2540,117,38,20,32,7,9,11,2540,2502,2482,1956,688,650,54,63,1280,1260,131,1661,631,0
19:46:49,7691.863,Fox,2540,117,38,20,30,9,9,11,2540,2502,2482,1958,688,650,54,63,1280,1260,131,1661,631,0
19:46:50,7693.393,Fox,2540,117,38,16,34,9,9,11,2540,2502,2486,1958,688,650,54,63,1280,1260,131,1661,631,0
19:46:50,7694.475,Fox,2542,118,40,16,33,9,9,11,2542,2502,2486,1958,688,650,55,63,1282,1260,131,1662,631,0
19:46:50,7694.808,Fox,2542,117,40,16,33,9,9,10,2542,2502,2486,1958,688,650,55,62,1282,1260,131,1662,632,0
19:46:51,7695.422,Fox,2542,117,40,16,33,7,11,10,2542,2502,2486,1958,690,650,55,62,1282,1260,131,1662,632,0
19:46:51,7696.032,Fox,2544,118,42,16,32,7,11,10,2544,2502,2486,1958,690,650,55,63,1283,1261,131,1663,632,0
19:46:51,7697.127,Fox,2544,118,42,16,32,6,12,10,2544,2502,2486,1958,691,650,55,63,1283,1261,131,1663,632,0
19:46:51,7697.581,Fox,2546,119,44,16,31,6,12,10,2546,2502,2486,1958,691,650,54,65,1283,1263,131,1664,632,0
19:46:51,7698.232,Fox,2548,120,46,16,30,6,12,10,2548,2502,2486,1958,691,650,54,66,1284,1264,131,1665,632,0
19:46:52,7699.07,Fox,2548,118,46,16,30,4,12,10,2548,2502,2486,1958,691,650,52,66,1284,1264,131,1667,632,0
19:46:52,7700.311,Fox,2548,118,46,14,32,4,12,10,2548,2502,2488,1958,691,650,52,66,1284,1264,131,1667,632,0
19:46:52,7700.793,Fox,2548,117,46,14,32,3,12,10,2548,2502,2488,1958,691,650,52,65,1284,1264,131,1668,632,0
19:46:53,7701.994,Fox,2550,118,46,12,33,3,12,10,2548,2502,2490,1958,691,650,51,67,1284,1266,131,1669,632,0
19:46:53,7702.339,Fox,2550,116,46,14,33,1,12,10,2550,2504,2490,1958,691,650,51,65,1284,1266,131,1671,632,0
19:46:53,7702.839,Fox,2550,115,44,16,33,1,12,9,2550,2506,2490,1958,691,650,51,64,1284,1266,131,1671,633,0
19:46:54,7705.723,Fox,2550,115,44,14,35,1,12,9,2550,2506,2492,1958,691,650,51,64,1284,1266,131,1671,633,0
19:46:55,7707.594,Fox,2550,113,44,14,35,1,12,7,2550,2506,2492,1958,691,650,49,64,1284,1266,131,1671,635,0
19:46:55,7708.149,Fox,2550,113,44,14,33,3,12,7,2550,2506,2492,1960,691,650,49,64,1284,1266,131,1671,635,0
19:46:55,7709.817,Fox,2550,113,42,16,32,4,12,7,2550,2508,2492,1961,691,650,49,64,1284,1266,131,1671,635,0
19:46:56,7710.492,Fox,2550,113,42,12,36,4,12,7,2550,2508,2496,1961,691,650,49,64,1284,1266,131,1671,635,0
19:46:56,7712.501,Fox,2550,113,40,14,33,7,12,7,2550,2510,2496,1964,691,650,49,64,1284,1266,131,1671,635,0
19:46:57,7713.407,Fox,2550,113,40,12,34,8,12,7,2550,2510,2498,1965,691,650,49,64,1284,1266,131,1671,635,0
19:46:57,7714.266,Fox,2550,112,40,12,34,8,12,6,2550,2510,2498,1965,691,650,48,64,1284,1266,131,1671,636,0
19:46:57,7715.269,Fox,2550,112,38,14,33,9,12,6,2550,2512,2498,1966,691,650,48,64,1284,1266,131,1671,636,0
19:46:58,7716.654,Fox,2552,113,38,14,31,10,12,6,2550,2512,2498,1967,691,650,48,65,1285,1267,131,1672,636,0
19:46:58,7716.816,Fox,2552,113,40,14,31,10,12,6,2552,2512,2498,1967,691,650,48,65,1285,1267,131,1672,636,0
19:46:58,7717.595,Fox,2552,112,40,14,31,10,12,5,2552,2512,2498,1967,691,650,47,65,1285,1267,131,1672,637,0
19:46:58,7718.206,Fox,2552,112,38,16,31,10,12,5,2552,2514,2498,1967,691,650,47,65,1285,1267,131,1672,637,0
19:46:58,7718.672,Fox,2552,111,38,16,31,9,12,5,2552,2514,2498,1967,691,650,47,64,1285,1267,131,1673,637,0
19:46:58,7719.118,Fox,2554,112,40,16,30,9,12,5,2554,2514,2498,1967,691,650,48,64,1287,1267,131,1674,637,0
19:46:59,7719.465,Fox,2554,112,40,16,26,13,12,5,2554,2514,2498,1971,691,650,48,64,1287,1267,131,1674,637,0
19:46:59,7720.123,Fox,2554,112,38,18,26,13,12,5,2554,2516,2498,1971,691,650,48,64,1287,1267,131,1674,637,0
19:46:59,7720.477,Fox,2554,111,38,18,26,12,12,5,2554,2516,2498,1971,691,650,48,63,1287,1267,131,1675,637,0
19:46:59,7721.287,Fox,2554,110,38,18,26,12,12,4,2554,2516,2498,1971,691,650,47,63,1287,1267,131,1675,638,0
19:47:00,7722.97,Fox,2554,107,38,18,26,9,12,4,2554,2516,2498,1971,691,650,46,61,1287,1267,131,1678,638,0
19:47:00,7723.746,Fox,2554,106,38,16,28,8,12,4,2554,2516,2500,1971,691,650,46,60,1287,1267,131,1679,638,0
19:47:00,7724.186,Fox,2554,106,38,14,30,8,12,4,2554,2516,2502,1971,691,650,46,60,1287,1267,131,1679,638,0
19:47:00,7724.821,Fox,2556,107,40,14,29,8,12,4,2556,2516,2502,1971,691,650,46,61,1288,1268,131,1680,638,0
19:47:00,7724.987,Fox,2556,107,40,14,28,9,12,4,2556,2516,2502,1972,691,650,46,61,1288,1268,131,1680,638,0
19:47:01,7725.754,Fox,2556,106,40,14,28,8,12,4,2556,2516,2502,1972,691,650,46,60,1288,1268,131,1681,638,0
19:47:01,7727.273,Fox,2556,105,40,14,28,7,12,4,2556,2516,2502,1972,691,650,45,60,1288,1268,131,1682,638,0
19:47:01,7727.813,Fox,2556,105,36,18,28,7,12,4,2556,2520,2502,1972,691,650,45,60,1288,1268,131,1682,638,0
19:47:02,7729.898,Fox,2556,103,34,20,28,5,12,4,2556,2522,2502,1972,691,650,45,58,1288,1268,131,1684,638,0
19:47:02,7730.267,Fox,2558,102,36,20,27,3,12,4,2558,2522,2502,1972,691,650,44,58,1289,1269,131,1687,638,0
19:47:03,7734.098,Fox,2562,105,40,20,26,3,12,4,2562,2522,2502,1972,691,650,45,60,1291,1271,131,1688,638,0
19:47:04,7735.476,Fox,2564,106,42,20,26,2,12,4,2564,2522,2502,1972,691,650,46,60,1292,1272,131,1689,638,0
19:47:05,7737.333,Fox,2564,106,40,22,26,2,12,4,2564,2524,2502,1972,691,650,46,60,1292,1272,131,1689,638,0
19:47:05,7738.65,Fox,2564,106,40,22,24,4,12,4,2564,2524,2502,1974,691,650,46,60,1292,1272,131,1689,638,0
19:47:05,7739.147,Fox,2564,106,40,22,23,5,12,4,2564,2524,2502,1975,691,650,46,60,1292,1272,131,1689,638,0
19:47:05,7739.612,Fox,2564,106,40,22,21,7,12,4,2564,2524,2502,1977,691,650,46,60,1292,1272,131,1689,638,0
19:47:06,7740.508,Fox,2566,107,42,22,20,7,10,6,2566,2524,2502,1977,691,652,46,61,1293,1273,131,1690,638,0
19:47:06,7740.684,Fox,2566,107,40,22,22,7,10,6,2566,2526,2504,1977,691,652,46,61,1293,1273,131,1690,638,0
19:47:06,7741.383,Fox,2566,107,40,20,23,8,10,6,2566,2526,2506,1978,691,652,46,61,1293,1273,131,1690,638,0
19:47:06,7743.151,Fox,2566,107,38,22,23,8,10,6,2566,2528,2506,1978,691,652,46,61,1293,1273,131,1690,638,0
19:47:07,7743.684,Fox,2566,107,38,22,23,8,9,7,2566,2528,2506,1978,691,653,46,61,1293,1273,131,1690,638,0
19:47:08,7747.447,Fox,2566,107,36,24,23,8,9,7,2566,2530,2506,1978,691,653,46,61,1293,1273,131,1690,638,0
19:47:08,7748.215,Fox,2566,107,36,22,25,8,9,7,2566,2530,2508,1978,691,653,46,61,1293,1273,131,1690,638,0
19:47:08,7748.882,Fox,2566,107,36,22,23,10,9,7,2566,2530,2508,1980,691,653,46,61,1293,1273,131,1690,638,0
19:47:08,7749.183,Fox,2566,105,36,22,23,8,9,7,2566,2530,2508,1980,691,653,46,59,1293,1273,131,1692,638,0
19:47:09,7749.691,Fox,2566,104,36,22,23,7,9,7,2566,2530,2508,1980,691,653,46,58,1293,1273,131,1693,638,0
19:47:09,7750.279,Fox,2566,102,34,24,23,5,9,7,2566,2532,2508,1980,691,653,44,58,1293,1273,131,1695,638,0
19:47:09,7750.811,Fox,2566,101,32,24,25,5,9,6,2566,2534,2510,1980,691,653,44,57,1293,1273,131,1695,639,0
19:47:09,7751.701,Fox,2566,100,32,24,25,4,9,6,2566,2534,2510,1980,691,653,44,56,1293,1273,131,1696,639,0
19:47:10,7753.793,Fox,2566,100,32,22,24,7,9,6,2566,2534,2512,1983,691,653,44,56,1293,1273,131,1696,639,0
19:47:11,7756.601,Fox,2566,100,32,20,26,7,9,6,2566,2534,2514,1983,691,653,44,56,1293,1273,131,1696,639,0
19:47:12,7758.545,Fox,2566,100,32,18,28,7,9,6,2566,2534,2516,1983,691,653,44,56,1293,1273,131,1696,639,0
19:47:12,7759.458,Fox,2566,98,32,18,28,5,9,6,2566,2534,2516,1983,691,653,44,54,1293,1273,131,1698,639,0
19:47:12,7759.818,Fox,2570,101,36,18,27,5,9,6,2570,2534,2516,1983,691,653,46,55,1296,1274,131,1699,639,0
19:47:12,7760.857,Fox,2570,101,36,18,25,7,9,6,2570,2534,2516,1985,691,653,46,55,1296,1274,131,1699,639,0
19:47:13,7761.379,Fox,2570,101,36,18,25,7,7,8,2570,2534,2516,1985,691,655,46,55,1296,1274,131,1699,639,0
19:47:13,7761.877,Fox,2572,102,38,18,24,7,7,8,2572,2534,2516,1985,691,655,46,56,1297,1275,131,1700,639,0
19:47:13,7762.209,Fox,2572,102,38,18,23,8,7,8,2572,2534,2516,1986,691,655,46,56,1297,1275,131,1700,639,0
19:47:14,7764.385,Fox,2572,99,38,18,23,5,7,8,2572,2534,2516,1986,691,655,44,55,1297,1275,131,1703,639,0
19:47:14,7766.203,Fox,2572,99,38,14,25,7,7,8,2572,2534,2520,1988,691,655,44,55,1297,1275,131,1703,639,0
19:47:15,7767.767,Fox,2572,98,38,14,25,7,7,7,2572,2534,2520,1988,691,655,44,54,1297,1275,131,1703,640,0
19:47:15,7768.411,Fox,2572,98,38,12,27,7,7,7,2572,2534,2522,1988,691,655,44,54,1297,1275,131,1703,640,0
19:47:15,7768.85,Fox,2572,98,36,14,27,7,7,7,2572,2536,2522,1988,691,655,44,54,1297,1275,131,1703,640,0
19:47:16,7770.738,Fox,2572,98,36,14,25,9,7,7,2572,2536,2522,1990,691,655,44,54,1297,1275,131,1703,640,0
19:47:16,7771.238,Fox,2572,96,36,14,23,9,7,7,2572,2536,2522,1992,691,655,42,54,1297,1275,131,1705,640,0
19:47:16,7771.57,Fox,2572,94,34,16,23,9,7,5,2572,2538,2522,1992,691,655,41,53,1297,1275,131,1705,642,0
19:47:16,7772.782,Fox,2572,93,34,16,23,8,5,7,2572,2538,2522,1992,691,657,41,52,1297,1275,131,1706,642,0
19:47:17,7773.714,Fox,2572,93,34,16,22,9,5,7,2572,2538,2522,1993,691,657,41,52,1297,1275,131,1706,642,0
19:47:17,7774.035,Fox,2572,93,32,18,22,9,5,7,2572,2540,2522,1993,691,657,41,52,1297,1275,131,1706,642,0
19:47:17,7775.736,Fox,2572,93,32,16,24,9,5,7,2572,2540,2524,1993,691,657,41,52,1297,1275,131,1706,642,0
19:47:18,7776.669,Fox,2572,91,32,16,24,7,5,7,2572,2540,2524,1993,691,657,39,52,1297,1275,131,1708,642,0
19:47:18,7776.999,Fox,2572,91,30,18,24,7,5,7,2572,2542,2524,1993,691,657,39,52,1297,1275,131,1708,642,0
19:47:18,7778.552,Fox,2572,91,28,20,24,7,5,7,2572,2544,2524,1993,691,657,39,52,1297,1275,131,1708,642,0
19:47:18,7779.164,Fox,2572,91,28,18,26,7,5,7,2572,2544,2526,1993,691,657,39,52,1297,1275,131,1708,642,0
19:47:19,7780.199,Fox,2572,91,26,20,26,7,5,7,2572,2546,2526,1993,691,657,39,52,1297,1275,131,1708,642,0
19:47:19,7780.765,Fox,2572,91,24,22,26,7,5,7,2572,2548,2526,1993,691,657,39,52,1297,1275,131,1708,642,0
19:47:19,7781.497,Fox,2572,87,24,20,28,3,5,7,2572,2548,2528,1993,691,657,37,50,1297,1275,131,1712,642,0
19:47:20,7782.651,Fox,2572,86,24,20,28,3,5,6,2572,2548,2528,1993,691,657,37,49,1297,1275,131,1712,643,0
19:47:20,7784.309,Fox,2572,85,24,20,26,4,5,6,2572,2548,2528,1995,691,657,36,49,1297,1275,131,1713,643,0
19:47:20,7784.789,Fox,2572,84,22,22,25,5,5,5,2572,2550,2528,1996,691,657,35,49,1297,1275,131,1713,644,0
19:47:21,7785.895,Fox,2572,84,22,20,27,5,5,5,2572,2550,2530,1996,691,657,35,49,1297,1275,131,1713,644,0
19:47:22,7788.775,Fox,2572,84,22,18,29,5,5,5,2572,2550,2532,1996,691,657,35,49,1297,1275,131,1713,644,0
19:47:22,7789.152,Fox,2572,84,22,16,31,5,5,5,2572,2550,2534,1996,691,657,35,49,1297,1275,131,1713,644,0
19:47:23,7790.883,Fox,2574,85,24,16,30,5,5,5,2574,2550,2534,1996,691,657,35,50,1298,1276,131,1714,644,0
19:47:23,7791.416,Fox,2574,85,24,16,30,5,3,7,2574,2550,2534,1996,691,659,35,50,1298,1276,131,1714,644,0
19:47:23,7792.24,Fox,2574,84,24,16,30,5,3,6,2574,2550,2534,1996,691,659,34,50,1298,1276,131,1714,645,0
19:47:23,7793.36,Fox,2576,85,26,16,29,5,3,6,2576,2550,2534,1996,691,659,34,51,1299,1277,131,1715,645,0
19:47:24,7794.185,Fox,2576,84,26,16,29,5,3,5,2576,2550,2534,1996,691,659,34,50,1299,1277,131,1715,646,0
19:47:24,7795.369,Fox,2576,83,26,16,29,4,3,5,2576,2550,2534,1996,691,659,34,49,1299,1277,131,1716,646,0
19:47:25,7799.321,Fox,2576,83,24,18,29,4,3,5,2576,2552,2534,1996,691,659,34,49,1299,1277,131,1716,646,0
19:47:26,7801.13,Fox,2576,83,24,18,28,5,3,5,2576,2552,2534,1997,691,659,34,49,1299,1277,131,1716,646,0
19:47:26,7801.821,Fox,2578,84,24,20,27,4,4,5,2578,2554,2534,1997,692,659,33,51,1299,1279,131,1717,646,0
19:47:26,7801.993,Fox,2578,84,24,20,25,6,4,5,2578,2554,2534,1999,692,659,33,51,1299,1279,131,1717,646,0
19:47:28,7807.374,Fox,2578,84,22,20,27,6,4,5,2578,2556,2536,1999,692,659,33,51,1299,1279,131,1717,646,0
19:47:29,7808.769,Fox,2578,84,22,20,25,8,4,5,2578,2556,2536,2001,692,659,33,51,1299,1279,131,1717,646,0
19:47:29,7810.04,Fox,2578,84,22,18,27,8,4,5,2578,2556,2538,2001,692,659,33,51,1299,1279,131,1717,646,0
19:47:29,7810.881,Fox,2582,88,24,18,27,8,4,5,2580,2556,2538,2001,692,659,35,53,1301,1281,131,1717,646,0
19:47:29,7811.045,Fox,2582,88,26,18,27,8,4,5,2582,2556,2538,2001,692,659,35,53,1301,1281,131,1717,646,0
19:47:29,7811.396,Fox,2582,88,26,18,25,10,4,5,2582,2556,2538,2003,692,659,35,53,1301,1281,131,1717,646,0
19:47:30,7811.704,Fox,2582,87,26,18,25,9,4,5,2582,2556,2538,2003,692,659,35,52,1301,1281,131,1718,646,0
19:47:30,7812.442,Fox,2582,85,26,16,27,7,4,5,2582,2556,2540,2003,692,659,35,50,1301,1281,131,1720,646,0
19:47:30,7812.79,Fox,2582,85,24,18,27,7,4,5,2582,2558,2540,2003,692,659,35,50,1301,1281,131,1720,646,0
19:47:30,7814.17,Fox,2582,85,24,18,25,9,4,5,2582,2558,2540,2005,692,659,35,50,1301,1281,131,1720,646,0
19:47:31,7815.521,Fox,2582,85,24,16,27,9,4,5,2582,2558,2542,2005,692,659,35,50,1301,1281,131,1720,646,0
19:47:31,7816.432,Fox,2584,86,26,16,27,8,4,5,2584,2558,2542,2005,692,659,36,50,1303,1281,131,1721,646,0
19:47:31,7816.587,Fox,2584,86,22,20,27,8,4,5,2584,2562,2542,2005,692,659,36,50,1303,1281,131,1721,646,0
19:47:31,7817.074,Fox,2584,86,22,18,28,9,4,5,2584,2562,2544,2006,692,659,36,50,1303,1281,131,1721,646,0
19:47:32,7818.02,Fox,2584,86,20,20,28,9,4,5,2584,2564,2544,2006,692,659,36,50,1303,1281,131,1721,646,0
19:47:32,7818.657,Fox,2584,86,20,18,30,9,4,5,2584,2564,2546,2006,692,659,36,50,1303,1281,131,1721,646,0
19:47:32,7819.253,Fox,2584,85,20,16,30,10,4,5,2584,2564,2548,2008,692,659,36,49,1303,1281,131,1722,646,0
19:47:33,7821.901,Fox,2584,84,20,16,30,9,4,5,2584,2564,2548,2008,692,659,36,48,1303,1281,131,1723,646,0
19:47:33,7823.185,Fox,2584,84,18,16,32,9,4,5,2584,2566,2550,2008,692,659,36,48,1303,1281,131,1723,646,0
19:47:34,7824.719,Fox,2584,82,18,16,32,7,4,5,2584,2566,2550,2008,692,659,36,46,1303,1281,131,1725,646,0
19:47:35,7826.725,Fox,2584,82,18,16,29,10,4,5,2584,2566,2550,2011,692,659,36,46,1303,1281,131,1725,646,0
19:47:35,7827.673,Fox,2584,81,18,16,29,9,4,5,2584,2566,2550,2011,692,659,36,45,1303,1281,131,1726,646,0
19:47:35,7828.938,Fox,2584,81,18,16,27,11,4,5,2584,2566,2550,2013,692,659,36,45,1303,1281,131,1726,646,0
19:47:36,7829.685,Fox,2584,79,18,16,27,9,4,5,2584,2566,2550,2013,692,659,34,45,1303,1281,131,1728,646,0
19:47:36,7831.313,Fox,2584,78,18,16,27,9,4,4,2584,2566,2550,2013,692,659,34,44,1303,1281,131,1728,647,0
19:47:37,7833.033,Fox,2584,77,18,16,27,9,2,5,2584,2566,2550,2013,692,661,33,44,1303,1281,131,1728,648,0
19:47:37,7833.356,Fox,2586,79,20,16,27,9,2,5,2586,2566,2550,2013,692,661,34,45,1304,1282,131,1728,648,0
19:47:37,7834.636,Fox,2586,79,20,16,27,9,1,6,2586,2566,2550,2013,692,662,34,45,1304,1282,131,1728,648,0
19:47:38,7836.335,Fox,2586,79,20,16,25,11,1,6,2586,2566,2550,2015,692,662,34,45,1304,1282,131,1728,648,0
19:47:38,7837.081,Fox,2586,78,20,16,25,10,1,6,2586,2566,2550,2015,692,662,34,44,1304,1282,131,1729,648,0
19:47:38,7837.394,Fox,2586,76,20,16,25,8,1,6,2586,2566,2550,2015,692,662,33,43,1304,1282,131,1731,648,0
19:47:38,7837.92,Fox,2586,76,20,14,27,8,1,6,2586,2566,2552,2015,692,662,33,43,1304,1282,131,1731,648,0
19:47:39,7839.657,Fox,2586,74,20,14,25,8,1,6,2586,2566,2552,2017,692,662,33,41,1304,1282,131,1733,648,0
19:47:39,7840.162,Fox,2586,74,20,12,27,8,1,6,2586,2566,2554,2017,692,662,33,41,1304,1282,131,1733,648,0
19:47:40,7842.021,Fox,2586,74,20,12,25,10,1,6,2586,2566,2554,2019,692,662,33,41,1304,1282,131,1733,648,0
19:47:40,7842.303,Fox,2586,74,16,16,25,10,1,6,2586,2570,2554,2019,692,662,33,41,1304,1282,131,1733,648,0
19:47:40,7844.481,Fox,2586,74,14,18,25,10,1,6,2586,2572,2554,2019,692,662,33,41,1304,1282,131,1733,648,0
19:47:41,7845.879,Fox,2586,74,14,16,27,10,1,6,2586,2572,2556,2019,692,662,33,41,1304,1282,131,1733,648,0
19:47:41,7846.433,Fox,2586,74,14,16,25,12,1,6,2586,2572,2556,2021,692,662,33,41,1304,1282,131,1733,648,0
19:47:41,7846.835,Fox,2586,72,14,16,25,10,1,6,2586,2572,2556,2021,692,662,33,39,1304,1282,131,1735,648,0
19:47:42,7849.331,Fox,2586,72,14,16,23,12,1,6,2586,2572,2556,2023,692,662,33,39,1304,1282,131,1735,648,0
19:47:42,7849.654,Fox,2586,72,14,16,21,14,1,6,2586,2572,2556,2025,692,662,33,39,1304,1282,131,1735,648,0
19:47:42,7850.226,Fox,2586,70,14,16,21,12,1,6,2586,2572,2556,2025,692,662,33,37,1304,1282,131,1737,648,0
19:47:43,7851.34,Fox,2586,70,14,14,23,12,1,6,2586,2572,2558,2025,692,662,33,37,1304,1282,131,1737,648,0
19:47:44,7854.147,Fox,2588,71,16,14,22,12,1,6,2588,2572,2558,2025,692,662,32,39,1304,1284,131,1738,648,0
19:47:44,7854.937,Fox,2590,72,18,14,21,12,1,6,2590,2572,2558,2025,692,662,32,40,1305,1285,131,1739,648,0
19:47:44,7855.107,Fox,2590,72,18,10,25,12,1,6,2590,2572,2562,2025,692,662,32,40,1305,1285,131,1739,648,0
19:47:44,7855.841,Fox,2592,74,20,10,25,12,1,6,2592,2572,2562,2025,692,662,32,42,1305,1287,131,1739,648,0
19:47:44,7856.473,Fox,2592,74,20,8,27,12,1,6,2592,2572,2564,2025,692,662,32,42,1305,1287,131,1739,648,0
19:47:45,7857.062,Fox,2594,73,22,8,26,10,1,6,2594,2572,2564,2025,692,662,30,43,1306,1288,131,1742,648,0
19:47:46,7859.915,Fox,2596,74,22,8,26,9,1,6,2594,2572,2564,2025,692,662,32,42,1308,1288,131,1743,648,0
19:47:46,7860.22,Fox,2596,72,24,8,26,7,1,6,2596,2572,2564,2025,692,662,32,40,1308,1288,131,1745,648,0
19:47:46,7861.593,Fox,2596,72,24,6,28,7,1,6,2596,2572,2566,2025,692,662,32,40,1308,1288,131,1745,648,0
19:47:46,7861.903,Fox,2596,71,24,6,28,7,1,5,2596,2572,2566,2025,692,662,32,39,1308,1288,131,1745,649,0
19:47:47,7863.117,Fox,2596,70,24,6,28,7,1,4,2596,2572,2566,2025,692,662,32,38,1308,1288,131,1745,650,0
19:47:48,7867.818,Fox,2596,70,24,6,26,9,1,4,2596,2572,2566,2027,692,662,32,38,1308,1288,131,1745,650,0
19:47:49,7870.355,Fox,2598,71,26,6,25,9,1,4,2598,2572,2566,2027,692,662,32,39,1309,1289,131,1746,650,0
19:47:49,7870.507,Fox,2598,71,26,6,24,10,1,4,2598,2572,2566,2028,692,662,32,39,1309,1289,131,1746,650,0
19:47:49,7870.985,Fox,2600,73,28,6,24,10,1,4,2600,2572,2566,2028,692,662,32,41,1309,1291,131,1746,650,0
19:47:50,7872.963,Fox,2600,73,28,6,22,12,1,4,2600,2572,2566,2030,692,662,32,41,1309,1291,131,1746,650,0
19:47:50,7873.39,Fox,2600,72,26,8,22,12,1,3,2600,2574,2566,2030,692,662,32,40,1309,1291,131,1746,651,0
19:47:51,7875.961,Fox,2600,72,24,10,21,13,1,3,2600,2576,2566,2031,692,662,32,40,1309,1291,131,1746,651,0
19:47:52,7877.612,Fox,2600,72,24,10,20,12,3,3,2600,2576,2566,2032,694,662,32,40,1309,1291,131,1746,651,0
19:47:52,7879.136,Fox,2600,72,24,10,18,14,3,3,2600,2576,2566,2034,694,662,32,40,1309,1291,131,1746,651,0
19:47:52,7879.844,Fox,2600,72,24,10,17,15,3,3,2600,2576,2566,2035,694,662,32,40,1309,1291,131,1746,651,0
19:47:53,7881.077,Fox,2600,71,24,6,21,14,3,3,2600,2576,2570,2035,694,662,32,39,1309,1291,131,1747,651,0
19:47:53,7882.952,Fox,2600,71,24,4,23,14,3,3,2600,2576,2572,2035,694,662,32,39,1309,1291,131,1747,651,0
19:47:54,7883.708,Fox,2600,70,24,4,21,15,3,3,2600,2576,2572,2037,694,662,32,38,1309,1291,131,1748,651,0
19:47:54,7884.341,Fox,2600,70,22,6,21,15,3,3,2600,2578,2572,2037,694,662,32,38,1309,1291,131,1748,651,0
19:47:54,7884.999,Fox,2600,69,22,6,21,15,3,2,2600,2578,2572,2037,694,662,31,38,1309,1291,131,1748,652,0
19:47:55,7888.289,Fox,2602,69,24,6,20,14,3,2,2602,2578,2572,2037,694,662,31,38,1310,1292,131,1750,652,0
19:47:56,7889.729,Fox,2602,67,24,6,20,12,3,2,2602,2578,2572,2037,694,662,31,36,1310,1292,131,1752,652,0
19:47:56,7890.375,Fox,2602,66,24,6,20,11,3,2,2602,2578,2572,2037,694,662,31,35,1310,1292,131,1753,652,0
19:47:56,7892.287,Fox,2604,67,26,6,19,11,3,2,2604,2578,2572,2037,694,662,31,36,1311,1293,131,1754,652,0
19:47:57,7893.691,Fox,2608,69,26,10,17,11,3,2,2608,2582,2572,2037,694,662,30,39,1312,1296,131,1756,652,0
19:47:57,7894.436,Fox,2610,69,28,10,16,10,3,2,2610,2582,2572,2037,694,662,29,40,1312,1298,131,1758,652,0
19:47:58,7898.438,Fox,2610,69,28,10,15,11,3,2,2610,2582,2572,2038,694,662,29,40,1312,1298,131,1758,652,0
19:47:59,7898.961,Fox,2610,69,26,12,15,11,3,2,2610,2584,2572,2038,694,662,29,40,1312,1298,131,1758,652,0
19:48:01,7904.859,Fox,2610,69,26,12,15,10,4,2,2610,2584,2572,2038,695,662,29,40,1312,1298,131,1758,652,0
19:48:01,7906.34,Fox,2610,69,26,12,13,12,4,2,2610,2584,2572,2040,695,662,29,40,1312,1298,131,1758,652,0
19:48:02,7908.888,Fox,2610,68,26,12,13,11,4,2,2610,2584,2572,2040,695,662,29,39,1312,1298,131,1759,652,0
19:48:03,7911.938,Fox,2610,68,26,10,14,12,4,2,2610,2584,2574,2041,695,662,29,39,1312,1298,131,1759,652,0
19:48:04,7914.339,Fox,2610,68,26,8,16,12,4,2,2610,2584,2576,2041,695,662,29,39,1312,1298,131,1759,652,0
19:48:04,7915.731,Fox,2612,70,28,8,12,16,4,2,2612,2584,2576,2045,695,662,30,40,1313,1299,131,1759,652,0
19:48:04,7915.928,Fox,2612,70,26,10,12,16,4,2,2612,2586,2576,2045,695,662,30,40,1313,1299,131,1759,652,0
19:48:05,7917.042,Fox,2612,69,26,10,11,16,4,2,2612,2586,2576,2046,695,662,30,39,1313,1299,131,1760,652,0
19:48:05,7917.704,Fox,2616,71,28,10,10,15,4,2,2614,2586,2576,2046,695,662,30,41,1315,1301,131,1762,652,0
19:48:05,7917.902,Fox,2616,71,30,10,10,15,4,2,2616,2586,2576,2046,695,662,30,41,1315,1301,131,1762,652,0
19:48:06,7922.264,Fox,2616,70,30,10,8,17,4,1,2616,2586,2576,2048,695,662,29,41,1315,1301,131,1762,653,0
19:48:07,7922.412,Fox,2616,69,30,10,8,16,4,1,2616,2586,2576,2048,695,662,29,40,1315,1301,131,1763,653,0
19:48:07,7922.862,Fox,2616,69,30,8,10,16,4,1,2616,2586,2578,2048,695,662,29,40,1315,1301,131,1763,653,0
19:48:08,7926.163,Fox,2616,66,30,8,10,13,4,1,2616,2586,2578,2048,695,662,28,38,1315,1301,131,1766,653,0
19:48:08,7928.171,Fox,2618,67,32,8,10,12,4,1,2618,2586,2578,2048,695,662,28,39,1316,1302,131,1767,653,0
19:48:10,7932.117,Fox,2618,67,32,4,14,12,4,1,2618,2586,2582,2048,695,662,28,39,1316,1302,131,1767,653,0
19:48:10,7932.613,Fox,2618,66,32,4,14,11,4,1,2618,2586,2582,2048,695,662,28,38,1316,1302,131,1768,653,0
19:48:10,7933.593,Fox,2620,68,34,4,14,11,4,1,2620,2586,2582,2048,695,662,28,40,1316,1304,131,1768,653,0
19:48:11,7935.453,Fox,2620,68,34,4,14,9,6,1,2620,2586,2582,2048,697,662,28,40,1316,1304,131,1768,653,0
19:48:11,7936.738,Fox,2620,68,32,6,14,9,6,1,2620,2588,2582,2048,697,662,28,40,1316,1304,131,1768,653,0
19:48:12,7937.605,Fox,2620,68,30,6,16,9,6,1,2620,2590,2584,2048,697,662,28,40,1316,1304,131,1768,653,0
19:48:12,7938.401,Fox,2620,68,28,8,16,9,6,1,2620,2592,2584,2048,697,662,28,40,1316,1304,131,1768,653,0
19:48:12,7939.188,Fox,2620,68,28,8,16,9,5,2,2620,2592,2584,2048,697,663,28,40,1316,1304,131,1768,653,0
19:48:12,7939.638,Fox,2620,68,26,10,16,9,5,2,2620,2594,2584,2048,697,663,28,40,1316,1304,131,1768,653,0
19:48:13,7941.421,Fox,2620,68,26,10,13,12,5,2,2620,2594,2584,2051,697,663,28,40,1316,1304,131,1768,653,0
19:48:13,7942.857,Fox,2620,68,24,12,13,11,6,2,2620,2596,2584,2051,698,663,28,40,1316,1304,131,1768,653,0
19:48:13,7943.364,Fox,2620,68,24,12,11,13,6,2,2620,2596,2584,2053,698,663,28,40,1316,1304,131,1768,653,0
19:48:14,7946.21,Fox,2622,69,26,12,11,12,6,2,2622,2596,2584,2053,698,663,28,41,1317,1305,131,1769,653,0
19:48:16,7951.909,Fox,2622,68,26,12,11,11,6,2,2622,2596,2584,2053,698,663,28,40,1317,1305,131,1770,653,0
19:48:17,7952.891,Fox,2622,68,24,14,11,11,6,2,2622,2598,2584,2053,698,663,28,40,1317,1305,131,1770,653,0
19:48:17,7953.575,Fox,2622,68,22,16,11,11,6,2,2622,2600,2584,2053,698,663,28,40,1317,1305,131,1770,653,0
19:48:17,7954.016,Fox,2622,67,22,16,11,10,6,2,2622,2600,2584,2053,698,663,28,39,1317,1305,131,1771,653,0
19:48:17,7954.491,Fox,2622,67,22,14,13,10,6,2,2622,2600,2586,2053,698,663,28,39,1317,1305,131,1771,653,0
19:48:19,7961.318,Fox,2622,67,22,14,13,8,8,2,2622,2600,2586,2053,700,663,28,39,1317,1305,131,1771,653,0
19:48:20,7963.953,Fox,2622,66,22,14,13,8,8,1,2622,2600,2586,2053,700,663,28,38,1317,1305,131,1771,654,0
19:48:21,7966.439,Fox,2622,66,22,14,13,7,9,1,2622,2600,2586,2053,701,663,28,38,1317,1305,131,1771,654,0
19:48:22,7969.505,Fox,2622,66,22,14,13,6,10,1,2622,2600,2586,2053,702,663,28,38,1317,1305,131,1771,654,0
19:48:23,7970.836,Fox,2622,66,20,16,13,6,10,1,2622,2602,2586,2053,702,663,28,38,1317,1305,131,1771,654,0
19:48:23,7972.505,Fox,2622,66,20,16,11,8,10,1,2622,2602,2586,2055,702,663,28,38,1317,1305,131,1771,654,0
19:48:24,7974.839,Fox,2622,66,18,18,9,10,10,1,2622,2604,2586,2057,702,663,28,38,1317,1305,131,1771,654,0
19:48:24,7975.313,Fox,2622,66,18,16,11,10,10,1,2622,2604,2588,2057,702,663,28,38,1317,1305,131,1771,654,0
19:48:24,7976.196,Fox,2622,66,14,18,13,10,10,1,2622,2608,2590,2057,702,663,28,38,1317,1305,131,1771,654,0
19:48:25,7976.984,Fox,2622,66,12,18,15,10,10,1,2622,2610,2592,2057,702,663,28,38,1317,1305,131,1771,654,0
19:48:25,7977.323,Fox,2622,66,12,18,15,9,11,1,2622,2610,2592,2057,703,663,28,38,1317,1305,131,1771,654,0
19:48:25,7977.945,Fox,2624,68,14,18,15,9,11,1,2624,2610,2592,2057,703,663,29,39,1318,1306,131,1771,654,0
19:48:25,7978.104,Fox,2624,68,14,16,17,9,11,1,2624,2610,2594,2057,703,663,29,39,1318,1306,131,1771,654,0
19:48:26,7981.086,Fox,2624,68,14,14,19,9,11,1,2624,2610,2596,2057,703,663,29,39,1318,1306,131,1771,654,0
19:48:27,7983.005,Fox,2624,66,14,14,19,7,11,1,2624,2610,2596,2057,703,663,28,38,1318,1306,131,1773,654,0
19:48:27,7983.292,Fox,2624,66,14,14,17,9,11,1,2624,2610,2596,2059,703,663,28,38,1318,1306,131,1773,654,0
19:48:28,7987.212,Fox,2626,67,16,14,16,9,11,1,2626,2610,2596,2059,703,663,28,39,1319,1307,131,1774,654,0
19:48:29,7988.332,Fox,2628,68,18,14,15,9,11,1,2628,2610,2596,2059,703,663,28,40,1320,1308,131,1775,654,0
19:48:30,7991.401,Fox,2628,68,18,12,17,9,11,1,2628,2610,2598,2059,703,663,28,40,1320,1308,131,1775,654,0
19:48:30,7992.025,Fox,2630,70,20,10,19,9,11,1,2630,2610,2600,2059,703,663,28,42,1320,1310,131,1775,654,0
19:48:30,7992.634,Fox,2630,70,20,10,17,11,11,1,2630,2610,2600,2061,703,663,28,42,1320,1310,131,1775,654,0
19:48:32,7998.037,Fox,2630,70,20,10,15,13,11,1,2630,2610,2600,2063,703,663,28,42,1320,1310,131,1775,654,0
19:48:32,7998.349,Fox,2630,70,18,12,15,13,11,1,2630,2612,2600,2063,703,663,28,42,1320,1310,131,1775,654,0
19:48:32,7999.923,Fox,2630,69,18,12,15,12,12,0,2630,2612,2600,2063,704,663,28,41,1320,1310,131,1775,655,0
19:48:33,8000.418,Fox,2630,69,14,16,15,12,12,0,2630,2616,2600,2063,704,663,28,41,1320,1310,131,1775,655,0
19:48:35,8008.633,Fox,2630,67,14,16,15,10,12,0,2630,2616,2600,2063,704,663,26,41,1320,1310,131,1777,655,0
19:48:36,8009.362,Fox,2630,67,14,14,17,10,12,0,2630,2616,2602,2063,704,663,26,41,1320,1310,131,1777,655,0
19:48:36,8010.836,Fox,2630,67,12,16,17,9,13,0,2630,2618,2602,2063,705,663,26,41,1320,1310,131,1777,655,0
19:48:37,8013.603,Fox,2632,69,12,14,19,9,13,0,2630,2618,2604,2063,705,663,27,42,1321,1311,131,1777,655,0
19:48:37,8013.796,Fox,2632,69,14,14,19,9,13,0,2632,2618,2604,2063,705,663,27,42,1321,1311,131,1777,655,0
19:48:37,8014.88,Fox,2634,70,16,10,20,11,13,0,2634,2618,2608,2065,705,663,27,43,1322,1312,131,1778,655,0
19:48:37,8015.06,Fox,2634,70,16,10,20,11,11,2,2634,2618,2608,2065,705,665,27,43,1322,1312,131,1778,655,0
19:48:38,8015.599,Fox,2634,70,16,8,22,11,11,2,2634,2618,2610,2065,705,665,27,43,1322,1312,131,1778,655,0
19:48:38,8016.126,Fox,2634,70,14,10,22,11,11,2,2634,2620,2610,2065,705,665,27,43,1322,1312,131,1778,655,0
19:48:42,8028.824,Fox,2634,70,12,12,22,11,11,2,2634,2622,2610,2065,705,665,27,43,1322,1312,131,1778,655,0
19:48:42,8030.006,Fox,2636,71,14,12,21,11,11,2,2636,2622,2610,2065,705,665,27,44,1323,1313,131,1779,655,0
19:48:44,8034.52,Fox,2638,73,16,12,21,11,11,2,2638,2622,2610,2065,705,665,27,46,1323,1315,131,1779,655,0
19:48:44,8034.874,Fox,2638,73,16,12,21,9,13,2,2638,2622,2610,2065,707,665,27,46,1323,1315,131,1779,655,0
19:48:44,8035.777,Fox,2638,73,16,12,19,11,13,2,2638,2622,2610,2067,707,665,27,46,1323,1315,131,1779,655,0
19:48:45,8036.5,Fox,2638,73,16,12,18,12,13,2,2638,2622,2610,2068,707,665,27,46,1323,1315,131,1779,655,0
19:48:45,8036.84,Fox,2638,73,16,10,20,12,13,2,2638,2622,2612,2068,707,665,27,46,1323,1315,131,1779,655,0
19:48:45,8037.542,Fox,2638,73,16,10,18,14,13,2,2638,2622,2612,2070,707,665,27,46,1323,1315,131,1779,655,0
19:48:45,8038.886,Fox,2638,73,16,6,20,16,13,2,2638,2622,2616,2072,707,665,27,46,1323,1315,131,1779,655,0
19:48:46,8041.602,Fox,2638,73,16,6,18,18,13,2,2638,2622,2616,2074,707,665,27,46,1323,1315,131,1779,655,0
19:48:47,8042.333,Fox,2638,73,16,6,18,18,12,3,2638,2622,2616,2074,707,666,27,46,1323,1315,131,1779,655,0
19:48:48,8046.385,Fox,2638,71,16,6,18,16,12,3,2638,2622,2616,2074,707,666,27,44,1323,1315,131,1781,655,0
19:48:48,8047.142,Fox,2638,70,16,6,18,15,12,3,2638,2622,2616,2074,707,666,27,43,1323,1315,131,1782,655,0
19:48:48,8048.066,Fox,2638,68,16,6,18,13,12,3,2638,2622,2616,2074,707,666,27,41,1323,1315,131,1784,655,0
19:48:49,8049.366,Fox,2638,66,16,4,20,11,12,3,2638,2622,2618,2074,707,666,26,40,1323,1315,131,1786,655,0
19:48:49,8050.91,Fox,2640,67,18,4,19,11,12,3,2640,2622,2618,2074,707,666,27,40,1325,1315,131,1787,655,0
19:48:50,8051.819,Fox,2642,69,20,4,19,11,12,3,2642,2622,2618,2074,707,666,29,40,1327,1315,131,1787,655,0
19:48:50,8051.982,Fox,2642,69,20,4,18,12,12,3,2642,2622,2618,2075,707,666,29,40,1327,1315,131,1787,655,0
19:48:50,8052.557,Fox,2642,69,20,4,16,14,12,3,2642,2622,2618,2077,707,666,29,40,1327,1315,131,1787,655,0
19:48:50,8053.995,Fox,2644,71,22,4,16,14,12,3,2644,2622,2618,2077,707,666,30,41,1328,1316,131,1787,655,0
19:48:51,8054.701,Fox,2644,71,22,2,18,14,12,3,2644,2622,2620,2077,707,666,30,41,1328,1316,131,1787,655,0
19:48:53,8060.563,Fox,2644,71,20,4,18,14,12,3,2644,2624,2620,2077,707,666,30,41,1328,1316,131,1787,655,0
19:48:53,8062.461,Fox,2644,70,20,4,18,13,12,3,2644,2624,2620,2077,707,666,30,40,1328,1316,131,1788,655,0
19:48:55,8066.807,Fox,2646,72,22,4,18,13,12,3,2646,2624,2620,2077,707,666,30,42,1328,1318,131,1788,655,0
19:48:55,8067.31,Fox,2646,72,22,2,20,13,12,3,2646,2624,2622,2077,707,666,30,42,1328,1318,131,1788,655,0
19:48:55,8068.342,Fox,2646,72,22,2,20,11,14,3,2646,2624,2622,2077,709,666,30,42,1328,1318,131,1788,655,0
19:48:56,8069.898,Fox,2646,72,20,4,18,13,14,3,2646,2626,2622,2079,709,666,30,42,1328,1318,131,1788,655,0
19:48:56,8070.883,Fox,2646,72,18,6,18,13,14,3,2646,2628,2622,2079,709,666,30,42,1328,1318,131,1788,655,0
19:48:57,8072.747,Fox,2648,73,18,6,18,13,14,2,2646,2628,2622,2079,709,666,32,41,1330,1318,131,1788,656,0
19:48:57,8073.137,Fox,2648,73,20,6,18,13,12,4,2648,2628,2622,2079,709,668,32,41,1330,1318,131,1788,656,0
19:48:57,8073.489,Fox,2650,75,22,6,18,13,12,4,2650,2628,2622,2079,709,668,33,42,1331,1319,131,1788,656,0
19:48:57,8073.845,Fox,2650,75,22,6,16,15,12,4,2650,2628,2622,2081,709,668,33,42,1331,1319,131,1788,656,0
19:48:57,8074.542,Fox,2650,75,20,8,16,15,12,4,2650,2630,2622,2081,709,668,33,42,1331,1319,131,1788,656,0
19:48:58,8075.542,Fox,2650,74,20,8,13,18,12,3,2650,2630,2622,2084,709,668,32,42,1331,1319,131,1788,657,0
19:48:58,8076.089,Fox,2650,74,20,8,11,20,12,3,2650,2630,2622,2086,709,668,32,42,1331,1319,131,1788,657,0
19:48:58,8076.972,Fox,2650,74,20,8,11,18,14,3,2650,2630,2622,2086,711,668,32,42,1331,1319,131,1788,657,0
19:48:59,8080.299,Fox,2650,72,20,8,11,16,13,4,2650,2630,2622,2086,711,669,31,41,1331,1319,131,1790,657,0
19:49:01,8084.31,Fox,2650,70,20,8,11,14,13,4,2650,2630,2622,2086,711,669,30,40,1331,1319,131,1792,657,0
19:49:01,8085.976,Fox,2652,68,22,8,10,11,13,4,2652,2630,2622,2086,711,669,29,39,1331,1321,131,1796,657,0
19:49:01,8086.16,Fox,2652,68,22,8,10,9,15,4,2652,2630,2622,2086,713,669,29,39,1331,1321,131,1796,657,0
19:49:04,8093.379,Fox,2652,67,22,8,10,9,15,3,2652,2630,2622,2086,713,669,28,39,1331,1321,131,1796,658,0
19:49:05,8096.339,Fox,2652,67,20,10,10,9,15,3,2652,2632,2622,2086,713,669,28,39,1331,1321,131,1796,658,0
19:49:05,8097.473,Fox,2652,67,18,12,8,11,15,3,2652,2634,2622,2088,713,669,28,39,1331,1321,131,1796,658,0
19:49:06,8099.031,Fox,2652,67,18,10,10,11,13,5,2652,2634,2624,2088,713,671,28,39,1331,1321,131,1796,658,0
19:49:06,8099.396,Fox,2652,67,18,10,6,15,13,5,2652,2634,2624,2092,713,671,28,39,1331,1321,131,1796,658,0
19:49:07,8103.577,Fox,2654,69,20,10,6,15,13,5,2654,2634,2624,2092,713,671,29,40,1332,1322,131,1796,658,0
19:49:07,8103.939,Fox,2654,69,20,10,6,15,12,6,2654,2634,2624,2092,713,672,29,40,1332,1322,131,1796,658,0
19:49:08,8107.047,Fox,2654,69,20,10,6,15,11,7,2654,2634,2624,2092,713,673,29,40,1332,1322,131,1796,658,0
19:49:08,8107.928,Fox,2654,68,20,10,6,14,11,7,2654,2634,2624,2092,713,673,29,39,1332,1322,132,1796,658,0
19:49:09,8108.483,Fox,2654,68,20,8,8,12,13,7,2654,2634,2626,2092,715,673,29,39,1332,1322,132,1796,658,0
19:49:09,8109.482,Fox,2654,68,20,6,10,12,13,7,2654,2634,2628,2092,715,673,29,39,1332,1322,132,1796,658,0
19:49:09,8110.076,Fox,2656,68,22,6,9,11,13,7,2656,2634,2628,2093,715,673,29,39,1332,1324,132,1798,658,0
19:49:10,8111.551,Fox,2658,70,24,6,9,11,13,7,2658,2634,2628,2093,715,673,29,41,1332,1326,132,1798,658,0
19:49:10,8112.663,Fox,2658,70,22,8,9,11,13,7,2658,2636,2628,2093,715,673,29,41,1332,1326,132,1798,658,0
19:49:10,8113.136,Fox,2658,70,22,6,11,11,13,7,2658,2636,2630,2093,715,673,29,41,1332,1326,132,1798,658,0
19:49:11,8114.844,Fox,2658,70,22,6,11,11,12,8,2658,2636,2630,2093,715,674,29,41,1332,1326,132,1798,658,0
19:49:11,8115.223,Fox,2658,70,22,6,9,13,12,8,2658,2636,2630,2095,715,674,29,41,1332,1326,132,1798,658,0
19:49:12,8117.126,Fox,2658,70,20,8,9,13,12,8,2658,2638,2630,2095,715,674,29,41,1332,1326,132,1798,658,0
19:49:13,8120.386,Fox,2658,69,20,8,9,12,12,8,2658,2638,2630,2095,715,674,29,40,1332,1326,132,1799,658,0
19:49:14,8125.863,Fox,2658,68,20,8,9,12,12,7,2658,2638,2630,2095,715,674,29,39,1332,1326,132,1799,659,0
19:49:15,8127.746,Fox,2658,68,20,8,7,14,12,7,2658,2638,2630,2097,715,674,29,39,1332,1326,132,1799,659,0
19:49:17,8133.652,Fox,2658,67,18,10,7,14,12,6,2658,2640,2630,2097,715,674,28,39,1332,1326,132,1799,660,0
19:49:17,8134.462,Fox,2658,67,16,12,7,14,12,6,2658,2642,2630,2097,715,674,28,39,1332,1326,132,1799,660,0
19:49:17,8134.848,Fox,2658,67,16,10,9,14,12,6,2658,2642,2632,2097,715,674,28,39,1332,1326,132,1799,660,0
19:49:18,8135.224,Fox,2658,67,16,10,9,12,14,6,2658,2642,2632,2097,717,674,28,39,1332,1326,132,1799,660,0
19:49:18,8136.021,Fox,2658,67,16,8,11,12,14,6,2658,2642,2634,2097,717,674,28,39,1332,1326,132,1799,660,0
19:49:18,8136.581,Fox,2658,67,14,10,11,12,14,6,2658,2644,2634,2097,717,674,28,39,1332,1326,132,1799,660,0
19:49:18,8137.562,Fox,2658,67,14,10,11,12,13,7,2658,2644,2634,2097,717,675,28,39,1332,1326,132,1799,660,0
19:49:19,8139.27,Fox,2658,66,14,10,11,12,13,6,2658,2644,2634,2097,717,675,28,38,1332,1326,132,1799,661,0
19:49:20,8141.322,Fox,2660,68,16,10,11,12,13,6,2660,2644,2634,2097,717,675,29,39,1333,1327,132,1799,661,0
19:49:21,8144.626,Fox,2662,69,18,10,10,12,13,6,2662,2644,2634,2097,717,675,28,41,1333,1329,133,1799,661,0
19:49:21,8146.063,Fox,2662,69,18,10,10,10,15,6,2662,2644,2634,2097,719,675,28,41,1333,1329,133,1799,661,0
19:49:22,8147.44,Fox,2662,68,18,10,10,10,15,5,2662,2644,2634,2097,719,675,27,41,1333,1329,133,1799,662,0
19:49:22,8148.103,Fox,2662,68,18,10,10,10,14,6,2662,2644,2634,2097,719,676,27,41,1333,1329,133,1799,662,0
19:49:22,8149.38,Fox,2662,68,16,12,10,10,14,6,2662,2646,2634,2097,719,676,27,41,1333,1329,133,1799,662,0
19:49:23,8151.269,Fox,2662,68,16,10,12,10,14,6,2662,2646,2636,2097,719,676,27,41,1333,1329,133,1799,662,0
19:49:24,8155.651,Fox,2662,68,14,10,14,10,14,6,2662,2648,2638,2097,719,676,27,41,1333,1329,133,1799,662,0
19:49:25,8156.085,Fox,2662,68,12,12,14,10,14,6,2662,2650,2638,2097,719,676,27,41,1333,1329,133,1799,662,0
19:49:26,8159.677,Fox,2662,67,12,12,12,12,14,5,2662,2650,2638,2099,719,676,27,40,1333,1329,133,1799,663,0
19:49:27,8163.144,Fox,2664,69,14,12,12,12,14,5,2664,2650,2638,2099,719,676,29,40,1335,1329,133,1799,663,0
19:49:29,8168.307,Fox,2666,70,16,12,12,12,14,4,2666,2650,2638,2099,719,676,29,41,1335,1331,133,1799,664,0
19:49:29,8168.742,Fox,2668,72,14,14,12,12,14,4,2666,2652,2638,2099,719,676,30,42,1336,1332,133,1799,664,0
19:49:29,8168.98,Fox,2668,72,16,14,10,14,14,4,2668,2652,2638,2101,719,676,30,42,1336,1332,133,1799,664,0
19:49:29,8169.843,Fox,2670,74,16,14,9,13,16,4,2668,2652,2638,2102,721,676,32,42,1338,1332,133,1799,664,0
19:49:29,8170.053,Fox,2670,74,18,14,9,13,16,4,2670,2652,2638,2102,721,676,32,42,1338,1332,133,1799,664,0
19:49:30,8172.039,Fox,2670,74,18,12,11,13,16,4,2670,2652,2640,2102,721,676,32,42,1338,1332,133,1799,664,0
19:49:30,8172.461,Fox,2670,74,18,12,11,13,14,6,2670,2652,2640,2102,721,678,32,42,1338,1332,133,1799,664,0
19:49:30,8172.875,Fox,2670,74,18,10,13,13,14,6,2670,2652,2642,2102,721,678,32,42,1338,1332,133,1799,664,0
19:49:31,8173.989,Fox,2672,75,18,10,10,15,14,6,2670,2652,2642,2104,721,678,31,44,1338,1334,133,1800,664,0
19:49:31,8174.226,Fox,2672,75,20,10,10,15,14,6,2672,2652,2642,2104,721,678,31,44,1338,1334,133,1800,664,0
19:49:31,8175.15,Fox,2672,75,20,8,12,15,14,6,2672,2652,2644,2104,721,678,31,44,1338,1334,133,1800,664,0
19:49:32,8178.453,Fox,2674,76,22,8,12,14,14,6,2674,2652,2644,2104,721,678,31,45,1339,1335,133,1801,664,0
19:49:32,8179.346,Fox,2674,75,22,8,12,13,14,6,2674,2652,2644,2104,721,678,31,44,1339,1335,133,1802,664,0
19:49:33,8181.123,Fox,2674,74,22,8,12,13,14,5,2674,2652,2644,2104,721,678,31,43,1339,1335,133,1802,665,0
19:49:34,8184.158,Fox,2674,72,22,8,12,11,14,5,2674,2652,2644,2104,721,678,31,41,1339,1335,133,1804,665,0
19:49:35,8186.379,Fox,2676,73,22,10,11,11,14,5,2676,2654,2644,2104,721,678,32,41,1341,1335,133,1805,665,0
19:49:35,8188.16,Fox,2678,75,22,8,13,11,14,5,2676,2654,2646,2104,721,678,33,42,1342,1336,133,1805,665,0
19:49:35,8188.398,Fox,2678,75,24,8,13,11,14,5,2678,2654,2646,2104,721,678,33,42,1342,1336,133,1805,665,0
19:49:36,8190.983,Fox,2678,75,24,8,13,10,15,5,2678,2654,2646,2104,722,678,33,42,1342,1336,133,1805,665,0
19:49:37,8192.229,Fox,2680,77,26,8,13,10,15,5,2680,2654,2646,2104,722,678,34,43,1343,1337,133,1805,665,0
19:49:37,8192.959,Fox,2680,77,24,10,13,8,17,5,2680,2656,2646,2104,724,678,34,43,1343,1337,133,1805,665,0
19:49:37,8194.127,Fox,2680,77,22,10,15,8,17,5,2680,2658,2648,2104,724,678,34,43,1343,1337,133,1805,665,0
19:49:37,8194.565,Fox,2680,77,22,8,17,8,17,5,2680,2658,2650,2104,724,678,34,43,1343,1337,133,1805,665,0
19:49:38,8195.414,Fox,2680,77,22,8,15,10,17,5,2680,2658,2650,2106,724,678,34,43,1343,1337,133,1805,665,0
19:49:38,8196.558,Fox,2680,77,22,8,14,11,17,5,2680,2658,2650,2107,724,678,34,43,1343,1337,133,1805,665,0
19:49:41,8206.003,Fox,2680,76,22,8,14,11,15,6,2680,2658,2650,2107,724,680,34,42,1343,1337,133,1805,666,0
19:49:42,8207.313,Fox,2680,75,22,6,16,10,15,6,2680,2658,2652,2107,724,680,34,41,1343,1337,133,1806,666,0
19:49:42,8208.357,Fox,2680,74,22,6,16,10,15,5,2680,2658,2652,2107,724,680,33,41,1343,1337,133,1806,667,0
19:49:42,8208.876,Fox,2680,74,22,6,16,8,17,5,2680,2658,2652,2107,726,680,33,41,1343,1337,133,1806,667,0
19:49:43,8210.607,Fox,2682,75,24,6,15,8,17,5,2682,2658,2652,2107,726,680,32,43,1343,1339,133,1807,667,0
19:49:43,8211.6,Fox,2682,75,24,6,14,9,17,5,2682,2658,2652,2108,726,680,32,43,1343,1339,133,1807,667,0
19:49:43,8212.563,Fox,2684,76,26,6,13,9,17,5,2684,2658,2652,2108,726,680,33,43,1345,1339,133,1808,667,0
19:49:44,8214.453,Fox,2686,78,28,6,13,9,15,7,2686,2658,2652,2108,726,682,34,44,1346,1340,133,1808,667,0
19:49:45,8216.293,Fox,2686,78,28,6,11,11,15,7,2686,2658,2652,2110,726,682,34,44,1346,1340,133,1808,667,0
19:49:46,8221.181,Fox,2688,80,30,6,11,11,15,7,2688,2658,2652,2110,726,682,34,46,1346,1342,133,1808,667,0
19:49:47,8221.46,Fox,2688,80,30,6,11,9,17,7,2688,2658,2652,2110,728,682,34,46,1346,1342,133,1808,667,0
19:49:47,8222.25,Fox,2688,79,30,6,11,8,17,7,2688,2658,2652,2110,728,682,34,45,1346,1342,133,1809,667,0
19:49:47,8224.088,Fox,2688,79,28,8,11,8,15,9,2688,2660,2652,2110,728,684,34,45,1346,1342,133,1809,667,0
19:49:48,8225.2,Fox,2690,81,28,6,13,8,15,9,2688,2660,2654,2110,728,684,35,46,1347,1343,133,1809,667,0
19:49:48,8225.497,Fox,2690,81,30,6,13,8,15,9,2690,2660,2654,2110,728,684,35,46,1347,1343,133,1809,667,0
19:49:48,8226.853,Fox,2692,81,30,6,12,7,15,9,2690,2660,2654,2110,728,684,36,45,1349,1343,133,1811,667,0
19:49:49,8227.416,Fox,2692,81,30,8,12,7,15,9,2692,2662,2654,2110,728,684,36,45,1349,1343,133,1811,667,0
19:49:50,8231.358,Fox,2692,81,30,6,14,7,15,9,2692,2662,2656,2110,728,684,36,45,1349,1343,133,1811,667,0
19:49:50,8232.659,Fox,2692,81,30,4,16,7,15,9,2692,2662,2658,2110,728,684,36,45,1349,1343,133,1811,667,0
19:49:51,8233.462,Fox,2694,83,32,4,15,8,15,9,2694,2662,2658,2111,728,684,38,45,1351,1343,133,1811,667,0
19:49:51,8235.311,Fox,2694,82,32,4,15,8,15,8,2694,2662,2658,2111,728,684,37,45,1351,1343,133,1811,668,0
19:49:51,8235.851,Fox,2694,82,32,4,13,10,15,8,2694,2662,2658,2113,728,684,37,45,1351,1343,133,1811,668,0
19:49:54,8243.485,Fox,2696,83,34,4,13,10,15,7,2696,2662,2658,2113,728,684,37,46,1352,1344,133,1811,669,0
19:49:54,8244.033,Fox,2696,82,34,4,13,9,15,7,2696,2662,2658,2113,728,684,36,46,1352,1344,133,1812,669,0
19:49:54,8244.896,Fox,2698,84,36,4,13,9,15,7,2698,2662,2658,2113,728,684,36,48,1352,1346,133,1812,669,0
19:49:55,8246.088,Fox,2700,86,36,6,13,9,13,9,2700,2664,2658,2113,728,686,36,50,1352,1348,133,1812,669,0
19:49:56,8248.7,Fox,2700,86,36,6,11,11,13,9,2700,2664,2658,2115,728,686,36,50,1352,1348,133,1812,669,0
19:49:56,8251.023,Fox,2700,86,34,8,11,11,13,9,2700,2666,2658,2115,728,686,36,50,1352,1348,133,1812,669,0
19:49:57,8251.62,Fox,2700,86,32,10,11,11,13,9,2700,2668,2658,2115,728,686,36,50,1352,1348,133,1812,669,0
19:49:57,8252.52,Fox,2702,88,34,10,11,11,13,9,2702,2668,2658,2115,728,686,38,50,1354,1348,133,1812,669,0
19:49:57,8253.113,Fox,2702,88,32,12,11,9,15,9,2702,2670,2658,2115,730,686,38,50,1354,1348,133,1812,669,0
19:49:58,8254.613,Fox,2702,88,32,12,9,11,15,9,2702,2670,2658,2117,730,686,38,50,1354,1348,133,1812,669,0
19:49:58,8255.199,Fox,2702,88,32,12,7,13,15,9,2702,2670,2658,2119,730,686,38,50,1354,1348,133,1812,669,0
19:49:59,8256.932,Fox,2702,88,30,14,7,13,15,9,2702,2672,2658,2119,730,686,38,50,1354,1348,133,1812,669,0
19:49:59,8259.104,Fox,2702,87,30,14,7,12,15,9,2702,2672,2658,2119,730,686,38,49,1354,1348,133,1813,669,0
19:50:00,8261.172,Fox,2702,87,28,16,7,12,15,9,2702,2674,2658,2119,730,686,38,49,1354,1348,133,1813,669,0
19:50:00,8262.606,Fox,2702,87,28,14,9,12,15,9,2702,2674,2660,2119,730,686,38,49,1354,1348,133,1813,669,0
19:50:01,8263.486,Fox,2702,87,28,14,9,11,16,9,2702,2674,2660,2119,731,686,38,49,1354,1348,133,1813,669,0
19:50:01,8264.375,Fox,2704,89,30,14,9,11,16,9,2704,2674,2660,2119,731,686,39,50,1355,1349,133,1813,669,0
19:50:01,8264.952,Fox,2704,87,30,14,9,10,16,8,2704,2674,2660,2119,731,686,38,49,1355,1349,133,1814,670,0
19:50:02,8265.85,Fox,2704,87,30,12,11,10,16,8,2704,2674,2662,2119,731,686,38,49,1355,1349,133,1814,670,0
19:50:02,8267.606,Fox,2704,87,30,12,9,12,16,8,2704,2674,2662,2121,731,686,38,49,1355,1349,133,1814,670,0
19:50:03,8269.063,Fox,2704,87,28,14,9,12,16,8,2704,2676,2662,2121,731,686,38,49,1355,1349,133,1814,670,0
19:50:03,8271.128,Fox,2704,87,26,16,9,12,16,8,2704,2678,2662,2121,731,686,38,49,1355,1349,133,1814,670,0
19:50:04,8272.927,Fox,2704,87,26,16,9,12,14,10,2704,2678,2662,2121,731,688,38,49,1355,1349,133,1814,670,0
19:50:04,8273.81,Fox,2704,86,26,16,9,12,14,9,2704,2678,2662,2121,731,688,37,49,1355,1349,133,1814,671,0
19:50:05,8275.01,Fox,2704,86,24,18,9,12,14,9,2704,2680,2662,2121,731,688,37,49,1355,1349,133,1814,671,0
19:50:05,8276.778,Fox,2704,84,24,18,9,12,14,7,2704,2680,2662,2121,731,688,37,47,1355,1349,133,1814,673,0
19:50:06,8278.239,Fox,2704,82,24,18,9,10,14,7,2704,2680,2662,2121,731,688,37,45,1355,1349,133,1816,673,0
19:50:08,8283.877,Fox,2704,82,24,18,9,10,12,9,2704,2680,2662,2121,731,690,37,45,1355,1349,133,1816,673,0
19:50:08,8284.477,Fox,2704,81,24,16,11,10,12,8,2704,2680,2664,2121,731,690,37,44,1355,1349,133,1816,674,0
19:50:08,8285.377,Fox,2704,81,24,16,9,12,12,8,2704,2680,2664,2123,731,690,37,44,1355,1349,133,1816,674,0
19:50:09,8286.576,Fox,2704,80,24,16,9,12,12,7,2704,2680,2664,2123,731,690,36,44,1355,1349,133,1816,675,0
19:50:10,8288.977,Fox,2704,80,24,16,9,10,14,7,2704,2680,2664,2123,733,690,36,44,1355,1349,133,1816,675,0
19:50:10,8289.576,Fox,2704,80,24,14,11,10,14,7,2704,2680,2666,2123,733,690,36,44,1355,1349,133,1816,675,0
19:50:10,8290.177,Fox,2704,80,24,12,13,10,14,7,2704,2680,2668,2123,733,690,36,44,1355,1349,133,1816,675,0
19:50:11,8291.677,Fox,2704,80,24,10,13,12,14,7,2704,2680,2670,2125,733,690,36,44,1355,1349,133,1816,675,0
19:50:11,8293.169,Fox,2704,80,22,12,11,14,14,7,2704,2682,2670,2127,733,690,36,44,1355,1349,133,1816,675,0
19:50:12,8294.669,Fox,2704,79,22,12,11,14,14,6,2704,2682,2670,2127,733,690,36,43,1355,1349,133,1816,676,0
19:50:12,8295.569,Fox,2704,79,20,12,13,14,14,6,2704,2684,2672,2127,733,690,36,43,1355,1349,133,1816,676,0
19:50:13,8296.169,Fox,2706,79,22,12,13,12,14,6,2706,2684,2672,2127,733,690,35,44,1355,1351,135,1816,676,0
19:50:13,8297.069,Fox,2706,79,20,14,13,12,14,6,2706,2686,2672,2127,733,690,35,44,1355,1351,135,1816,676,0
19:50:14,8299.77,Fox,2706,79,20,12,15,12,14,6,2706,2686,2674,2127,733,690,35,44,1355,1351,135,1816,676,0
19:50:15,8302.169,Fox,2706,78,20,12,15,11,14,6,2706,2686,2674,2127,733,690,35,43,1355,1351,136,1816,676,0
19:50:16,8303.97,Fox,2708,79,18,14,15,10,14,6,2706,2688,2674,2127,733,690,36,43,1356,1352,136,1817,676,0
19:50:16,8304.27,Fox,2708,79,20,14,15,10,14,6,2708,2688,2674,2127,733,690,36,43,1356,1352,136,1817,676,0
19:50:16,8305.77,Fox,2710,80,20,14,15,10,14,5,2708,2688,2674,2127,733,690,38,42,1358,1352,136,1817,677,0
19:50:16,8306.069,Fox,2710,80,22,14,15,10,14,5,2710,2688,2674,2127,733,690,38,42,1358,1352,136,1817,677,0
19:50:17,8307.569,Fox,2710,80,22,12,17,10,12,7,2710,2688,2676,2127,733,692,38,42,1358,1352,136,1817,677,0
19:50:17,8308.169,Fox,2710,80,20,14,17,10,12,7,2710,2690,2676,2127,733,692,38,42,1358,1352,136,1817,677,0
19:50:18,8309.669,Fox,2712,82,20,14,19,9,13,7,2712,2692,2678,2127,734,692,40,42,1360,1352,136,1817,677,0
19:50:19,8313.27,Fox,2712,82,20,12,21,9,13,7,2712,2692,2680,2127,734,692,40,42,1360,1352,136,1817,677,0
19:50:20,8314.47,Fox,2712,81,20,12,21,9,13,6,2712,2692,2680,2127,734,692,40,41,1360,1352,136,1817,678,0
19:50:20,8316.27,Fox,2712,81,18,14,21,9,13,6,2712,2694,2680,2127,734,692,40,41,1360,1352,136,1817,678,0
19:50:21,8317.47,Fox,2712,80,18,14,21,9,13,5,2712,2694,2680,2127,734,692,39,41,1360,1352,136,1817,679,0
19:50:22,8321.959,Fox,2714,82,20,14,21,9,13,5,2714,2694,2680,2127,734,692,41,41,1362,1352,136,1817,679,0
19:50:23,8322.858,Fox,2716,84,22,14,21,9,13,5,2716,2694,2680,2127,734,692,41,43,1362,1354,136,1817,679,0
19:50:23,8323.158,Fox,2716,84,22,14,19,11,13,5,2716,2694,2680,2129,734,692,41,43,1362,1354,136,1817,679,0
19:50:23,8323.759,Fox,2716,83,22,14,19,11,13,4,2716,2694,2680,2129,734,692,40,43,1362,1354,136,1817,680,0
19:50:24,8326.459,Fox,2716,83,20,16,17,13,13,4,2716,2696,2680,2131,734,692,40,43,1362,1354,136,1817,680,0
19:50:25,8327.658,Fox,2716,83,18,18,17,13,13,4,2716,2698,2680,2131,734,692,40,43,1362,1354,136,1817,680,0
19:50:25,8328.858,Fox,2716,83,16,20,17,13,12,5,2716,2700,2680,2131,734,693,40,43,1362,1354,136,1817,680,0
19:50:25,8329.158,Fox,2716,83,16,20,17,11,14,5,2716,2700,2680,2131,736,693,40,43,1362,1354,136,1817,680,0
19:50:26,8330.658,Fox,2716,83,16,20,17,11,12,7,2716,2700,2680,2131,736,695,40,43,1362,1354,136,1817,680,0
19:50:26,8331.858,Fox,2716,83,16,18,19,11,12,7,2716,2700,2682,2131,736,695,40,43,1362,1354,136,1817,680,0
19:50:27,8333.658,Fox,2716,83,16,16,21,11,12,7,2716,2700,2684,2131,736,695,40,43,1362,1354,136,1817,680,0
19:50:28,8335.158,Fox,2716,83,14,18,21,11,12,7,2716,2702,2684,2131,736,695,40,43,1362,1354,136,1817,680,0
19:50:28,8336.059,Fox,2718,85,14,16,23,11,12,7,2716,2702,2686,2131,736,695,41,44,1363,1355,136,1817,680,0
19:50:28,8336.358,Fox,2718,85,16,16,23,11,12,7,2718,2702,2686,2131,736,695,41,44,1363,1355,136,1817,680,0
19:50:29,8338.459,Fox,2720,87,18,16,23,11,12,7,2720,2702,2686,2131,736,695,42,45,1364,1356,136,1817,680,0
19:50:29,8339.358,Fox,2722,88,20,16,22,11,12,7,2722,2702,2686,2131,736,695,42,46,1365,1357,136,1818,680,0
19:50:30,8342.358,Fox,2722,88,20,14,24,10,13,7,2722,2702,2688,2131,737,695,42,46,1365,1357,136,1818,680,0
19:50:31,8344.158,Fox,2722,87,20,14,24,10,13,6,2722,2702,2688,2131,737,695,41,46,1365,1357,136,1818,681,0
19:50:31,8344.759,Fox,2722,87,20,14,22,12,13,6,2722,2702,2688,2133,737,695,41,46,1365,1357,136,1818,681,0
19:50:32,8346.559,Fox,2724,89,22,12,24,12,11,8,2724,2702,2690,2133,737,697,41,48,1365,1359,136,1818,681,0
19:50:32,8347.459,Fox,2726,91,22,14,24,12,11,8,2726,2704,2690,2133,737,697,42,49,1366,1360,136,1818,681,0
19:50:33,8348.358,Fox,2726,91,22,12,26,11,12,8,2726,2704,2692,2133,738,697,42,49,1366,1360,136,1818,681,0
19:50:33,8348.959,Fox,2726,90,22,12,26,9,14,7,2726,2704,2692,2133,740,697,41,49,1366,1360,136,1818,682,0
19:50:33,8350.158,Fox,2726,90,22,12,24,11,14,7,2726,2704,2692,2135,740,697,41,49,1366,1360,136,1818,682,0
19:50:34,8350.759,Fox,2726,90,22,12,22,13,14,7,2726,2704,2692,2137,740,697,41,49,1366,1360,136,1818,682,0
19:50:34,8351.658,Fox,2726,90,22,12,20,15,14,7,2726,2704,2692,2139,740,697,41,49,1366,1360,136,1818,682,0
19:50:35,8354.059,Fox,2728,91,24,12,19,15,14,7,2728,2704,2692,2139,740,697,41,50,1367,1361,136,1819,682,0
19:50:35,8354.658,Fox,2728,91,24,10,21,15,14,7,2728,2704,2694,2139,740,697,41,50,1367,1361,136,1819,682,0
19:50:35,8355.259,Fox,2728,89,24,10,21,14,14,6,2728,2704,2694,2139,740,697,40,49,1367,1361,137,1819,683,0
19:50:36,8355.858,Fox,2728,89,24,10,19,16,14,6,2728,2704,2694,2141,740,697,40,49,1367,1361,137,1819,683,0
19:50:37,8358.259,Fox,2728,88,24,10,19,16,14,5,2728,2704,2694,2141,740,697,40,48,1367,1361,137,1819,684,0
19:50:37,8358.858,Fox,2728,88,24,10,19,16,12,7,2728,2704,2694,2141,740,699,40,48,1367,1361,137,1819,684,0
19:50:38,8360.358,Fox,2728,86,24,10,18,15,12,7,2728,2704,2694,2142,740,699,40,46,1367,1361,139,1819,684,0
19:50:38,8361.259,Fox,2728,85,24,10,18,15,12,6,2728,2704,2694,2142,740,699,39,46,1367,1361,139,1819,685,0
19:50:39,8364.559,Fox,2728,85,24,8,20,15,12,6,2728,2704,2696,2142,740,699,39,46,1367,1361,139,1819,685,0
19:50:40,8366.358,Fox,2728,83,24,6,22,13,12,6,2728,2704,2698,2142,740,699,39,44,1367,1361,140,1820,685,0
19:50:40,8367.259,Fox,2728,83,24,4,24,13,12,6,2728,2704,2700,2142,740,699,39,44,1367,1361,140,1820,685,0
19:50:41,8368.158,Fox,2728,83,24,4,22,15,12,6,2728,2704,2700,2144,740,699,39,44,1367,1361,140,1820,685,0
19:50:41,8370.559,Fox,2728,82,24,4,20,16,12,6,2728,2704,2700,2146,740,699,39,43,1367,1361,140,1821,685,0
19:50:42,8371.158,Fox,2730,83,26,4,19,16,12,6,2730,2704,2700,2146,740,699,39,44,1368,1362,141,1821,685,0
19:50:43,8373.858,Fox,2730,83,26,2,20,17,12,6,2730,2704,2702,2147,740,699,39,44,1368,1362,141,1821,685,0
19:50:43,8375.059,Fox,2732,84,28,2,19,17,12,6,2732,2704,2702,2147,740,699,40,44,1370,1362,142,1821,685,0
19:50:45,8378.358,Fox,2732,82,28,2,19,15,12,6,2732,2704,2702,2147,740,699,38,44,1370,1362,142,1823,685,0
19:50:45,8379.259,Fox,2734,83,28,4,19,15,12,5,2734,2706,2702,2147,740,699,39,44,1371,1363,142,1823,686,0
19:50:46,8380.459,Fox,2734,81,28,4,19,13,12,5,2734,2706,2702,2147,740,699,38,43,1371,1363,142,1825,686,0
19:50:46,8382.559,Fox,2736,83,30,4,19,13,12,5,2736,2706,2702,2147,740,699,38,45,1371,1365,142,1825,686,0
19:50:47,8384.358,Fox,2736,82,30,4,19,12,12,5,2736,2706,2702,2147,740,699,38,44,1371,1365,142,1826,686,0
19:50:48,8385.559,Fox,2738,83,32,2,20,11,13,5,2738,2706,2704,2147,741,699,38,45,1372,1366,142,1827,686,0
19:50:48,8387.059,Fox,2740,84,32,4,19,10,14,5,2740,2708,2704,2147,742,699,37,47,1372,1368,142,1828,686,0
19:50:49,8388.858,Fox,2740,84,30,6,19,10,14,5,2740,2710,2704,2147,742,699,37,47,1372,1368,142,1828,686,0
19:50:49,8389.459,Fox,2740,83,30,6,19,10,14,4,2740,2710,2704,2147,742,699,36,47,1372,1368,142,1828,687,0
19:50:50,8390.358,Fox,2742,85,32,6,19,10,14,4,2742,2710,2704,2147,742,699,36,49,1372,1370,142,1828,687,0
19:50:50,8390.658,Fox,2742,85,32,6,19,10,12,6,2742,2710,2704,2147,742,701,36,49,1372,1370,142,1828,687,0
19:50:50,8392.459,Fox,2742,85,30,8,17,12,12,6,2742,2712,2704,2149,742,701,36,49,1372,1370,142,1828,687,0
19:50:52,8396.059,Fox,2742,85,30,8,16,13,12,6,2742,2712,2704,2150,742,701,36,49,1372,1370,142,1828,687,0
19:50:52,8397.259,Fox,2742,83,30,8,16,13,12,4,2742,2712,2704,2150,742,701,36,47,1372,1370,142,1828,689,0
19:50:53,8399.658,Fox,2744,85,32,8,16,13,12,4,2744,2712,2704,2150,742,701,38,47,1374,1370,142,1828,689,0
19:50:54,8400.559,Fox,2746,87,34,8,16,13,12,4,2746,2712,2704,2150,742,701,38,49,1374,1372,142,1828,689,0
19:50:54,8401.158,Fox,2746,87,34,8,16,13,11,5,2746,2712,2704,2150,742,702,38,49,1374,1372,142,1828,689,0
19:50:54,8402.358,Fox,2748,87,36,8,15,13,11,4,2748,2712,2704,2150,742,702,37,50,1375,1373,143,1828,690,0
19:50:55,8402.959,Fox,2748,85,36,8,13,13,11,4,2748,2712,2704,2152,742,702,37,48,1375,1373,143,1830,690,0
19:50:55,8404.459,Fox,2748,85,34,10,13,13,11,4,2748,2714,2704,2152,742,702,37,48,1375,1373,143,1830,690,0
19:50:56,8405.358,Fox,2748,85,32,12,13,13,11,4,2748,2716,2704,2152,742,702,37,48,1375,1373,143,1830,690,0
19:50:56,8406.559,Fox,2748,84,32,12,13,12,11,4,2748,2716,2704,2152,742,702,37,47,1375,1373,144,1830,690,0
19:50:56,8407.158,Fox,2748,84,32,12,12,13,11,4,2748,2716,2704,2153,742,702,37,47,1375,1373,144,1830,690,0
19:50:57,8408.658,Fox,2748,84,32,12,10,15,11,4,2748,2716,2704,2155,742,702,37,47,1375,1373,144,1830,690,0
19:50:57,8409.259,Fox,2748,83,32,12,10,15,11,3,2748,2716,2704,2155,742,702,37,46,1375,1373,144,1830,691,0
19:50:59,8413.158,Fox,2752,83,36,12,8,13,11,3,2752,2716,2704,2155,742,702,37,46,1377,1375,148,1830,691,0
19:51:00,8415.259,Fox,2752,83,36,12,6,15,11,3,2752,2716,2704,2157,742,702,37,46,1377,1375,148,1830,691,0
19:51:01,8416.459,Fox,2752,83,36,12,6,13,13,3,2752,2716,2704,2157,744,702,37,46,1377,1375,148,1830,691,0
19:51:01,8417.658,Fox,2752,82,36,10,8,12,13,3,2752,2716,2706,2157,744,702,37,45,1377,1375,148,1831,691,0
19:51:02,8419.158,Fox,2752,81,34,12,8,11,13,3,2752,2718,2706,2157,744,702,36,45,1377,1375,148,1832,691,0
19:51:02,8419.759,Fox,2752,81,34,12,8,9,15,3,2752,2718,2706,2157,746,702,36,45,1377,1375,148,1832,691,0
19:51:03,8421.259,Fox,2752,80,32,14,8,9,15,2,2752,2720,2706,2157,746,702,35,45,1377,1375,148,1832,692,0
19:51:03,8421.858,Fox,2752,80,30,16,8,9,15,2,2752,2722,2706,2157,746,702,35,45,1377,1375,148,1832,692,0
19:51:05,8425.459,Fox,2754,81,30,14,9,9,15,2,2752,2722,2708,2158,746,702,34,47,1377,1377,148,1833,692,0
19:51:05,8425.759,Fox,2754,81,32,14,9,9,15,2,2754,2722,2708,2158,746,702,34,47,1377,1377,148,1833,692,0
19:51:06,8426.959,Fox,2756,83,32,14,7,11,13,4,2754,2722,2708,2160,746,704,35,48,1378,1378,148,1833,692,0
19:51:06,8427.259,Fox,2756,83,34,12,9,11,13,4,2756,2722,2710,2160,746,704,35,48,1378,1378,148,1833,692,0
19:51:06,8427.858,Fox,2756,83,34,12,7,13,13,4,2756,2722,2710,2162,746,704,35,48,1378,1378,148,1833,692,0
19:51:06,8429.059,Fox,2756,83,32,14,7,13,13,4,2756,2724,2710,2162,746,704,35,48,1378,1378,148,1833,692,0
19:51:07,8429.959,Fox,2756,83,30,16,7,13,13,4,2756,2726,2710,2162,746,704,35,48,1378,1378,148,1833,692,0
19:51:07,8430.858,Fox,2756,83,30,14,9,13,13,4,2756,2726,2712,2162,746,704,35,48,1378,1378,148,1833,692,0
19:51:09,8435.658,Fox,2756,82,30,14,9,12,13,4,2756,2726,2712,2162,746,704,35,47,1378,1378,149,1833,692,0
19:51:10,8436.559,Fox,2756,82,28,16,9,12,13,4,2756,2728,2712,2162,746,704,35,47,1378,1378,149,1833,692,0
19:51:11,8438.358,Fox,2756,82,28,16,9,11,14,4,2756,2728,2712,2162,747,704,35,47,1378,1378,149,1833,692,0
19:51:13,8443.158,Fox,2756,82,28,14,11,11,14,4,2756,2728,2714,2162,747,704,35,47,1378,1378,149,1833,692,0
19:51:13,8444.059,Fox,2756,82,28,12,13,9,16,4,2756,2728,2716,2162,749,704,35,47,1378,1378,149,1833,692,0
19:51:14,8445.259,Fox,2756,82,28,12,13,7,18,4,2756,2728,2716,2162,751,704,35,47,1378,1378,149,1833,692,0
19:51:14,8446.158,Fox,2756,82,28,12,11,9,18,4,2756,2728,2716,2164,751,704,35,47,1378,1378,149,1833,692,0
19:51:15,8447.358,Fox,2756,82,28,12,11,9,17,5,2756,2728,2716,2164,751,705,35,47,1378,1378,149,1833,692,0
19:51:17,8453.059,Fox,2758,84,30,12,11,9,17,5,2758,2728,2716,2164,751,705,37,47,1380,1378,149,1833,692,0
19:51:17,8453.658,Fox,2758,84,28,14,11,9,17,5,2758,2730,2716,2164,751,705,37,47,1380,1378,149,1833,692,0
19:51:20,8457.858,Fox,2760,86,28,14,13,9,17,5,2760,2732,2718,2164,751,705,38,48,1381,1379,149,1833,692,0
19:51:20,8459.658,Fox,2760,86,28,12,15,9,17,5,2760,2732,2720,2164,751,705,38,48,1381,1379,149,1833,692,0
19:51:21,8460.559,Fox,2760,86,28,10,17,9,17,5,2760,2732,2722,2164,751,705,38,48,1381,1379,149,1833,692,0
19:51:21,8461.759,Fox,2760,86,26,12,17,9,17,5,2760,2734,2722,2164,751,705,38,48,1381,1379,149,1833,692,0
19:51:22,8462.358,Fox,2760,85,26,12,17,9,17,4,2760,2734,2722,2164,751,705,38,47,1381,1379,149,1833,693,0
19:51:23,8465.059,Fox,2762,86,26,14,16,9,17,4,2762,2736,2722,2164,751,705,37,49,1381,1381,149,1834,693,0
19:51:24,8466.858,Fox,2762,86,26,14,16,9,15,6,2762,2736,2722,2164,751,707,37,49,1381,1381,149,1834,693,0
19:51:24,8467.759,Fox,2762,85,26,12,18,9,15,5,2762,2736,2724,2164,751,707,36,49,1381,1381,149,1834,694,0
19:51:25,8468.059,Fox,2762,85,24,14,18,9,15,5,2762,2738,2724,2164,751,707,36,49,1381,1381,149,1834,694,0
19:51:25,8468.658,Fox,2762,85,24,12,20,9,15,5,2762,2738,2726,2164,751,707,36,49,1381,1381,149,1834,694,0
19:51:25,8469.559,Fox,2762,85,22,14,20,9,15,5,2762,2740,2726,2164,751,707,36,49,1381,1381,149,1834,694,0
19:51:27,8472.858,Fox,2762,85,20,16,20,9,15,5,2762,2742,2726,2164,751,707,36,49,1381,1381,149,1834,694,0
19:51:28,8475.259,Fox,2762,85,20,14,22,9,15,5,2762,2742,2728,2164,751,707,36,49,1381,1381,149,1834,694,0
19:51:30,8477.959,Fox,2762,84,20,14,20,11,15,4,2762,2742,2728,2166,751,707,36,48,1381,1381,149,1834,695,0
19:51:30,8479.459,Fox,2762,84,20,14,20,11,14,5,2762,2742,2728,2166,751,708,36,48,1381,1381,149,1834,695,0
19:51:32,8482.459,Fox,2762,83,18,16,20,11,14,4,2762,2744,2728,2166,751,708,36,47,1381,1381,149,1834,696,0
19:51:32,8483.059,Fox,2762,83,16,18,20,11,14,4,2762,2746,2728,2166,751,708,36,47,1381,1381,149,1834,696,0
19:51:33,8484.858,Fox,2762,83,14,20,20,11,14,4,2762,2748,2728,2166,751,708,36,47,1381,1381,149,1834,696,0
19:51:34,8486.059,Fox,2762,83,14,20,19,12,13,5,2762,2748,2728,2167,751,709,36,47,1381,1381,149,1834,696,0
19:51:34,8486.358,Fox,2762,83,14,20,19,12,11,7,2762,2748,2728,2167,751,711,36,47,1381,1381,149,1834,696,0
19:51:35,8488.158,Fox,2762,81,14,20,17,12,11,7,2762,2748,2728,2169,751,711,36,45,1381,1381,151,1834,696,0
19:51:36,8490.559,Fox,2764,82,16,20,16,12,11,7,2764,2748,2728,2169,751,711,36,46,1382,1382,152,1834,696,0
19:51:37,8491.459,Fox,2764,82,16,20,15,13,11,7,2764,2748,2728,2170,751,711,36,46,1382,1382,152,1834,696,0
19:51:37,8492.358,Fox,2764,82,16,18,17,13,11,7,2764,2748,2730,2170,751,711,36,46,1382,1382,152,1834,696,0
19:51:39,8495.959,Fox,2766,84,14,22,17,13,11,7,2766,2752,2730,2170,751,711,36,48,1382,1384,152,1834,696,0
19:51:39,8496.259,Fox,2766,84,14,20,19,13,11,7,2766,2752,2732,2170,751,711,36,48,1382,1384,152,1834,696,0
19:51:41,8499.559,Fox,2770,87,18,20,18,13,11,7,2770,2752,2732,2170,751,711,36,51,1383,1387,153,1834,696,0
19:51:41,8500.459,Fox,2770,87,18,18,20,13,11,7,2770,2752,2734,2170,751,711,36,51,1383,1387,153,1834,696,0
19:51:42,8501.959,Fox,2772,88,18,18,20,12,11,7,2770,2752,2734,2170,751,711,36,52,1384,1388,154,1834,696,0
19:51:42,8502.259,Fox,2772,88,20,18,20,11,12,7,2772,2752,2734,2170,752,711,36,52,1384,1388,154,1834,696,0
19:51:43,8503.759,Fox,2772,88,20,16,20,13,12,7,2772,2752,2736,2172,752,711,36,52,1384,1388,154,1834,696,0
19:51:43,8504.358,Fox,2772,88,20,16,18,15,12,7,2772,2752,2736,2174,752,711,36,52,1384,1388,154,1834,696,0
19:51:44,8506.759,Fox,2772,88,20,14,20,15,12,7,2772,2752,2738,2174,752,711,36,52,1384,1388,154,1834,696,0
19:51:45,8508.559,Fox,2772,88,18,14,22,14,13,7,2772,2754,2740,2174,753,711,36,52,1384,1388,154,1834,696,0
19:51:46,8509.759,Fox,2772,88,16,16,22,14,13,7,2772,2756,2740,2174,753,711,36,52,1384,1388,154,1834,696,0
19:51:47,8511.559,Fox,2772,88,16,14,24,14,13,7,2772,2756,2742,2174,753,711,36,52,1384,1388,154,1834,696,0
19:51:47,8512.459,Fox,2774,90,18,14,24,14,13,7,2774,2756,2742,2174,753,711,37,53,1385,1389,154,1834,696,0
19:51:48,8513.658,Fox,2776,92,20,14,24,14,13,7,2776,2756,2742,2174,753,711,38,54,1386,1390,154,1834,696,0
19:51:50,8517.858,Fox,2776,91,20,14,22,16,13,6,2776,2756,2742,2176,753,711,37,54,1386,1390,154,1834,697,0
19:51:50,8518.759,Fox,2776,90,20,14,22,16,13,5,2776,2756,2742,2176,753,711,37,53,1386,1390,154,1834,698,0
19:51:51,8519.959,Fox,2778,92,22,14,20,16,15,5,2778,2756,2742,2178,755,711,39,53,1388,1390,154,1834,698,0
19:51:51,8521.158,Fox,2778,92,22,12,21,15,17,5,2778,2756,2744,2179,757,711,39,53,1388,1390,154,1834,698,0
19:51:52,8521.759,Fox,2778,92,22,10,23,15,17,5,2778,2756,2746,2179,757,711,39,53,1388,1390,154,1834,698,0
19:51:52,8523.259,Fox,2780,94,22,10,23,15,16,6,2778,2756,2746,2179,757,712,40,54,1389,1391,154,1834,698,0
19:51:53,8523.559,Fox,2780,94,24,8,25,15,16,6,2780,2756,2748,2179,757,712,40,54,1389,1391,154,1834,698,0
19:51:53,8524.459,Fox,2780,94,24,8,25,15,15,7,2780,2756,2748,2179,757,713,40,54,1389,1391,154,1834,698,0
19:51:55,8528.059,Fox,2780,94,24,8,23,17,15,7,2780,2756,2748,2181,757,713,40,54,1389,1391,154,1834,698,0
19:51:55,8528.959,Fox,2780,94,24,8,21,19,15,7,2780,2756,2748,2183,757,713,40,54,1389,1391,154,1834,698,0
19:51:57,8531.658,Fox,2782,94,26,8,20,18,15,7,2782,2756,2748,2183,757,713,41,53,1391,1391,154,1836,698,0
19:51:58,8534.358,Fox,2782,94,26,4,24,18,15,7,2782,2756,2752,2183,757,713,41,53,1391,1391,154,1836,698,0
19:51:58,8535.559,Fox,2782,94,24,6,22,20,15,7,2782,2758,2752,2185,757,713,41,53,1391,1391,154,1836,698,0
19:51:59,8537.658,Fox,2784,95,26,6,21,20,15,7,2784,2758,2752,2185,757,713,42,53,1393,1391,154,1837,698,0
19:52:01,8539.459,Fox,2786,96,28,6,21,17,17,7,2786,2758,2752,2185,759,713,43,53,1395,1391,155,1837,698,0
19:52:01,8540.358,Fox,2788,98,28,8,21,17,17,7,2788,2760,2752,2185,759,713,43,55,1395,1393,155,1837,698,0
19:52:02,8542.158,Fox,2790,100,30,8,21,17,17,7,2790,2760,2752,2185,759,713,44,56,1396,1394,155,1837,698,0
19:52:04,8545.459,Fox,2794,104,32,8,21,17,17,7,2792,2760,2752,2185,759,713,47,57,1399,1395,155,1837,698,0
19:52:04,8545.759,Fox,2794,104,34,8,21,17,17,7,2794,2760,2752,2185,759,713,47,57,1399,1395,155,1837,698,0
19:52:04,8546.959,Fox,2794,104,34,6,23,17,17,7,2794,2760,2754,2185,759,713,47,57,1399,1395,155,1837,698,0
19:52:05,8547.559,Fox,2794,104,32,8,23,17,17,7,2794,2762,2754,2185,759,713,47,57,1399,1395,155,1837,698,0
19:52:05,8548.459,Fox,2794,104,32,6,25,17,17,7,2794,2762,2756,2185,759,713,47,57,1399,1395,155,1837,698,0
19:52:06,8550.858,Fox,2794,103,32,6,25,17,17,6,2794,2762,2756,2185,759,713,47,56,1399,1395,155,1837,699,0
19:52:07,8551.759,Fox,2796,105,34,6,25,17,17,6,2796,2762,2756,2185,759,713,49,56,1401,1395,155,1837,699,0
19:52:07,8552.658,Fox,2796,105,34,6,23,19,17,6,2796,2762,2756,2187,759,713,49,56,1401,1395,155,1837,699,0
19:52:08,8553.559,Fox,2796,104,34,6,23,19,17,5,2796,2762,2756,2187,759,713,49,55,1401,1395,155,1837,700,0
19:52:08,8554.158,Fox,2796,104,34,6,23,19,15,7,2796,2762,2756,2187,759,715,49,55,1401,1395,155,1837,700,0
19:52:09,8556.259,Fox,2800,108,38,6,23,19,15,7,2800,2762,2756,2187,759,715,50,58,1402,1398,155,1837,700,0
19:52:10,8557.759,Fox,2800,107,38,6,23,19,13,8,2800,2762,2756,2187,759,717,49,58,1402,1398,155,1837,701,0
19:52:11,8560.759,Fox,2800,107,38,6,21,21,13,8,2800,2762,2756,2189,759,717,49,58,1402,1398,155,1837,701,0
19:52:12,8562.858,Fox,2802,109,40,6,21,21,13,8,2802,2762,2756,2189,759,717,50,59,1403,1399,155,1837,701,0
19:52:13,8564.059,Fox,2802,109,40,6,19,23,13,8,2802,2762,2756,2191,759,717,50,59,1403,1399,155,1837,701,0
19:52:14,8567.358,Fox,2802,108,40,6,17,25,13,7,2802,2762,2756,2193,759,717,49,59,1403,1399,155,1837,702,0
19:52:15,8568.559,Fox,2802,108,40,6,15,27,13,7,2802,2762,2756,2195,759,717,49,59,1403,1399,155,1837,702,0
19:52:17,8571.858,Fox,2802,108,40,6,13,29,13,7,2802,2762,2756,2197,759,717,49,59,1403,1399,155,1837,702,0
19:52:17,8573.059,Fox,2802,108,38,8,13,29,13,7,2802,2764,2756,2197,759,717,49,59,1403,1399,155,1837,702,0
19:52:18,8574.259,Fox,2802,108,38,6,15,29,13,7,2802,2764,2758,2197,759,717,49,59,1403,1399,155,1837,702,0
19:52:19,8575.759,Fox,2802,108,38,6,15,29,12,8,2802,2764,2758,2197,759,718,49,59,1403,1399,155,1837,702,0
19:52:20,8578.459,Fox,2802,107,36,8,15,29,12,7,2802,2766,2758,2197,759,718,49,58,1403,1399,155,1837,703,0
19:52:21,8579.358,Fox,2802,106,36,6,17,27,13,7,2802,2766,2760,2197,760,718,49,57,1403,1399,156,1837,703,0
19:52:21,8580.259,Fox,2804,108,38,6,17,27,13,7,2804,2766,2760,2197,760,718,49,59,1403,1401,156,1837,703,0
19:52:21,8580.858,Fox,2806,110,40,6,17,27,13,7,2806,2766,2760,2197,760,718,51,59,1405,1401,156,1837,703,0
19:52:21,8581.158,Fox,2806,110,40,6,15,27,15,7,2806,2766,2760,2199,762,718,51,59,1405,1401,156,1837,703,0
19:52:22,8582.059,Fox,2808,112,38,10,13,29,13,9,2808,2770,2760,2201,762,720,53,59,1407,1401,156,1837,703,0
19:52:22,8582.658,Fox,2808,111,38,10,13,28,11,11,2808,2770,2760,2201,762,722,53,58,1407,1401,157,1837,703,0
19:52:23,8583.858,Fox,2808,111,38,10,11,30,11,11,2808,2770,2760,2203,762,722,53,58,1407,1401,157,1837,703,0
19:52:23,8584.759,Fox,2808,111,36,12,11,30,11,11,2808,2772,2760,2203,762,722,53,58,1407,1401,157,1837,703,0
19:52:24,8586.559,Fox,2810,113,38,10,13,30,11,11,2810,2772,2762,2203,762,722,54,59,1408,1402,157,1837,703,0
19:52:26,8589.858,Fox,2812,115,40,10,13,30,11,11,2812,2772,2762,2203,762,722,55,60,1409,1403,157,1837,703,0
19:52:27,8592.858,Fox,2812,114,40,10,13,30,11,10,2812,2772,2762,2203,762,722,54,60,1409,1403,157,1837,704,0
19:52:28,8594.959,Fox,2812,114,38,12,9,34,11,10,2812,2774,2762,2207,762,722,54,60,1409,1403,157,1837,704,0
19:52:29,8596.158,Fox,2812,113,36,14,9,34,11,9,2812,2776,2762,2207,762,722,54,59,1409,1403,157,1837,705,0
19:52:29,8597.059,Fox,2812,113,36,14,9,32,13,9,2812,2776,2762,2207,764,722,54,59,1409,1403,157,1837,705,0
19:52:30,8597.959,Fox,2814,115,38,14,9,30,15,9,2814,2776,2762,2207,766,722,54,61,1409,1405,157,1837,705,0
19:52:32,8601.858,Fox,2816,117,40,14,9,30,15,9,2816,2776,2762,2207,766,722,56,61,1411,1405,157,1837,705,0
19:52:32,8602.459,Fox,2816,117,38,16,9,30,15,9,2816,2778,2762,2207,766,722,56,61,1411,1405,157,1837,705,0
19:52:34,8605.158,Fox,2818,118,40,16,9,29,15,9,2818,2778,2762,2207,766,722,58,60,1413,1405,158,1837,705,0
19:52:34,8606.059,Fox,2818,118,38,18,9,29,15,9,2818,2780,2762,2207,766,722,58,60,1413,1405,158,1837,705,0
19:52:34,8606.959,Fox,2820,120,40,18,9,29,15,9,2820,2780,2762,2207,766,722,59,61,1414,1406,158,1837,705,0
19:52:35,8607.259,Fox,2820,120,40,18,7,31,15,9,2820,2780,2762,2209,766,722,59,61,1414,1406,158,1837,705,0
19:52:35,8608.759,Fox,2820,120,40,18,5,33,15,9,2820,2780,2762,2211,766,722,59,61,1414,1406,158,1837,705,0
19:52:37,8611.759,Fox,2820,120,40,16,7,31,17,9,2820,2780,2764,2211,768,722,59,61,1414,1406,158,1837,705,0
19:52:38,8613.559,Fox,2820,120,40,16,7,29,19,9,2820,2780,2764,2211,770,722,59,61,1414,1406,158,1837,705,0
19:52:38,8614.459,Fox,2822,122,38,18,7,29,19,9,2820,2782,2764,2211,770,722,60,62,1415,1407,158,1837,705,0
19:52:38,8614.759,Fox,2822,122,40,18,7,29,19,9,2822,2782,2764,2211,770,722,60,62,1415,1407,158,1837,705,0
19:52:39,8615.959,Fox,2824,124,42,18,7,29,19,9,2824,2782,2764,2211,770,722,61,63,1416,1408,158,1837,705,0
19:52:39,8617.158,Fox,2824,124,42,16,9,29,19,9,2824,2782,2766,2211,770,722,61,63,1416,1408,158,1837,705,0
19:52:41,8619.259,Fox,2824,123,42,16,9,28,19,9,2824,2782,2766,2211,770,722,61,62,1416,1408,158,1838,705,0
19:52:41,8620.158,Fox,2824,122,40,18,9,28,19,8,2824,2784,2766,2211,770,722,61,61,1416,1408,158,1838,706,0
19:52:41,8620.759,Fox,2824,122,40,14,13,28,19,8,2824,2784,2770,2211,770,722,61,61,1416,1408,158,1838,706,0
19:52:42,8621.959,Fox,2824,122,38,16,13,26,21,8,2824,2786,2770,2211,772,722,61,61,1416,1408,158,1838,706,0
19:52:42,8622.858,Fox,2824,122,36,18,13,25,22,8,2824,2788,2770,2211,773,722,61,61,1416,1408,158,1838,706,0
19:52:43,8623.459,Fox,2824,122,36,16,15,25,22,8,2824,2788,2772,2211,773,722,61,61,1416,1408,158,1838,706,0
19:52:43,8624.658,Fox,2824,122,34,18,15,25,22,8,2824,2790,2772,2211,773,722,61,61,1416,1408,158,1838,706,0
19:52:44,8626.158,Fox,2826,124,36,18,15,25,22,8,2826,2790,2772,2211,773,722,61,63,1416,1410,158,1838,706,0
19:52:45,8628.259,Fox,2826,124,32,22,15,25,22,8,2826,2794,2772,2211,773,722,61,63,1416,1410,158,1838,706,0
19:52:46,8629.158,Fox,2826,123,32,22,15,23,24,7,2826,2794,2772,2211,775,722,61,62,1416,1410,158,1838,707,0
19:52:48,8633.658,Fox,2826,122,32,20,17,23,24,6,2826,2794,2774,2211,775,722,60,62,1416,1410,158,1838,708,0
19:52:48,8634.559,Fox,2826,122,30,22,15,25,24,6,2826,2796,2774,2213,775,722,60,62,1416,1410,158,1838,708,0
19:52:48,8635.158,Fox,2826,121,30,20,17,25,23,6,2826,2796,2776,2213,775,722,59,62,1416,1410,158,1839,708,0
19:52:49,8635.759,Fox,2826,120,30,20,17,25,23,5,2826,2796,2776,2213,775,722,58,62,1416,1410,158,1839,709,0
19:52:49,8636.959,Fox,2826,119,30,20,17,25,23,4,2826,2796,2776,2213,775,722,57,62,1416,1410,158,1839,710,0
19:52:50,8638.759,Fox,2826,119,26,24,17,25,23,4,2826,2800,2776,2213,775,722,57,62,1416,1410,158,1839,710,0
19:52:51,8639.658,Fox,2828,121,26,24,15,27,22,5,2826,2800,2776,2215,775,723,58,63,1417,1411,158,1839,710,0
19:52:51,8639.959,Fox,2828,121,28,24,15,27,22,5,2828,2800,2776,2215,775,723,58,63,1417,1411,158,1839,710,0
19:52:51,8641.158,Fox,2828,121,28,22,17,27,22,5,2828,2800,2778,2215,775,723,58,63,1417,1411,158,1839,710,0
19:52:53,8644.759,Fox,2828,121,28,20,19,27,22,5,2828,2800,2780,2215,775,723,58,63,1417,1411,158,1839,710,0
19:52:53,8645.358,Fox,2828,121,26,22,19,27,22,5,2828,2802,2780,2215,775,723,58,63,1417,1411,158,1839,710,0
19:52:54,8646.559,Fox,2828,121,26,22,17,27,23,6,2828,2802,2780,2217,777,724,58,63,1417,1411,158,1839,710,0
19:52:54,8647.158,Fox,2830,123,28,22,17,27,23,6,2830,2802,2780,2217,777,724,59,64,1418,1412,158,1839,710,0
19:52:57,8653.158,Fox,2830,122,28,20,19,27,23,5,2830,2802,2782,2217,777,724,58,64,1418,1412,158,1839,711,0
19:52:58,8654.358,Fox,2830,122,28,20,19,25,25,5,2830,2802,2782,2217,779,724,58,64,1418,1412,158,1839,711,0
19:52:59,8657.059,Fox,2830,121,28,20,19,24,25,5,2830,2802,2782,2217,779,724,58,63,1418,1412,159,1839,711,0
19:53:00,8657.658,Fox,2830,121,28,20,19,22,25,7,2830,2802,2782,2217,781,726,58,63,1418,1412,159,1839,711,0
19:53:00,8658.559,Fox,2834,125,30,20,19,22,25,7,2832,2802,2782,2217,781,726,59,66,1419,1415,159,1839,711,0
19:53:00,8658.858,Fox,2834,125,32,18,21,22,23,9,2834,2802,2784,2217,781,728,59,66,1419,1415,159,1839,711,0
19:53:01,8660.959,Fox,2836,127,34,16,23,20,25,9,2836,2802,2786,2217,783,728,59,68,1419,1417,159,1839,711,0
19:53:02,8661.559,Fox,2838,129,36,14,25,20,25,9,2838,2802,2788,2217,783,728,60,69,1420,1418,159,1839,711,0
19:53:02,8662.459,Fox,2842,133,40,14,25,19,26,9,2842,2802,2788,2217,784,728,62,71,1422,1420,159,1839,711,0
19:53:02,8662.759,Fox,2842,133,38,16,25,19,26,9,2842,2804,2788,2217,784,728,62,71,1422,1420,159,1839,711,0
19:53:03,8663.358,Fox,2842,133,36,16,27,19,26,9,2842,2806,2790,2217,784,728,62,71,1422,1420,159,1839,711,0
19:53:03,8664.858,Fox,2844,135,34,18,27,19,26,9,2842,2808,2790,2217,784,728,64,71,1424,1420,159,1839,711,0
19:53:04,8665.459,Fox,2844,135,36,18,27,18,27,9,2844,2808,2790,2217,785,728,64,71,1424,1420,159,1839,711,0
19:53:04,8666.658,Fox,2844,134,36,16,29,18,27,8,2844,2808,2792,2217,785,728,64,70,1424,1420,159,1839,712,0
19:53:05,8667.259,Fox,2846,136,38,14,31,18,27,8,2846,2808,2794,2217,785,728,66,70,1426,1420,159,1839,712,0
19:53:05,8668.759,Fox,2850,140,40,14,31,18,27,8,2848,2808,2794,2217,785,728,69,71,1429,1421,159,1839,712,0
19:53:06,8669.059,Fox,2850,140,40,16,31,18,27,8,2850,2810,2794,2217,785,728,69,71,1429,1421,159,1839,712,0
19:53:07,8672.059,Fox,2852,141,42,16,28,20,27,8,2852,2810,2794,2219,785,728,69,72,1430,1422,160,1839,712,0
19:53:07,8672.358,Fox,2852,141,40,18,28,20,27,8,2852,2812,2794,2219,785,728,69,72,1430,1422,160,1839,712,0
19:53:08,8672.959,Fox,2852,141,40,16,30,20,27,8,2852,2812,2796,2219,785,728,69,72,1430,1422,160,1839,712,0
19:53:08,8673.559,Fox,2852,140,40,16,30,20,27,7,2852,2812,2796,2219,785,728,69,71,1430,1422,160,1839,713,0
19:53:08,8674.759,Fox,2852,140,40,16,30,18,29,7,2852,2812,2796,2219,787,728,69,71,1430,1422,160,1839,713,0
19:53:09,8675.658,Fox,2854,142,42,16,30,16,31,7,2854,2812,2796,2219,789,728,70,72,1431,1423,160,1839,713,0
19:53:10,8677.459,Fox,2854,142,42,12,32,16,32,8,2854,2812,2800,2221,791,729,70,72,1431,1423,160,1839,713,0
19:53:11,8679.858,Fox,2854,141,42,12,32,16,32,7,2854,2812,2800,2221,791,729,70,71,1431,1423,160,1839,714,0
19:53:12,8680.459,Fox,2854,141,40,14,32,16,32,7,2854,2814,2800,2221,791,729,70,71,1431,1423,160,1839,714,0
19:53:12,8681.358,Fox,2858,144,42,14,27,20,32,7,2856,2814,2800,2225,791,729,72,72,1434,1424,161,1839,714,0
19:53:12,8681.658,Fox,2858,144,44,14,27,20,32,7,2858,2814,2800,2225,791,729,72,72,1434,1424,161,1839,714,0
19:53:13,8684.059,Fox,2858,144,44,12,27,22,32,7,2858,2814,2802,2227,791,729,72,72,1434,1424,161,1839,714,0
19:53:14,8684.358,Fox,2858,144,42,14,27,22,32,7,2858,2816,2802,2227,791,729,72,72,1434,1424,161,1839,714,0
19:53:16,8687.959,Fox,2860,146,40,16,27,22,32,7,2858,2818,2802,2227,791,729,74,72,1436,1424,161,1839,714,0
19:53:16,8688.259,Fox,2860,146,42,16,27,19,35,7,2860,2818,2802,2227,794,729,74,72,1436,1424,161,1839,714,0
19:53:16,8689.459,Fox,2860,145,40,18,27,19,35,6,2860,2820,2802,2227,794,729,74,71,1436,1424,161,1839,715,0
19:53:17,8690.658,Fox,2860,144,40,18,27,19,35,5,2860,2820,2802,2227,794,729,73,71,1436,1424,161,1839,716,0
19:53:18,8691.559,Fox,2860,142,40,18,27,17,35,5,2860,2820,2802,2227,794,729,73,69,1436,1424,163,1839,716,0
19:53:19,8693.658,Fox,2862,144,42,18,27,17,35,5,2862,2820,2802,2227,794,729,75,69,1438,1424,163,1839,716,0
19:53:19,8693.959,Fox,2862,144,42,18,25,19,35,5,2862,2820,2802,2229,794,729,75,69,1438,1424,163,1839,716,0
19:53:19,8695.158,Fox,2862,144,42,18,24,20,35,5,2862,2820,2802,2230,794,729,75,69,1438,1424,163,1839,716,0
19:53:21,8697.259,Fox,2862,144,40,20,24,20,35,5,2862,2822,2802,2230,794,729,75,69,1438,1424,163,1839,716,0
19:53:21,8698.459,Fox,2862,144,38,22,24,20,35,5,2862,2824,2802,2230,794,729,75,69,1438,1424,163,1839,716,0
19:53:22,8700.858,Fox,2862,144,38,22,24,18,37,5,2862,2824,2802,2230,796,729,75,69,1438,1424,163,1839,716,0
19:53:23,8701.759,Fox,2864,146,40,20,25,19,37,5,2864,2824,2804,2231,796,729,76,70,1439,1425,163,1839,716,0
19:53:23,8702.358,Fox,2864,146,40,18,27,18,38,5,2864,2824,2806,2231,797,729,76,70,1439,1425,163,1839,716,0
19:53:24,8703.259,Fox,2868,149,42,16,28,18,38,5,2866,2824,2808,2231,797,729,77,72,1441,1427,164,1839,716,0
19:53:24,8703.559,Fox,2868,149,44,16,28,18,38,5,2868,2824,2808,2231,797,729,77,72,1441,1427,164,1839,716,0
19:53:25,8705.059,Fox,2868,149,44,16,26,20,38,5,2868,2824,2808,2233,797,729,77,72,1441,1427,164,1839,716,0
19:53:25,8705.658,Fox,2868,148,44,16,26,19,38,5,2868,2824,2808,2233,797,729,77,71,1441,1427,165,1839,716,0
19:53:26,8706.559,Fox,2870,150,46,16,26,19,38,5,2870,2824,2808,2233,797,729,77,73,1441,1429,165,1839,716,0
19:53:27,8707.759,Fox,2870,150,46,14,28,19,38,5,2870,2824,2810,2233,797,729,77,73,1441,1429,165,1839,716,0
19:53:27,8708.658,Fox,2870,149,44,16,28,19,38,4,2870,2826,2810,2233,797,729,77,72,1441,1429,165,1839,717,0
19:53:29,8711.059,Fox,2870,149,44,14,30,19,38,4,2870,2826,2812,2233,797,729,77,72,1441,1429,165,1839,717,0
19:53:30,8713.158,Fox,2872,150,46,14,27,21,38,4,2872,2826,2812,2235,797,729,77,73,1442,1430,166,1839,717,0
19:53:31,8713.759,Fox,2878,155,48,14,26,21,38,4,2874,2826,2812,2235,797,729,80,75,1446,1432,167,1839,717,0
19:53:31,8714.358,Fox,2880,157,54,14,26,21,38,4,2880,2826,2812,2235,797,729,82,75,1448,1432,167,1839,717,0
19:53:32,8717.358,Fox,2882,159,54,14,26,21,37,5,2880,2826,2812,2235,797,730,84,75,1450,1432,167,1839,717,0
19:53:33,8717.658,Fox,2882,159,56,14,26,21,37,5,2882,2826,2812,2235,797,730,84,75,1450,1432,167,1839,717,0
19:53:33,8719.158,Fox,2882,158,56,12,26,23,35,6,2882,2826,2814,2237,797,732,84,74,1450,1432,167,1839,718,0
19:53:34,8720.059,Fox,2882,157,56,12,26,23,35,5,2882,2826,2814,2237,797,732,84,73,1450,1432,167,1839,719,0
19:53:34,8720.959,Fox,2884,159,58,12,24,25,35,5,2884,2826,2814,2239,797,732,85,74,1451,1433,167,1839,719,0
19:53:35,8721.858,Fox,2884,159,58,12,22,27,35,5,2884,2826,2814,2241,797,732,85,74,1451,1433,167,1839,719,0
19:53:35,8722.459,Fox,2884,159,56,14,22,27,35,5,2884,2828,2814,2241,797,732,85,74,1451,1433,167,1839,719,0
19:53:35,8723.059,Fox,2884,159,56,12,24,27,35,5,2884,2828,2816,2241,797,732,85,74,1451,1433,167,1839,719,0
19:53:36,8723.658,Fox,2884,159,56,12,22,29,35,5,2884,2828,2816,2243,797,732,85,74,1451,1433,167,1839,719,0
19:53:37,8726.358,Fox,2884,159,56,10,24,29,35,5,2884,2828,2818,2243,797,732,85,74,1451,1433,167,1839,719,0
19:53:38,8727.259,Fox,2884,159,56,10,22,31,35,5,2884,2828,2818,2245,797,732,85,74,1451,1433,167,1839,719,0
19:53:38,8728.459,Fox,2886,161,56,8,24,29,37,5,2884,2828,2820,2245,799,732,86,75,1452,1434,167,1839,719,0
19:53:38,8728.759,Fox,2886,161,58,8,24,29,37,5,2886,2828,2820,2245,799,732,86,75,1452,1434,167,1839,719,0
19:53:39,8729.658,Fox,2886,159,56,10,24,27,37,5,2886,2830,2820,2245,799,732,84,75,1452,1434,169,1839,719,0
19:53:41,8733.259,Fox,2886,159,56,10,23,26,39,5,2886,2830,2820,2246,801,732,84,75,1452,1434,169,1839,719,0
19:53:41,8734.459,Fox,2886,159,56,10,23,26,37,7,2886,2830,2820,2246,801,734,84,75,1452,1434,169,1839,719,0
19:53:42,8735.358,Fox,2886,159,56,10,23,26,35,9,2886,2830,2820,2246,801,736,84,75,1452,1434,169,1839,719,0
19:53:42,8735.959,Fox,2886,159,56,8,25,26,35,9,2886,2830,2822,2246,801,736,84,75,1452,1434,169,1839,719,0
19:53:43,8737.158,Fox,2886,159,56,6,27,26,35,9,2886,2830,2824,2246,801,736,84,75,1452,1434,169,1839,719,0
19:53:43,8737.759,Fox,2886,159,56,6,23,30,35,9,2886,2830,2824,2250,801,736,84,75,1452,1434,169,1839,719,0
19:53:44,8740.158,Fox,2890,161,60,6,21,29,36,9,2890,2830,2824,2250,802,736,85,76,1455,1435,169,1841,719,0
19:53:45,8741.358,Fox,2892,163,58,10,21,29,36,9,2892,2834,2824,2250,802,736,86,77,1456,1436,169,1841,719,0
19:53:45,8742.559,Fox,2896,167,60,10,21,29,36,9,2894,2834,2824,2250,802,736,88,79,1458,1438,169,1841,719,0
19:53:46,8742.858,Fox,2896,167,62,10,21,29,36,9,2896,2834,2824,2250,802,736,88,79,1458,1438,169,1841,719,0
19:53:46,8743.759,Fox,2898,168,62,12,21,28,36,9,2898,2836,2824,2250,802,736,89,79,1460,1438,170,1841,719,0
19:53:46,8744.358,Fox,2898,168,60,14,19,30,36,9,2898,2838,2824,2252,802,736,89,79,1460,1438,170,1841,719,0
19:53:47,8744.959,Fox,2898,168,56,18,19,30,36,9,2898,2842,2824,2252,802,736,89,79,1460,1438,170,1841,719,0
19:53:48,8747.658,Fox,2898,168,54,18,21,30,36,9,2898,2844,2826,2252,802,736,89,79,1460,1438,170,1841,719,0
19:53:49,8748.559,Fox,2904,172,60,18,20,30,36,8,2904,2844,2826,2252,802,736,91,81,1464,1440,170,1842,720,0
19:53:49,8748.858,Fox,2904,172,60,18,20,30,34,10,2904,2844,2826,2252,802,738,91,81,1464,1440,170,1842,720,0
19:53:49,8749.759,Fox,2904,172,58,20,20,30,34,10,2904,2846,2826,2252,802,738,91,81,1464,1440,170,1842,720,0
19:53:50,8750.959,Fox,2908,176,62,20,20,30,32,12,2908,2846,2826,2252,802,740,95,81,1468,1440,170,1842,720,0
19:53:50,8751.559,Fox,2908,176,58,24,20,30,32,12,2908,2850,2826,2252,802,740,95,81,1468,1440,170,1842,720,0
19:53:50,8752.759,Fox,2910,178,60,24,20,30,32,12,2910,2850,2826,2252,802,740,95,83,1468,1442,170,1842,720,0
19:53:51,8754.559,Fox,2910,178,58,26,20,30,32,12,2910,2852,2826,2252,802,740,95,83,1468,1442,170,1842,720,0
19:53:52,8756.358,Fox,2912,180,60,26,20,30,32,12,2912,2852,2826,2252,802,740,96,84,1469,1443,170,1842,720,0
19:53:53,8758.158,Fox,2912,180,58,28,20,30,32,12,2912,2854,2826,2252,802,740,96,84,1469,1443,170,1842,720,0
19:53:54,8759.059,Fox,2912,180,58,28,20,30,30,14,2912,2854,2826,2252,802,742,96,84,1469,1443,170,1842,720,0
19:53:54,8759.959,Fox,2912,180,58,28,20,30,29,15,2912,2854,2826,2252,802,743,96,84,1469,1443,170,1842,720,0
19:53:55,8761.158,Fox,2912,180,58,26,22,30,29,15,2912,2854,2828,2252,802,743,96,84,1469,1443,170,1842,720,0
19:53:55,8761.759,Fox,2912,180,58,26,20,32,29,15,2912,2854,2828,2254,802,743,96,84,1469,1443,170,1842,720,0
19:53:56,8763.559,Fox,2914,182,60,26,18,34,29,15,2914,2854,2828,2256,802,743,98,84,1471,1443,170,1842,720,0
19:53:56,8764.158,Fox,2914,182,56,30,18,34,29,15,2914,2858,2828,2256,802,743,98,84,1471,1443,170,1842,720,0
19:53:57,8765.358,Fox,2918,185,58,30,18,34,29,14,2916,2858,2828,2256,802,743,99,86,1473,1445,170,1842,721,0
19:53:57,8765.658,Fox,2918,185,60,30,18,32,31,14,2918,2858,2828,2256,804,743,99,86,1473,1445,170,1842,721,0
19:53:57,8766.559,Fox,2918,185,60,30,18,32,29,16,2918,2858,2828,2256,804,745,99,86,1473,1445,170,1842,721,0
19:53:58,8768.358,Fox,2918,185,60,28,18,34,29,16,2918,2858,2830,2258,804,745,99,86,1473,1445,170,1842,721,0
19:53:59,8769.259,Fox,2920,186,60,28,18,34,29,15,2918,2858,2830,2258,804,745,100,86,1474,1446,170,1842,722,0
19:53:59,8769.858,Fox,2922,188,62,28,18,34,29,15,2920,2858,2830,2258,804,745,101,87,1475,1447,170,1842,722,0
19:54:00,8770.459,Fox,2924,190,66,28,18,34,29,15,2924,2858,2830,2258,804,745,103,87,1477,1447,170,1842,722,0
19:54:00,8771.059,Fox,2926,191,64,30,17,32,31,15,2924,2860,2830,2258,806,745,104,87,1479,1447,170,1843,722,0
19:54:00,8771.358,Fox,2926,190,66,30,16,33,31,14,2926,2860,2830,2259,806,745,104,86,1479,1447,170,1843,723,0
19:54:01,8772.259,Fox,2926,188,66,30,16,31,31,14,2926,2860,2830,2259,806,745,104,84,1479,1447,170,1845,723,0
19:54:02,8774.059,Fox,2928,190,68,30,16,31,31,14,2928,2860,2830,2259,806,745,106,84,1481,1447,170,1845,723,0
19:54:02,8774.959,Fox,2930,192,70,30,16,29,33,14,2930,2860,2830,2259,808,745,106,86,1481,1449,170,1845,723,0
19:54:03,8776.158,Fox,2930,191,68,32,16,29,33,13,2930,2862,2830,2259,808,745,106,85,1481,1449,170,1845,724,0
19:54:03,8776.759,Fox,2930,190,68,32,16,29,33,12,2930,2862,2830,2259,808,745,106,84,1481,1449,170,1845,725,0
19:54:04,8777.658,Fox,2932,192,70,32,16,27,35,12,2932,2862,2830,2259,810,745,107,85,1482,1450,170,1845,725,0
19:54:04,8778.259,Fox,2932,191,70,32,16,27,35,11,2932,2862,2830,2259,810,745,107,84,1482,1450,170,1845,726,0
19:54:05,8779.759,Fox,2932,191,70,30,16,29,35,11,2932,2862,2832,2261,810,745,107,84,1482,1450,170,1845,726,0
19:54:05,8780.059,Fox,2932,190,70,28,18,29,35,10,2932,2862,2834,2261,810,745,106,84,1482,1450,170,1845,727,0
19:54:05,8781.559,Fox,2932,189,70,28,18,29,35,9,2932,2862,2834,2261,810,745,105,84,1482,1450,170,1845,728,0
19:54:06,8782.158,Fox,2932,189,70,26,20,29,35,9,2932,2862,2836,2261,810,745,105,84,1482,1450,170,1845,728,0
19:54:06,8782.759,Fox,2932,189,70,24,22,29,35,9,2932,2862,2838,2261,810,745,105,84,1482,1450,170,1845,728,0
19:54:06,8783.658,Fox,2934,191,72,20,25,30,33,11,2934,2862,2842,2262,810,747,106,85,1483,1451,170,1845,728,0
19:54:07,8784.559,Fox,2936,193,70,22,25,30,33,11,2934,2864,2842,2262,810,747,106,87,1483,1453,170,1845,728,0
19:54:07,8784.858,Fox,2936,193,72,22,25,30,33,11,2936,2864,2842,2262,810,747,106,87,1483,1453,170,1845,728,0
19:54:08,8786.059,Fox,2936,193,68,26,25,30,33,11,2936,2868,2842,2262,810,747,106,87,1483,1453,170,1845,728,0
19:54:08,8786.658,Fox,2936,193,68,24,25,32,33,11,2936,2868,2844,2264,810,747,106,87,1483,1453,170,1845,728,0
19:54:08,8786.959,Fox,2936,192,68,24,25,32,33,10,2936,2868,2844,2264,810,747,105,87,1483,1453,170,1845,729,0
19:54:08,8787.559,Fox,2936,192,68,24,25,30,35,10,2936,2868,2844,2264,812,747,105,87,1483,1453,170,1845,729,0
19:54:09,8788.459,Fox,2936,192,68,22,25,32,35,10,2936,2868,2846,2266,812,747,105,87,1483,1453,170,1845,729,0
19:54:09,8789.059,Fox,2936,192,66,24,25,32,35,10,2936,2870,2846,2266,812,747,105,87,1483,1453,170,1845,729,0
19:54:10,8790.259,Fox,2936,190,66,20,29,30,35,10,2936,2870,2850,2266,812,747,105,85,1483,1453,172,1845,729,0
19:54:10,8790.858,Fox,2938,191,68,20,29,30,35,9,2938,2870,2850,2266,812,747,106,85,1484,1454,172,1845,730,0
19:54:11,8791.759,Fox,2940,193,70,20,29,30,33,11,2940,2870,2850,2266,812,749,107,86,1485,1455,172,1845,730,0
19:54:11,8792.358,Fox,2942,195,72,20,29,30,33,11,2942,2870,2850,2266,812,749,107,88,1485,1457,172,1845,730,0
19:54:11,8793.259,Fox,2942,195,72,18,31,30,33,11,2942,2870,2852,2266,812,749,107,88,1485,1457,172,1845,730,0
19:54:12,8793.858,Fox,2942,194,72,18,31,29,33,11,2942,2870,2852,2266,812,749,106,88,1485,1457,172,1846,730,0
19:54:12,8795.358,Fox,2944,196,72,18,31,28,32,13,2942,2870,2852,2266,813,751,106,90,1485,1459,172,1846,730,0
19:54:13,8795.658,Fox,2944,196,72,20,31,28,32,13,2944,2872,2852,2266,813,751,106,90,1485,1459,172,1846,730,0
19:54:13,8796.559,Fox,2944,196,66,26,29,30,32,13,2944,2878,2852,2268,813,751,106,90,1485,1459,172,1846,730,0
19:54:13,8797.158,Fox,2946,198,64,26,31,30,32,13,2944,2880,2854,2268,813,751,106,92,1485,1461,172,1846,730,0
19:54:14,8797.459,Fox,2946,198,66,26,29,32,32,13,2946,2880,2854,2270,813,751,106,92,1485,1461,172,1846,730,0
19:54:14,8798.059,Fox,2946,198,66,26,29,32,30,15,2946,2880,2854,2270,813,753,106,92,1485,1461,172,1846,730,0
19:54:14,8798.658,Fox,2946,198,66,26,29,30,32,15,2946,2880,2854,2270,815,753,106,92,1485,1461,172,1846,730,0
19:54:15,8799.559,Fox,2948,200,68,26,29,30,31,16,2948,2880,2854,2270,815,754,106,94,1485,1463,172,1846,730,0
19:54:15,8800.158,Fox,2950,202,68,28,29,30,31,16,2950,2882,2854,2270,815,754,106,96,1485,1465,172,1846,730,0
19:54:15,8800.459,Fox,2950,201,68,28,29,30,31,15,2950,2882,2854,2270,815,754,105,96,1485,1465,172,1846,731,0
19:54:16,8802.858,Fox,2950,201,68,24,33,30,30,16,2950,2882,2858,2270,815,755,105,96,1485,1465,172,1846,731,0
19:54:16,8803.459,Fox,2950,201,66,26,33,30,30,16,2950,2884,2858,2270,815,755,105,96,1485,1465,172,1846,731,0
19:54:17,8804.059,Fox,2950,200,66,26,33,30,30,15,2950,2884,2858,2270,815,755,104,96,1485,1465,172,1846,732,0
19:54:17,8804.959,Fox,2952,202,68,26,33,30,30,15,2952,2884,2858,2270,815,755,105,97,1486,1466,172,1846,732,0
19:54:18,8806.759,Fox,2952,202,68,26,33,28,32,15,2952,2884,2858,2270,817,755,105,97,1486,1466,172,1846,732,0
19:54:18,8807.658,Fox,2952,202,68,26,31,30,32,15,2952,2884,2858,2272,817,755,105,97,1486,1466,172,1846,732,0
19:54:19,8809.459,Fox,2952,202,68,24,33,30,32,15,2952,2884,2860,2272,817,755,105,97,1486,1466,172,1846,732,0
19:54:19,8810.059,Fox,2952,200,68,24,33,30,32,13,2952,2884,2860,2272,817,755,104,96,1486,1466,172,1846,734,0
19:54:20,8811.259,Fox,2952,200,66,26,33,30,32,13,2952,2886,2860,2272,817,755,104,96,1486,1466,172,1846,734,0
19:54:20,8812.158,Fox,2952,200,66,26,33,30,30,15,2952,2886,2860,2272,817,757,104,96,1486,1466,172,1846,734,0
19:54:21,8813.059,Fox,2952,200,66,26,33,30,28,17,2952,2886,2860,2272,817,759,104,96,1486,1466,172,1846,734,0
19:54:22,8814.858,Fox,2954,202,66,24,35,28,28,19,2952,2886,2862,2272,819,761,106,96,1488,1466,172,1846,734,0
19:54:22,8815.459,Fox,2954,202,68,24,35,26,30,19,2954,2886,2862,2272,821,761,106,96,1488,1466,172,1846,734,0
19:54:23,8817.259,Fox,2954,202,68,24,35,24,32,19,2954,2886,2862,2272,823,761,106,96,1488,1466,172,1846,734,0
19:54:23,8818.158,Fox,2956,202,70,24,34,23,32,19,2956,2886,2862,2272,823,761,106,96,1489,1467,173,1847,734,0
19:54:24,8819.959,Fox,2958,203,72,24,33,23,32,19,2958,2886,2862,2272,823,761,106,97,1490,1468,174,1847,734,0
19:54:24,8820.559,Fox,2958,202,72,24,33,22,33,18,2958,2886,2862,2272,824,761,106,96,1490,1468,174,1847,735,0
19:54:24,8820.858,Fox,2958,202,72,24,33,21,34,18,2958,2886,2862,2272,825,761,106,96,1490,1468,174,1847,735,0
19:54:25,8821.759,Fox,2960,204,74,24,31,23,34,18,2960,2886,2862,2274,825,761,107,97,1491,1469,174,1847,735,0
19:54:25,8822.959,Fox,2960,204,70,26,33,23,34,18,2960,2890,2864,2274,825,761,107,97,1491,1469,174,1847,735,0
19:54:26,8823.259,Fox,2960,203,70,26,33,23,34,17,2960,2890,2864,2274,825,761,107,96,1491,1469,174,1847,736,0
19:54:26,8824.158,Fox,2962,205,68,28,33,23,34,17,2960,2892,2864,2274,825,761,108,97,1492,1470,174,1847,736,0
19:54:26,8824.759,Fox,2962,205,70,24,37,23,34,17,2962,2892,2868,2274,825,761,108,97,1492,1470,174,1847,736,0
19:54:27,8825.358,Fox,2964,206,68,28,36,23,34,17,2964,2896,2868,2274,825,761,107,99,1492,1472,175,1847,736,0
19:54:27,8825.658,Fox,2964,206,68,28,36,23,31,20,2964,2896,2868,2274,825,764,107,99,1492,1472,175,1847,736,0
19:54:27,8826.559,Fox,2966,207,66,30,35,23,31,20,2964,2898,2868,2274,825,764,108,99,1494,1472,176,1847,736,0
19:54:27,8826.858,Fox,2966,207,68,30,35,23,31,20,2966,2898,2868,2274,825,764,108,99,1494,1472,176,1847,736,0
19:54:28,8827.759,Fox,2966,207,68,28,37,23,31,20,2966,2898,2870,2274,825,764,108,99,1494,1472,176,1847,736,0
19:54:28,8828.959,Fox,2968,208,68,28,34,25,31,20,2966,2898,2870,2276,825,764,107,101,1494,1474,177,1847,736,0
19:54:29,8829.559,Fox,2972,210,70,28,32,25,31,20,2968,2898,2870,2276,825,764,106,104,1495,1477,179,1847,736,0
19:54:29,8830.158,Fox,2974,211,74,28,31,25,31,20,2972,2898,2870,2276,825,764,107,104,1497,1477,179,1848,736,0
19:54:29,8830.459,Fox,2974,210,76,28,31,25,31,19,2974,2898,2870,2276,825,764,107,103,1497,1477,179,1848,737,0
19:54:29,8831.358,Fox,2974,210,70,34,31,21,35,19,2974,2904,2870,2276,829,764,107,103,1497,1477,179,1848,737,0
19:54:30,8832.559,Fox,2974,208,70,34,31,21,35,17,2974,2904,2870,2276,829,764,106,102,1497,1477,179,1848,739,0
19:54:30,8833.459,Fox,2976,210,68,38,31,21,35,17,2976,2908,2870,2276,829,764,106,104,1497,1479,179,1848,739,0
19:54:31,8834.658,Fox,2976,209,68,36,33,21,35,16,2976,2908,2872,2276,829,764,106,103,1497,1479,179,1848,740,0
19:54:31,8835.259,Fox,2976,209,66,32,39,21,35,16,2976,2910,2878,2276,829,764,106,103,1497,1479,179,1848,740,0
19:54:31,8835.858,Fox,2976,207,66,30,41,21,35,14,2976,2910,2880,2276,829,764,105,102,1497,1479,179,1848,742,0
19:54:32,8836.759,Fox,2978,208,68,30,40,21,35,14,2978,2910,2880,2276,829,764,105,103,1498,1480,180,1848,742,0
19:54:32,8837.358,Fox,2978,207,68,30,40,21,35,13,2978,2910,2880,2276,829,764,105,102,1498,1480,180,1848,743,0
19:54:33,8838.259,Fox,2980,208,70,30,39,19,35,15,2980,2910,2880,2276,831,766,106,102,1500,1480,180,1849,743,0
19:54:33,8839.158,Fox,2982,209,68,30,40,19,35,15,2980,2912,2882,2276,831,766,106,103,1501,1481,180,1850,743,0
19:54:33,8839.759,Fox,2984,211,70,30,40,19,34,16,2982,2912,2882,2276,831,767,108,103,1503,1481,180,1850,743,0
19:54:34,8840.358,Fox,2984,211,72,30,37,22,34,16,2984,2912,2882,2279,831,767,108,103,1503,1481,180,1850,743,0
19:54:34,8841.559,Fox,2992,219,74,30,37,22,34,16,2986,2912,2882,2279,831,767,110,109,1505,1487,180,1850,743,0
19:54:34,8842.158,Fox,2992,219,80,28,39,22,34,16,2992,2912,2884,2279,831,767,110,109,1505,1487,180,1850,743,0
19:54:35,8842.759,Fox,2994,221,80,28,37,24,34,16,2992,2912,2884,2281,831,767,111,110,1506,1488,180,1850,743,0
19:54:35,8843.059,Fox,2994,221,82,28,36,25,34,16,2994,2912,2884,2282,831,767,111,110,1506,1488,180,1850,743,0
19:54:35,8843.959,Fox,2994,221,82,28,34,27,34,16,2994,2912,2884,2284,831,767,111,110,1506,1488,180,1850,743,0
19:54:36,8845.759,Fox,2996,223,84,28,34,27,34,16,2996,2912,2884,2284,831,767,112,111,1507,1489,180,1850,743,0
19:54:36,8846.059,Fox,2996,223,82,30,34,27,34,16,2996,2914,2884,2284,831,767,112,111,1507,1489,180,1850,743,0
19:54:37,8846.658,Fox,2996,222,82,30,34,27,34,15,2996,2914,2884,2284,831,767,111,111,1507,1489,180,1850,744,0
19:54:37,8848.158,Fox,2998,224,80,34,34,27,34,15,2998,2918,2884,2284,831,767,113,111,1509,1489,180,1850,744,0
19:54:38,8848.759,Fox,3000,225,82,34,32,29,34,14,3000,2918,2884,2286,831,767,114,111,1510,1490,180,1850,745,0
19:54:38,8849.358,Fox,3002,227,84,34,32,29,34,14,3002,2918,2884,2286,831,767,114,113,1510,1492,180,1850,745,0
19:54:38,8850.259,Fox,3002,227,84,32,33,30,34,14,3002,2918,2886,2287,831,767,114,113,1510,1492,180,1850,745,0
19:54:39,8850.559,Fox,3002,226,84,32,32,31,34,13,3002,2918,2886,2288,831,767,114,112,1510,1492,180,1850,746,0
19:54:39,8852.059,Fox,3002,226,82,34,32,31,34,13,3002,2920,2886,2288,831,767,114,112,1510,1492,180,1850,746,0
19:54:40,8852.959,Fox,3002,224,78,38,32,29,34,13,3002,2924,2886,2288,831,767,114,110,1510,1492,180,1852,746,0
19:54:40,8853.559,Fox,3004,225,80,38,31,29,34,13,3004,2924,2886,2289,831,767,116,109,1512,1492,181,1852,746,0
19:54:40,8853.858,Fox,3004,223,78,40,31,29,34,11,3004,2926,2886,2289,831,767,116,107,1512,1492,181,1852,748,0
19:54:40,8854.459,Fox,3004,222,78,40,31,28,34,11,3004,2926,2886,2289,831,767,116,106,1512,1492,182,1852,748,0
19:54:41,8855.658,Fox,3006,224,80,40,31,28,34,11,3006,2926,2886,2289,831,767,116,108,1512,1494,182,1852,748,0
19:54:41,8856.559,Fox,3006,223,78,42,31,28,34,10,3006,2928,2886,2289,831,767,116,107,1512,1494,182,1852,749,0
19:54:42,8857.459,Fox,3006,223,76,44,30,27,36,10,3006,2930,2886,2290,833,767,116,107,1512,1494,182,1852,749,0
19:54:43,8859.559,Fox,3008,224,76,44,30,27,36,9,3006,2930,2886,2290,833,767,117,107,1513,1495,182,1852,750,0
19:54:43,8860.158,Fox,3008,224,76,46,30,27,36,9,3008,2932,2886,2290,833,767,117,107,1513,1495,182,1852,750,0
19:54:43,8861.059,Fox,3008,222,76,46,30,25,36,9,3008,2932,2886,2290,833,767,116,106,1513,1495,183,1853,750,0
19:54:44,8861.658,Fox,3010,224,76,42,34,23,38,9,3008,2932,2890,2290,835,767,118,106,1515,1495,183,1853,750,0
19:54:44,8861.959,Fox,3010,224,78,42,34,23,38,9,3010,2932,2890,2290,835,767,118,106,1515,1495,183,1853,750,0
19:54:44,8862.858,Fox,3012,225,78,40,34,24,38,9,3010,2932,2892,2291,835,767,117,108,1515,1497,184,1853,750,0
19:54:44,8863.158,Fox,3012,224,80,40,32,26,38,8,3012,2932,2892,2293,835,767,116,108,1515,1497,184,1853,751,0
19:54:45,8864.059,Fox,3012,224,80,36,36,26,38,8,3012,2932,2896,2293,835,767,116,108,1515,1497,184,1853,751,0
19:54:45,8865.259,Fox,3014,226,82,34,38,25,39,8,3014,2932,2898,2293,836,767,118,108,1517,1497,184,1853,751,0
19:54:46,8865.559,Fox,3014,226,82,34,38,25,37,10,3014,2932,2898,2293,836,769,118,108,1517,1497,184,1853,751,0
19:54:46,8866.158,Fox,3014,226,80,36,38,25,37,10,3014,2934,2898,2293,836,769,118,108,1517,1497,184,1853,751,0
19:54:46,8867.658,Fox,3016,227,78,38,38,24,37,10,3014,2936,2898,2293,836,769,119,108,1518,1498,184,1854,751,0
19:54:47,8867.959,Fox,3016,227,80,38,38,24,37,10,3016,2936,2898,2293,836,769,119,108,1518,1498,184,1854,751,0
19:54:47,8869.759,Fox,3016,227,80,32,42,26,37,10,3016,2936,2904,2295,836,769,119,108,1518,1498,184,1854,751,0
19:54:48,8870.358,Fox,3016,227,80,32,42,26,35,12,3016,2936,2904,2295,836,771,119,108,1518,1498,184,1854,751,0
19:54:48,8871.559,Fox,3018,228,82,32,41,26,35,12,3018,2936,2904,2295,836,771,119,109,1519,1499,185,1854,751,0
19:54:48,8872.459,Fox,3020,229,82,28,44,26,35,12,3018,2936,2908,2295,836,771,119,110,1520,1500,185,1855,751,0
19:54:49,8872.759,Fox,3020,229,84,28,44,26,35,12,3020,2936,2908,2295,836,771,119,110,1520,1500,185,1855,751,0
19:54:49,8873.358,Fox,3020,228,82,30,44,25,35,12,3020,2938,2908,2295,836,771,119,109,1520,1500,185,1856,751,0
19:54:49,8874.259,Fox,3022,230,80,30,46,25,35,12,3020,2940,2910,2295,836,771,119,111,1520,1502,185,1856,751,0
19:54:49,8874.858,Fox,3022,230,80,32,46,25,35,12,3022,2942,2910,2295,836,771,119,111,1520,1502,185,1856,751,0
19:54:50,8875.459,Fox,3024,231,80,32,45,25,35,12,3022,2942,2910,2296,836,771,118,113,1520,1504,185,1857,751,0
19:54:50,8876.059,Fox,3024,230,82,32,45,25,35,11,3024,2942,2910,2296,836,771,117,113,1520,1504,185,1857,752,0
19:54:51,8877.559,Fox,3024,230,82,30,47,25,34,12,3024,2942,2912,2296,836,772,117,113,1520,1504,185,1857,752,0
19:54:51,8878.158,Fox,3024,230,80,32,47,25,34,12,3024,2944,2912,2296,836,772,117,113,1520,1504,185,1857,752,0
19:54:52,8880.259,Fox,3026,230,80,34,46,22,36,12,3026,2946,2912,2296,838,772,116,114,1521,1505,185,1859,752,0
19:54:52,8880.858,Fox,3028,232,82,34,46,22,36,12,3028,2946,2912,2296,838,772,116,116,1521,1507,185,1859,752,0
19:54:53,8882.059,Fox,3028,232,80,36,46,20,38,12,3028,2948,2912,2296,840,772,116,116,1521,1507,185,1859,752,0
19:54:53,8882.658,Fox,3028,232,78,38,46,20,38,12,3028,2950,2912,2296,840,772,116,116,1521,1507,185,1859,752,0
19:54:53,8883.559,Fox,3028,231,78,38,44,22,38,11,3028,2950,2912,2298,840,772,115,116,1521,1507,185,1859,753,0
19:54:54,8885.059,Fox,3030,233,80,36,42,26,38,11,3030,2950,2914,2302,840,772,115,118,1521,1509,185,1859,753,0
19:54:55,8886.858,Fox,3030,233,80,32,46,26,38,11,3030,2950,2918,2302,840,772,115,118,1521,1509,185,1859,753,0
19:54:55,8887.459,Fox,3032,235,80,34,46,26,38,11,3032,2952,2918,2302,840,772,115,120,1521,1511,185,1859,753,0
19:54:55,8888.059,Fox,3032,235,80,34,44,28,38,11,3032,2952,2918,2304,840,772,115,120,1521,1511,185,1859,753,0
19:54:56,8889.858,Fox,3032,235,80,34,44,26,40,11,3032,2952,2918,2304,842,772,115,120,1521,1511,185,1859,753,0
19:54:56,8891.059,Fox,3032,234,80,32,46,24,42,10,3032,2952,2920,2304,844,772,114,120,1521,1511,185,1859,754,0
19:54:56,8891.658,Fox,3032,234,80,28,50,24,42,10,3032,2952,2924,2304,844,772,114,120,1521,1511,185,1859,754,0
19:54:57,8892.559,Fox,3032,234,80,26,52,24,42,10,3032,2952,2926,2304,844,772,114,120,1521,1511,185,1859,754,0
19:54:58,8894.658,Fox,3034,236,82,26,51,25,42,10,3034,2952,2926,2305,844,772,115,121,1522,1512,185,1859,754,0
19:54:58,8895.559,Fox,3034,235,82,24,48,29,42,10,3034,2952,2928,2310,844,772,115,120,1522,1512,186,1859,754,0
19:54:59,8896.158,Fox,3034,234,82,22,48,31,42,9,3034,2952,2930,2312,844,772,114,120,1522,1512,186,1859,755,0
19:54:59,8896.459,Fox,3034,233,82,22,48,31,42,8,3034,2952,2930,2312,844,772,114,119,1522,1512,186,1859,756,0
19:54:59,8897.358,Fox,3036,234,84,22,48,31,42,7,3036,2952,2930,2312,844,772,115,119,1524,1512,186,1859,757,0
19:55:00,8897.959,Fox,3038,236,84,24,48,31,42,7,3038,2954,2930,2312,844,772,116,120,1525,1513,186,1859,757,0
19:55:00,8898.559,Fox,3040,236,86,24,48,29,42,7,3040,2954,2930,2312,844,772,117,119,1526,1514,188,1859,757,0
19:55:00,8899.158,Fox,3040,236,86,22,48,31,42,7,3040,2954,2932,2314,844,772,117,119,1526,1514,188,1859,757,0
19:55:01,8900.658,Fox,3040,236,84,24,48,31,42,7,3040,2956,2932,2314,844,772,117,119,1526,1514,188,1859,757,0
19:55:01,8901.259,Fox,3040,236,84,24,48,30,43,7,3040,2956,2932,2314,845,772,117,119,1526,1514,188,1859,757,0
19:55:02,8902.759,Fox,3042,238,84,26,47,31,43,7,3042,2958,2932,2315,845,772,117,121,1526,1516,188,1859,757,0
19:55:02,8903.358,Fox,3046,241,88,26,46,31,41,9,3046,2958,2932,2315,845,774,118,123,1528,1518,188,1860,757,0
19:55:02,8904.559,Fox,3048,243,88,28,46,31,41,9,3048,2960,2932,2315,845,774,118,125,1528,1520,188,1860,757,0
19:55:02,8904.858,Fox,3048,243,88,26,48,31,41,9,3048,2960,2934,2315,845,774,118,125,1528,1520,188,1860,757,0
19:55:03,8905.759,Fox,3050,243,90,26,47,30,41,9,3050,2960,2934,2315,845,774,119,124,1530,1520,189,1861,757,0
19:55:03,8906.358,Fox,3054,245,92,24,49,28,41,9,3052,2960,2936,2315,845,774,118,127,1531,1523,191,1861,757,0
19:55:03,8906.959,Fox,3054,245,92,26,49,28,41,9,3054,2962,2936,2315,845,774,118,127,1531,1523,191,1861,757,0
19:55:03,8907.259,Fox,3054,244,92,26,49,28,41,8,3054,2962,2936,2315,845,774,118,126,1531,1523,191,1861,758,0
19:55:04,8907.858,Fox,3054,244,90,28,49,28,41,8,3054,2964,2936,2315,845,774,118,126,1531,1523,191,1861,758,0
19:55:04,8908.459,Fox,3054,244,90,28,49,28,39,10,3054,2964,2936,2315,845,776,118,126,1531,1523,191,1861,758,0
19:55:04,8909.658,Fox,3058,246,92,30,49,27,39,9,3058,2966,2936,2315,845,776,118,128,1532,1526,192,1861,759,0
19:55:05,8910.259,Fox,3058,246,92,30,47,29,39,9,3058,2966,2936,2317,845,776,118,128,1532,1526,192,1861,759,0
19:55:05,8911.759,Fox,3060,247,92,32,46,29,39,9,3060,2968,2936,2317,845,776,118,129,1533,1527,193,1861,759,0
19:55:05,8912.358,Fox,3060,247,88,34,48,29,37,11,3060,2972,2938,2317,845,778,118,129,1533,1527,193,1861,759,0
19:55:06,8912.959,Fox,3060,246,86,34,50,28,37,11,3060,2974,2940,2317,845,778,118,128,1533,1527,193,1862,759,0
19:55:06,8913.559,Fox,3060,246,86,32,52,28,37,11,3060,2974,2942,2317,845,778,118,128,1533,1527,193,1862,759,0
19:55:06,8915.059,Fox,3060,246,86,32,52,26,37,13,3060,2974,2942,2317,847,780,118,128,1533,1527,193,1862,759,0
19:55:07,8915.959,Fox,3060,246,84,34,52,26,37,13,3060,2976,2942,2317,847,780,118,128,1533,1527,193,1862,759,0
19:55:07,8916.858,Fox,3060,246,84,32,54,26,37,13,3060,2976,2944,2317,847,780,118,128,1533,1527,193,1862,759,0
19:55:08,8917.759,Fox,3062,248,86,32,54,26,37,13,3062,2976,2944,2317,847,780,119,129,1534,1528,193,1862,759,0
19:55:08,8918.658,Fox,3062,248,86,30,56,26,37,13,3062,2976,2946,2317,847,780,119,129,1534,1528,193,1862,759,0
19:55:09,8919.559,Fox,3064,250,84,32,56,26,37,13,3062,2978,2946,2317,847,780,120,130,1535,1529,193,1862,759,0
19:55:09,8920.158,Fox,3068,254,86,32,56,26,37,13,3064,2978,2946,2317,847,780,121,133,1536,1532,193,1862,759,0
19:55:09,8920.759,Fox,3068,253,88,32,58,26,37,12,3068,2980,2948,2317,847,780,120,133,1536,1532,193,1862,760,0
19:55:10,8921.358,Fox,3068,251,88,30,60,25,37,11,3068,2980,2950,2317,847,780,119,132,1536,1532,193,1863,761,0
19:55:10,8921.959,Fox,3068,251,86,32,56,29,37,11,3068,2982,2950,2321,847,780,119,132,1536,1532,193,1863,761,0
19:55:11,8922.559,Fox,3070,253,86,34,56,27,39,11,3070,2984,2950,2321,849,780,121,132,1538,1532,193,1863,761,0
19:55:11,8922.858,Fox,3070,253,86,34,55,28,39,11,3070,2984,2950,2322,849,780,121,132,1538,1532,193,1863,761,0
19:55:11,8924.358,Fox,3074,257,80,42,53,30,39,11,3072,2992,2950,2324,849,780,123,134,1540,1534,193,1863,761,0
19:55:12,8924.959,Fox,3076,259,82,42,53,30,37,13,3074,2992,2950,2324,849,782,123,136,1540,1536,193,1863,761,0
19:55:12,8925.559,Fox,3078,261,84,44,51,32,37,13,3078,2994,2950,2326,849,782,125,136,1542,1536,193,1863,761,0
19:55:12,8926.158,Fox,3080,263,86,42,53,32,37,13,3080,2994,2952,2326,849,782,126,137,1543,1537,193,1863,761,0
19:55:12,8926.759,Fox,3082,264,88,42,52,32,37,13,3082,2994,2952,2326,849,782,127,137,1545,1537,193,1864,761,0
19:55:13,8927.658,Fox,3084,266,90,42,52,32,37,13,3084,2994,2952,2326,849,782,129,137,1547,1537,193,1864,761,0
19:55:13,8928.259,Fox,3086,267,90,44,51,32,37,13,3086,2996,2952,2326,849,782,130,137,1549,1537,194,1864,761,0
19:55:13,8929.158,Fox,3088,269,92,44,51,32,37,13,3088,2996,2952,2326,849,782,131,138,1550,1538,194,1864,761,0
19:55:14,8930.059,Fox,3088,269,92,44,46,37,37,13,3088,2996,2952,2331,849,782,131,138,1550,1538,194,1864,761,0
19:55:14,8930.658,Fox,3088,269,90,46,46,37,37,13,3088,2998,2952,2331,849,782,131,138,1550,1538,194,1864,761,0
19:55:14,8931.259,Fox,3088,269,88,48,46,37,37,13,3088,3000,2952,2331,849,782,131,138,1550,1538,194,1864,761,0
19:55:14,8932.158,Fox,3088,268,86,50,46,36,37,13,3088,3002,2952,2331,849,782,131,137,1550,1538,194,1865,761,0
19:55:15,8932.459,Fox,3088,268,86,50,42,40,36,14,3088,3002,2952,2335,849,783,131,137,1550,1538,194,1865,761,0
19:55:15,8933.658,Fox,3090,269,86,50,42,38,37,14,3088,3002,2952,2335,850,783,132,137,1551,1539,195,1865,761,0
19:55:15,8934.259,Fox,3090,269,88,50,40,38,39,14,3090,3002,2952,2337,852,783,132,137,1551,1539,195,1865,761,0
19:55:16,8935.759,Fox,3092,270,90,50,40,37,39,14,3092,3002,2952,2337,852,783,131,139,1551,1541,195,1866,761,0
19:55:16,8936.358,Fox,3092,270,88,50,42,37,37,16,3092,3004,2954,2337,852,785,131,139,1551,1541,195,1866,761,0
19:55:17,8936.959,Fox,3094,271,90,50,41,37,37,16,3094,3004,2954,2337,852,785,131,140,1552,1542,195,1867,761,0
19:55:17,8938.158,Fox,3094,271,88,52,40,38,37,16,3094,3006,2954,2338,852,785,131,140,1552,1542,195,1867,761,0
19:55:17,8938.759,Fox,3096,272,90,52,39,38,37,16,3096,3006,2954,2338,852,785,131,141,1553,1543,196,1867,761,0
19:55:17,8939.358,Fox,3096,272,90,50,41,38,37,16,3096,3006,2956,2338,852,785,131,141,1553,1543,196,1867,761,0
19:55:18,8939.959,Fox,3096,271,90,50,41,37,37,16,3096,3006,2956,2338,852,785,130,141,1553,1543,196,1868,761,0
19:55:18,8940.559,Fox,3096,269,90,50,41,35,37,16,3096,3006,2956,2338,852,785,129,140,1553,1543,196,1870,761,0
19:55:18,8941.158,Fox,3096,269,90,48,43,35,37,16,3096,3006,2958,2338,852,785,129,140,1553,1543,196,1870,761,0
19:55:18,8941.759,Fox,3096,268,90,48,43,35,37,15,3096,3006,2958,2338,852,785,129,139,1553,1543,196,1870,762,0
19:55:19,8942.358,Fox,3096,268,88,50,43,33,39,15,3096,3008,2958,2338,854,785,129,139,1553,1543,196,1870,762,0
19:55:19,8942.959,Fox,3096,268,88,48,45,33,39,15,3096,3008,2960,2338,854,785,129,139,1553,1543,196,1870,762,0
19:55:19,8943.858,Fox,3098,270,90,48,45,33,39,15,3098,3008,2960,2338,854,785,129,141,1553,1545,196,1870,762,0
19:55:20,8944.459,Fox,3100,272,90,50,45,33,37,17,3100,3010,2960,2338,854,787,129,143,1553,1547,196,1870,762,0
19:55:20,8945.059,Fox,3102,272,90,50,43,33,37,17,3100,3010,2960,2340,854,787,130,142,1554,1548,196,1872,762,0
19:55:20,8945.658,Fox,3102,272,90,50,45,33,37,17,3102,3012,2962,2340,854,787,130,142,1554,1548,196,1872,762,0
19:55:21,8946.858,Fox,3102,272,90,48,45,35,37,17,3102,3012,2964,2342,854,787,130,142,1554,1548,196,1872,762,0
19:55:21,8947.158,Fox,3102,272,90,48,43,36,38,17,3102,3012,2964,2344,855,787,130,142,1554,1548,196,1872,762,0
19:55:21,8948.059,Fox,3104,274,90,48,45,36,38,17,3104,3014,2966,2344,855,787,130,144,1554,1550,196,1872,762,0
19:55:21,8948.358,Fox,3104,273,90,48,45,35,38,17,3104,3014,2966,2344,855,787,130,143,1554,1550,196,1873,762,0
19:55:22,8950.459,Fox,3104,273,88,48,47,35,38,17,3104,3016,2968,2344,855,787,130,143,1554,1550,196,1873,762,0
19:55:22,8951.059,Fox,3104,273,88,44,49,37,38,17,3104,3016,2972,2346,855,787,130,143,1554,1550,196,1873,762,0
19:55:23,8951.959,Fox,3106,275,88,42,49,39,36,19,3104,3016,2974,2348,855,789,130,145,1554,1552,196,1873,762,0
19:55:23,8952.559,Fox,3110,279,94,42,49,39,36,19,3110,3016,2974,2348,855,789,134,145,1558,1552,196,1873,762,0
19:55:23,8952.858,Fox,3110,279,94,42,47,41,34,21,3110,3016,2974,2350,855,791,134,145,1558,1552,196,1873,762,0
19:55:24,8954.358,Fox,3112,280,94,44,47,40,34,21,3112,3018,2974,2350,855,791,134,146,1559,1553,196,1874,762,0
19:55:24,8954.658,Fox,3112,280,94,42,49,40,32,23,3112,3018,2976,2350,855,793,134,146,1559,1553,196,1874,762,0
19:55:25,8955.559,Fox,3114,282,94,44,47,42,32,23,3114,3020,2976,2352,855,793,134,148,1559,1555,196,1874,762,0
19:55:25,8956.459,Fox,3116,283,96,44,45,44,32,22,3116,3020,2976,2354,855,793,135,148,1560,1556,196,1874,763,0
19:55:25,8957.059,Fox,3116,283,94,46,45,42,34,22,3116,3022,2976,2354,857,793,135,148,1560,1556,196,1874,763,0
19:55:26,8957.959,Fox,3118,283,96,44,47,40,33,23,3118,3022,2978,2354,857,794,135,148,1561,1557,196,1876,763,0
19:55:26,8958.559,Fox,3120,284,96,46,47,39,32,24,3120,3024,2978,2354,857,795,136,148,1563,1557,196,1877,763,0
19:55:26,8959.158,Fox,3122,286,98,46,45,41,32,24,3122,3024,2978,2356,857,795,137,149,1564,1558,196,1877,763,0
19:55:26,8959.459,Fox,3122,285,98,44,47,41,32,23,3122,3024,2980,2356,857,795,137,148,1564,1558,196,1877,764,0
19:55:27,8960.959,Fox,3124,287,100,42,49,41,32,23,3124,3024,2982,2356,857,795,138,149,1565,1559,196,1877,764,0
19:55:27,8961.259,Fox,3124,287,100,40,51,41,32,23,3124,3024,2984,2356,857,795,138,149,1565,1559,196,1877,764,0
19:55:28,8963.059,Fox,3124,286,98,34,59,41,32,22,3124,3026,2992,2356,857,795,137,149,1565,1559,196,1877,765,0
19:55:28,8963.658,Fox,3126,288,98,36,59,41,32,22,3126,3028,2992,2356,857,795,138,150,1566,1560,196,1877,765,0
19:55:28,8964.559,Fox,3128,290,100,34,61,41,32,22,3128,3028,2994,2356,857,795,140,150,1568,1560,196,1877,765,0
19:55:29,8965.158,Fox,3128,290,100,34,59,43,32,22,3128,3028,2994,2358,857,795,140,150,1568,1560,196,1877,765,0
19:55:29,8966.358,Fox,3128,290,100,34,57,45,32,22,3128,3028,2994,2360,857,795,140,150,1568,1560,196,1877,765,0
19:55:29,8966.959,Fox,3128,290,100,32,59,45,32,22,3128,3028,2996,2360,857,795,140,150,1568,1560,196,1877,765,0
19:55:30,8967.559,Fox,3128,290,98,34,59,45,32,22,3128,3030,2996,2360,857,795,140,150,1568,1560,196,1877,765,0
19:55:30,8968.759,Fox,3128,290,98,34,59,44,29,26,3128,3030,2996,2360,858,799,140,150,1568,1560,196,1877,765,0
19:55:30,8969.658,Fox,3128,289,98,32,61,43,29,26,3128,3030,2998,2360,858,799,140,149,1568,1560,197,1877,765,0
19:55:31,8969.959,Fox,3128,289,96,32,63,43,29,26,3128,3032,3000,2360,858,799,140,149,1568,1560,197,1877,765,0
19:55:31,8970.559,Fox,3128,289,96,30,65,43,29,26,3128,3032,3002,2360,858,799,140,149,1568,1560,197,1877,765,0
19:55:31,8972.358,Fox,3128,288,96,30,63,45,29,25,3128,3032,3002,2362,858,799,139,149,1568,1560,197,1877,766,0
19:55:32,8973.559,Fox,3130,290,98,30,61,47,29,25,3130,3032,3002,2364,858,799,140,150,1569,1561,197,1877,766,0
19:55:32,8973.858,Fox,3130,290,98,30,59,49,29,25,3130,3032,3002,2366,858,799,140,150,1569,1561,197,1877,766,0
19:55:32,8974.759,Fox,3130,289,98,28,61,49,29,24,3130,3032,3004,2366,858,799,140,149,1569,1561,197,1877,767,0
19:55:33,8975.358,Fox,3132,291,100,28,61,49,27,26,3132,3032,3004,2366,858,801,142,149,1571,1561,197,1877,767,0
19:55:33,8975.959,Fox,3132,289,100,28,61,49,27,24,3132,3032,3004,2366,858,801,141,148,1571,1561,197,1877,769,0
19:55:33,8977.158,Fox,3132,287,98,28,61,47,29,24,3132,3034,3006,2368,860,801,141,146,1571,1561,199,1877,769,0
19:55:34,8977.759,Fox,3134,288,100,28,60,47,29,24,3134,3034,3006,2368,860,801,142,146,1573,1561,199,1878,769,0
19:55:34,8978.358,Fox,3140,293,104,28,59,46,30,24,3138,3034,3006,2368,861,801,143,150,1575,1565,199,1879,769,0
19:55:34,8978.959,Fox,3140,292,106,28,57,46,32,23,3140,3034,3006,2370,863,801,142,150,1575,1565,199,1879,770,0
19:55:35,8980.158,Fox,3142,292,106,30,56,46,32,22,3142,3036,3006,2370,863,801,143,149,1577,1565,199,1880,771,0
19:55:35,8980.459,Fox,3142,292,104,32,56,46,32,22,3142,3038,3006,2370,863,801,143,149,1577,1565,199,1880,771,0
19:55:35,8981.059,Fox,3142,292,102,32,56,48,32,22,3142,3040,3008,2372,863,801,143,149,1577,1565,199,1880,771,0
19:55:35,8981.658,Fox,3142,292,102,32,54,50,32,22,3142,3040,3008,2374,863,801,143,149,1577,1565,199,1880,771,0
19:55:36,8983.459,Fox,3144,294,102,30,56,50,32,22,3142,3040,3010,2374,863,801,145,149,1579,1565,199,1880,771,0
19:55:36,8984.059,Fox,3146,296,106,30,56,50,32,22,3146,3040,3010,2374,863,801,146,150,1580,1566,199,1880,771,0
19:55:37,8984.658,Fox,3148,297,108,28,58,49,32,22,3148,3040,3012,2374,863,801,146,151,1580,1568,199,1881,771,0
19:55:37,8985.259,Fox,3152,301,108,30,58,49,32,22,3150,3042,3012,2374,863,801,148,153,1582,1570,199,1881,771,0
19:55:37,8985.858,Fox,3156,304,110,34,57,49,32,22,3156,3046,3012,2374,863,801,148,156,1583,1573,199,1882,771,0
19:55:38,8986.459,Fox,3158,306,112,32,58,50,32,22,3158,3046,3014,2375,863,801,149,157,1584,1574,199,1882,771,0
19:55:38,8987.059,Fox,3164,312,114,34,58,50,32,22,3162,3048,3014,2375,863,801,152,160,1587,1577,199,1882,771,0
19:55:38,8987.658,Fox,3168,314,118,34,58,48,32,22,3166,3048,3014,2375,863,801,154,160,1589,1579,200,1883,771,0
19:55:39,8988.259,Fox,3168,314,118,36,58,47,33,22,3168,3050,3014,2375,864,801,154,160,1589,1579,200,1883,771,0
19:55:39,8988.858,Fox,3168,313,116,38,58,47,33,21,3168,3052,3014,2375,864,801,154,159,1589,1579,200,1883,772,0
19:55:39,8989.158,Fox,3168,313,114,38,60,43,37,21,3168,3054,3016,2375,868,801,154,159,1589,1579,200,1883,772,0
19:55:39,8989.759,Fox,3168,312,114,38,60,43,37,20,3168,3054,3016,2375,868,801,154,158,1589,1579,200,1883,773,0
19:55:40,8990.658,Fox,3172,316,116,38,60,43,37,20,3170,3054,3016,2375,868,801,155,161,1590,1582,200,1883,773,0
19:55:40,8990.959,Fox,3172,316,118,38,60,43,37,20,3172,3054,3016,2375,868,801,155,161,1590,1582,200,1883,773,0
19:55:40,8991.559,Fox,3172,315,118,38,60,42,37,20,3172,3054,3016,2375,868,801,155,160,1590,1582,200,1884,773,0
19:55:40,8992.158,Fox,3172,315,114,42,60,42,37,20,3172,3058,3016,2375,868,801,155,160,1590,1582,200,1884,773,0
19:55:41,8992.759,Fox,3172,315,114,40,62,41,38,20,3172,3058,3018,2375,869,801,155,160,1590,1582,200,1884,773,0
19:55:41,8994.259,Fox,3172,315,112,40,64,41,38,20,3172,3060,3020,2375,869,801,155,160,1590,1582,200,1884,773,0
19:55:41,8994.559,Fox,3172,315,112,40,64,41,36,22,3172,3060,3020,2375,869,803,155,160,1590,1582,200,1884,773,0
19:55:42,8995.158,Fox,3172,314,112,40,64,41,36,21,3172,3060,3020,2375,869,803,154,160,1590,1582,200,1884,774,0
19:55:42,8995.759,Fox,3172,314,112,38,66,41,36,21,3172,3060,3022,2375,869,803,154,160,1590,1582,200,1884,774,0
19:55:42,8996.658,Fox,3176,318,114,38,64,43,36,21,3174,3060,3022,2377,869,803,156,162,1592,1584,200,1884,774,0
19:55:42,8996.959,Fox,3176,317,116,36,66,42,36,21,3176,3060,3024,2377,869,803,156,161,1592,1584,200,1885,774,0
19:55:43,8998.158,Fox,3178,319,118,36,66,42,36,21,3178,3060,3024,2377,869,803,158,161,1594,1584,200,1885,774,0
19:55:43,8998.759,Fox,3182,321,120,36,64,42,36,21,3180,3060,3024,2377,869,803,158,163,1596,1586,200,1887,774,0
19:55:43,8999.358,Fox,3184,323,122,36,64,42,34,23,3182,3060,3024,2377,869,805,159,164,1597,1587,200,1887,774,0
19:55:44,8999.658,Fox,3184,323,124,36,63,43,34,23,3184,3060,3024,2378,869,805,159,164,1597,1587,200,1887,774,0
19:55:44,9000.259,Fox,3184,323,122,38,63,43,34,23,3184,3062,3024,2378,869,805,159,164,1597,1587,200,1887,774,0
19:55:44,9001.459,Fox,3184,323,122,36,64,44,34,23,3184,3062,3026,2379,869,805,159,164,1597,1587,200,1887,774,0
19:55:45,9002.358,Fox,3186,324,120,36,65,44,33,24,3184,3064,3028,2379,869,806,159,165,1598,1588,200,1888,774,0
19:55:45,9002.959,Fox,3188,325,118,40,64,44,33,24,3186,3068,3028,2379,869,806,159,166,1599,1589,200,1889,774,0
19:55:45,9003.559,Fox,3190,326,120,40,61,46,33,24,3188,3068,3028,2381,869,806,159,167,1600,1590,200,1890,774,0
19:55:45,9003.858,Fox,3190,325,122,40,61,45,34,23,3190,3068,3028,2381,870,806,159,166,1600,1590,200,1890,775,0
19:55:46,9004.759,Fox,3194,329,126,40,61,45,34,23,3194,3068,3028,2381,870,806,162,167,1603,1591,200,1890,775,0
19:55:46,9005.358,Fox,3196,331,124,42,61,45,34,23,3194,3070,3028,2381,870,806,163,168,1604,1592,200,1890,775,0
19:55:46,9005.959,Fox,3198,332,128,42,59,46,34,23,3198,3070,3028,2382,870,806,163,169,1605,1593,201,1890,775,0
19:55:46,9006.559,Fox,3202,335,132,40,61,46,34,22,3202,3070,3030,2382,870,806,165,170,1607,1595,201,1890,776,0
19:55:47,9007.158,Fox,3204,337,130,44,59,48,34,22,3204,3074,3030,2384,870,806,166,171,1608,1596,201,1890,776,0
19:55:47,9007.759,Fox,3204,336,128,46,59,48,34,21,3204,3076,3030,2384,870,806,165,171,1608,1596,201,1890,777,0
19:55:47,9008.358,Fox,3206,337,126,48,58,48,34,21,3204,3078,3030,2385,870,806,164,173,1608,1598,201,1891,777,0
19:55:47,9008.658,Fox,3206,337,126,48,60,48,34,21,3206,3080,3032,2385,870,806,164,173,1608,1598,201,1891,777,0
19:55:47,9009.559,Fox,3206,335,124,50,60,48,34,19,3206,3082,3032,2385,870,806,163,172,1608,1598,201,1891,779,0
19:55:48,9010.158,Fox,3206,334,122,52,60,47,34,19,3206,3084,3032,2385,870,806,163,171,1608,1598,201,1892,779,0
19:55:48,9010.759,Fox,3206,333,120,54,58,48,34,19,3206,3086,3032,2387,870,806,162,171,1608,1598,201,1893,779,0
19:55:48,9011.658,Fox,3206,333,118,56,54,52,34,19,3206,3088,3032,2391,870,806,162,171,1608,1598,201,1893,779,0
19:55:48,9011.959,Fox,3206,332,118,56,52,53,34,19,3206,3088,3032,2393,870,806,162,170,1608,1598,201,1894,779,0
19:55:49,9013.759,Fox,3206,331,118,56,52,52,34,19,3206,3088,3032,2393,870,806,162,169,1608,1598,201,1895,779,0
19:55:50,9015.259,Fox,3206,331,118,56,50,52,36,19,3206,3088,3032,2395,872,806,162,169,1608,1598,201,1895,779,0
19:55:50,9015.858,Fox,3206,330,118,54,52,52,36,18,3206,3088,3034,2395,872,806,162,168,1608,1598,201,1895,780,0
19:55:51,9016.759,Fox,3206,328,116,56,52,51,36,17,3206,3090,3034,2395,872,806,161,167,1608,1598,201,1896,781,0
19:55:51,9017.658,Fox,3208,329,118,56,52,50,34,19,3208,3090,3034,2395,872,808,163,166,1610,1598,201,1897,781,0
19:55:51,9018.259,Fox,3210,331,118,58,51,49,36,19,3210,3092,3034,2396,874,808,164,167,1611,1599,201,1897,781,0
19:55:51,9018.858,Fox,3212,332,120,56,53,48,37,18,3212,3092,3036,2396,875,808,163,169,1611,1601,201,1897,782,0
19:55:52,9019.459,Fox,3212,332,118,56,55,48,35,20,3212,3094,3038,2396,875,810,163,169,1611,1601,201,1897,782,0
19:55:52,9020.059,Fox,3216,333,118,54,54,49,35,19,3212,3094,3040,2397,875,810,162,171,1612,1604,201,1899,783,0
19:55:52,9020.658,Fox,3218,335,124,54,54,49,35,19,3218,3094,3040,2397,875,810,162,173,1612,1606,201,1899,783,0
19:55:52,9021.259,Fox,3220,335,124,56,52,49,35,19,3220,3096,3040,2399,875,810,163,172,1613,1607,202,1900,783,0
19:55:53,9021.858,Fox,3222,337,124,56,50,51,35,19,3220,3096,3040,2401,875,810,165,172,1615,1607,202,1900,783,0
19:55:53,9022.459,Fox,3224,339,128,56,50,51,35,19,3224,3096,3040,2401,875,810,166,173,1616,1608,202,1900,783,0
19:55:53,9023.358,Fox,3228,343,130,56,43,58,35,19,3226,3096,3040,2408,875,810,169,174,1619,1609,202,1900,783,0
19:55:53,9023.959,Fox,3230,345,132,54,45,55,38,19,3228,3096,3042,2408,878,810,170,175,1620,1610,202,1900,783,0
19:55:54,9024.559,Fox,3230,342,134,50,48,56,38,16,3230,3096,3046,2409,878,810,169,173,1620,1610,202,1900,786,0
19:55:54,9025.759,Fox,3230,341,134,48,50,56,38,15,3230,3096,3048,2409,878,810,168,173,1620,1610,202,1900,787,0
19:55:54,9026.358,Fox,3230,340,132,50,50,52,42,14,3230,3098,3048,2409,882,810,168,172,1620,1610,202,1900,788,0
19:55:55,9027.259,Fox,3230,340,130,50,51,53,40,16,3230,3100,3050,2410,882,812,168,172,1620,1610,202,1900,788,0
19:55:55,9027.858,Fox,3230,340,128,48,55,53,40,16,3230,3102,3054,2410,882,812,168,172,1620,1610,202,1900,788,0
19:55:55,9028.759,Fox,3232,340,130,48,54,52,38,18,3232,3102,3054,2410,882,814,167,173,1620,1612,203,1901,788,0
19:55:56,9029.658,Fox,3234,341,132,48,53,53,38,17,3234,3102,3054,2411,882,814,168,173,1621,1613,203,1901,789,0
19:55:56,9030.559,Fox,3234,340,130,50,51,54,38,17,3234,3104,3054,2413,882,814,167,173,1621,1613,203,1902,789,0
19:55:56,9031.158,Fox,3236,341,132,46,53,55,38,17,3236,3104,3058,2415,882,814,166,175,1621,1615,204,1902,789,0
19:55:56,9031.459,Fox,3236,340,132,46,53,54,38,17,3236,3104,3058,2415,882,814,166,174,1621,1615,204,1903,789,0
19:55:57,9032.658,Fox,3240,344,134,46,53,54,38,17,3238,3104,3058,2415,882,814,168,176,1623,1617,204,1903,789,0
19:55:57,9032.959,Fox,3240,344,136,44,55,54,38,17,3240,3104,3060,2415,882,814,168,176,1623,1617,204,1903,789,0
19:55:57,9033.858,Fox,3240,342,136,44,55,53,38,16,3240,3104,3060,2415,882,814,167,175,1623,1617,204,1904,790,0
19:55:58,9035.059,Fox,3240,341,130,50,54,53,38,16,3240,3110,3060,2416,882,814,167,174,1623,1617,204,1905,790,0
19:55:58,9036.259,Fox,3242,342,132,50,54,53,38,15,3242,3110,3060,2416,882,814,166,176,1623,1619,204,1905,791,0
19:55:59,9036.858,Fox,3242,341,130,52,54,53,38,14,3242,3112,3060,2416,882,814,165,176,1623,1619,204,1905,792,0
19:55:59,9037.158,Fox,3242,341,130,52,52,55,38,14,3242,3112,3060,2418,882,814,165,176,1623,1619,204,1905,792,0
19:55:59,9038.352,Fox,3244,343,128,54,52,55,38,14,3242,3114,3060,2418,882,814,166,177,1624,1620,204,1905,792,0
19:55:59,9038.952,Fox,3244,343,130,52,54,53,39,15,3244,3114,3062,2418,884,815,166,177,1624,1620,204,1905,792,0
19:55:59,9039.252,Fox,3244,343,128,54,54,53,39,15,3244,3116,3062,2418,884,815,166,177,1624,1620,204,1905,792,0
19:56:00,9040.752,Fox,3244,343,126,56,54,51,41,15,3244,3118,3062,2418,886,815,166,177,1624,1620,204,1905,792,0
19:56:00,9041.352,Fox,3244,343,124,56,56,51,41,15,3244,3120,3064,2418,886,815,166,177,1624,1620,204,1905,792,0
19:56:00,9041.952,Fox,3246,345,122,54,58,53,41,15,3244,3122,3068,2420,886,815,168,177,1626,1620,204,1905,792,0
19:56:01,9042.552,Fox,3252,351,124,54,58,53,41,15,3246,3122,3068,2420,886,815,172,179,1630,1622,204,1905,792,0
19:56:01,9042.852,Fox,3252,351,130,54,58,53,41,15,3252,3122,3068,2420,886,815,172,179,1630,1622,204,1905,792,0
19:56:01,9043.752,Fox,3252,351,128,54,58,55,41,15,3252,3124,3070,2422,886,815,172,179,1630,1622,204,1905,792,0
19:56:02,9044.952,Fox,3254,353,130,54,56,55,43,15,3254,3124,3070,2424,888,815,172,181,1630,1624,204,1905,792,0
19:56:02,9045.552,Fox,3256,354,130,52,58,53,45,14,3254,3124,3072,2424,890,815,173,181,1632,1624,204,1905,793,0
19:56:02,9045.852,Fox,3256,354,132,50,60,53,45,14,3256,3124,3074,2424,890,815,173,181,1632,1624,204,1905,793,0
19:56:02,9046.752,Fox,3256,354,130,48,64,53,45,14,3256,3126,3078,2424,890,815,173,181,1632,1624,204,1905,793,0
19:56:03,9047.352,Fox,3256,354,128,48,64,55,45,14,3256,3128,3080,2426,890,815,173,181,1632,1624,204,1905,793,0
19:56:03,9047.952,Fox,3258,354,130,46,66,53,45,14,3258,3128,3082,2426,890,815,174,180,1633,1625,204,1907,793,0
19:56:03,9048.852,Fox,3260,355,132,44,68,53,45,13,3260,3128,3084,2426,890,815,176,179,1635,1625,204,1907,794,0
19:56:03,9049.452,Fox,3260,355,132,42,70,51,47,13,3260,3128,3086,2426,892,815,176,179,1635,1625,204,1907,794,0
19:56:04,9050.052,Fox,3260,354,132,42,68,51,49,12,3260,3128,3086,2428,894,815,175,179,1635,1625,204,1907,795,0
19:56:04,9050.352,Fox,3260,354,132,40,70,51,49,12,3260,3128,3088,2428,894,815,175,179,1635,1625,204,1907,795,0
19:56:04,9051.852,Fox,3262,356,134,40,70,51,49,12,3262,3128,3088,2428,894,815,175,181,1635,1627,204,1907,795,0
19:56:05,9052.752,Fox,3262,356,134,40,70,50,48,14,3262,3128,3088,2428,895,817,175,181,1635,1627,204,1907,795,0
19:56:05,9053.352,Fox,3262,355,134,40,69,51,48,13,3262,3128,3088,2429,895,817,175,180,1635,1627,204,1907,796,0
19:56:05,9054.552,Fox,3262,355,134,40,67,53,48,13,3262,3128,3088,2431,895,817,175,180,1635,1627,204,1907,796,0
19:56:06,9055.152,Fox,3262,353,134,38,69,51,48,13,3262,3128,3090,2431,895,817,175,178,1635,1627,206,1907,796,0
19:56:06,9056.051,Fox,3264,354,136,38,69,51,48,12,3264,3128,3090,2431,895,817,174,180,1635,1629,206,1907,797,0
19:56:06,9056.351,Fox,3264,353,134,40,67,53,48,11,3264,3130,3090,2433,895,817,173,180,1635,1629,206,1907,798,0
19:56:07,9056.95,Fox,3264,353,134,38,69,53,48,11,3264,3130,3092,2433,895,817,173,180,1635,1629,206,1907,798,0
19:56:07,9057.851,Fox,3266,355,134,38,67,55,48,11,3264,3130,3092,2435,895,817,175,180,1637,1629,206,1907,798,0
19:56:07,9058.15,Fox,3266,355,134,38,69,55,48,11,3266,3132,3094,2435,895,817,175,180,1637,1629,206,1907,798,0
19:56:07,9058.75,Fox,3266,355,134,38,69,53,50,11,3266,3132,3094,2435,897,817,175,180,1637,1629,206,1907,798,0
19:56:08,9059.65,Fox,3268,357,136,38,69,53,50,11,3268,3132,3094,2435,897,817,176,181,1638,1630,206,1907,798,0
19:56:08,9060.25,Fox,3270,359,138,36,71,53,48,13,3270,3132,3096,2435,897,819,178,181,1640,1630,206,1907,798,0
19:56:08,9060.551,Fox,3270,359,136,38,71,53,48,13,3270,3134,3096,2435,897,819,178,181,1640,1630,206,1907,798,0
19:56:08,9061.45,Fox,3274,363,134,44,71,53,48,13,3274,3140,3096,2435,897,819,180,183,1642,1632,206,1907,798,0
19:56:09,9062.351,Fox,3276,365,136,44,69,55,48,13,3276,3140,3096,2437,897,819,180,185,1642,1634,206,1907,798,0
19:56:09,9062.95,Fox,3276,365,134,46,67,57,48,13,3276,3142,3096,2439,897,819,180,185,1642,1634,206,1907,798,0
19:56:09,9063.551,Fox,3278,365,136,46,66,56,48,13,3278,3142,3096,2439,897,819,180,185,1643,1635,206,1909,798,0
19:56:09,9064.15,Fox,3280,366,138,46,65,56,48,13,3280,3142,3096,2439,897,819,181,185,1645,1635,206,1910,798,0
19:56:10,9065.351,Fox,3284,370,138,44,67,56,48,13,3280,3142,3098,2439,897,819,184,186,1648,1636,206,1910,798,0
19:56:10,9065.95,Fox,3284,369,142,42,69,53,50,13,3284,3142,3100,2439,899,819,184,185,1648,1636,206,1911,798,0
19:56:10,9066.551,Fox,3288,372,142,42,70,53,50,13,3286,3144,3102,2439,899,819,186,186,1651,1637,206,1912,798,0
19:56:10,9066.851,Fox,3288,372,142,44,68,53,52,13,3288,3146,3102,2441,901,819,186,186,1651,1637,206,1912,798,0
19:56:11,9067.75,Fox,3288,370,140,46,68,50,53,13,3288,3148,3102,2441,902,819,186,184,1651,1637,206,1914,798,0
19:56:11,9068.351,Fox,3290,372,136,50,68,50,53,13,3288,3152,3102,2441,902,819,186,186,1651,1639,206,1914,798,0
19:56:11,9068.65,Fox,3290,372,134,54,68,50,53,13,3290,3156,3102,2441,902,819,186,186,1651,1639,206,1914,798,0
19:56:11,9069.25,Fox,3290,371,132,54,68,52,53,12,3290,3158,3104,2443,902,819,185,186,1651,1639,206,1914,799,0
19:56:12,9070.15,Fox,3290,371,126,60,68,52,53,12,3290,3164,3104,2443,902,819,185,186,1651,1639,206,1914,799,0
19:56:12,9070.75,Fox,3290,370,122,64,68,52,53,11,3290,3168,3104,2443,902,819,185,185,1651,1639,206,1914,800,0
19:56:12,9071.351,Fox,3296,375,126,64,67,52,52,12,3294,3168,3104,2443,902,820,188,187,1655,1641,206,1915,800,0
19:56:12,9071.65,Fox,3296,375,128,64,67,52,50,14,3296,3168,3104,2443,902,822,188,187,1655,1641,206,1915,800,0
19:56:13,9072.551,Fox,3296,373,128,64,67,48,52,14,3296,3168,3104,2443,904,822,187,186,1655,1641,207,1916,800,0
19:56:13,9073.75,Fox,3296,373,124,62,73,48,52,14,3296,3172,3110,2443,904,822,187,186,1655,1641,207,1916,800,0
19:56:13,9074.65,Fox,3298,375,126,62,73,47,53,14,3298,3172,3110,2443,905,822,189,186,1657,1641,207,1916,800,0
19:56:14,9075.551,Fox,3298,375,126,60,75,45,55,14,3298,3172,3112,2443,907,822,189,186,1657,1641,207,1916,800,0
19:56:14,9076.45,Fox,3300,377,128,60,74,46,55,14,3300,3172,3112,2444,907,822,189,188,1657,1643,207,1916,800,0
19:56:14,9076.75,Fox,3300,377,128,58,76,46,55,14,3300,3172,3114,2444,907,822,189,188,1657,1643,207,1916,800,0
19:56:15,9077.95,Fox,3306,382,130,56,77,46,55,14,3302,3172,3116,2444,907,822,191,191,1660,1646,207,1917,800,0
19:56:15,9078.25,Fox,3306,382,134,56,77,46,55,14,3306,3172,3116,2444,907,822,191,191,1660,1646,207,1917,800,0
19:56:15,9079.45,Fox,3306,380,132,56,77,46,55,14,3306,3174,3118,2446,907,822,191,189,1660,1646,207,1919,800,0
19:56:16,9080.051,Fox,3308,381,130,56,76,48,53,16,3306,3176,3120,2448,907,824,192,189,1662,1646,208,1919,800,0
19:56:16,9080.351,Fox,3308,381,132,54,76,50,53,16,3308,3176,3122,2450,907,824,192,189,1662,1646,208,1919,800,0
19:56:16,9081.25,Fox,3308,379,130,56,76,49,53,15,3308,3178,3122,2450,907,824,190,189,1662,1646,208,1920,801,0
19:56:16,9081.851,Fox,3308,379,126,60,76,49,53,15,3308,3182,3122,2450,907,824,190,189,1662,1646,208,1920,801,0
19:56:17,9082.45,Fox,3312,383,126,60,78,49,53,15,3310,3184,3124,2450,907,824,192,191,1664,1648,208,1920,801,0
19:56:17,9083.051,Fox,3314,385,130,60,78,49,53,15,3314,3184,3124,2450,907,824,193,192,1665,1649,208,1920,801,0
19:56:17,9083.95,Fox,3316,387,132,60,78,49,53,15,3316,3184,3124,2450,907,824,193,194,1665,1651,208,1920,801,0
19:56:18,9084.551,Fox,3318,389,134,60,76,51,53,15,3318,3184,3124,2452,907,824,193,196,1665,1653,208,1920,801,0
19:56:18,9085.15,Fox,3320,391,136,58,76,53,52,16,3320,3184,3126,2454,907,825,195,196,1667,1653,208,1920,801,0
19:56:18,9085.75,Fox,3322,393,134,58,78,53,52,16,3320,3186,3128,2454,907,825,196,197,1668,1654,208,1920,801,0
19:56:18,9086.351,Fox,3324,395,136,60,76,55,52,16,3324,3188,3128,2456,907,825,198,197,1670,1654,208,1920,801,0
19:56:19,9086.95,Fox,3328,396,134,62,74,54,52,16,3324,3190,3128,2456,907,825,198,198,1672,1656,208,1923,801,0
19:56:19,9087.551,Fox,3330,397,136,66,72,55,52,16,3330,3194,3128,2458,907,825,198,199,1673,1657,209,1923,801,0
19:56:19,9088.45,Fox,3334,400,138,68,69,58,52,15,3334,3196,3128,2461,907,825,200,200,1675,1659,209,1923,802,0
19:56:20,9089.051,Fox,3334,398,136,70,69,58,52,13,3334,3198,3128,2461,907,825,198,200,1675,1659,209,1923,804,0
19:56:20,9089.65,Fox,3340,402,134,74,68,57,52,13,3336,3202,3128,2461,907,825,198,204,1677,1663,209,1925,804,0
19:56:20,9090.25,Fox,3340,400,136,76,68,54,54,12,3340,3204,3128,2461,909,825,198,202,1677,1663,209,1926,805,0
19:56:20,9090.851,Fox,3340,398,136,76,68,53,54,11,3340,3204,3128,2461,909,825,197,201,1677,1663,210,1926,806,0
19:56:21,9091.75,Fox,3342,400,136,78,64,57,54,11,3342,3206,3128,2465,909,825,198,202,1678,1664,210,1926,806,0
19:56:21,9092.95,Fox,3344,402,138,78,64,57,54,11,3344,3206,3128,2465,909,825,199,203,1679,1665,210,1926,806,0
19:56:22,9093.851,Fox,3348,405,138,78,63,58,54,10,3344,3206,3128,2466,909,825,199,206,1680,1668,210,1926,807,0
19:56:22,9094.45,Fox,3348,405,142,78,63,58,52,12,3348,3206,3128,2466,909,827,199,206,1680,1668,210,1926,807,0
19:56:22,9095.051,Fox,3350,407,144,76,65,58,52,12,3350,3206,3130,2466,909,827,200,207,1681,1669,210,1926,807,0
19:56:23,9095.351,Fox,3350,405,144,76,65,56,52,12,3350,3206,3130,2466,909,827,200,205,1681,1669,211,1927,807,0
19:56:23,9096.851,Fox,3352,405,146,74,67,54,52,12,3352,3206,3132,2466,909,827,201,204,1682,1670,211,1929,807,0
19:56:24,9097.75,Fox,3356,409,148,74,67,54,52,12,3354,3206,3132,2466,909,827,205,204,1686,1670,211,1929,807,0
19:56:24,9098.351,Fox,3358,410,150,74,67,53,52,12,3356,3206,3132,2466,909,827,207,203,1688,1670,211,1930,807,0
19:56:24,9098.95,Fox,3358,410,152,72,69,53,52,12,3358,3206,3134,2466,909,827,207,203,1688,1670,211,1930,807,0
19:56:24,9099.851,Fox,3358,409,152,66,74,53,52,12,3358,3206,3140,2467,909,827,206,203,1688,1670,211,1931,807,0
19:56:25,9100.45,Fox,3358,409,150,68,74,52,53,12,3358,3208,3140,2467,910,827,206,203,1688,1670,211,1931,807,0
19:56:25,9101.351,Fox,3360,411,150,68,76,52,53,12,3360,3210,3142,2467,910,827,207,204,1689,1671,211,1931,807,0
19:56:25,9101.95,Fox,3362,411,148,70,74,51,54,12,3360,3212,3142,2469,911,827,207,204,1689,1673,211,1933,807,0
19:56:26,9102.25,Fox,3362,410,150,70,70,55,54,11,3362,3212,3142,2473,911,827,207,203,1689,1673,211,1933,808,0
19:56:26,9103.45,Fox,3364,411,146,76,69,55,54,11,3364,3218,3142,2473,911,827,208,203,1691,1673,212,1933,808,0
19:56:26,9104.051,Fox,3364,410,144,78,69,54,54,11,3364,3220,3142,2473,911,827,208,202,1691,1673,213,1933,808,0
19:56:26,9104.351,Fox,3364,410,144,78,67,56,54,11,3364,3220,3142,2475,911,827,208,202,1691,1673,213,1933,808,0
19:56:27,9105.25,Fox,3366,411,140,78,70,53,57,11,3364,3224,3146,2475,914,827,208,203,1692,1674,213,1934,808,0
19:56:27,9105.851,Fox,3366,411,142,76,72,51,59,11,3366,3224,3148,2475,916,827,208,203,1692,1674,213,1934,808,0
19:56:27,9106.45,Fox,3366,411,138,78,71,54,58,12,3366,3228,3150,2478,916,828,208,203,1692,1674,213,1934,808,0
19:56:28,9107.051,Fox,3370,415,138,74,75,56,58,12,3368,3230,3156,2480,916,828,211,204,1695,1675,213,1934,808,0
19:56:28,9107.65,Fox,3370,415,140,72,75,58,58,12,3370,3230,3158,2482,916,828,211,204,1695,1675,213,1934,808,0
19:56:28,9108.25,Fox,3370,415,140,68,77,60,58,12,3370,3230,3162,2484,916,828,211,204,1695,1675,213,1934,808,0
19:56:28,9108.851,Fox,3370,415,140,64,79,61,59,12,3370,3230,3166,2486,917,828,211,204,1695,1675,213,1934,808,0
19:56:29,9109.15,Fox,3370,415,140,62,81,61,59,12,3370,3230,3168,2486,917,828,211,204,1695,1675,213,1934,808,0
19:56:29,9110.051,Fox,3372,416,142,62,79,62,59,12,3372,3230,3168,2488,917,828,212,204,1696,1676,213,1935,808,0
19:56:29,9110.95,Fox,3374,415,144,62,77,63,59,10,3374,3230,3168,2489,917,828,211,204,1697,1677,213,1936,810,0
19:56:30,9111.851,Fox,3374,415,142,62,79,63,59,10,3374,3232,3170,2489,917,828,211,204,1697,1677,213,1936,810,0
19:56:30,9112.45,Fox,3376,415,142,62,81,62,59,9,3376,3234,3172,2489,917,828,213,202,1699,1677,213,1937,811,0
19:56:31,9113.95,Fox,3378,417,142,64,81,62,59,9,3378,3236,3172,2489,917,828,214,203,1700,1678,213,1937,811,0
19:56:31,9114.551,Fox,3378,417,142,64,81,61,58,11,3378,3236,3172,2489,918,830,214,203,1700,1678,213,1937,811,0
19:56:31,9115.45,Fox,3378,417,140,66,81,59,60,11,3378,3238,3172,2489,920,830,214,203,1700,1678,213,1937,811,0
19:56:32,9116.051,Fox,3378,417,138,68,79,61,59,12,3378,3240,3172,2491,920,831,214,203,1700,1678,213,1937,811,0
19:56:32,9116.65,Fox,3380,419,140,68,79,59,59,14,3380,3240,3172,2491,922,833,214,205,1700,1680,213,1937,811,0
19:56:32,9117.25,Fox,3380,416,140,68,79,53,62,14,3380,3240,3172,2491,926,833,214,202,1700,1680,213,1940,811,0
19:56:32,9117.851,Fox,3384,418,142,66,79,53,62,14,3382,3240,3174,2493,926,833,213,205,1701,1683,213,1942,811,0
19:56:32,9118.15,Fox,3384,417,144,64,81,52,62,14,3384,3240,3176,2493,926,833,213,204,1701,1683,213,1943,811,0
19:56:33,9119.051,Fox,3386,416,144,66,79,52,62,13,3386,3242,3176,2495,926,833,210,206,1701,1685,215,1943,812,0
19:56:33,9119.351,Fox,3386,416,144,64,81,52,62,13,3386,3242,3178,2495,926,833,210,206,1701,1685,215,1943,812,0
19:56:33,9120.25,Fox,3388,418,144,60,85,52,62,13,3386,3242,3182,2495,926,833,211,207,1702,1686,215,1943,812,0
19:56:33,9120.851,Fox,3388,418,146,58,85,53,63,13,3388,3242,3184,2497,927,833,211,207,1702,1686,215,1943,812,0
19:56:34,9121.45,Fox,3388,417,144,60,85,52,63,13,3388,3244,3184,2497,927,833,211,206,1702,1686,216,1943,812,0
19:56:34,9122.051,Fox,3390,419,146,60,85,52,63,13,3390,3244,3184,2497,927,833,211,208,1702,1688,216,1943,812,0
19:56:35,9123.851,Fox,3394,421,148,58,85,51,64,13,3392,3244,3186,2497,928,833,212,209,1705,1689,217,1944,812,0
19:56:35,9124.45,Fox,3396,422,150,56,87,49,66,12,3394,3244,3188,2497,930,833,213,209,1706,1690,217,1944,813,0
19:56:35,9125.051,Fox,3396,422,150,56,89,49,66,12,3396,3246,3190,2497,930,833,213,209,1706,1690,217,1944,813,0
19:56:36,9125.65,Fox,3400,425,148,62,86,51,66,12,3400,3252,3190,2499,930,833,215,210,1709,1691,217,1945,813,0
19:56:36,9126.25,Fox,3400,424,148,58,88,52,65,13,3400,3252,3194,2501,930,834,215,209,1709,1691,218,1945,813,0
19:56:36,9127.15,Fox,3402,425,150,54,91,53,61,16,3402,3252,3198,2502,930,838,215,210,1710,1692,218,1945,814,0
19:56:37,9127.75,Fox,3404,425,150,52,94,52,61,16,3404,3254,3202,2502,930,838,215,210,1711,1693,219,1946,814,0
19:56:37,9128.65,Fox,3404,425,148,52,96,51,62,16,3404,3256,3204,2502,931,838,215,210,1711,1693,219,1946,814,0
19:56:37,9129.551,Fox,3408,428,152,52,95,51,62,16,3408,3256,3204,2502,931,838,216,212,1713,1695,219,1947,814,0
19:56:38,9130.15,Fox,3410,430,154,50,95,53,62,16,3410,3256,3206,2504,931,838,218,212,1715,1695,219,1947,814,0
19:56:38,9130.75,Fox,3412,431,152,52,95,52,61,17,3410,3258,3206,2504,931,839,218,213,1715,1697,220,1947,814,0
19:56:38,9131.351,Fox,3416,433,154,52,94,52,61,16,3412,3258,3206,2504,931,839,218,215,1717,1699,220,1948,815,0
19:56:38,9131.95,Fox,3420,437,156,54,94,52,61,16,3416,3260,3206,2504,931,839,221,216,1720,1700,220,1948,815,0
19:56:39,9132.25,Fox,3420,437,160,54,94,52,61,16,3420,3260,3206,2504,931,839,221,216,1720,1700,220,1948,815,0
19:56:39,9134.351,Fox,3420,437,160,54,90,56,61,16,3420,3260,3206,2508,931,839,221,216,1720,1700,220,1948,815,0
19:56:40,9134.95,Fox,3420,436,158,56,90,54,63,15,3420,3262,3206,2508,933,839,221,215,1720,1700,220,1948,816,0
19:56:40,9135.551,Fox,3426,442,162,56,90,54,63,15,3424,3262,3206,2508,933,839,223,219,1722,1704,220,1948,816,0
19:56:40,9136.15,Fox,3428,444,166,56,88,56,63,15,3428,3262,3206,2510,933,839,225,219,1724,1704,220,1948,816,0
19:56:41,9136.75,Fox,3432,446,166,56,88,54,63,15,3428,3262,3206,2510,933,839,227,219,1726,1706,220,1950,816,0
19:56:41,9137.351,Fox,3434,447,172,56,86,53,65,15,3434,3262,3206,2512,935,839,227,220,1726,1708,220,1951,816,0
19:56:41,9138.551,Fox,3438,450,170,58,83,55,65,15,3434,3264,3206,2514,935,839,229,221,1729,1709,220,1952,816,0
19:56:42,9138.851,Fox,3438,450,174,56,85,55,65,15,3438,3264,3208,2514,935,839,229,221,1729,1709,220,1952,816,0
19:56:42,9139.75,Fox,3438,450,174,54,85,57,65,15,3438,3264,3210,2516,935,839,229,221,1729,1709,220,1952,816,0
19:56:42,9140.351,Fox,3438,450,174,52,86,56,67,15,3438,3264,3212,2517,937,839,229,221,1729,1709,220,1952,816,0
19:56:42,9140.95,Fox,3438,450,172,54,85,57,67,15,3438,3266,3212,2518,937,839,229,221,1729,1709,220,1952,816,0
19:56:43,9141.851,Fox,3438,450,172,48,91,57,66,16,3438,3266,3218,2518,937,840,229,221,1729,1709,220,1952,816,0
19:56:43,9142.45,Fox,3442,453,170,48,92,57,66,16,3438,3268,3220,2518,937,840,231,222,1732,1710,220,1953,816,0
19:56:43,9143.051,Fox,3442,453,172,50,91,56,68,16,3442,3270,3220,2519,939,840,231,222,1732,1710,220,1953,816,0
19:56:44,9143.65,Fox,3448,457,172,46,93,56,68,16,3442,3270,3224,2519,939,840,230,227,1733,1715,220,1955,816,0
19:56:44,9144.25,Fox,3450,458,174,50,92,56,68,16,3448,3274,3224,2519,939,840,231,227,1735,1715,220,1956,816,0
19:56:44,9144.851,Fox,3450,458,174,48,96,56,68,16,3450,3276,3228,2519,939,840,231,227,1735,1715,220,1956,816,0
19:56:45,9145.75,Fox,3452,458,176,46,95,58,68,15,3452,3276,3230,2521,939,840,230,228,1736,1716,220,1957,817,0
19:56:45,9146.351,Fox,3460,465,180,48,94,58,68,15,3458,3278,3230,2521,939,840,230,235,1737,1723,220,1958,817,0
19:56:45,9146.95,Fox,3462,466,182,50,93,58,68,15,3462,3280,3230,2521,939,840,229,237,1737,1725,221,1958,817,0
19:56:46,9147.551,Fox,3464,467,184,50,93,57,68,15,3464,3280,3230,2521,939,840,231,236,1739,1725,221,1959,817,0
19:56:46,9148.15,Fox,3466,469,182,54,93,55,70,15,3466,3284,3230,2521,941,840,233,236,1741,1725,221,1959,817,0
19:56:46,9148.45,Fox,3466,467,182,54,93,53,70,15,3466,3284,3230,2521,941,840,232,235,1741,1725,221,1961,817,0
19:56:46,9149.351,Fox,3466,467,178,58,93,53,70,15,3466,3288,3230,2521,941,840,232,235,1741,1725,221,1961,817,0
19:56:47,9149.95,Fox,3466,467,178,56,95,51,72,15,3466,3288,3232,2521,943,840,232,235,1741,1725,221,1961,817,0
19:56:47,9151.15,Fox,3466,466,176,56,97,50,72,15,3466,3290,3234,2521,943,840,232,234,1741,1725,221,1962,817,0
19:56:48,9152.051,Fox,3470,470,180,56,97,50,72,15,3470,3290,3234,2521,943,840,234,236,1743,1727,221,1962,817,0
19:56:48,9152.351,Fox,3470,470,180,54,99,50,72,15,3470,3290,3236,2521,943,840,234,236,1743,1727,221,1962,817,0
19:56:48,9152.95,Fox,3470,469,180,54,99,49,70,17,3470,3290,3236,2521,943,842,234,235,1743,1727,221,1963,817,0
19:56:49,9153.851,Fox,3476,475,178,56,101,49,70,17,3472,3294,3238,2521,943,842,237,238,1746,1730,221,1963,817,0
19:56:49,9154.15,Fox,3476,475,180,56,103,49,70,17,3476,3296,3240,2521,943,842,237,238,1746,1730,221,1963,817,0
19:56:49,9155.051,Fox,3480,478,182,56,102,49,70,17,3478,3296,3240,2521,943,842,239,239,1749,1731,221,1964,817,0
19:56:50,9155.65,Fox,3484,479,186,56,99,50,68,18,3482,3296,3240,2523,943,844,239,240,1751,1733,221,1966,818,0
19:56:50,9155.95,Fox,3484,479,188,56,99,48,70,18,3484,3296,3240,2523,945,844,239,240,1751,1733,221,1966,818,0
19:56:50,9156.551,Fox,3484,479,188,56,99,48,69,19,3484,3296,3240,2523,945,845,239,240,1751,1733,221,1966,818,0
19:56:50,9157.45,Fox,3484,479,186,56,99,50,69,19,3484,3298,3242,2525,945,845,239,240,1751,1733,221,1966,818,0
19:56:51,9158.351,Fox,3488,483,188,56,99,50,69,19,3486,3298,3242,2525,945,845,241,242,1753,1735,221,1966,818,0
19:56:51,9158.95,Fox,3490,484,188,58,98,50,69,19,3488,3300,3242,2525,945,845,240,244,1753,1737,221,1967,818,0
19:56:51,9159.551,Fox,3490,484,190,58,96,52,69,19,3490,3300,3242,2527,945,845,240,244,1753,1737,221,1967,818,0
19:56:52,9160.15,Fox,3492,485,192,56,95,52,71,19,3492,3300,3244,2529,947,845,241,244,1755,1737,221,1968,818,0
19:56:52,9160.75,Fox,3492,485,186,62,93,54,71,19,3492,3306,3244,2531,947,845,241,244,1755,1737,221,1968,818,0
19:56:53,9161.65,Fox,3496,488,188,62,92,54,68,22,3494,3306,3244,2531,947,848,242,246,1757,1739,222,1968,818,0
19:56:53,9161.95,Fox,3496,488,190,62,92,54,68,22,3496,3306,3244,2531,947,848,242,246,1757,1739,222,1968,818,0
19:56:53,9162.851,Fox,3498,489,190,64,92,53,68,22,3498,3308,3244,2531,947,848,243,246,1759,1739,222,1969,818,0
19:56:54,9163.45,Fox,3508,499,200,62,94,53,68,22,3508,3308,3246,2531,947,848,251,248,1767,1741,222,1969,818,0
19:56:54,9164.051,Fox,3516,505,202,56,98,53,64,26,3510,3308,3252,2531,947,852,252,253,1770,1746,222,1971,818,0
19:56:54,9164.351,Fox,3516,505,208,56,98,53,64,26,3516,3308,3252,2531,947,852,252,253,1770,1746,222,1971,818,0
19:56:55,9165.25,Fox,3518,507,204,60,98,53,64,26,3516,3312,3252,2531,947,852,253,254,1771,1747,222,1971,818,0
19:56:55,9165.851,Fox,3520,506,206,62,95,55,64,24,3520,3314,3252,2533,947,852,252,254,1772,1748,222,1972,820,0
19:56:55,9166.45,Fox,3520,506,204,62,95,57,64,24,3520,3316,3254,2535,947,852,252,254,1772,1748,222,1972,820,0
19:56:55,9167.051,Fox,3528,514,208,62,95,59,64,24,3526,3318,3256,2537,947,852,258,256,1778,1750,222,1972,820,0
19:56:56,9167.65,Fox,3534,518,208,64,89,63,64,24,3528,3320,3256,2541,947,852,257,261,1779,1755,222,1974,820,0
19:56:56,9168.25,Fox,3536,518,216,64,88,63,63,24,3536,3320,3256,2542,947,852,257,261,1780,1756,222,1976,820,0
19:56:56,9168.851,Fox,3538,519,212,68,83,67,63,24,3536,3324,3256,2546,947,852,256,263,1780,1758,222,1977,820,0
19:56:57,9169.45,Fox,3538,519,214,66,82,70,63,24,3538,3324,3258,2549,947,852,256,263,1780,1758,222,1977,820,0
19:56:57,9170.051,Fox,3538,518,208,70,83,70,63,24,3538,3330,3260,2550,947,852,255,263,1780,1758,222,1978,820,0
19:56:57,9170.95,Fox,3538,518,204,74,83,70,63,24,3538,3334,3260,2550,947,852,255,263,1780,1758,222,1978,820,0
19:56:58,9172.45,Fox,3538,518,198,80,81,72,63,24,3538,3340,3260,2552,947,852,255,263,1780,1758,222,1978,820,0
19:56:59,9173.051,Fox,3542,521,202,78,80,73,64,24,3542,3340,3262,2554,948,852,257,264,1783,1759,222,1979,820,0
19:56:59,9173.65,Fox,3544,521,202,78,79,71,65,24,3542,3340,3262,2554,949,852,256,265,1784,1760,223,1980,820,0
19:56:59,9174.25,Fox,3550,526,204,80,78,71,65,24,3546,3342,3262,2554,949,852,258,268,1787,1763,223,1981,820,0
19:56:59,9174.551,Fox,3550,526,208,80,78,71,65,24,3550,3342,3262,2554,949,852,258,268,1787,1763,223,1981,820,0
19:57:00,9175.75,Fox,3552,527,208,82,78,70,65,24,3552,3344,3262,2554,949,852,258,269,1788,1764,223,1982,820,0
19:57:01,9176.65,Fox,3552,525,204,86,78,68,63,26,3552,3348,3262,2554,949,854,258,267,1788,1764,223,1984,820,0
19:57:01,9177.551,Fox,3552,521,202,86,80,66,63,24,3552,3350,3264,2554,949,854,256,265,1788,1764,223,1986,822,0
19:57:01,9178.15,Fox,3558,520,206,86,77,61,63,25,3556,3350,3264,2554,951,856,255,265,1791,1767,223,1992,823,0
19:57:02,9178.75,Fox,3560,520,208,86,72,64,63,25,3558,3350,3264,2558,951,856,255,265,1792,1768,223,1994,823,0
19:57:02,9179.351,Fox,3560,517,208,86,74,61,63,25,3560,3352,3266,2558,951,856,255,262,1792,1768,223,1997,823,0
19:57:03,9179.95,Fox,3564,518,212,86,72,60,63,25,3564,3352,3266,2558,951,856,253,265,1793,1771,224,1999,823,0
19:57:03,9180.551,Fox,3566,520,210,90,72,60,63,25,3566,3356,3266,2558,951,856,253,267,1793,1773,224,1999,823,0
19:57:03,9181.15,Fox,3566,520,208,90,72,60,65,25,3566,3358,3268,2560,953,856,253,267,1793,1773,224,1999,823,0
19:57:04,9181.75,Fox,3568,521,208,88,72,59,67,25,3566,3358,3270,2561,955,856,253,268,1794,1774,224,2000,823,0
19:57:04,9182.351,Fox,3572,524,212,88,72,59,64,27,3570,3358,3270,2561,955,858,254,270,1796,1776,224,2001,823,0
19:57:04,9182.95,Fox,3574,524,214,84,75,58,62,29,3572,3358,3274,2561,955,860,254,270,1797,1777,224,2003,823,0
19:57:04,9183.551,Fox,3574,524,216,82,77,58,62,29,3574,3358,3276,2561,955,860,254,270,1797,1777,224,2003,823,0
19:57:05,9183.851,Fox,3574,523,214,84,77,58,62,28,3574,3360,3276,2561,955,860,254,269,1797,1777,224,2003,824,0
19:57:05,9184.75,Fox,3578,526,214,84,76,58,64,28,3576,3362,3278,2563,957,860,255,271,1799,1779,224,2004,824,0
19:57:05,9185.351,Fox,3580,528,216,82,77,59,64,28,3578,3362,3280,2564,957,860,255,273,1799,1781,224,2004,824,0
19:57:06,9185.95,Fox,3582,529,218,84,75,60,64,28,3582,3364,3280,2565,957,860,254,275,1799,1783,224,2005,824,0
19:57:06,9186.851,Fox,3582,529,218,80,77,62,62,30,3582,3364,3284,2567,957,862,254,275,1799,1783,224,2005,824,0
19:57:07,9187.45,Fox,3584,531,220,80,76,63,62,30,3584,3364,3284,2568,957,862,256,275,1801,1783,224,2005,824,0
19:57:07,9188.051,Fox,3584,531,218,78,78,65,60,32,3584,3366,3288,2570,957,864,256,275,1801,1783,224,2005,824,0
19:57:07,9188.65,Fox,3588,532,222,78,75,65,60,32,3588,3366,3288,2573,957,864,256,276,1803,1785,224,2008,824,0
19:57:07,9189.25,Fox,3590,534,224,78,74,66,60,32,3590,3366,3288,2574,957,864,257,277,1804,1786,224,2008,824,0
19:57:08,9189.851,Fox,3592,535,222,80,75,66,60,32,3592,3370,3290,2574,957,864,256,279,1804,1788,224,2009,824,0
19:57:08,9190.45,Fox,3596,537,226,80,72,67,59,33,3596,3370,3290,2576,957,865,257,280,1807,1789,224,2011,824,0
19:57:09,9191.351,Fox,3600,539,228,80,72,65,59,33,3598,3370,3290,2576,957,865,259,280,1809,1791,224,2013,824,0
19:57:09,9191.65,Fox,3600,538,230,80,72,64,59,33,3600,3370,3290,2576,957,865,259,279,1809,1791,224,2014,824,0
19:57:09,9192.551,Fox,3600,536,228,78,76,64,59,31,3600,3372,3294,2576,957,865,258,278,1809,1791,224,2014,826,0
19:57:09,9192.851,Fox,3600,536,228,76,78,64,59,31,3600,3372,3296,2576,957,865,258,278,1809,1791,224,2014,826,0
19:57:10,9193.75,Fox,3600,535,226,78,78,64,59,30,3600,3374,3296,2576,957,865,257,278,1809,1791,224,2014,827,0
19:57:10,9194.351,Fox,3602,537,228,78,78,64,59,30,3602,3374,3296,2576,957,865,257,280,1809,1793,224,2014,827,0
19:57:10,9194.95,Fox,3602,536,226,80,78,61,61,30,3602,3376,3296,2576,959,865,257,279,1809,1793,224,2015,827,0
19:57:11,9195.551,Fox,3602,535,226,80,78,57,64,30,3602,3376,3296,2576,962,865,257,278,1809,1793,224,2016,827,0
19:57:11,9195.851,Fox,3602,535,226,78,80,57,64,30,3602,3376,3298,2576,962,865,257,278,1809,1793,224,2016,827,0
19:57:11,9196.45,Fox,3602,535,224,80,80,57,62,32,3602,3378,3298,2576,962,867,257,278,1809,1793,224,2016,827,0
19:57:12,9197.65,Fox,3602,534,224,78,82,56,63,31,3602,3378,3300,2576,963,867,256,278,1809,1793,224,2016,828,0
19:57:12,9197.95,Fox,3602,532,224,78,82,54,63,31,3602,3378,3300,2576,963,867,255,277,1809,1793,224,2018,828,0
19:57:12,9198.851,Fox,3606,534,226,78,81,53,63,31,3604,3378,3300,2576,963,867,257,277,1812,1794,224,2020,828,0
19:57:13,9199.45,Fox,3608,535,228,74,87,51,64,31,3608,3380,3306,2576,964,867,259,276,1814,1794,224,2021,828,0
19:57:13,9200.051,Fox,3608,535,228,74,86,51,65,31,3608,3380,3306,2577,965,867,259,276,1814,1794,224,2021,828,0
19:57:14,9200.65,Fox,3610,534,226,78,83,51,65,31,3610,3384,3306,2579,965,867,258,276,1814,1796,224,2024,828,0
19:57:14,9201.551,Fox,3610,534,224,78,85,50,66,31,3610,3386,3308,2579,966,867,258,276,1814,1796,224,2024,828,0
19:57:15,9202.45,Fox,3610,533,224,78,80,55,66,30,3610,3386,3308,2584,966,867,258,275,1814,1796,224,2024,829,0
19:57:15,9203.051,Fox,3610,532,222,80,79,56,66,29,3610,3388,3308,2585,966,867,258,274,1814,1796,224,2024,830,0
19:57:15,9203.65,Fox,3610,532,222,78,81,54,66,31,3610,3388,3310,2585,968,869,258,274,1814,1796,224,2024,830,0
19:57:16,9204.25,Fox,3610,532,222,74,83,56,66,31,3610,3388,3314,2587,968,869,258,274,1814,1796,224,2024,830,0
19:57:16,9204.551,Fox,3610,532,220,76,83,56,64,33,3610,3390,3314,2587,968,871,258,274,1814,1796,224,2024,830,0
19:57:16,9205.45,Fox,3612,534,220,74,82,59,63,34,3610,3390,3316,2590,968,872,258,276,1814,1798,224,2024,830,0
19:57:17,9206.051,Fox,3612,534,222,72,83,60,63,34,3612,3390,3318,2591,968,872,258,276,1814,1798,224,2024,830,0
19:57:17,9206.65,Fox,3614,535,220,74,85,60,62,34,3614,3394,3320,2591,968,872,259,276,1816,1798,224,2025,830,0
19:57:17,9207.551,Fox,3620,538,218,72,88,59,62,33,3614,3396,3324,2591,968,872,261,277,1821,1799,225,2026,831,0
19:57:18,9208.15,Fox,3620,537,220,76,88,59,62,32,3620,3400,3324,2591,968,872,261,276,1821,1799,225,2026,832,0
19:57:18,9208.75,Fox,3620,535,220,70,94,59,62,30,3620,3400,3330,2591,968,872,261,274,1821,1799,225,2026,834,0
19:57:18,9209.051,Fox,3620,534,220,70,94,58,63,29,3620,3400,3330,2591,969,872,260,274,1821,1799,225,2027,834,0
19:57:19,9209.95,Fox,3624,536,222,68,97,57,63,29,3624,3402,3334,2591,969,872,259,277,1822,1802,226,2028,834,0
19:57:19,9210.551,Fox,3624,535,220,70,95,58,61,31,3624,3404,3334,2593,969,874,259,276,1822,1802,226,2029,834,0
19:57:19,9211.15,Fox,3624,534,220,64,101,56,62,31,3624,3404,3340,2593,970,874,259,275,1822,1802,226,2030,834,0
19:57:19,9211.45,Fox,3624,534,220,64,100,57,62,31,3624,3404,3340,2594,970,874,259,275,1822,1802,226,2030,834,0
19:57:20,9212.351,Fox,3624,531,216,68,100,52,63,32,3624,3408,3340,2594,972,875,259,272,1822,1802,226,2033,834,0
19:57:20,9212.95,Fox,3626,531,216,68,100,52,61,34,3626,3410,3342,2596,972,877,261,270,1824,1802,226,2035,834,0
19:57:20,9213.551,Fox,3626,530,214,70,100,51,61,34,3626,3412,3342,2596,972,877,261,269,1824,1802,226,2036,834,0
19:57:21,9214.45,Fox,3626,529,210,72,101,51,61,34,3626,3416,3344,2597,972,877,261,268,1824,1802,226,2037,834,0
19:57:21,9214.75,Fox,3626,528,206,76,100,52,61,33,3626,3420,3344,2598,972,877,260,268,1824,1802,226,2037,835,0
19:57:21,9215.351,Fox,3626,527,206,72,104,51,61,33,3626,3420,3348,2598,972,877,259,268,1824,1802,226,2038,835,0
19:57:22,9216.551,Fox,3628,527,208,70,105,50,61,33,3628,3420,3350,2598,972,877,259,268,1825,1803,227,2039,835,0
19:57:22,9217.15,Fox,3628,526,208,70,105,50,61,32,3628,3420,3350,2598,972,877,258,268,1825,1803,227,2039,836,0
19:57:23,9218.351,Fox,3630,528,204,74,105,52,61,32,3630,3426,3352,2600,972,877,259,269,1826,1804,227,2039,836,0
19:57:23,9218.95,Fox,3632,528,202,74,107,50,62,31,3630,3428,3354,2600,974,877,257,271,1826,1806,227,2040,837,0
19:57:24,9219.551,Fox,3632,528,200,76,109,50,62,31,3632,3432,3356,2600,974,877,257,271,1826,1806,227,2040,837,0
19:57:24,9220.15,Fox,3632,527,198,76,111,49,62,31,3632,3434,3358,2600,974,877,256,271,1826,1806,227,2041,837,0
19:57:24,9220.75,Fox,3632,525,198,76,110,48,62,31,3632,3434,3358,2601,974,877,256,269,1826,1806,227,2043,837,0
19:57:25,9221.65,Fox,3632,524,194,80,110,47,62,31,3632,3438,3358,2601,974,877,256,268,1826,1806,227,2044,837,0
19:57:25,9222.25,Fox,3638,528,198,80,108,47,62,31,3636,3438,3358,2601,974,877,257,271,1829,1809,227,2046,837,0
19:57:25,9222.551,Fox,3638,528,200,78,110,47,62,31,3638,3438,3360,2601,974,877,257,271,1829,1809,227,2046,837,0
19:57:25,9223.45,Fox,3640,527,200,76,111,43,64,31,3638,3438,3362,2601,976,877,255,272,1829,1811,227,2049,837,0
19:57:26,9224.051,Fox,3646,529,202,76,107,44,64,30,3640,3438,3362,2602,976,877,255,274,1832,1814,227,2052,838,0
19:57:26,9224.65,Fox,3650,532,210,74,104,49,64,29,3648,3438,3364,2607,976,877,257,275,1835,1815,227,2052,839,0
19:57:26,9225.25,Fox,3652,532,210,78,103,48,64,29,3652,3442,3364,2607,976,877,257,275,1836,1816,227,2054,839,0
19:57:27,9225.851,Fox,3656,535,212,78,102,48,64,29,3654,3442,3364,2607,976,877,258,277,1838,1818,227,2055,839,0
19:57:27,9226.45,Fox,3658,537,210,84,102,48,64,29,3658,3448,3364,2607,976,877,259,278,1839,1819,227,2055,839,0
19:57:27,9227.051,Fox,3660,539,210,84,102,50,64,29,3660,3450,3366,2609,976,877,259,280,1839,1821,227,2055,839,0
19:57:28,9227.65,Fox,3662,540,210,84,100,48,67,29,3660,3450,3366,2610,979,877,259,281,1840,1822,228,2055,839,0
19:57:28,9228.25,Fox,3662,537,210,84,102,46,65,30,3662,3452,3368,2610,979,879,259,278,1840,1822,228,2057,840,0
19:57:28,9228.851,Fox,3662,536,204,88,104,46,65,29,3662,3458,3370,2610,979,879,259,277,1840,1822,228,2057,841,0
19:57:28,9229.45,Fox,3666,539,202,92,103,44,67,29,3664,3462,3370,2610,981,879,261,278,1843,1823,228,2058,841,0
19:57:29,9230.051,Fox,3672,542,206,94,100,44,67,29,3670,3464,3370,2611,981,879,261,281,1845,1827,228,2061,841,0
19:57:29,9230.65,Fox,3672,541,206,96,98,44,68,29,3672,3466,3370,2613,982,879,261,280,1845,1827,228,2062,841,0
19:57:29,9231.25,Fox,3676,544,208,94,100,44,68,28,3674,3466,3372,2613,982,879,262,282,1847,1829,228,2062,842,0
19:57:30,9231.851,Fox,3678,546,212,94,100,44,68,28,3678,3466,3372,2613,982,879,262,284,1847,1831,228,2062,842,0
19:57:30,9232.45,Fox,3682,549,216,92,102,43,68,28,3682,3466,3374,2613,982,879,263,286,1848,1834,228,2063,842,0
19:57:30,9233.051,Fox,3682,548,216,92,102,42,69,27,3682,3466,3374,2613,983,879,262,286,1848,1834,228,2063,843,0
19:57:30,9233.65,Fox,3682,548,216,90,102,43,70,27,3682,3466,3376,2615,984,879,262,286,1848,1834,228,2063,843,0
19:57:31,9234.551,Fox,3684,549,212,94,102,42,70,27,3682,3470,3376,2615,984,879,262,287,1849,1835,228,2064,843,0
19:57:31,9235.15,Fox,3688,548,216,92,103,41,70,24,3686,3470,3378,2615,984,879,259,289,1850,1838,228,2066,846,0
19:57:31,9235.75,Fox,3690,549,218,92,103,40,70,24,3688,3470,3378,2615,984,879,259,290,1851,1839,228,2067,846,0
19:57:32,9236.351,Fox,3690,549,218,94,103,40,70,24,3690,3472,3378,2615,984,879,259,290,1851,1839,228,2067,846,0
19:57:32,9236.65,Fox,3690,549,214,98,103,40,70,24,3690,3476,3378,2615,984,879,259,290,1851,1839,228,2067,846,0
19:57:32,9237.551,Fox,3694,551,214,100,100,42,70,23,3692,3478,3378,2617,984,879,261,290,1854,1840,228,2068,847,0
19:57:32,9238.15,Fox,3694,549,212,102,102,41,69,23,3694,3482,3380,2617,984,880,260,289,1854,1840,228,2069,848,0
19:57:33,9238.75,Fox,3696,551,210,104,102,40,70,23,3694,3484,3380,2617,985,880,261,290,1855,1841,228,2069,848,0
19:57:33,9239.351,Fox,3696,551,212,100,106,40,70,23,3696,3484,3384,2617,985,880,261,290,1855,1841,228,2069,848,0
19:57:33,9239.65,Fox,3696,551,212,100,104,42,69,24,3696,3484,3384,2619,985,881,261,290,1855,1841,228,2069,848,0
19:57:34,9240.551,Fox,3704,558,214,98,106,41,69,24,3698,3484,3386,2619,985,881,265,293,1860,1844,228,2070,848,0
19:57:34,9241.15,Fox,3706,558,218,102,104,42,69,23,3706,3488,3386,2620,985,881,265,293,1861,1845,229,2070,849,0
19:57:34,9241.75,Fox,3710,561,218,102,104,43,69,23,3708,3490,3388,2621,985,881,266,295,1863,1847,229,2071,849,0
19:57:35,9242.351,Fox,3712,563,220,102,104,43,69,23,3710,3490,3388,2621,985,881,266,297,1863,1849,229,2071,849,0
19:57:35,9242.95,Fox,3716,566,222,104,101,46,66,25,3714,3492,3388,2624,985,883,267,299,1865,1851,229,2072,849,0
19:57:35,9243.551,Fox,3718,567,226,102,103,46,63,27,3718,3492,3390,2624,985,885,268,299,1866,1852,229,2073,849,0
19:57:35,9244.15,Fox,3720,566,226,104,100,47,63,26,3720,3494,3390,2626,985,885,267,299,1867,1853,230,2074,850,0
19:57:36,9244.75,Fox,3726,568,228,106,98,46,63,25,3724,3496,3390,2626,985,885,266,302,1870,1856,230,2077,851,0
19:57:36,9245.351,Fox,3726,568,228,104,101,47,63,25,3726,3498,3394,2627,985,885,266,302,1870,1856,230,2077,851,0
19:57:36,9245.95,Fox,3728,570,220,112,103,47,63,25,3728,3508,3396,2627,985,885,267,303,1871,1857,230,2077,851,0
19:57:37,9246.551,Fox,3730,571,220,114,102,47,62,26,3730,3510,3396,2627,985,886,268,303,1873,1857,230,2078,851,0
19:57:37,9247.15,Fox,3732,572,214,116,103,49,62,26,3730,3516,3400,2629,985,886,269,303,1875,1857,230,2079,851,0
19:57:37,9247.45,Fox,3732,571,216,116,103,49,62,25,3732,3516,3400,2629,985,886,269,302,1875,1857,230,2079,852,0
19:57:38,9248.351,Fox,3736,574,212,118,101,52,62,25,3732,3520,3402,2633,985,886,271,303,1877,1859,230,2080,852,0
19:57:38,9248.95,Fox,3738,575,216,116,102,52,62,25,3736,3520,3404,2633,985,886,271,304,1878,1860,230,2081,852,0
19:57:38,9249.551,Fox,3740,575,212,122,101,52,62,24,3738,3526,3404,2633,985,886,271,304,1880,1860,230,2082,853,0
19:57:39,9250.15,Fox,3742,575,214,124,98,53,62,24,3742,3528,3404,2635,985,886,271,304,1882,1860,231,2083,853,0
19:57:39,9250.75,Fox,3744,577,208,128,102,52,63,24,3744,3536,3408,2635,986,886,272,305,1883,1861,231,2083,853,0
19:57:39,9251.65,Fox,3750,582,208,128,103,52,63,24,3746,3538,3410,2635,986,886,272,310,1884,1866,231,2084,853,0
19:57:40,9252.25,Fox,3754,584,216,126,104,51,63,24,3754,3538,3412,2635,986,886,273,311,1887,1867,231,2086,853,0
19:57:40,9253.15,Fox,3756,583,218,122,105,53,61,24,3756,3538,3416,2637,986,888,270,313,1887,1869,231,2088,854,0
19:57:40,9253.75,Fox,3760,580,222,118,107,46,65,22,3760,3538,3420,2637,990,888,268,312,1889,1871,231,2093,856,0
19:57:41,9254.65,Fox,3760,578,222,118,107,44,59,28,3760,3538,3420,2637,990,894,268,310,1889,1871,231,2095,856,0
19:57:41,9255.851,Fox,3762,577,220,122,106,43,59,27,3762,3542,3420,2637,990,894,267,310,1889,1873,231,2097,857,0
19:57:42,9256.45,Fox,3766,579,218,124,102,45,59,27,3762,3544,3420,2639,990,894,267,312,1891,1875,231,2099,857,0
19:57:42,9257.051,Fox,3766,579,216,124,108,45,59,27,3766,3550,3426,2639,990,894,267,312,1891,1875,231,2099,857,0
19:57:42,9257.65,Fox,3766,578,216,122,110,44,59,27,3766,3550,3428,2639,990,894,267,311,1891,1875,231,2100,857,0
19:57:43,9258.25,Fox,3768,579,214,120,111,46,59,27,3766,3552,3432,2641,990,894,267,312,1892,1876,231,2101,857,0
19:57:43,9258.851,Fox,3768,575,216,118,113,42,58,28,3768,3552,3434,2641,990,895,264,311,1892,1876,231,2105,857,0
19:57:43,9259.15,Fox,3768,575,216,118,113,41,59,28,3768,3552,3434,2641,991,895,264,311,1892,1876,231,2105,857,0
19:57:43,9260.051,Fox,3768,575,216,114,114,44,59,28,3768,3552,3438,2644,991,895,264,311,1892,1876,231,2105,857,0
19:57:44,9260.95,Fox,3770,575,210,120,114,41,60,28,3768,3558,3438,2644,992,895,265,310,1893,1877,231,2107,857,0
19:57:44,9261.551,Fox,3772,575,212,122,113,41,59,28,3772,3560,3438,2644,992,896,266,309,1895,1877,231,2108,858,0
19:57:45,9262.15,Fox,3776,578,214,122,111,40,59,30,3774,3560,3438,2645,994,898,267,311,1897,1879,231,2109,858,0
19:57:45,9262.75,Fox,3780,581,212,126,110,38,61,30,3776,3564,3438,2645,996,898,269,312,1900,1880,231,2110,858,0
19:57:45,9263.351,Fox,3780,580,214,128,110,36,62,30,3780,3566,3438,2645,997,898,269,311,1900,1880,231,2111,858,0
19:57:45,9263.95,Fox,3780,577,214,124,113,36,61,29,3780,3566,3442,2646,997,898,267,310,1900,1880,231,2113,859,0
19:57:46,9264.551,Fox,3782,578,214,126,110,38,61,29,3782,3568,3442,2648,997,898,267,311,1901,1881,231,2114,859,0
19:57:46,9265.15,Fox,3782,577,210,124,116,38,61,28,3782,3572,3448,2648,997,898,267,310,1901,1881,231,2114,860,0
19:57:46,9265.75,Fox,3784,578,210,124,115,38,63,28,3784,3574,3450,2650,999,898,267,311,1902,1882,231,2115,860,0
19:57:47,9266.351,Fox,3788,581,212,124,112,39,64,28,3786,3574,3450,2652,1000,898,267,314,1903,1885,231,2116,860,0
19:57:47,9266.95,Fox,3790,582,216,122,113,39,64,28,3790,3574,3452,2652,1000,898,267,315,1904,1886,231,2117,860,0
19:57:47,9267.551,Fox,3790,582,212,120,118,40,64,28,3790,3578,3458,2653,1000,898,267,315,1904,1886,231,2117,860,0
19:57:48,9268.15,Fox,3790,581,210,118,121,41,64,27,3790,3580,3462,2654,1000,898,266,315,1904,1886,231,2117,861,0
19:57:48,9268.75,Fox,3790,580,208,118,121,43,64,26,3790,3582,3464,2656,1000,898,265,315,1904,1886,231,2117,862,0
19:57:48,9269.351,Fox,3792,580,208,116,122,43,64,25,3790,3582,3466,2657,1000,898,267,313,1906,1886,231,2118,863,0
19:57:49,9269.95,Fox,3792,579,208,118,120,45,64,24,3792,3584,3466,2659,1000,898,266,313,1906,1886,231,2118,864,0
19:57:49,9270.25,Fox,3792,576,208,118,120,42,64,24,3792,3584,3466,2659,1000,898,266,310,1906,1886,231,2121,864,0
19:57:49,9271.45,Fox,3792,576,204,122,115,47,64,24,3792,3588,3466,2664,1000,898,266,310,1906,1886,231,2121,864,0
19:57:50,9272.051,Fox,3792,576,202,124,115,46,65,24,3792,3590,3466,2664,1001,898,266,310,1906,1886,231,2121,864,0
19:57:50,9272.65,Fox,3792,576,200,126,115,46,63,26,3792,3592,3466,2664,1001,900,266,310,1906,1886,231,2121,864,0
19:57:50,9273.25,Fox,3792,574,196,126,118,47,62,25,3792,3596,3470,2665,1001,900,265,309,1906,1886,231,2122,865,0
19:57:51,9274.15,Fox,3792,574,192,130,118,47,62,25,3792,3600,3470,2665,1001,900,265,309,1906,1886,231,2122,865,0
19:57:51,9274.75,Fox,3794,573,194,130,117,45,60,27,3794,3600,3470,2666,1001,902,264,309,1906,1888,231,2125,865,0
19:57:51,9275.351,Fox,3796,575,194,124,123,45,60,27,3794,3600,3476,2666,1001,902,266,309,1908,1888,231,2125,865,0
19:57:52,9275.95,Fox,3798,577,198,124,119,49,60,27,3798,3600,3476,2670,1001,902,268,309,1910,1888,231,2125,865,0
19:57:52,9276.551,Fox,3802,577,200,120,120,49,59,27,3800,3600,3480,2672,1001,902,269,308,1913,1889,231,2129,865,0
19:57:52,9277.15,Fox,3808,582,206,118,124,48,59,27,3808,3602,3484,2672,1001,902,271,311,1916,1892,231,2130,865,0
19:57:53,9277.75,Fox,3814,586,208,118,122,48,59,27,3810,3602,3484,2672,1001,902,272,314,1919,1895,231,2132,865,0
19:57:53,9278.351,Fox,3816,586,212,118,120,48,57,29,3814,3602,3484,2673,1001,904,272,314,1920,1896,231,2134,865,0
19:57:53,9278.95,Fox,3816,586,214,118,120,47,58,29,3816,3602,3484,2673,1002,904,272,314,1920,1896,231,2134,865,0
19:57:54,9279.551,Fox,3818,584,216,116,119,46,58,29,3818,3602,3486,2675,1002,904,272,312,1921,1897,231,2138,865,0
19:57:54,9279.851,Fox,3818,584,216,114,121,44,60,29,3818,3602,3488,2675,1004,904,272,312,1921,1897,231,2138,865,0
19:57:54,9280.75,Fox,3818,583,216,112,123,42,59,31,3818,3602,3490,2675,1005,906,272,311,1921,1897,232,2138,865,0
19:57:55,9281.351,Fox,3818,582,214,112,125,41,59,31,3818,3604,3492,2675,1005,906,271,311,1921,1897,232,2139,865,0
19:57:55,9281.95,Fox,3820,581,210,116,125,37,60,31,3818,3608,3492,2675,1006,906,273,308,1923,1897,232,2142,865,0
19:57:55,9282.551,Fox,3822,583,214,116,125,37,60,31,3822,3608,3492,2675,1006,906,275,308,1925,1897,232,2142,865,0
19:57:56,9283.15,Fox,3824,584,214,114,128,37,60,31,3824,3610,3496,2676,1006,906,274,310,1925,1899,232,2143,865,0
19:57:56,9283.75,Fox,3826,585,216,114,126,38,60,31,3826,3610,3496,2678,1006,906,275,310,1926,1900,232,2144,865,0
19:57:56,9284.351,Fox,3828,586,216,112,127,38,60,31,3826,3610,3498,2678,1006,906,275,311,1927,1901,232,2145,865,0
19:57:57,9284.95,Fox,3834,589,218,102,136,37,60,30,3828,3610,3508,2678,1006,906,275,314,1929,1905,232,2147,866,0
19:57:57,9285.551,Fox,3834,589,224,94,144,37,58,32,3834,3610,3516,2678,1006,908,275,314,1929,1905,232,2147,866,0
19:57:58,9286.15,Fox,3836,586,226,94,143,33,58,32,3836,3610,3516,2678,1006,908,275,311,1931,1905,232,2152,866,0
19:57:58,9287.051,Fox,3836,584,226,90,145,34,58,31,3836,3610,3520,2680,1006,908,275,309,1931,1905,232,2153,867,0
19:57:59,9287.65,Fox,3838,586,228,90,145,34,56,33,3838,3610,3520,2680,1006,910,276,310,1932,1906,232,2153,867,0
19:57:59,9288.25,Fox,3840,587,228,86,150,34,56,33,3840,3612,3526,2680,1006,910,275,312,1932,1908,232,2154,867,0
19:57:59,9288.851,Fox,3844,588,228,84,149,34,56,33,3840,3612,3528,2681,1006,910,275,313,1934,1910,232,2157,867,0
19:58:00,9289.45,Fox,3846,587,230,78,156,34,56,31,3844,3614,3536,2681,1006,910,275,312,1936,1910,232,2158,869,0
19:58:00,9290.051,Fox,3846,586,232,78,156,33,56,31,3846,3614,3536,2681,1006,910,274,312,1936,1910,232,2159,869,0
19:58:00,9290.351,Fox,3846,586,226,82,158,33,56,31,3846,3620,3538,2681,1006,910,274,312,1936,1910,232,2159,869,0
19:58:01,9291.25,Fox,3848,587,228,82,157,33,56,31,3848,3620,3538,2681,1006,910,273,314,1936,1912,232,2160,869,0
19:58:01,9291.851,Fox,3850,587,230,82,154,34,56,31,3850,3620,3538,2683,1006,910,272,315,1936,1914,232,2162,869,0
19:58:01,9292.75,Fox,3852,588,228,86,151,36,56,31,3852,3624,3538,2685,1006,910,271,317,1936,1916,232,2163,869,0
19:58:02,9293.351,Fox,3854,588,230,86,150,35,56,31,3854,3624,3538,2685,1006,910,270,318,1936,1918,232,2165,869,0
19:58:02,9293.95,Fox,3854,588,230,86,150,34,56,32,3854,3624,3538,2685,1007,911,270,318,1936,1918,232,2165,869,0
19:58:02,9294.551,Fox,3856,587,232,82,153,32,56,32,3856,3624,3542,2685,1007,911,271,316,1938,1918,232,2168,869,0
19:58:03,9295.45,Fox,3856,587,230,80,155,34,56,32,3856,3626,3546,2687,1007,911,271,316,1938,1918,232,2168,869,0
19:58:03,9296.051,Fox,3862,590,234,76,156,34,56,32,3860,3626,3550,2687,1007,911,270,320,1940,1922,232,2171,869,0
19:58:03,9296.351,Fox,3862,590,236,76,156,34,56,32,3862,3626,3550,2687,1007,911,270,320,1940,1922,232,2171,869,0
19:58:04,9296.95,Fox,3862,589,236,74,158,34,55,32,3862,3626,3552,2687,1007,911,269,320,1940,1922,232,2172,869,0
19:58:04,9297.851,Fox,3862,586,236,74,157,32,53,34,3862,3626,3552,2687,1007,913,267,319,1940,1922,232,2175,869,0
19:58:04,9298.15,Fox,3862,586,236,74,155,34,53,34,3862,3626,3552,2689,1007,913,267,319,1940,1922,232,2175,869,0
19:58:05,9299.351,Fox,3862,584,234,72,157,35,53,33,3862,3628,3556,2691,1007,913,266,318,1940,1922,232,2176,870,0
19:58:05,9299.65,Fox,3862,584,234,70,158,36,53,33,3862,3628,3558,2692,1007,913,266,318,1940,1922,232,2176,870,0
19:58:05,9300.551,Fox,3862,584,234,68,158,38,53,33,3862,3628,3560,2694,1007,913,266,318,1940,1922,232,2176,870,0
19:58:06,9301.15,Fox,3864,586,232,66,162,38,53,33,3862,3630,3564,2694,1007,913,267,319,1941,1923,232,2176,870,0
19:58:06,9301.75,Fox,3864,586,232,66,164,38,53,33,3864,3632,3566,2694,1007,913,267,319,1941,1923,232,2176,870,0
19:58:07,9302.351,Fox,3866,588,234,66,162,40,53,33,3866,3632,3566,2696,1007,913,267,321,1941,1925,232,2176,870,0
19:58:07,9303.551,Fox,3866,588,234,62,164,42,53,33,3866,3632,3570,2698,1007,913,267,321,1941,1925,232,2176,870,0
19:58:08,9304.15,Fox,3876,595,240,60,163,42,53,33,3872,3632,3572,2698,1007,913,268,327,1945,1931,232,2179,870,0
19:58:08,9304.75,Fox,3878,596,242,62,165,41,53,33,3878,3636,3574,2698,1007,913,269,327,1947,1931,232,2180,870,0
19:58:08,9305.051,Fox,3878,596,240,64,165,41,53,33,3878,3638,3574,2698,1007,913,269,327,1947,1931,232,2180,870,0
19:58:08,9305.95,Fox,3880,594,240,62,164,41,53,32,3878,3638,3576,2700,1007,913,268,326,1948,1932,232,2184,870,0
19:58:09,9306.25,Fox,3880,594,240,62,164,42,54,32,3880,3640,3578,2702,1008,913,268,326,1948,1932,232,2184,870,0
19:58:09,9307.15,Fox,3880,594,232,66,166,44,54,32,3880,3648,3582,2704,1008,913,268,326,1948,1932,232,2184,870,0
19:58:09,9307.75,Fox,3884,596,228,70,164,43,55,32,3880,3652,3582,2704,1009,913,270,326,1952,1932,232,2186,870,0
19:58:10,9308.351,Fox,3884,596,230,72,164,43,55,32,3884,3654,3582,2704,1009,913,270,326,1952,1932,232,2186,870,0
19:58:10,9308.95,Fox,3884,594,226,74,165,42,55,32,3884,3658,3584,2705,1009,913,270,324,1952,1932,234,2186,870,0
19:58:10,9309.551,Fox,3884,594,224,76,164,43,55,32,3884,3660,3584,2706,1009,913,270,324,1952,1932,234,2186,870,0
19:58:11,9310.15,Fox,3884,593,224,72,168,42,55,32,3884,3660,3588,2706,1009,913,270,323,1952,1932,234,2187,870,0
19:58:11,9310.75,Fox,3886,594,222,72,169,42,54,33,3884,3662,3590,2706,1009,914,270,324,1953,1933,234,2188,870,0
19:58:11,9311.351,Fox,3888,592,226,70,169,42,53,32,3888,3662,3592,2708,1009,915,271,321,1955,1933,234,2190,872,0
19:58:12,9311.95,Fox,3892,595,226,68,171,43,53,32,3890,3664,3596,2709,1009,915,272,323,1957,1935,234,2191,872,0
19:58:12,9312.551,Fox,3892,594,222,72,171,44,53,32,3892,3670,3598,2711,1009,915,272,322,1957,1935,234,2192,872,0
19:58:12,9313.15,Fox,3892,593,220,72,171,46,53,31,3892,3672,3600,2713,1009,915,272,321,1957,1935,234,2192,873,0
19:58:13,9313.75,Fox,3896,595,220,74,167,48,53,31,3894,3674,3600,2715,1009,915,273,322,1960,1936,234,2194,873,0
19:58:13,9314.351,Fox,3898,594,218,78,166,46,53,31,3896,3678,3600,2715,1009,915,273,321,1961,1937,234,2197,873,0
19:58:13,9314.95,Fox,3898,592,216,82,166,45,53,30,3898,3682,3600,2715,1009,915,273,319,1961,1937,234,2198,874,0
19:58:14,9315.551,Fox,3898,591,216,80,168,45,50,32,3898,3682,3602,2715,1009,917,272,319,1961,1937,234,2199,874,0
19:58:14,9316.45,Fox,3898,590,216,80,168,45,49,32,3898,3682,3602,2715,1009,917,272,318,1961,1937,234,2200,874,0
19:58:15,9317.351,Fox,3902,594,216,82,162,51,49,32,3900,3684,3602,2721,1009,917,273,321,1962,1940,234,2200,874,0
19:58:15,9317.95,Fox,3902,592,214,86,161,48,52,31,3902,3688,3602,2722,1012,917,272,320,1962,1940,234,2201,875,0
19:58:15,9318.851,Fox,3904,593,212,88,157,52,49,33,3902,3690,3602,2726,1012,919,271,322,1962,1942,234,2202,875,0
19:58:15,9319.45,Fox,3904,592,214,88,157,51,47,35,3904,3690,3602,2726,1012,921,271,321,1962,1942,234,2203,875,0
19:58:16,9320.051,Fox,3906,592,214,88,158,48,49,35,3906,3692,3604,2726,1014,921,271,321,1963,1943,234,2205,875,0
19:58:16,9320.65,Fox,3906,592,212,86,160,50,49,35,3906,3694,3608,2728,1014,921,271,321,1963,1943,234,2205,875,0
19:58:16,9320.95,Fox,3906,591,212,86,160,50,48,35,3906,3694,3608,2728,1014,921,271,320,1963,1943,234,2206,875,0
19:58:17,9321.851,Fox,3906,589,210,86,162,48,48,35,3906,3696,3610,2728,1014,921,271,318,1963,1943,234,2208,875,0
19:58:17,9322.45,Fox,3908,588,210,86,161,46,46,37,3906,3696,3610,2728,1014,923,269,319,1964,1944,234,2211,875,0
19:58:18,9323.051,Fox,3910,587,210,88,160,43,47,37,3908,3698,3610,2728,1015,923,269,318,1965,1945,234,2214,875,0
19:58:18,9323.65,Fox,3910,585,204,96,160,41,47,37,3910,3706,3610,2728,1015,923,269,316,1965,1945,234,2216,875,0
19:58:18,9324.25,Fox,3912,584,204,98,159,39,48,36,3912,3708,3610,2729,1016,923,269,315,1966,1946,234,2218,876,0
19:58:18,9324.551,Fox,3912,584,202,100,159,39,48,36,3912,3710,3610,2729,1016,923,269,315,1966,1946,234,2218,876,0
19:58:19,9325.45,Fox,3912,584,198,104,154,44,48,36,3912,3714,3610,2734,1016,923,269,315,1966,1946,234,2218,876,0
19:58:19,9326.051,Fox,3914,583,194,108,153,44,48,34,3912,3718,3610,2735,1016,923,267,316,1966,1948,234,2219,878,0
19:58:20,9326.65,Fox,3918,586,194,110,152,44,48,34,3914,3720,3610,2735,1016,923,269,317,1969,1949,234,2220,878,0
19:58:20,9327.25,Fox,3918,586,194,112,153,44,49,34,3918,3724,3612,2736,1017,923,269,317,1969,1949,234,2220,878,0
19:58:20,9327.851,Fox,3926,587,198,112,147,45,49,34,3924,3726,3614,2742,1017,923,267,320,1971,1955,237,2224,878,0
19:58:21,9328.45,Fox,3930,590,200,114,143,48,49,34,3928,3728,3614,2745,1017,923,268,322,1973,1957,238,2224,878,0
19:58:21,9329.051,Fox,3934,588,204,110,147,46,48,33,3934,3730,3620,2745,1017,923,265,323,1973,1961,238,2229,879,0
19:58:21,9329.65,Fox,3936,587,206,110,145,45,48,33,3936,3730,3620,2746,1017,923,266,321,1975,1961,238,2232,879,0
19:58:22,9330.25,Fox,3942,590,210,112,142,45,48,33,3942,3732,3620,2746,1017,923,266,324,1978,1964,238,2235,879,0
19:58:22,9331.15,Fox,3946,591,210,112,145,42,49,33,3946,3736,3624,2746,1018,923,268,323,1982,1964,238,2238,879,0
19:58:23,9331.75,Fox,3950,593,210,114,144,42,49,32,3948,3738,3624,2746,1018,923,267,326,1983,1967,238,2239,880,0
19:58:23,9332.351,Fox,3950,593,210,116,144,42,49,32,3950,3740,3624,2746,1018,923,267,326,1983,1967,238,2239,880,0
19:58:23,9332.95,Fox,3952,594,208,118,143,42,48,33,3950,3742,3624,2746,1018,924,267,327,1984,1968,238,2240,880,0
19:58:24,9333.551,Fox,3954,595,210,120,139,46,46,34,3954,3744,3624,2750,1018,926,267,328,1984,1970,238,2240,881,0
19:58:24,9334.15,Fox,3954,593,208,120,141,46,46,32,3954,3746,3626,2750,1018,926,266,327,1984,1970,238,2240,883,0
19:58:24,9334.75,Fox,3960,594,200,128,140,43,46,31,3954,3754,3626,2750,1018,926,264,330,1986,1974,238,2244,884,0
19:58:25,9335.351,Fox,3966,597,208,128,137,44,46,30,3962,3754,3626,2751,1018,926,263,334,1988,1978,238,2246,885,0
19:58:25,9335.95,Fox,3968,593,212,130,134,41,46,30,3968,3756,3626,2753,1018,926,263,330,1989,1979,238,2252,885,0
19:58:26,9336.551,Fox,3976,595,210,134,128,43,46,28,3970,3760,3626,2755,1018,926,263,332,1993,1983,238,2256,887,0
19:58:26,9337.15,Fox,3982,599,220,134,123,46,45,29,3980,3760,3626,2758,1018,927,262,337,1994,1988,238,2258,887,0
19:58:26,9337.75,Fox,3988,602,226,132,122,46,45,29,3986,3760,3628,2759,1018,927,263,339,1997,1991,238,2261,887,0
19:58:27,9338.351,Fox,3990,598,226,134,121,41,45,29,3988,3762,3628,2759,1018,927,263,335,1998,1992,238,2267,887,0
19:58:27,9338.95,Fox,3990,596,228,134,121,39,44,30,3990,3762,3628,2759,1018,928,263,333,1998,1992,238,2269,887,0
19:58:27,9339.551,Fox,3992,596,224,136,123,39,44,28,3990,3766,3630,2759,1018,928,262,334,1999,1993,238,2269,889,0
19:58:28,9340.15,Fox,3994,595,228,136,118,43,43,27,3994,3766,3630,2763,1018,928,261,334,1999,1995,238,2271,890,0
19:58:28,9340.75,Fox,3994,595,228,134,118,44,44,27,3994,3766,3632,2765,1019,928,261,334,1999,1995,238,2271,890,0
19:58:28,9341.051,Fox,3994,595,226,136,118,44,44,27,3994,3768,3632,2765,1019,928,261,334,1999,1995,238,2271,890,0
19:58:29,9341.95,Fox,3998,597,228,136,116,44,44,27,3996,3768,3632,2765,1019,928,260,337,2000,1998,238,2273,890,0
19:58:29,9342.25,Fox,3998,597,230,136,116,44,44,27,3998,3768,3632,2765,1019,928,260,337,2000,1998,238,2273,890,0
19:58:30,9343.45,Fox,4004,601,230,132,116,46,44,27,3998,3768,3636,2767,1019,928,262,339,2004,2000,238,2275,890,0
19:58:30,9344.051,Fox,4004,597,232,134,118,42,44,27,4004,3772,3638,2767,1019,928,260,337,2004,2000,238,2279,890,0
19:58:30,9344.65,Fox,4008,599,232,136,116,43,44,26,4006,3774,3638,2768,1019,928,259,340,2004,2004,238,2280,891,0
19:58:31,9345.25,Fox,4010,600,234,136,110,50,44,26,4010,3776,3640,2775,1019,928,260,340,2006,2004,238,2281,891,0
19:58:31,9345.851,Fox,4010,599,230,132,111,56,44,26,4010,3780,3648,2782,1019,928,260,339,2006,2004,238,2282,891,0
19:58:31,9346.45,Fox,4012,597,232,128,114,54,44,25,4012,3780,3652,2782,1019,928,259,338,2007,2005,238,2285,892,0
19:58:32,9347.051,Fox,4012,596,230,128,114,56,43,25,4012,3782,3654,2784,1019,929,258,338,2007,2005,238,2285,893,0
19:58:32,9347.65,Fox,4016,597,232,124,116,55,43,25,4014,3782,3658,2785,1019,929,260,337,2010,2006,238,2288,893,0
19:58:32,9348.25,Fox,4020,599,234,124,117,54,43,25,4018,3784,3660,2785,1019,929,261,338,2012,2008,238,2290,893,0
19:58:33,9348.851,Fox,4020,599,234,126,113,58,42,26,4020,3786,3660,2789,1019,930,261,338,2012,2008,238,2290,893,0
19:58:33,9349.45,Fox,4020,599,230,128,110,63,42,26,4020,3790,3662,2794,1019,930,261,338,2012,2008,238,2290,893,0
19:58:33,9350.051,Fox,4022,601,230,128,109,62,42,28,4020,3790,3662,2795,1021,932,261,340,2012,2010,238,2290,893,0
19:58:34,9350.65,Fox,4026,602,236,126,109,61,42,28,4026,3790,3664,2797,1021,932,260,342,2013,2013,239,2292,893,0
19:58:34,9351.25,Fox,4036,607,240,120,112,59,42,28,4030,3790,3670,2797,1021,932,264,343,2020,2016,239,2297,893,0
19:58:34,9351.551,Fox,4036,606,246,118,114,57,44,27,4036,3790,3672,2797,1023,932,263,343,2020,2016,239,2297,894,0
19:58:35,9352.45,Fox,4036,606,244,118,116,57,44,27,4036,3792,3674,2797,1023,932,263,343,2020,2016,239,2297,894,0
19:58:35,9353.051,Fox,4038,608,246,114,120,57,44,27,4038,3792,3678,2797,1023,932,263,345,2020,2018,239,2297,894,0
19:58:36,9353.65,Fox,4042,610,248,110,122,57,44,27,4040,3792,3682,2797,1023,932,262,348,2021,2021,239,2299,894,0
19:58:36,9354.25,Fox,4044,610,250,110,122,55,44,27,4042,3792,3682,2797,1023,932,262,348,2022,2022,239,2301,894,0
19:58:36,9354.851,Fox,4044,608,252,110,121,55,44,26,4044,3792,3682,2798,1023,932,261,347,2022,2022,239,2302,895,0
19:58:37,9355.75,Fox,4044,604,252,110,118,53,45,26,4044,3792,3682,2801,1024,932,259,345,2022,2022,239,2306,895,0
19:58:37,9356.351,Fox,4044,599,252,106,119,52,45,25,4044,3792,3686,2804,1024,932,258,341,2022,2022,239,2310,896,0
19:58:37,9356.65,Fox,4044,599,252,104,121,52,43,27,4044,3792,3688,2804,1024,934,258,341,2022,2022,239,2310,896,0
19:58:38,9357.551,Fox,4046,601,252,104,122,53,43,27,4046,3794,3690,2805,1024,934,259,342,2023,2023,239,2310,896,0
19:58:38,9358.15,Fox,4048,600,250,106,122,50,43,27,4046,3796,3690,2805,1025,934,257,343,2023,2025,239,2313,896,0
19:58:38,9358.75,Fox,4048,599,250,106,124,50,43,26,4048,3798,3692,2805,1025,934,257,342,2023,2025,239,2314,896,0
19:58:39,9359.351,Fox,4050,597,248,108,125,46,45,25,4050,3802,3694,2805,1027,934,257,340,2024,2026,239,2317,897,0
19:58:39,9359.95,Fox,4050,592,242,114,122,44,45,25,4050,3808,3694,2808,1027,934,257,335,2024,2026,239,2322,897,0
19:58:40,9360.551,Fox,4050,591,236,118,123,44,45,25,4050,3814,3696,2809,1027,934,257,334,2024,2026,239,2323,897,0
19:58:40,9361.15,Fox,4050,589,234,120,123,42,44,26,4050,3816,3696,2809,1027,935,257,332,2024,2026,239,2325,897,0
19:58:40,9361.75,Fox,4052,590,234,118,120,45,45,26,4050,3816,3698,2813,1028,935,257,333,2025,2027,239,2326,897,0
19:58:41,9362.351,Fox,4052,590,234,112,126,47,45,26,4052,3818,3706,2815,1028,935,257,333,2025,2027,239,2326,897,0
19:58:41,9363.25,Fox,4052,590,234,108,130,47,45,26,4052,3818,3710,2815,1028,935,257,333,2025,2027,239,2326,897,0
19:58:42,9363.851,Fox,4054,592,234,106,129,49,46,26,4052,3818,3712,2818,1029,935,257,335,2025,2029,239,2326,897,0
19:58:42,9364.45,Fox,4056,594,236,102,132,50,46,26,4054,3818,3716,2819,1029,935,259,335,2027,2029,239,2326,897,0
19:58:42,9365.051,Fox,4058,594,234,104,132,49,45,28,4056,3822,3718,2820,1030,937,259,335,2028,2030,239,2328,897,0
19:58:43,9365.65,Fox,4060,594,236,104,133,49,44,28,4060,3824,3720,2820,1030,938,260,334,2030,2030,239,2329,898,0
19:58:43,9366.25,Fox,4060,592,234,100,139,47,44,28,4060,3826,3726,2820,1030,938,260,332,2030,2030,239,2331,898,0
19:58:43,9366.551,Fox,4060,589,234,100,137,48,44,26,4060,3826,3726,2822,1030,938,260,329,2030,2030,239,2332,900,0
19:58:44,9367.45,Fox,4062,590,234,100,134,52,43,27,4062,3828,3728,2826,1030,939,260,330,2031,2031,239,2333,900,0
19:58:44,9367.75,Fox,4062,589,228,104,136,51,43,27,4062,3834,3730,2826,1030,939,260,329,2031,2031,239,2334,900,0
19:58:45,9368.95,Fox,4062,588,226,104,138,51,43,26,4062,3836,3732,2826,1030,939,260,328,2031,2031,239,2334,901,0
19:58:45,9369.551,Fox,4064,588,228,104,137,51,43,25,4064,3836,3732,2826,1030,939,259,329,2032,2032,239,2335,902,0
19:58:45,9370.15,Fox,4066,587,228,102,138,51,43,25,4066,3838,3736,2828,1030,939,259,328,2033,2033,239,2338,902,0
19:58:46,9370.75,Fox,4066,585,226,102,138,52,42,25,4066,3840,3738,2830,1030,940,259,326,2033,2033,239,2339,903,0
19:58:46,9371.351,Fox,4066,582,226,98,140,53,39,26,4066,3840,3742,2832,1030,941,259,323,2033,2033,239,2342,903,0
19:58:46,9371.95,Fox,4066,579,222,100,139,53,39,26,4066,3844,3744,2835,1030,941,259,320,2033,2033,239,2345,903,0
19:58:47,9372.551,Fox,4068,578,222,102,138,51,39,26,4068,3846,3744,2835,1030,941,259,319,2034,2034,239,2348,903,0
19:58:47,9373.15,Fox,4070,579,222,96,142,53,39,25,4068,3846,3750,2837,1030,941,260,319,2036,2034,239,2349,903,0
19:58:47,9373.75,Fox,4070,579,222,94,146,53,39,25,4070,3848,3754,2837,1030,941,260,319,2036,2034,239,2349,903,0
19:58:48,9374.351,Fox,4072,577,222,94,148,49,39,25,4072,3850,3756,2837,1030,941,258,319,2036,2036,239,2353,903,0
19:58:48,9374.95,Fox,4072,576,222,90,152,48,39,25,4072,3850,3760,2837,1030,941,258,318,2036,2036,239,2354,903,0
19:58:48,9375.25,Fox,4072,574,220,92,152,47,39,24,4072,3852,3760,2837,1030,941,257,317,2036,2036,239,2356,903,0
19:58:49,9376.15,Fox,4076,576,222,94,148,49,39,24,4076,3854,3760,2839,1030,941,257,319,2038,2038,239,2358,903,0
19:58:49,9377.051,Fox,4076,573,220,94,150,47,39,23,4076,3856,3762,2839,1030,941,257,316,2038,2038,239,2360,904,0
19:58:50,9377.95,Fox,4076,569,220,90,154,43,39,23,4076,3856,3766,2839,1030,941,257,312,2038,2038,239,2364,904,0
19:58:50,9378.551,Fox,4078,570,218,94,153,43,39,23,4078,3860,3766,2839,1030,941,256,314,2038,2040,239,2365,904,0
19:58:51,9378.851,Fox,4078,570,216,96,153,43,39,23,4078,3862,3766,2839,1030,941,256,314,2038,2040,239,2365,904,0
19:58:51,9379.75,Fox,4080,568,216,94,154,41,39,22,4078,3862,3768,2839,1030,941,253,315,2039,2041,239,2369,904,0
19:58:51,9380.351,Fox,4080,567,218,94,153,42,39,21,4080,3862,3768,2840,1030,941,252,315,2039,2041,239,2369,905,0
19:58:52,9380.95,Fox,4080,565,218,94,150,43,39,21,4080,3862,3768,2843,1030,941,252,313,2039,2041,239,2371,905,0
19:58:52,9381.551,Fox,4084,565,220,94,148,41,39,21,4082,3862,3768,2843,1030,941,252,313,2042,2042,239,2375,905,0
19:58:52,9382.15,Fox,4084,563,222,94,146,41,39,21,4084,3862,3768,2845,1030,941,252,311,2042,2042,239,2377,905,0
19:58:53,9382.75,Fox,4084,561,222,90,150,39,39,21,4084,3862,3772,2845,1030,941,251,310,2042,2042,239,2379,905,0
19:58:54,9383.65,Fox,4086,561,224,86,154,37,39,21,4086,3862,3776,2845,1030,941,253,308,2044,2042,239,2381,905,0
19:58:54,9384.25,Fox,4088,561,222,84,157,37,39,20,4086,3864,3780,2845,1030,941,252,309,2044,2044,239,2382,906,0
19:58:54,9384.851,Fox,4092,563,226,86,155,37,39,20,4092,3866,3780,2845,1030,941,251,312,2045,2047,239,2384,906,0
19:58:54,9385.15,Fox,4092,563,226,86,155,36,40,20,4092,3866,3780,2845,1031,941,251,312,2045,2047,239,2384,906,0
19:58:55,9386.051,Fox,4094,563,226,84,156,34,41,20,4092,3866,3782,2845,1033,941,251,312,2046,2048,239,2386,906,0
19:58:55,9386.65,Fox,4094,561,222,90,156,32,41,20,4094,3872,3782,2845,1033,941,251,310,2046,2048,239,2388,906,0
19:58:56,9387.25,Fox,4094,560,216,94,156,34,41,19,4094,3878,3784,2847,1033,941,251,309,2046,2048,239,2388,907,0
19:58:56,9387.851,Fox,4094,560,216,90,160,34,41,19,4094,3878,3788,2847,1033,941,251,309,2046,2048,239,2388,907,0
19:58:56,9388.15,Fox,4094,560,216,88,162,34,41,19,4094,3878,3790,2847,1033,941,251,309,2046,2048,239,2388,907,0
19:58:56,9388.75,Fox,4094,560,214,90,162,34,41,19,4094,3880,3790,2847,1033,941,251,309,2046,2048,239,2388,907,0
19:58:57,9389.65,Fox,4098,560,214,90,159,36,41,16,4094,3880,3790,2849,1033,941,252,308,2049,2049,239,2390,909,0
19:58:57,9390.25,Fox,4102,563,218,90,159,36,40,16,4098,3880,3790,2849,1033,941,252,311,2050,2052,239,2391,909,0
19:58:58,9390.851,Fox,4102,562,218,92,161,35,40,16,4102,3884,3792,2849,1033,941,251,311,2050,2052,239,2392,909,0
19:58:58,9391.45,Fox,4102,561,218,92,158,37,36,20,4102,3884,3792,2852,1033,945,251,310,2050,2052,239,2393,909,0
19:58:58,9392.051,Fox,4102,559,218,92,158,35,36,20,4102,3884,3792,2852,1033,945,249,310,2050,2052,239,2395,909,0
19:58:59,9392.95,Fox,4102,557,218,92,158,31,38,20,4102,3884,3792,2852,1035,945,249,308,2050,2052,239,2397,909,0
19:58:59,9393.551,Fox,4104,557,218,94,157,31,38,19,4104,3886,3792,2852,1035,945,248,309,2051,2053,239,2399,909,0
19:59:00,9394.15,Fox,4106,557,216,96,156,30,38,19,4104,3888,3792,2852,1035,945,248,309,2052,2054,239,2401,909,0
19:59:00,9394.75,Fox,4110,559,216,100,154,30,38,19,4108,3892,3792,2852,1035,945,248,311,2054,2056,239,2403,909,0
19:59:00,9395.351,Fox,4114,562,220,100,153,30,38,19,4112,3892,3792,2852,1035,945,250,312,2057,2057,239,2404,909,0
19:59:00,9395.95,Fox,4114,562,222,98,155,30,38,19,4114,3892,3794,2852,1035,945,250,312,2057,2057,239,2404,909,0
19:59:01,9396.551,Fox,4114,561,218,102,155,29,38,19,4114,3896,3794,2852,1035,945,250,311,2057,2057,239,2405,909,0
19:59:01,9397.15,Fox,4118,564,218,100,158,29,37,20,4116,3898,3798,2852,1035,946,250,314,2058,2060,239,2406,909,0
19:59:02,9397.75,Fox,4120,563,220,98,159,27,37,20,4118,3898,3800,2852,1035,946,249,314,2058,2062,239,2409,909,0
19:59:02,9398.351,Fox,4120,563,222,90,166,28,36,21,4120,3898,3808,2853,1035,947,249,314,2058,2062,239,2409,909,0
19:59:02,9399.25,Fox,4122,564,222,84,171,28,36,21,4120,3898,3814,2853,1035,947,249,315,2059,2063,239,2410,909,0
19:59:03,9399.851,Fox,4124,563,224,84,172,25,37,21,4124,3900,3816,2854,1037,948,249,314,2060,2064,239,2412,910,0
19:59:03,9400.15,Fox,4124,562,222,86,172,25,36,21,4124,3902,3816,2854,1037,948,249,313,2060,2064,239,2413,910,0
19:59:04,9401.051,Fox,4126,563,224,84,171,26,36,22,4126,3902,3818,2856,1038,949,250,313,2062,2064,239,2414,910,0
19:59:04,9401.65,Fox,4130,566,224,86,170,26,36,22,4128,3904,3818,2856,1038,949,252,314,2065,2065,239,2415,910,0
19:59:04,9402.25,Fox,4134,565,226,86,168,23,36,22,4130,3904,3818,2856,1038,949,252,313,2067,2067,239,2420,910,0
19:59:04,9402.551,Fox,4134,565,228,88,168,23,36,22,4134,3906,3818,2856,1038,949,252,313,2067,2067,239,2420,910,0
19:59:05,9403.75,Fox,4134,565,228,84,171,24,33,25,4134,3906,3822,2857,1038,952,252,313,2067,2067,239,2420,910,0
19:59:05,9404.351,Fox,4134,565,228,82,171,26,33,25,4134,3906,3824,2859,1038,952,252,313,2067,2067,239,2420,910,0
19:59:06,9404.95,Fox,4136,566,230,80,172,26,33,25,4136,3906,3826,2859,1038,952,252,314,2068,2068,239,2421,910,0
19:59:06,9405.25,Fox,4136,566,228,82,170,28,33,25,4136,3908,3826,2861,1038,952,252,314,2068,2068,239,2421,910,0
19:59:06,9406.15,Fox,4138,568,228,82,165,35,33,25,4138,3910,3828,2868,1038,952,253,315,2069,2069,239,2421,910,0
19:59:07,9406.75,Fox,4138,568,226,78,167,39,33,25,4138,3912,3834,2872,1038,952,253,315,2069,2069,239,2421,910,0
19:59:07,9407.351,Fox,4144,571,230,76,166,39,33,25,4142,3912,3836,2873,1038,952,253,318,2072,2072,239,2424,910,0
19:59:07,9407.95,Fox,4146,572,232,76,162,42,33,25,4144,3912,3836,2876,1038,952,252,320,2072,2074,240,2424,910,0
19:59:08,9408.551,Fox,4148,572,234,76,159,43,33,25,4146,3912,3836,2878,1038,952,251,321,2072,2076,240,2426,910,0
19:59:08,9409.15,Fox,4154,577,240,76,160,43,33,25,4154,3914,3838,2878,1038,952,254,323,2076,2078,240,2427,910,0
19:59:08,9409.75,Fox,4154,577,236,78,160,45,32,26,4154,3918,3840,2880,1038,953,254,323,2076,2078,240,2427,910,0
19:59:09,9410.65,Fox,4160,579,232,82,161,44,32,26,4158,3926,3844,2880,1038,953,256,323,2081,2079,240,2431,910,0
19:59:09,9411.25,Fox,4164,578,232,84,159,43,33,25,4162,3930,3846,2883,1039,953,257,321,2084,2080,240,2435,911,0
19:59:10,9411.851,Fox,4164,578,230,88,154,48,33,25,4164,3934,3846,2888,1039,953,257,321,2084,2080,240,2435,911,0
19:59:10,9412.45,Fox,4166,578,228,88,155,48,32,25,4164,3936,3848,2888,1039,953,257,321,2085,2081,240,2437,911,0
19:59:11,9413.051,Fox,4170,581,226,92,155,50,31,25,4168,3942,3850,2890,1039,953,260,321,2088,2082,240,2438,911,0
19:59:11,9413.65,Fox,4172,581,226,96,152,52,31,24,4172,3946,3850,2892,1039,953,259,322,2088,2084,240,2439,912,0
19:59:11,9414.25,Fox,4176,583,224,96,150,54,31,24,4172,3948,3852,2895,1039,953,260,323,2090,2086,240,2441,912,0
19:59:12,9414.851,Fox,4178,581,228,96,152,51,31,23,4178,3950,3854,2895,1039,953,260,321,2091,2087,240,2444,913,0
19:59:12,9415.75,Fox,4180,580,228,96,153,49,31,23,4180,3952,3856,2895,1039,953,259,321,2091,2089,240,2447,913,0
19:59:12,9416.351,Fox,4180,573,226,98,152,45,31,21,4180,3954,3856,2896,1039,953,256,317,2091,2089,240,2452,915,0
19:59:13,9416.95,Fox,4180,572,226,98,149,47,30,22,4180,3954,3856,2899,1039,954,255,317,2091,2089,240,2453,915,0
19:59:13,9417.551,Fox,4180,571,220,98,154,47,28,24,4180,3960,3862,2900,1039,956,255,316,2091,2089,240,2454,915,0
19:59:13,9418.15,Fox,4180,569,214,104,154,45,28,24,4180,3966,3862,2900,1039,956,255,314,2091,2089,240,2456,915,0
19:59:14,9418.45,Fox,4180,569,212,106,154,45,28,24,4180,3968,3862,2900,1039,956,255,314,2091,2089,240,2456,915,0
19:59:14,9419.351,Fox,4180,569,204,114,152,47,27,25,4180,3976,3862,2902,1039,957,255,314,2091,2089,240,2456,915,0
19:59:14,9419.95,Fox,4182,570,200,120,151,47,27,25,4182,3982,3862,2902,1039,957,255,315,2092,2090,240,2457,915,0
19:59:15,9420.551,Fox,4186,571,194,126,147,49,27,24,4182,3988,3862,2904,1039,957,255,316,2095,2091,240,2459,916,0
19:59:15,9421.15,Fox,4186,570,196,128,147,49,27,23,4186,3990,3862,2904,1039,957,255,315,2095,2091,240,2459,917,0
19:59:15,9421.75,Fox,4186,568,196,128,147,46,28,23,4186,3990,3862,2904,1040,957,254,314,2095,2091,240,2461,917,0
19:59:16,9422.351,Fox,4190,565,194,130,139,46,29,23,4186,3992,3862,2910,1041,957,252,313,2096,2094,240,2468,917,0
19:59:16,9422.95,Fox,4196,568,200,130,137,47,29,23,4194,3994,3864,2911,1041,957,251,317,2098,2098,240,2471,917,0
19:59:16,9423.551,Fox,4196,566,202,128,136,48,29,23,4196,3994,3866,2914,1041,957,251,315,2098,2098,240,2473,917,0
19:59:17,9424.15,Fox,4196,564,202,128,134,48,29,23,4196,3994,3866,2916,1041,957,251,313,2098,2098,240,2475,917,0
19:59:17,9424.75,Fox,4196,560,198,132,132,47,29,22,4196,3998,3866,2918,1041,957,251,309,2098,2098,240,2478,918,0
19:59:17,9425.351,Fox,4198,561,198,126,137,47,29,22,4196,3998,3872,2919,1041,957,251,310,2099,2099,240,2479,918,0
19:59:18,9425.95,Fox,4202,563,202,120,140,48,29,22,4200,3998,3878,2921,1041,957,251,312,2101,2101,240,2481,918,0
19:59:18,9426.551,Fox,4202,563,198,126,135,53,29,22,4202,4004,3878,2926,1041,957,251,312,2101,2101,240,2481,918,0
19:59:18,9427.15,Fox,4206,563,198,128,134,50,29,22,4204,4006,3878,2926,1041,957,253,310,2104,2102,240,2485,918,0
19:59:19,9427.75,Fox,4206,562,196,130,135,50,29,22,4206,4010,3880,2927,1041,957,253,309,2104,2102,240,2486,918,0
19:59:19,9428.351,Fox,4210,564,200,130,132,51,29,22,4210,4010,3880,2929,1041,957,253,311,2105,2105,240,2488,918,0
19:59:19,9429.25,Fox,4210,563,198,128,134,53,29,21,4210,4012,3884,2931,1041,957,253,310,2105,2105,240,2488,919,0
19:59:20,9430.15,Fox,4210,561,196,130,132,54,29,20,4210,4014,3884,2933,1041,957,253,308,2105,2105,240,2489,920,0
19:59:20,9430.75,Fox,4212,562,194,134,130,54,30,20,4212,4018,3884,2934,1042,957,253,309,2106,2106,240,2490,920,0
19:59:20,9431.051,Fox,4212,562,192,136,130,54,30,20,4212,4020,3884,2934,1042,957,253,309,2106,2106,240,2490,920,0
19:59:21,9431.65,Fox,4212,562,192,136,129,55,29,21,4212,4020,3884,2935,1042,958,253,309,2106,2106,240,2490,920,0
19:59:21,9432.551,Fox,4212,561,192,132,132,55,29,21,4212,4020,3888,2936,1042,958,253,308,2106,2106,240,2491,920,0
19:59:21,9433.15,Fox,4214,558,188,136,132,52,29,21,4214,4026,3890,2937,1042,958,253,305,2108,2106,241,2495,920,0
19:59:22,9433.75,Fox,4214,557,184,138,126,56,32,21,4214,4030,3892,2945,1045,958,253,304,2108,2106,241,2496,920,0
19:59:22,9434.351,Fox,4216,556,178,144,125,54,32,21,4214,4036,3892,2945,1045,958,251,305,2108,2108,241,2499,920,0
19:59:22,9434.95,Fox,4220,556,182,142,124,54,32,20,4218,4036,3894,2947,1045,958,251,305,2110,2110,241,2502,921,0
19:59:23,9435.551,Fox,4222,554,182,142,122,54,32,20,4220,4038,3896,2950,1045,958,250,304,2110,2112,241,2506,921,0
19:59:23,9436.15,Fox,4222,552,182,142,124,52,32,20,4222,4040,3898,2950,1045,958,249,303,2110,2112,241,2508,921,0
19:59:23,9436.75,Fox,4222,549,180,144,124,48,33,20,4222,4042,3898,2950,1046,958,247,302,2110,2112,241,2511,921,0
19:59:24,9437.351,Fox,4226,550,182,146,121,48,33,20,4226,4044,3898,2952,1046,958,248,302,2112,2114,241,2514,921,0
19:59:24,9437.95,Fox,4228,550,184,146,120,47,33,20,4228,4044,3898,2952,1046,958,247,303,2112,2116,241,2516,921,0
19:59:24,9438.551,Fox,4228,550,184,144,120,48,34,20,4228,4044,3900,2954,1047,958,247,303,2112,2116,241,2516,921,0
19:59:25,9439.15,Fox,4230,551,186,142,121,48,34,20,4230,4044,3902,2954,1047,958,246,305,2112,2118,241,2517,921,0
19:59:25,9439.75,Fox,4236,554,188,142,120,44,36,20,4232,4044,3902,2954,1049,958,247,307,2116,2120,241,2520,921,0
19:59:25,9440.351,Fox,4238,555,192,142,120,45,36,20,4238,4046,3904,2955,1049,958,246,309,2116,2122,241,2521,921,0
19:59:25,9440.95,Fox,4238,553,190,144,120,41,38,20,4238,4048,3904,2955,1051,958,246,307,2116,2122,242,2522,921,0
19:59:26,9441.25,Fox,4238,552,190,142,122,40,38,20,4238,4048,3906,2955,1051,958,246,306,2116,2122,242,2523,921,0
19:59:26,9442.15,Fox,4240,552,188,144,121,40,38,19,4238,4050,3906,2955,1051,958,245,307,2116,2124,242,2524,922,0
19:59:26,9442.75,Fox,4246,554,192,144,119,39,38,18,4242,4050,3906,2956,1051,958,245,309,2118,2128,242,2527,923,0
19:59:27,9443.351,Fox,4248,555,196,144,116,41,38,18,4246,4050,3906,2958,1051,958,244,311,2118,2130,242,2528,923,0
19:59:27,9443.95,Fox,4248,550,198,142,116,38,38,18,4248,4050,3908,2960,1051,958,244,306,2118,2130,242,2533,923,0
19:59:27,9444.551,Fox,4252,550,198,142,115,38,38,17,4250,4052,3910,2962,1051,958,242,308,2119,2133,243,2535,924,0
19:59:28,9445.15,Fox,4254,549,202,142,114,36,38,17,4254,4052,3910,2962,1051,958,242,307,2120,2134,243,2538,924,0
19:59:28,9445.75,Fox,4256,546,204,140,115,33,36,18,4256,4052,3912,2962,1051,959,239,307,2120,2136,243,2543,924,0
19:59:28,9446.051,Fox,4256,546,204,140,113,35,36,18,4256,4052,3912,2964,1051,959,239,307,2120,2136,243,2543,924,0
19:59:28,9446.95,Fox,4258,547,202,142,112,35,36,18,4256,4054,3912,2964,1051,959,239,308,2121,2137,243,2544,924,0
19:59:29,9447.551,Fox,4260,548,202,142,113,35,36,18,4258,4056,3914,2965,1051,959,238,310,2121,2139,243,2545,924,0
19:59:29,9448.15,Fox,4264,547,202,142,111,37,36,17,4262,4060,3918,2969,1051,959,236,311,2122,2142,243,2549,925,0
19:59:29,9448.75,Fox,4268,547,206,142,108,36,36,17,4266,4060,3918,2970,1051,959,235,312,2123,2145,243,2553,925,0
19:59:30,9449.351,Fox,4268,547,208,134,116,36,36,17,4268,4060,3926,2970,1051,959,235,312,2123,2145,243,2553,925,0
19:59:30,9449.95,Fox,4268,547,206,132,120,34,38,17,4268,4062,3930,2970,1053,959,235,312,2123,2145,243,2553,925,0
19:59:30,9450.551,Fox,4268,546,206,128,124,33,38,17,4268,4062,3934,2970,1053,959,235,311,2123,2145,243,2554,925,0
19:59:31,9451.15,Fox,4272,547,210,126,124,33,38,16,4272,4062,3936,2970,1053,959,234,313,2125,2147,243,2556,926,0
19:59:31,9451.75,Fox,4274,549,210,120,130,33,38,16,4272,4062,3942,2970,1053,959,235,314,2126,2148,243,2556,926,0
19:59:31,9452.351,Fox,4274,549,210,118,134,33,38,16,4274,4064,3946,2970,1053,959,235,314,2126,2148,243,2556,926,0
19:59:32,9452.95,Fox,4274,548,208,118,136,33,38,15,4274,4066,3948,2970,1053,959,235,313,2126,2148,243,2556,927,0
19:59:32,9453.551,Fox,4274,546,208,116,138,31,38,15,4274,4066,3950,2970,1053,959,234,312,2126,2148,243,2558,927,0
19:59:32,9454.15,Fox,4276,548,210,116,138,31,38,15,4276,4066,3950,2970,1053,959,235,313,2127,2149,243,2558,927,0
19:59:33,9454.75,Fox,4276,546,210,112,142,29,38,15,4276,4066,3954,2970,1053,959,235,311,2127,2149,243,2560,927,0
19:59:33,9455.351,Fox,4278,545,208,114,141,26,39,15,4276,4068,3954,2970,1054,959,233,312,2127,2151,243,2563,927,0
19:59:33,9455.95,Fox,4278,545,208,116,141,26,36,18,4278,4070,3954,2970,1054,962,233,312,2127,2151,243,2563,927,0
19:59:34,9456.551,Fox,4278,544,208,108,147,27,36,18,4278,4070,3962,2972,1054,962,233,311,2127,2151,244,2563,927,0
19:59:34,9457.15,Fox,4278,544,206,104,152,28,36,18,4278,4072,3968,2973,1054,962,233,311,2127,2151,244,2563,927,0
19:59:34,9457.75,Fox,4280,544,208,102,153,27,34,20,4280,4072,3970,2974,1054,964,232,312,2127,2153,244,2565,927,0
19:59:35,9458.351,Fox,4282,543,210,92,161,26,34,20,4282,4072,3980,2975,1054,964,231,312,2128,2154,244,2568,927,0
19:59:35,9458.95,Fox,4284,541,208,90,160,29,34,20,4284,4076,3986,2981,1054,964,231,310,2129,2155,244,2572,927,0
19:59:35,9459.551,Fox,4284,541,208,88,158,33,34,20,4284,4076,3988,2985,1054,964,231,310,2129,2155,244,2572,927,0
19:59:35,9460.15,Fox,4284,541,208,86,159,34,34,20,4284,4076,3990,2986,1054,964,231,310,2129,2155,244,2572,927,0
19:59:36,9461.051,Fox,4286,542,208,86,159,35,33,21,4286,4078,3992,2987,1054,965,231,311,2130,2156,244,2573,927,0
19:59:36,9461.65,Fox,4286,542,208,84,161,35,32,22,4286,4078,3994,2987,1054,966,231,311,2130,2156,244,2573,927,0
19:59:36,9461.95,Fox,4286,541,208,84,161,35,32,21,4286,4078,3994,2987,1054,966,231,310,2130,2156,244,2573,928,0
19:59:37,9462.551,Fox,4286,541,206,86,161,35,32,21,4286,4080,3994,2987,1054,966,231,310,2130,2156,244,2573,928,0
19:59:37,9463.45,Fox,4288,542,206,82,164,35,32,21,4286,4080,3998,2987,1054,966,230,312,2130,2158,244,2574,928,0
19:59:38,9464.051,Fox,4290,544,208,84,164,35,32,21,4290,4082,3998,2987,1054,966,231,313,2131,2159,244,2574,928,0
19:59:38,9464.65,Fox,4290,544,206,86,162,37,31,22,4290,4084,3998,2989,1054,967,231,313,2131,2159,244,2574,928,0
19:59:38,9465.25,Fox,4290,544,206,80,167,38,31,22,4290,4084,4004,2990,1054,967,231,313,2131,2159,244,2574,928,0
19:59:38,9465.851,Fox,4294,546,208,78,168,38,31,21,4292,4084,4006,2990,1054,967,230,316,2132,2162,244,2575,929,0
19:59:39,9466.45,Fox,4298,548,208,76,170,38,31,21,4294,4086,4010,2992,1054,967,231,317,2135,2163,244,2577,929,0
19:59:39,9467.051,Fox,4304,549,216,78,162,41,31,21,4304,4088,4010,2997,1054,967,231,318,2138,2166,244,2582,929,0
19:59:39,9467.65,Fox,4306,551,214,80,162,43,31,21,4306,4092,4012,2999,1054,967,233,318,2140,2166,244,2582,929,0
19:59:40,9468.25,Fox,4310,552,218,80,160,42,31,21,4310,4092,4012,2999,1054,967,231,321,2141,2169,244,2585,929,0
19:59:40,9468.851,Fox,4310,550,216,80,162,41,30,21,4310,4094,4014,2999,1054,968,231,319,2141,2169,244,2587,929,0
19:59:40,9469.45,Fox,4310,548,216,76,165,40,30,21,4310,4094,4018,3000,1054,968,230,318,2141,2169,244,2589,929,0
19:59:41,9470.051,Fox,4310,545,216,74,165,39,30,21,4310,4094,4020,3002,1054,968,230,315,2141,2169,244,2592,929,0
19:59:41,9470.95,Fox,4314,546,218,74,161,40,30,21,4312,4094,4020,3004,1054,968,232,314,2145,2169,244,2595,929,0
19:59:42,9471.551,Fox,4316,546,220,72,163,39,30,20,4314,4094,4022,3004,1054,968,232,314,2146,2170,244,2596,930,0
19:59:42,9471.851,Fox,4316,546,222,68,167,39,30,20,4316,4094,4026,3004,1054,968,232,314,2146,2170,244,2596,930,0
19:59:42,9472.75,Fox,4316,544,218,62,175,41,30,18,4316,4098,4036,3006,1054,968,232,312,2146,2170,244,2596,932,0
19:59:42,9473.351,Fox,4316,543,214,66,173,43,30,17,4316,4102,4036,3008,1054,968,232,311,2146,2170,244,2596,933,0
19:59:43,9474.551,Fox,4316,543,214,64,173,43,32,17,4316,4102,4038,3010,1056,968,232,311,2146,2170,244,2596,933,0
19:59:43,9475.15,Fox,4316,541,214,60,175,43,32,17,4316,4102,4042,3012,1056,968,232,309,2146,2170,244,2598,933,0
19:59:44,9475.75,Fox,4316,538,214,58,177,42,30,17,4316,4102,4044,3012,1056,968,231,307,2146,2170,244,2601,933,0
19:59:44,9476.351,Fox,4320,540,214,60,175,42,30,17,4318,4104,4044,3013,1056,968,230,310,2147,2173,244,2603,933,0
19:59:44,9476.95,Fox,4328,544,220,62,172,41,30,17,4326,4106,4044,3013,1056,968,235,309,2155,2173,244,2607,933,0
19:59:44,9477.551,Fox,4328,541,218,66,169,41,30,17,4328,4110,4044,3016,1056,968,234,307,2155,2173,244,2610,933,0
19:59:45,9478.15,Fox,4328,541,214,70,168,42,29,18,4328,4114,4044,3017,1056,969,234,307,2155,2173,244,2610,933,0
19:59:45,9478.75,Fox,4328,540,214,68,170,41,29,18,4328,4114,4046,3017,1056,969,233,307,2155,2173,244,2611,933,0
19:59:46,9479.95,Fox,4332,541,212,70,170,40,29,18,4330,4118,4048,3017,1056,969,231,310,2155,2177,244,2614,933,0
19:59:46,9480.551,Fox,4332,539,212,70,172,38,29,18,4332,4120,4050,3017,1056,969,231,308,2155,2177,244,2616,933,0
19:59:46,9481.45,Fox,4334,539,212,70,172,36,29,18,4332,4120,4050,3017,1056,969,233,306,2157,2177,244,2618,933,0
19:59:47,9482.051,Fox,4334,539,212,72,172,36,29,18,4334,4122,4050,3017,1056,969,233,306,2157,2177,244,2618,933,0
19:59:47,9482.65,Fox,4336,540,210,74,171,36,29,18,4334,4124,4050,3017,1056,969,233,307,2158,2178,244,2619,933,0
19:59:47,9483.25,Fox,4336,538,212,72,171,36,29,18,4336,4124,4052,3019,1056,969,233,305,2158,2178,244,2621,933,0
19:59:48,9483.851,Fox,4336,536,210,74,169,36,29,18,4336,4126,4052,3021,1056,969,233,303,2158,2178,244,2623,933,0
19:59:48,9484.45,Fox,4336,536,206,78,169,36,29,18,4336,4130,4052,3021,1056,969,233,303,2158,2178,244,2623,933,0
19:59:48,9485.051,Fox,4336,534,202,82,169,34,29,18,4336,4134,4052,3021,1056,969,233,301,2158,2178,244,2625,933,0
19:59:48,9485.65,Fox,4336,532,202,80,167,36,29,18,4336,4134,4054,3025,1056,969,233,299,2158,2178,244,2627,933,0
19:59:49,9486.25,Fox,4336,532,202,78,166,39,29,18,4336,4134,4056,3028,1056,969,233,299,2158,2178,244,2627,933,0
19:59:49,9486.851,Fox,4336,531,202,74,170,38,29,18,4336,4134,4060,3028,1056,969,232,299,2158,2178,244,2628,933,0
19:59:50,9487.45,Fox,4340,533,200,76,169,38,28,18,4336,4136,4060,3028,1056,970,234,299,2161,2179,244,2629,934,0
19:59:50,9488.051,Fox,4340,530,204,76,168,36,28,18,4340,4136,4060,3029,1056,970,234,296,2161,2179,244,2632,934,0
19:59:50,9488.65,Fox,4344,531,204,76,168,35,28,18,4342,4138,4062,3029,1056,970,235,296,2164,2180,244,2635,934,0
19:59:50,9489.25,Fox,4348,532,208,76,166,35,26,19,4346,4138,4062,3029,1056,972,236,296,2167,2181,244,2637,935,0
19:59:51,9489.851,Fox,4348,532,206,80,163,38,26,19,4348,4142,4062,3032,1056,972,236,296,2167,2181,244,2637,935,0
19:59:51,9490.45,Fox,4350,533,206,82,163,38,26,18,4350,4144,4062,3032,1056,972,236,297,2168,2182,244,2637,936,0
19:59:51,9490.75,Fox,4350,533,204,82,165,38,26,18,4350,4146,4064,3032,1056,972,236,297,2168,2182,244,2637,936,0
19:59:52,9491.65,Fox,4352,534,198,88,166,38,26,18,4352,4154,4066,3032,1056,972,236,298,2169,2183,244,2638,936,0
19:59:52,9492.551,Fox,4360,540,202,88,164,38,26,18,4356,4154,4066,3033,1056,972,237,303,2172,2188,244,2640,936,0
19:59:53,9493.15,Fox,4362,541,202,92,162,39,26,18,4360,4158,4066,3034,1056,972,237,304,2173,2189,244,2641,936,0
19:59:53,9493.75,Fox,4364,542,202,94,160,42,26,18,4364,4162,4068,3037,1056,972,237,305,2174,2190,244,2642,936,0
19:59:53,9494.351,Fox,4372,544,204,96,156,40,26,18,4368,4164,4068,3037,1056,972,235,309,2176,2196,244,2648,936,0
19:59:53,9494.65,Fox,4372,544,208,94,158,40,26,18,4372,4164,4070,3037,1056,972,235,309,2176,2196,244,2648,936,0
19:59:54,9495.551,Fox,4372,543,204,96,159,41,26,17,4372,4168,4072,3038,1056,972,235,308,2176,2196,244,2648,937,0
19:59:54,9496.15,Fox,4376,541,204,100,156,38,26,17,4376,4172,4072,3039,1056,972,235,306,2178,2198,244,2654,937,0
19:59:54,9496.75,Fox,4378,539,206,100,155,35,26,17,4378,4172,4072,3039,1056,972,234,305,2179,2199,244,2658,937,0
19:59:55,9497.351,Fox,4378,539,200,102,159,35,26,17,4378,4178,4076,3039,1056,972,234,305,2179,2199,244,2658,937,0
19:59:55,9497.95,Fox,4384,542,204,102,156,35,26,17,4382,4178,4076,3039,1056,972,233,309,2181,2203,244,2661,937,0
19:59:55,9498.551,Fox,4384,540,204,104,156,34,26,16,4384,4180,4076,3039,1056,972,233,307,2181,2203,244,2662,938,0
19:59:56,9499.15,Fox,4386,540,204,104,152,37,25,16,4384,4180,4076,3042,1056,973,233,307,2182,2204,244,2663,939,0
19:59:56,9499.75,Fox,4388,541,206,102,154,36,25,16,4386,4180,4078,3042,1056,973,234,307,2184,2204,244,2664,939,0
19:59:56,9500.351,Fox,4390,540,208,102,153,33,26,16,4388,4180,4078,3042,1057,973,231,309,2184,2206,244,2667,939,0
19:59:56,9500.95,Fox,4392,540,210,102,151,35,25,15,4390,4180,4078,3044,1057,974,231,309,2185,2207,244,2668,940,0
19:59:57,9501.551,Fox,4392,540,212,100,152,34,27,15,4392,4180,4080,3045,1059,974,231,309,2185,2207,244,2668,940,0
19:59:57,9502.15,Fox,4396,542,216,100,151,31,29,15,4396,4180,4080,3045,1061,974,231,311,2187,2209,244,2670,940,0
19:59:57,9502.75,Fox,4398,542,214,100,152,31,28,15,4396,4182,4082,3045,1061,975,230,312,2187,2211,244,2672,940,0
19:59:58,9503.351,Fox,4400,541,214,102,153,27,30,15,4400,4186,4084,3045,1063,975,230,311,2189,2211,244,2675,940,0
19:59:58,9503.95,Fox,4404,542,216,102,151,26,30,15,4402,4186,4084,3045,1063,975,231,311,2192,2212,244,2678,940,0
19:59:58,9504.551,Fox,4412,545,220,102,146,26,30,15,4406,4186,4084,3046,1063,975,231,314,2196,2216,244,2683,940,0
19:59:59,9505.15,Fox,4412,545,222,104,146,28,30,15,4412,4190,4086,3048,1063,975,231,314,2196,2216,244,2683,940,0
19:59:59,9505.75,Fox,4412,543,216,108,147,28,30,14,4412,4196,4088,3049,1063,975,231,312,2196,2216,244,2684,941,0
19:59:59,9506.051,Fox,4412,543,216,104,151,28,30,14,4412,4196,4092,3049,1063,975,231,312,2196,2216,244,2684,941,0
20:00:00,9506.95,Fox,4414,543,216,104,150,27,30,14,4412,4196,4092,3049,1063,975,231,312,2197,2217,244,2686,941,0
20:00:00,9507.551,Fox,4414,543,218,102,152,27,30,14,4414,4196,4094,3049,1063,975,231,312,2197,2217,244,2686,941,0
20:00:00,9508.15,Fox,4416,544,216,104,149,29,30,14,4414,4198,4094,3051,1063,975,231,313,2198,2218,244,2687,941,0
20:00:01,9508.75,Fox,4416,544,214,108,145,33,30,14,4416,4202,4094,3055,1063,975,231,313,2198,2218,244,2687,941,0
20:00:01,9509.351,Fox,4422,546,218,108,141,34,30,13,4420,4202,4094,3059,1063,975,234,312,2202,2220,244,2690,942,0
20:00:01,9509.95,Fox,4426,547,218,112,136,36,30,13,4424,4206,4094,3062,1063,975,234,313,2204,2222,244,2693,942,0
20:00:02,9510.551,Fox,4430,550,224,112,130,41,30,13,4430,4206,4094,3068,1063,975,236,314,2207,2223,244,2694,942,0
20:00:02,9511.15,Fox,4434,550,222,112,131,40,30,13,4432,4210,4098,3069,1063,975,237,313,2210,2224,244,2698,942,0
20:00:02,9511.75,Fox,4434,550,224,108,130,45,30,13,4434,4210,4102,3074,1063,975,237,313,2210,2224,244,2698,942,0
20:00:02,9512.051,Fox,4434,549,224,108,130,44,30,13,4434,4210,4102,3074,1063,975,237,312,2210,2224,244,2699,942,0
20:00:03,9512.95,Fox,4436,550,226,108,129,45,30,12,4436,4210,4102,3075,1063,975,236,314,2210,2226,244,2699,943,0
20:00:03,9513.551,Fox,4438,551,224,110,126,47,30,12,4436,4212,4102,3078,1063,975,236,315,2211,2227,244,2700,943,0
20:00:03,9514.15,Fox,4438,551,226,110,126,45,32,12,4438,4212,4102,3078,1065,975,236,315,2211,2227,244,2700,943,0
20:00:04,9514.75,Fox,4442,553,230,108,126,45,32,12,4442,4212,4104,3079,1065,975,237,316,2213,2229,244,2702,943,0
20:00:04,9515.351,Fox,4442,552,230,108,124,46,32,12,4442,4212,4104,3081,1065,975,237,315,2213,2229,244,2703,943,0
20:00:04,9515.95,Fox,4442,552,228,106,128,46,32,12,4442,4214,4108,3081,1065,975,237,315,2213,2229,244,2703,943,0
20:00:05,9516.551,Fox,4442,551,228,102,128,49,32,12,4442,4214,4112,3085,1065,975,237,314,2213,2229,244,2704,943,0
20:00:05,9517.15,Fox,4444,552,226,102,125,53,32,12,4442,4216,4114,3089,1065,975,238,314,2215,2229,244,2705,943,0
20:00:05,9517.75,Fox,4450,556,228,106,122,54,32,12,4448,4220,4114,3090,1065,975,240,316,2219,2231,244,2707,943,0
20:00:06,9518.351,Fox,4454,556,230,106,117,57,32,12,4452,4222,4116,3096,1065,975,239,317,2220,2234,244,2711,943,0
20:00:06,9518.95,Fox,4456,554,232,104,114,59,32,11,4454,4222,4118,3101,1065,975,238,316,2222,2234,244,2714,944,0
20:00:06,9519.551,Fox,4456,553,234,102,112,63,32,10,4456,4222,4120,3105,1065,975,238,315,2222,2234,244,2714,945,0
20:00:07,9520.15,Fox,4456,548,230,106,111,59,32,10,4456,4226,4120,3106,1065,975,238,310,2222,2234,245,2718,945,0
20:00:07,9520.75,Fox,4458,546,230,106,112,56,32,10,4458,4228,4122,3106,1065,975,237,309,2223,2235,245,2722,945,0
20:00:07,9521.351,Fox,4460,543,230,104,113,53,32,9,4458,4228,4124,3107,1065,975,237,306,2223,2237,245,2726,946,0
20:00:08,9521.95,Fox,4460,542,230,106,111,53,34,8,4460,4230,4124,3109,1067,975,237,305,2223,2237,245,2726,947,0
20:00:08,9522.551,Fox,4462,540,226,110,112,50,34,8,4462,4236,4126,3109,1067,975,237,303,2224,2238,245,2730,947,0
20:00:08,9523.15,Fox,4462,539,224,108,116,49,34,8,4462,4238,4130,3109,1067,975,236,303,2224,2238,245,2731,947,0
20:00:08,9523.75,Fox,4462,538,224,104,117,51,32,10,4462,4238,4134,3112,1067,977,236,302,2224,2238,245,2732,947,0
20:00:09,9524.051,Fox,4462,536,224,104,117,49,32,10,4462,4238,4134,3112,1067,977,236,300,2224,2238,245,2734,947,0
20:00:09,9525.25,Fox,4468,539,222,108,112,50,33,10,4464,4242,4134,3115,1068,977,237,302,2227,2241,245,2737,947,0
20:00:10,9525.851,Fox,4470,540,224,112,111,50,33,10,4470,4246,4134,3115,1068,977,238,302,2229,2241,245,2738,947,0
20:00:10,9526.45,Fox,4472,541,222,112,108,54,33,10,4470,4248,4136,3119,1068,977,238,303,2230,2242,245,2739,947,0
20:00:10,9527.051,Fox,4476,536,224,114,106,50,33,7,4474,4250,4136,3119,1068,977,237,299,2233,2243,245,2745,950,0
20:00:10,9527.65,Fox,4476,532,222,116,108,45,34,7,4476,4254,4138,3119,1069,977,237,295,2233,2243,245,2749,950,0
20:00:11,9528.25,Fox,4478,533,222,118,107,45,34,7,4478,4256,4138,3120,1069,977,239,294,2235,2243,245,2750,950,0
20:00:11,9528.851,Fox,4478,527,222,112,113,40,34,6,4478,4256,4144,3120,1069,977,238,289,2235,2243,245,2755,951,0
20:00:11,9529.45,Fox,4478,522,222,110,114,36,34,6,4478,4256,4146,3121,1069,977,238,284,2235,2243,245,2760,951,0
20:00:12,9530.051,Fox,4478,519,220,110,114,36,34,5,4478,4258,4148,3123,1069,977,238,281,2235,2243,245,2762,952,0
20:00:12,9530.65,Fox,4478,518,216,108,120,35,32,7,4478,4262,4154,3123,1069,979,238,280,2235,2243,245,2763,952,0
20:00:12,9531.25,Fox,4480,519,214,112,119,35,32,7,4480,4266,4154,3123,1069,979,238,281,2236,2244,245,2764,952,0
20:00:13,9531.851,Fox,4482,519,212,110,120,36,32,7,4480,4268,4158,3125,1069,979,239,280,2238,2244,245,2766,952,0
20:00:13,9532.45,Fox,4486,520,216,106,119,38,32,7,4484,4268,4162,3129,1069,979,242,278,2242,2244,245,2769,952,0
20:00:13,9533.051,Fox,4488,521,218,104,114,44,32,7,4486,4268,4164,3135,1069,979,241,280,2242,2246,245,2770,952,0
20:00:13,9533.65,Fox,4488,521,216,108,114,44,32,7,4488,4272,4164,3135,1069,979,241,280,2242,2246,245,2770,952,0
20:00:14,9534.25,Fox,4488,518,216,104,118,41,32,7,4488,4272,4168,3135,1069,979,241,277,2242,2246,245,2773,952,0
20:00:14,9534.851,Fox,4490,519,214,102,119,43,32,7,4488,4274,4172,3137,1069,979,241,278,2243,2247,245,2774,952,0
20:00:14,9535.45,Fox,4492,520,218,102,115,46,32,7,4492,4274,4172,3140,1069,979,241,279,2244,2248,245,2775,952,0
20:00:15,9536.051,Fox,4492,517,218,96,119,45,32,7,4492,4274,4178,3142,1069,979,240,277,2244,2248,245,2778,952,0
20:00:15,9536.95,Fox,4492,515,216,96,121,43,32,7,4492,4276,4180,3142,1069,979,240,275,2244,2248,245,2780,952,0
20:00:15,9537.25,Fox,4492,515,216,96,121,43,30,9,4492,4276,4180,3142,1069,981,240,275,2244,2248,245,2780,952,0
20:00:16,9538.45,Fox,4492,514,214,98,121,42,30,9,4492,4278,4180,3142,1069,981,240,274,2244,2248,245,2781,952,0
20:00:16,9539.351,Fox,4492,513,214,98,120,43,30,8,4492,4278,4180,3143,1069,981,240,273,2244,2248,245,2781,953,0
20:00:17,9539.95,Fox,4492,512,214,98,118,43,31,8,4492,4278,4180,3145,1070,981,240,272,2244,2248,245,2782,953,0
20:00:17,9540.551,Fox,4494,511,212,100,117,41,31,8,4492,4280,4180,3145,1070,981,239,272,2244,2250,245,2785,953,0
20:00:17,9541.15,Fox,4494,511,212,100,118,42,31,8,4494,4282,4182,3146,1070,981,239,272,2244,2250,245,2785,953,0
20:00:17,9541.45,Fox,4494,511,210,102,118,42,31,8,4494,4284,4182,3146,1070,981,239,272,2244,2250,245,2785,953,0
20:00:18,9542.351,Fox,4500,513,212,98,120,40,31,8,4496,4284,4186,3146,1070,981,239,274,2246,2254,245,2789,953,0
20:00:18,9542.65,Fox,4500,509,216,98,120,36,31,8,4500,4284,4186,3146,1070,981,238,271,2246,2254,245,2793,953,0
20:00:19,9543.851,Fox,4506,511,216,96,122,35,31,7,4502,4286,4190,3147,1070,981,238,273,2247,2259,245,2796,954,0
20:00:19,9544.45,Fox,4506,511,220,90,128,35,31,7,4506,4286,4196,3147,1070,981,238,273,2247,2259,245,2796,954,0
20:00:19,9545.051,Fox,4506,509,220,90,128,33,31,7,4506,4286,4196,3147,1070,981,238,271,2247,2259,245,2798,954,0
20:00:20,9545.95,Fox,4506,506,220,90,126,32,31,7,4506,4286,4196,3149,1070,981,238,268,2247,2259,245,2801,954,0
20:00:20,9546.551,Fox,4508,505,218,94,124,31,31,7,4508,4290,4196,3150,1070,981,237,268,2248,2260,245,2804,954,0
20:00:20,9547.15,Fox,4510,506,218,90,126,32,31,7,4508,4290,4200,3151,1070,981,237,269,2249,2261,245,2805,954,0
20:00:20,9547.45,Fox,4510,506,220,88,128,32,31,7,4510,4290,4202,3151,1070,981,237,269,2249,2261,245,2805,954,0
20:00:21,9548.65,Fox,4510,506,216,88,132,32,31,7,4510,4294,4206,3151,1070,981,237,269,2249,2261,245,2805,954,0
20:00:21,9549.25,Fox,4510,506,212,92,131,33,31,7,4510,4298,4206,3152,1070,981,237,269,2249,2261,245,2805,954,0
20:00:21,9549.851,Fox,4514,507,210,94,134,31,31,7,4514,4304,4210,3152,1070,981,238,269,2252,2262,245,2808,954,0
20:00:22,9550.45,Fox,4514,505,208,96,134,29,31,7,4514,4306,4210,3152,1070,981,238,267,2252,2262,245,2810,954,0
20:00:22,9551.051,Fox,4514,505,204,100,133,30,31,7,4514,4310,4210,3153,1070,981,238,267,2252,2262,245,2810,954,0
20:00:22,9551.65,Fox,4514,504,204,100,132,30,31,7,4514,4310,4210,3154,1070,981,238,266,2252,2262,245,2811,954,0
20:00:23,9552.25,Fox,4514,504,204,98,134,28,33,7,4514,4310,4212,3154,1072,981,238,266,2252,2262,245,2811,954,0
20:00:23,9552.851,Fox,4518,506,208,98,132,28,33,7,4518,4310,4212,3154,1072,981,239,267,2255,2263,245,2813,954,0
20:00:23,9553.45,Fox,4518,506,206,100,132,27,34,7,4518,4312,4212,3154,1073,981,239,267,2255,2263,245,2813,954,0
20:00:24,9554.051,Fox,4520,506,204,102,130,27,34,7,4518,4314,4212,3155,1073,981,239,267,2256,2264,245,2815,954,0
20:00:24,9554.351,Fox,4520,506,204,102,132,27,34,7,4520,4316,4214,3155,1073,981,239,267,2256,2264,245,2815,954,0
20:00:24,9555.25,Fox,4524,508,206,102,128,29,34,7,4522,4316,4214,3157,1073,981,241,267,2260,2264,245,2817,954,0
20:00:24,9555.851,Fox,4524,508,208,100,128,31,34,7,4524,4316,4216,3159,1073,981,241,267,2260,2264,245,2817,954,0
20:00:25,9556.45,Fox,4526,507,208,96,131,29,34,7,4524,4316,4220,3159,1073,981,240,267,2260,2266,245,2820,954,0
20:00:25,9557.051,Fox,4530,509,210,94,132,29,34,6,4526,4316,4222,3159,1073,981,241,268,2262,2268,245,2821,955,0
20:00:25,9557.65,Fox,4530,508,214,94,130,30,34,6,4530,4316,4222,3161,1073,981,241,267,2262,2268,245,2822,955,0
20:00:26,9558.851,Fox,4530,508,212,92,134,30,33,7,4530,4318,4226,3161,1073,982,241,267,2262,2268,245,2822,955,0
20:00:26,9559.45,Fox,4532,508,204,98,135,29,32,8,4530,4326,4228,3161,1073,983,241,267,2263,2269,245,2824,955,0
20:00:26,9560.051,Fox,4534,509,206,100,132,31,32,8,4534,4328,4228,3163,1073,983,240,269,2263,2271,245,2825,955,0
20:00:27,9560.351,Fox,4534,509,206,98,134,29,34,8,4534,4328,4230,3163,1075,983,240,269,2263,2271,245,2825,955,0
20:00:27,9561.25,Fox,4536,510,206,92,139,27,36,8,4534,4328,4236,3163,1077,983,239,271,2263,2273,245,2826,955,0
20:00:27,9561.851,Fox,4540,512,210,90,138,28,36,8,4538,4328,4238,3165,1077,983,240,272,2265,2275,245,2828,955,0
20:00:28,9562.45,Fox,4542,512,212,92,137,27,36,8,4542,4330,4238,3165,1077,983,239,273,2265,2277,245,2830,955,0
20:00:28,9562.75,Fox,4542,512,210,94,137,27,36,8,4542,4332,4238,3165,1077,983,239,273,2265,2277,245,2830,955,0
20:00:28,9563.65,Fox,4542,512,210,92,138,28,36,8,4542,4332,4240,3166,1077,983,239,273,2265,2277,245,2830,955,0
20:00:28,9564.25,Fox,4542,512,208,88,144,28,36,8,4542,4334,4246,3166,1077,983,239,273,2265,2277,245,2830,955,0
20:00:29,9564.851,Fox,4544,512,210,86,146,26,36,8,4544,4334,4248,3166,1077,983,239,273,2266,2278,245,2832,955,0
20:00:29,9565.45,Fox,4546,511,208,88,143,26,36,8,4544,4336,4248,3168,1077,983,238,273,2268,2278,245,2835,955,0
20:00:29,9566.051,Fox,4546,511,210,84,145,28,36,8,4546,4336,4252,3170,1077,983,238,273,2268,2278,245,2835,955,0
20:00:29,9566.65,Fox,4550,512,212,82,143,29,36,8,4548,4336,4254,3173,1077,983,240,272,2271,2279,245,2838,955,0
20:00:30,9567.25,Fox,4552,514,216,80,145,29,36,8,4552,4336,4256,3173,1077,983,242,272,2273,2279,245,2838,955,0
20:00:30,9568.15,Fox,4556,514,218,80,142,28,35,9,4554,4336,4256,3174,1077,984,242,272,2275,2281,245,2842,955,0
20:00:30,9568.45,Fox,4556,514,220,78,144,28,35,9,4556,4336,4258,3174,1077,984,242,272,2275,2281,245,2842,955,0
20:00:31,9569.351,Fox,4556,514,220,74,148,28,35,9,4556,4336,4262,3174,1077,984,242,272,2275,2281,245,2842,955,0
20:00:31,9569.95,Fox,4560,516,222,70,150,28,35,9,4558,4336,4266,3174,1077,984,242,274,2277,2283,245,2844,955,0
20:00:31,9570.551,Fox,4562,516,222,72,152,26,35,9,4562,4340,4268,3174,1077,984,244,272,2279,2283,245,2846,955,0
20:00:32,9571.15,Fox,4564,518,220,74,152,26,32,12,4562,4342,4268,3174,1077,987,245,273,2280,2284,245,2846,955,0
20:00:32,9571.75,Fox,4564,518,218,78,150,28,32,12,4564,4346,4268,3176,1077,987,245,273,2280,2284,245,2846,955,0
20:00:32,9572.351,Fox,4566,518,218,76,150,30,32,12,4566,4348,4272,3179,1077,987,246,272,2282,2284,245,2848,955,0
20:00:33,9573.25,Fox,4566,518,216,76,152,30,32,12,4566,4350,4274,3179,1077,987,246,272,2282,2284,245,2848,955,0
20:00:33,9574.15,Fox,4570,520,216,78,151,29,31,13,4568,4352,4274,3179,1077,988,247,273,2284,2286,245,2850,955,0
20:00:34,9574.75,Fox,4572,520,218,78,150,29,31,12,4570,4352,4274,3179,1077,988,247,273,2286,2286,245,2851,956,0
20:00:34,9575.351,Fox,4572,520,212,84,150,31,31,12,4572,4360,4276,3181,1077,988,247,273,2286,2286,245,2851,956,0
20:00:34,9575.95,Fox,4572,518,210,86,149,30,30,13,4572,4362,4276,3182,1077,989,245,273,2286,2286,245,2853,956,0
20:00:34,9576.551,Fox,4572,516,208,88,147,29,31,13,4572,4364,4276,3184,1078,989,245,271,2286,2286,245,2855,956,0
20:00:35,9577.15,Fox,4574,514,202,94,147,27,29,15,4574,4372,4278,3185,1078,991,245,269,2287,2287,245,2859,956,0
20:00:35,9578.051,Fox,4576,515,204,94,146,27,27,17,4576,4372,4278,3185,1078,993,245,270,2288,2288,245,2860,956,0
20:00:36,9578.65,Fox,4578,515,202,98,144,27,27,17,4578,4376,4278,3187,1078,993,246,269,2290,2288,245,2862,956,0
20:00:36,9579.25,Fox,4578,515,200,98,145,28,27,17,4578,4378,4280,3188,1078,993,246,269,2290,2288,245,2862,956,0
20:00:36,9579.851,Fox,4578,514,200,96,145,30,27,16,4578,4378,4282,3190,1078,993,246,268,2290,2288,245,2862,957,0
20:00:36,9580.45,Fox,4582,516,198,98,145,30,27,16,4580,4382,4284,3190,1078,993,245,271,2291,2291,245,2864,957,0
20:00:37,9581.051,Fox,4584,517,198,100,143,31,27,16,4582,4384,4284,3191,1078,993,244,273,2291,2293,245,2865,957,0
20:00:37,9581.65,Fox,4586,517,200,100,140,33,27,15,4584,4384,4284,3193,1078,993,243,274,2291,2295,245,2866,958,0
20:00:37,9582.25,Fox,4586,516,200,100,142,32,27,15,4586,4386,4286,3193,1078,993,243,273,2291,2295,245,2867,958,0
20:00:37,9582.551,Fox,4586,513,198,102,141,30,27,15,4586,4388,4286,3194,1078,993,243,270,2291,2295,245,2870,958,0
20:00:38,9583.45,Fox,4588,514,198,104,140,30,27,15,4588,4390,4286,3195,1078,993,243,271,2292,2296,245,2871,958,0
20:00:38,9584.051,Fox,4590,516,196,106,136,34,27,15,4588,4392,4286,3199,1078,993,243,273,2292,2298,245,2871,958,0
20:00:39,9584.65,Fox,4594,519,196,110,135,34,27,15,4592,4396,4286,3199,1078,993,245,274,2295,2299,245,2872,958,0
20:00:39,9585.25,Fox,4594,519,198,106,139,34,27,15,4594,4396,4290,3199,1078,993,245,274,2295,2299,245,2872,958,0
20:00:39,9585.851,Fox,4594,518,194,110,139,33,27,15,4594,4400,4290,3199,1078,993,245,273,2295,2299,245,2873,958,0
20:00:40,9586.45,Fox,4598,520,194,112,136,34,27,15,4596,4402,4290,3201,1078,993,245,275,2296,2302,245,2875,958,0
20:00:40,9587.051,Fox,4600,519,194,114,137,32,25,17,4600,4406,4292,3201,1078,995,245,274,2297,2303,245,2878,958,0
20:00:40,9587.65,Fox,4600,518,188,118,138,32,25,17,4600,4412,4294,3202,1078,995,245,273,2297,2303,245,2879,958,0
20:00:40,9588.25,Fox,4600,518,188,108,148,32,25,17,4600,4412,4304,3202,1078,995,245,273,2297,2303,245,2879,958,0
20:00:41,9589.15,Fox,4600,516,188,106,145,35,25,17,4600,4412,4306,3207,1078,995,245,271,2297,2303,245,2881,958,0
20:00:41,9589.75,Fox,4600,515,186,104,147,36,25,17,4600,4414,4310,3209,1078,995,245,270,2297,2303,245,2882,958,0
20:00:42,9590.351,Fox,4602,514,188,104,144,36,25,17,4602,4414,4310,3211,1078,995,245,269,2298,2304,245,2885,958,0
20:00:42,9590.95,Fox,4602,514,186,106,139,41,25,17,4602,4416,4310,3216,1078,995,245,269,2298,2304,245,2885,958,0
20:00:42,9591.551,Fox,4606,515,190,106,137,40,25,17,4606,4416,4310,3216,1078,995,245,270,2300,2306,245,2888,958,0
20:00:42,9592.15,Fox,4608,516,186,110,134,44,25,17,4608,4422,4312,3220,1078,995,245,271,2301,2307,245,2889,958,0
20:00:43,9592.75,Fox,4608,516,182,112,133,47,24,18,4608,4426,4314,3223,1078,996,245,271,2301,2307,245,2889,958,0
20:00:43,9593.351,Fox,4614,520,182,114,132,48,24,18,4612,4430,4316,3224,1078,996,245,275,2303,2311,246,2890,958,0
20:00:43,9593.95,Fox,4614,519,180,118,132,47,24,18,4614,4434,4316,3224,1078,996,245,274,2303,2311,246,2891,958,0
20:00:43,9594.551,Fox,4614,515,180,118,131,44,24,18,4614,4434,4316,3225,1078,996,243,272,2303,2311,246,2895,958,0
20:00:44,9595.15,Fox,4614,515,180,118,128,47,24,18,4614,4434,4316,3228,1078,996,243,272,2303,2311,246,2895,958,0
20:00:44,9595.45,Fox,4614,515,178,120,128,47,24,18,4614,4436,4316,3228,1078,996,243,272,2303,2311,246,2895,958,0
20:00:44,9596.351,Fox,4616,516,176,122,123,51,24,18,4614,4438,4316,3232,1078,996,242,274,2303,2313,246,2896,958,0
20:00:45,9596.95,Fox,4616,514,178,122,123,49,24,18,4616,4438,4316,3232,1078,996,241,273,2303,2313,246,2898,958,0
20:00:45,9597.551,Fox,4618,515,176,124,123,50,24,18,4618,4442,4318,3234,1078,996,240,275,2303,2315,246,2899,958,0
20:00:45,9598.15,Fox,4620,515,176,116,131,48,24,18,4618,4442,4326,3234,1078,996,240,275,2304,2316,246,2901,958,0
20:00:45,9598.45,Fox,4620,514,178,114,133,48,24,17,4620,4442,4328,3234,1078,996,240,274,2304,2316,246,2901,959,0
20:00:46,9599.65,Fox,4622,511,178,114,133,44,24,16,4620,4442,4328,3234,1078,996,240,271,2305,2317,246,2905,960,0
20:00:46,9600.25,Fox,4622,511,174,120,133,44,24,16,4622,4448,4328,3234,1078,996,240,271,2305,2317,246,2905,960,0
20:00:47,9600.851,Fox,4622,509,170,124,133,42,24,16,4622,4452,4328,3234,1078,996,240,269,2305,2317,246,2907,960,0
20:00:47,9601.45,Fox,4622,504,168,122,135,39,24,16,4622,4454,4332,3236,1078,996,237,267,2305,2317,246,2912,960,0
20:00:47,9601.75,Fox,4622,503,166,124,135,39,24,15,4622,4456,4332,3236,1078,996,237,266,2305,2317,246,2912,961,0
20:00:47,9602.65,Fox,4622,499,166,124,134,36,24,15,4622,4456,4332,3237,1078,996,233,266,2305,2317,246,2916,961,0
20:00:48,9603.25,Fox,4622,497,164,124,136,33,25,15,4622,4458,4334,3237,1079,996,233,264,2305,2317,246,2918,961,0
20:00:48,9603.551,Fox,4622,496,164,124,136,32,25,15,4622,4458,4334,3237,1079,996,232,264,2305,2317,246,2919,961,0
20:00:48,9604.45,Fox,4624,497,162,124,132,37,25,15,4622,4460,4336,3242,1079,996,232,265,2306,2318,246,2920,961,0
20:00:49,9605.051,Fox,4628,498,162,126,128,38,25,15,4624,4462,4336,3244,1079,996,231,267,2307,2321,246,2923,961,0
20:00:49,9605.65,Fox,4628,495,166,126,128,35,25,15,4628,4462,4336,3244,1079,996,231,264,2307,2321,246,2926,961,0
20:00:49,9606.25,Fox,4632,497,168,126,126,35,25,15,4630,4462,4336,3244,1079,996,229,268,2307,2325,246,2928,961,0
20:00:50,9606.851,Fox,4636,498,170,126,125,33,25,15,4632,4462,4336,3244,1079,996,229,269,2308,2328,246,2931,961,0
20:00:50,9607.45,Fox,4638,499,176,126,121,36,25,15,4638,4462,4336,3247,1079,996,229,270,2309,2329,246,2932,961,0
20:00:50,9608.051,Fox,4640,498,170,132,119,35,25,15,4638,4468,4336,3248,1079,996,229,269,2310,2330,246,2935,961,0
20:00:50,9608.65,Fox,4640,498,170,134,117,35,27,15,4640,4470,4336,3250,1081,996,229,269,2310,2330,246,2935,961,0
20:00:51,9609.25,Fox,4644,500,172,132,119,35,27,15,4644,4472,4340,3251,1081,996,230,270,2313,2331,246,2937,961,0
20:00:51,9609.851,Fox,4644,500,168,134,117,39,27,15,4644,4476,4342,3255,1081,996,230,270,2313,2331,246,2937,961,0
20:00:51,9610.45,Fox,4646,500,168,130,121,38,27,14,4644,4476,4346,3255,1081,996,230,270,2315,2331,246,2939,961,0
20:00:52,9611.051,Fox,4648,500,170,130,122,38,27,13,4648,4478,4348,3255,1081,996,230,270,2317,2331,246,2940,962,0
20:00:52,9611.95,Fox,4650,499,172,128,123,35,26,15,4650,4478,4350,3255,1082,998,229,270,2318,2332,246,2943,962,0
20:00:52,9612.25,Fox,4650,499,172,128,122,36,26,15,4650,4478,4350,3256,1082,998,229,270,2318,2332,246,2943,962,0
20:00:52,9612.851,Fox,4650,498,172,126,124,33,28,15,4650,4478,4352,3256,1084,998,229,269,2318,2332,246,2944,962,0
20:00:53,9613.75,Fox,4652,500,172,124,128,33,28,15,4652,4480,4356,3256,1084,998,230,270,2319,2333,246,2944,962,0
20:00:53,9614.051,Fox,4652,500,172,120,132,33,28,15,4652,4480,4360,3256,1084,998,230,270,2319,2333,246,2944,962,0
20:00:53,9614.95,Fox,4652,494,168,120,136,28,27,15,4652,4484,4364,3256,1084,998,230,264,2319,2333,246,2950,962,0
20:00:54,9615.551,Fox,4652,492,166,118,140,26,27,15,4652,4486,4368,3256,1084,998,230,262,2319,2333,246,2952,962,0
20:00:54,9616.15,Fox,4654,494,164,116,142,28,27,15,4652,4488,4372,3258,1084,998,231,263,2320,2334,246,2952,962,0
20:00:54,9616.75,Fox,4656,495,166,116,138,31,27,15,4654,4488,4372,3261,1084,998,232,263,2322,2334,246,2953,962,0
20:00:55,9617.351,Fox,4656,495,168,112,140,33,27,15,4656,4488,4376,3263,1084,998,232,263,2322,2334,246,2953,962,0
20:00:55,9617.95,Fox,4656,492,164,114,142,31,27,14,4656,4492,4378,3263,1084,998,232,260,2322,2334,246,2955,963,0
20:00:55,9618.25,Fox,4656,491,164,114,142,30,27,14,4656,4492,4378,3263,1084,998,232,259,2322,2334,247,2955,963,0
20:00:56,9619.15,Fox,4662,496,166,110,142,33,27,14,4658,4492,4382,3266,1084,998,235,261,2326,2336,247,2956,963,0
20:00:56,9619.75,Fox,4662,495,170,108,142,32,29,14,4662,4492,4384,3268,1086,998,235,260,2326,2336,247,2957,963,0
20:00:56,9620.351,Fox,4664,494,172,108,142,29,29,14,4664,4492,4384,3268,1086,998,235,259,2327,2337,248,2959,963,0
20:00:56,9620.65,Fox,4664,494,172,106,142,31,29,14,4664,4492,4386,3270,1086,998,235,259,2327,2337,248,2959,963,0
20:00:57,9621.551,Fox,4664,494,172,104,140,35,29,14,4664,4492,4388,3274,1086,998,235,259,2327,2337,248,2959,963,0
20:00:57,9621.851,Fox,4664,494,172,102,140,37,29,14,4664,4492,4390,3276,1086,998,235,259,2327,2337,248,2959,963,0
20:00:57,9622.75,Fox,4664,493,172,100,142,36,29,14,4664,4492,4392,3276,1086,998,235,258,2327,2337,248,2960,963,0
20:00:58,9623.351,Fox,4664,493,170,98,146,36,29,14,4664,4494,4396,3276,1086,998,235,258,2327,2337,248,2960,963,0
20:00:58,9624.25,Fox,4666,494,170,96,143,40,29,14,4664,4494,4398,3280,1086,998,235,259,2328,2338,248,2961,963,0
20:00:58,9624.851,Fox,4666,494,170,96,142,43,29,14,4666,4496,4400,3283,1086,998,235,259,2328,2338,248,2961,963,0
20:00:59,9625.45,Fox,4666,494,166,96,144,45,29,14,4666,4500,4404,3285,1086,998,235,259,2328,2338,248,2961,963,0
20:00:59,9626.051,Fox,4668,496,168,88,150,47,29,14,4668,4500,4412,3287,1086,998,236,260,2329,2339,248,2961,963,0
20:00:59,9626.65,Fox,4674,498,166,94,146,43,33,14,4672,4506,4412,3289,1090,998,237,261,2332,2342,248,2965,963,0
20:01:00,9627.25,Fox,4678,498,172,94,143,42,33,14,4678,4506,4412,3291,1090,998,237,261,2334,2344,248,2969,963,0
20:01:00,9628.15,Fox,4680,496,174,94,142,40,33,13,4680,4506,4412,3291,1090,998,235,261,2334,2346,248,2972,964,0
20:01:00,9628.75,Fox,4680,496,174,92,143,41,33,13,4680,4506,4414,3292,1090,998,235,261,2334,2346,248,2972,964,0
20:01:01,9629.351,Fox,4680,493,172,94,141,40,33,13,4680,4508,4414,3294,1090,998,234,259,2334,2346,248,2975,964,0
20:01:01,9629.95,Fox,4680,491,170,94,140,41,33,13,4680,4510,4416,3297,1090,998,234,257,2334,2346,248,2977,964,0
20:01:01,9630.551,Fox,4680,491,170,90,141,44,33,13,4680,4510,4420,3300,1090,998,234,257,2334,2346,248,2977,964,0
20:01:02,9631.15,Fox,4680,489,170,86,145,42,33,13,4680,4510,4424,3300,1090,998,234,255,2334,2346,248,2979,964,0
20:01:02,9631.75,Fox,4682,489,172,80,151,42,32,12,4682,4510,4430,3300,1090,998,233,256,2335,2347,248,2981,964,0
20:01:02,9632.65,Fox,4684,488,170,80,152,42,32,12,4684,4514,4434,3302,1090,998,234,254,2337,2347,248,2984,964,0
20:01:03,9633.851,Fox,4686,490,172,80,150,44,32,12,4686,4514,4434,3304,1090,998,235,255,2338,2348,248,2984,964,0
20:01:03,9634.15,Fox,4686,490,172,78,152,44,32,12,4686,4514,4436,3304,1090,998,235,255,2338,2348,248,2984,964,0
20:01:03,9635.051,Fox,4690,487,172,76,152,39,32,12,4686,4514,4438,3304,1090,998,235,252,2341,2349,248,2991,964,0
20:01:04,9635.65,Fox,4690,485,172,80,150,39,32,12,4690,4518,4438,3306,1090,998,235,250,2341,2349,248,2993,964,0
20:01:04,9635.95,Fox,4690,485,172,76,154,39,32,12,4690,4518,4442,3306,1090,998,235,250,2341,2349,248,2993,964,0
20:01:04,9636.851,Fox,4692,484,172,78,154,36,32,12,4692,4520,4442,3306,1090,998,236,248,2342,2350,248,2996,964,0
20:01:04,9637.45,Fox,4692,483,172,78,152,37,31,13,4692,4520,4442,3308,1090,999,236,247,2342,2350,248,2997,964,0
20:01:05,9638.051,Fox,4692,480,168,82,152,35,31,12,4692,4524,4442,3308,1090,999,236,244,2342,2350,248,2999,965,0
20:01:05,9638.65,Fox,4696,482,172,80,152,35,31,12,4696,4524,4444,3308,1090,999,237,245,2345,2351,248,3001,965,0
20:01:05,9639.25,Fox,4696,480,170,76,156,36,29,13,4696,4526,4450,3310,1090,1001,236,244,2345,2351,248,3002,966,0
20:01:06,9639.851,Fox,4698,479,168,76,157,36,27,15,4698,4530,4454,3312,1090,1003,236,243,2346,2352,248,3005,966,0
20:01:06,9640.45,Fox,4698,476,168,74,158,34,26,16,4698,4530,4456,3313,1090,1004,236,240,2346,2352,248,3008,966,0
20:01:06,9641.051,Fox,4700,475,168,74,158,31,26,16,4698,4530,4456,3313,1090,1004,237,238,2347,2353,248,3011,966,0
20:01:06,9641.351,Fox,4700,475,170,74,158,31,26,16,4700,4530,4456,3313,1090,1004,237,238,2347,2353,248,3011,966,0
20:01:07,9642.25,Fox,4700,475,168,74,160,31,26,16,4700,4532,4458,3313,1090,1004,237,238,2347,2353,248,3011,966,0
20:01:07,9642.851,Fox,4700,475,166,74,160,33,26,16,4700,4534,4460,3315,1090,1004,237,238,2347,2353,248,3011,966,0
20:01:07,9643.15,Fox,4700,473,166,74,160,31,26,16,4700,4534,4460,3315,1090,1004,237,236,2347,2353,248,3013,966,0
20:01:08,9644.051,Fox,4702,473,166,74,162,29,26,16,4702,4536,4462,3315,1090,1004,237,236,2348,2354,248,3015,966,0
20:01:08,9644.65,Fox,4702,473,162,78,162,29,26,16,4702,4540,4462,3315,1090,1004,237,236,2348,2354,248,3015,966,0
20:01:08,9645.25,Fox,4702,473,160,80,160,31,26,16,4702,4542,4462,3317,1090,1004,237,236,2348,2354,248,3015,966,0
20:01:08,9645.551,Fox,4702,473,160,80,158,33,26,16,4702,4542,4462,3319,1090,1004,237,236,2348,2354,248,3015,966,0
20:01:09,9646.45,Fox,4702,471,160,78,160,31,26,16,4702,4542,4464,3319,1090,1004,236,235,2348,2354,248,3017,966,0
20:01:09,9647.051,Fox,4708,474,166,72,163,31,26,16,4708,4542,4470,3319,1090,1004,236,238,2351,2357,248,3020,966,0
20:01:09,9647.65,Fox,4710,474,164,74,160,32,26,16,4708,4544,4470,3322,1090,1004,237,237,2352,2358,248,3022,966,0
20:01:09,9648.25,Fox,4714,476,164,72,160,34,26,16,4710,4546,4474,3324,1090,1004,237,239,2354,2360,248,3024,966,0
20:01:10,9648.851,Fox,4718,478,170,70,155,39,26,16,4716,4546,4476,3329,1090,1004,237,241,2356,2362,248,3026,966,0
20:01:10,9649.45,Fox,4720,480,168,72,157,39,26,16,4718,4550,4478,3329,1090,1004,238,242,2357,2363,248,3026,966,0
20:01:10,9650.051,Fox,4722,479,170,74,153,40,26,16,4722,4552,4478,3332,1090,1004,238,241,2358,2364,248,3029,966,0
20:01:10,9650.65,Fox,4724,480,170,76,152,40,26,16,4724,4554,4478,3332,1090,1004,238,242,2359,2365,248,3030,966,0
20:01:11,9651.25,Fox,4726,480,170,78,151,39,26,16,4726,4556,4478,3332,1090,1004,238,242,2360,2366,248,3032,966,0
20:01:11,9651.551,Fox,4726,480,170,78,151,39,24,18,4726,4556,4478,3332,1090,1006,238,242,2360,2366,248,3032,966,0
20:01:11,9652.45,Fox,4734,484,172,78,148,40,24,18,4730,4558,4480,3333,1090,1006,238,246,2364,2370,248,3036,966,0
20:01:12,9653.051,Fox,4734,483,172,82,148,39,24,18,4734,4562,4480,3333,1090,1006,238,245,2364,2370,248,3037,966,0
20:01:12,9653.65,Fox,4738,486,176,78,150,40,24,18,4738,4562,4484,3335,1090,1006,239,247,2366,2372,248,3038,966,0
20:01:12,9654.25,Fox,4748,492,184,78,148,40,24,18,4748,4564,4486,3335,1090,1006,240,252,2371,2377,248,3042,966,0
20:01:12,9654.851,Fox,4752,494,184,78,148,40,24,18,4750,4566,4488,3335,1090,1006,238,256,2371,2381,248,3044,966,0
20:01:13,9655.15,Fox,4752,494,186,78,148,40,24,18,4752,4566,4488,3335,1090,1006,238,256,2371,2381,248,3044,966,0
20:01:13,9656.051,Fox,4754,493,186,78,148,38,24,17,4752,4566,4488,3335,1090,1006,238,255,2371,2383,248,3046,967,0
20:01:13,9656.65,Fox,4756,494,188,76,152,37,24,17,4756,4568,4492,3335,1090,1006,239,255,2373,2383,248,3047,967,0
20:01:14,9656.95,Fox,4756,494,186,78,152,37,24,17,4756,4570,4492,3335,1090,1006,239,255,2373,2383,248,3047,967,0
20:01:14,9657.851,Fox,4756,494,184,80,150,39,24,17,4756,4572,4492,3337,1090,1006,239,255,2373,2383,248,3047,967,0
20:01:14,9658.45,Fox,4756,492,184,80,146,41,24,17,4756,4572,4492,3341,1090,1006,238,254,2373,2383,248,3049,967,0
20:01:15,9659.051,Fox,4758,487,186,80,145,35,22,19,4758,4572,4492,3341,1090,1008,235,252,2374,2384,248,3056,967,0
20:01:15,9659.95,Fox,4760,487,186,82,144,35,22,18,4760,4574,4492,3341,1090,1008,234,253,2374,2386,248,3057,968,0
20:01:15,9660.551,Fox,4760,484,184,84,144,32,22,18,4760,4576,4492,3341,1090,1008,234,250,2374,2386,248,3060,968,0
20:01:16,9661.45,Fox,4764,486,184,86,141,33,22,18,4762,4578,4492,3343,1090,1008,236,250,2378,2386,248,3062,968,0
20:01:16,9662.051,Fox,4766,486,188,84,140,35,22,17,4766,4578,4494,3345,1090,1008,235,251,2378,2388,248,3063,969,0
20:01:16,9662.65,Fox,4768,487,190,84,140,35,21,17,4768,4578,4494,3345,1090,1009,235,252,2378,2390,248,3063,970,0
20:01:17,9663.25,Fox,4768,487,186,88,138,37,21,17,4768,4582,4494,3347,1090,1009,235,252,2378,2390,248,3063,970,0
20:01:17,9663.851,Fox,4770,487,184,84,143,36,21,17,4768,4584,4500,3347,1090,1009,235,252,2379,2391,248,3065,970,0
20:01:17,9664.45,Fox,4778,491,184,86,138,37,21,17,4770,4586,4500,3348,1090,1009,237,254,2385,2393,248,3069,970,0
20:01:17,9665.051,Fox,4778,491,192,84,140,37,20,18,4778,4586,4502,3348,1090,1010,237,254,2385,2393,248,3069,970,0
20:01:18,9665.351,Fox,4778,491,192,80,144,37,20,18,4778,4586,4506,3348,1090,1010,237,254,2385,2393,248,3069,970,0
20:01:18,9666.25,Fox,4780,492,190,82,143,37,20,18,4778,4588,4506,3348,1090,1010,237,255,2386,2394,248,3070,970,0
20:01:18,9666.851,Fox,4782,493,192,84,143,36,20,18,4782,4590,4506,3348,1090,1010,237,256,2387,2395,248,3071,970,0
20:01:19,9667.45,Fox,4784,494,188,88,142,36,20,18,4782,4594,4506,3348,1090,1010,236,258,2387,2397,248,3072,970,0
20:01:19,9667.75,Fox,4784,494,190,86,144,36,20,18,4784,4594,4508,3348,1090,1010,236,258,2387,2397,248,3072,970,0
20:01:19,9668.65,Fox,4786,491,190,84,146,32,20,17,4784,4594,4510,3348,1090,1010,235,256,2387,2399,248,3076,971,0
20:01:20,9669.25,Fox,4788,491,188,88,144,32,20,17,4786,4598,4510,3349,1090,1010,234,257,2388,2400,248,3078,971,0
20:01:20,9669.851,Fox,4792,493,190,90,143,32,20,16,4790,4600,4510,3349,1090,1010,235,258,2391,2401,248,3079,972,0
20:01:20,9670.45,Fox,4792,493,192,90,141,34,20,16,4792,4600,4510,3351,1090,1010,235,258,2391,2401,248,3079,972,0
20:01:21,9671.351,Fox,4796,497,196,86,144,35,20,16,4796,4600,4514,3352,1090,1010,239,258,2395,2401,248,3079,972,0
20:01:22,9672.25,Fox,4800,495,200,86,141,32,20,16,4800,4600,4514,3353,1090,1010,238,257,2396,2404,248,3085,972,0
20:01:22,9673.15,Fox,4802,496,198,88,139,34,20,15,4800,4602,4514,3355,1090,1010,238,258,2397,2405,248,3085,973,0
20:01:23,9673.75,Fox,4806,499,204,88,139,33,20,15,4806,4602,4514,3355,1090,1010,238,261,2398,2408,248,3086,973,0
20:01:23,9674.351,Fox,4806,499,200,88,138,38,20,15,4806,4606,4518,3360,1090,1010,238,261,2398,2408,248,3086,973,0
20:01:24,9674.95,Fox,4808,499,200,90,136,36,22,15,4808,4608,4518,3361,1092,1010,238,261,2399,2409,248,3088,973,0
20:01:24,9675.551,Fox,4808,499,200,88,137,37,22,15,4808,4608,4520,3362,1092,1010,238,261,2399,2409,248,3088,973,0
20:01:25,9676.15,Fox,4808,499,194,94,130,44,22,15,4808,4614,4520,3369,1092,1010,238,261,2399,2409,248,3088,973,0
20:01:25,9676.75,Fox,4808,499,194,90,134,44,22,15,4808,4614,4524,3369,1092,1010,238,261,2399,2409,248,3088,973,0
20:01:25,9677.051,Fox,4808,499,194,90,134,44,21,16,4808,4614,4524,3369,1092,1011,238,261,2399,2409,248,3088,973,0
20:01:26,9677.95,Fox,4814,502,194,88,129,48,21,16,4808,4614,4526,3373,1092,1011,241,261,2405,2409,248,3091,973,0
20:01:27,9678.551,Fox,4814,502,200,84,132,49,21,16,4814,4614,4530,3374,1092,1011,241,261,2405,2409,248,3091,973,0
20:01:27,9679.45,Fox,4818,504,202,86,127,52,21,16,4818,4616,4530,3377,1092,1011,242,262,2408,2410,248,3093,973,0
20:01:28,9680.051,Fox,4820,503,200,88,125,52,21,15,4818,4618,4530,3378,1092,1011,243,260,2410,2410,248,3095,974,0
20:01:28,9680.65,Fox,4820,502,202,88,125,51,21,15,4820,4618,4530,3378,1092,1011,242,260,2410,2410,248,3096,974,0
20:01:28,9681.25,Fox,4820,501,200,86,128,51,21,15,4820,4620,4534,3379,1092,1011,242,259,2410,2410,248,3097,974,0
20:01:28,9681.551,Fox,4820,500,200,86,128,50,21,15,4820,4620,4534,3379,1092,1011,242,258,2410,2410,248,3098,974,0
20:01:29,9682.45,Fox,4826,503,202,88,125,50,21,15,4824,4622,4534,3381,1092,1011,242,261,2412,2414,248,3101,974,0
20:01:29,9683.051,Fox,4828,504,206,84,127,51,21,15,4828,4622,4538,3382,1092,1011,242,262,2413,2415,248,3102,974,0
20:01:30,9683.65,Fox,4828,499,206,80,129,49,23,12,4828,4622,4542,3384,1094,1011,238,261,2413,2415,248,3104,977,0
20:01:30,9684.551,Fox,4828,496,206,80,127,49,23,11,4828,4622,4542,3386,1094,1011,237,259,2413,2415,248,3106,978,0
20:01:30,9684.851,Fox,4828,494,206,80,126,48,23,11,4828,4622,4542,3387,1094,1011,237,257,2413,2415,248,3108,978,0
20:01:31,9685.75,Fox,4830,493,206,80,123,48,23,11,4828,4622,4542,3389,1094,1011,237,256,2414,2416,248,3111,978,0
20:01:31,9686.351,Fox,4832,492,210,78,117,53,23,11,4832,4622,4544,3396,1094,1011,237,255,2415,2417,248,3114,978,0
20:01:31,9686.95,Fox,4836,490,212,76,117,49,23,11,4834,4622,4546,3396,1094,1011,238,252,2418,2418,248,3120,978,0
20:01:32,9687.551,Fox,4838,491,214,78,117,48,23,11,4838,4624,4546,3396,1094,1011,238,253,2419,2419,248,3121,978,0
20:01:32,9688.15,Fox,4840,489,210,78,121,44,23,11,4838,4628,4550,3396,1094,1011,237,252,2420,2420,248,3125,978,0
20:01:32,9688.75,Fox,4840,488,210,78,121,45,23,11,4840,4630,4552,3398,1094,1011,237,251,2420,2420,248,3126,978,0
20:01:33,9689.351,Fox,4842,489,210,78,122,45,23,11,4842,4632,4554,3398,1094,1011,237,252,2421,2421,248,3127,978,0
20:01:33,9689.95,Fox,4842,486,204,82,123,41,23,13,4842,4638,4556,3399,1096,1013,237,249,2421,2421,248,3130,978,0
20:01:33,9690.551,Fox,4846,486,206,82,121,40,22,13,4844,4638,4556,3399,1096,1014,237,249,2423,2423,248,3133,979,0
20:01:33,9691.15,Fox,4846,486,206,82,117,46,22,13,4846,4640,4558,3405,1096,1014,237,249,2423,2423,248,3133,979,0
20:01:34,9691.75,Fox,4846,484,202,82,119,47,22,12,4846,4644,4562,3407,1096,1014,237,247,2423,2423,248,3134,980,0
20:01:34,9692.351,Fox,4848,485,204,82,114,51,22,12,4848,4644,4562,3411,1096,1014,237,248,2424,2424,248,3135,980,0
20:01:35,9692.95,Fox,4852,486,208,80,112,52,22,12,4852,4644,4564,3414,1096,1014,238,248,2426,2426,248,3138,980,0
20:01:35,9693.551,Fox,4852,485,204,82,114,51,22,12,4852,4648,4566,3414,1096,1014,238,247,2426,2426,248,3139,980,0
20:01:35,9694.15,Fox,4854,485,206,82,114,49,22,12,4854,4648,4566,3414,1096,1014,240,245,2428,2426,248,3141,980,0
20:01:35,9694.75,Fox,4858,487,208,84,111,50,22,12,4858,4650,4566,3416,1096,1014,238,249,2428,2430,248,3143,980,0
20:01:36,9695.351,Fox,4858,484,208,82,111,49,22,12,4858,4650,4568,3418,1096,1014,237,247,2428,2430,248,3146,980,0
20:01:36,9695.95,Fox,4858,483,208,80,113,48,22,12,4858,4650,4570,3418,1096,1014,236,247,2428,2430,248,3147,980,0
20:01:36,9696.551,Fox,4860,482,206,80,112,48,22,12,4858,4652,4572,3421,1096,1014,234,248,2428,2432,248,3150,980,0
20:01:36,9696.851,Fox,4860,478,208,80,112,44,22,12,4860,4652,4572,3421,1096,1014,234,244,2428,2432,248,3154,980,0
20:01:37,9697.75,Fox,4860,477,208,80,112,44,20,13,4860,4652,4572,3421,1096,1016,233,244,2428,2432,248,3154,981,0
20:01:37,9698.65,Fox,4860,476,208,78,114,44,18,14,4860,4652,4574,3421,1096,1018,233,243,2428,2432,248,3154,982,0
20:01:37,9699.25,Fox,4860,474,206,78,114,44,18,14,4860,4654,4576,3423,1096,1018,232,242,2428,2432,248,3156,982,0
20:01:38,9699.851,Fox,4860,474,204,78,114,46,18,14,4860,4656,4578,3425,1096,1018,232,242,2428,2432,248,3156,982,0
20:01:38,9700.45,Fox,4862,473,204,78,112,46,18,13,4860,4656,4578,3427,1096,1018,232,241,2429,2433,248,3158,983,0
20:01:38,9701.051,Fox,4864,475,206,78,110,47,19,13,4862,4656,4578,3429,1097,1018,233,242,2430,2434,248,3158,983,0
20:01:39,9701.65,Fox,4866,475,206,78,112,45,19,13,4864,4658,4580,3429,1097,1018,234,241,2432,2434,248,3160,983,0
20:01:39,9702.25,Fox,4866,473,204,80,112,45,19,13,4866,4662,4582,3431,1097,1018,234,239,2432,2434,248,3162,983,0
20:01:39,9702.851,Fox,4870,473,206,80,112,43,19,13,4870,4664,4584,3431,1097,1018,233,240,2435,2435,248,3166,983,0
20:01:39,9703.45,Fox,4872,473,208,78,111,43,20,13,4872,4664,4586,3433,1098,1018,234,239,2437,2435,248,3168,983,0
20:01:40,9704.051,Fox,4872,473,208,78,110,44,20,13,4872,4664,4586,3434,1098,1018,234,239,2437,2435,248,3168,983,0
20:01:40,9704.65,Fox,4872,473,208,76,112,44,20,13,4872,4664,4588,3434,1098,1018,234,239,2437,2435,248,3168,983,0
20:01:40,9705.851,Fox,4874,474,208,72,115,44,20,13,4872,4664,4592,3434,1098,1018,234,240,2438,2436,248,3169,983,0
20:01:41,9706.45,Fox,4876,475,210,70,116,44,20,13,4874,4664,4594,3434,1098,1018,234,241,2439,2437,248,3170,983,0
20:01:41,9707.051,Fox,4876,475,210,72,111,49,20,13,4876,4666,4594,3439,1098,1018,234,241,2439,2437,248,3170,983,0
20:01:41,9707.65,Fox,4876,475,210,70,111,51,20,13,4876,4666,4596,3441,1098,1018,234,241,2439,2437,248,3170,983,0
20:01:42,9708.25,Fox,4880,477,212,66,113,51,20,13,4878,4666,4600,3442,1098,1018,233,244,2440,2440,248,3172,983,0
20:01:42,9708.551,Fox,4880,477,212,68,112,52,20,13,4880,4668,4600,3443,1098,1018,233,244,2440,2440,248,3172,983,0
20:01:42,9709.45,Fox,4882,478,208,74,112,51,20,13,4882,4674,4600,3443,1098,1018,232,246,2440,2442,248,3173,983,0
20:01:42,9710.051,Fox,4882,476,204,78,110,51,20,13,4882,4678,4600,3445,1098,1018,232,244,2440,2442,249,3174,983,0
20:01:43,9710.65,Fox,4882,473,202,80,110,48,20,13,4882,4680,4600,3445,1098,1018,232,241,2440,2442,249,3177,983,0
20:01:43,9711.551,Fox,4882,470,202,78,112,45,20,13,4882,4680,4602,3445,1098,1018,230,240,2440,2442,249,3180,983,0
20:01:44,9712.45,Fox,4888,475,208,78,111,45,20,13,4888,4680,4602,3445,1098,1018,233,242,2444,2444,249,3181,983,0
20:01:44,9712.75,Fox,4888,473,208,74,114,44,20,13,4888,4680,4606,3446,1098,1018,232,241,2444,2444,249,3183,983,0
20:01:44,9713.65,Fox,4890,472,210,72,114,43,20,13,4890,4680,4608,3447,1098,1018,231,241,2444,2446,249,3186,983,0
20:01:45,9714.25,Fox,4892,473,210,74,112,44,19,14,4892,4682,4608,3448,1098,1019,232,241,2446,2446,249,3187,983,0
20:01:45,9714.851,Fox,4896,474,210,68,114,43,21,14,4892,4682,4614,3450,1100,1019,232,242,2448,2448,249,3190,983,0
20:01:45,9715.15,Fox,4896,474,212,70,114,41,23,14,4896,4684,4614,3450,1102,1019,232,242,2448,2448,249,3190,983,0
20:01:45,9716.051,Fox,4898,475,214,70,113,41,23,14,4898,4684,4614,3450,1102,1019,231,244,2448,2450,249,3191,983,0
20:01:46,9716.65,Fox,4900,476,212,72,111,42,23,14,4898,4686,4614,3451,1102,1019,232,244,2450,2450,249,3192,983,0
20:01:46,9717.25,Fox,4900,473,214,72,109,42,22,14,4900,4686,4614,3453,1102,1019,230,243,2450,2450,249,3195,983,0
20:01:46,9717.851,Fox,4900,469,210,74,111,36,24,14,4900,4690,4616,3453,1104,1019,229,240,2450,2450,249,3199,983,0
20:01:47,9718.75,Fox,4902,470,212,72,113,35,24,14,4902,4690,4618,3453,1104,1019,230,240,2451,2451,249,3200,983,0
20:01:47,9719.351,Fox,4902,469,210,74,113,34,24,14,4902,4692,4618,3453,1104,1019,230,239,2451,2451,249,3201,983,0
20:01:47,9719.95,Fox,4904,471,210,72,115,34,24,14,4902,4692,4620,3453,1104,1019,231,240,2452,2452,249,3201,983,0
20:01:47,9720.25,Fox,4904,469,212,72,115,32,24,14,4904,4692,4620,3453,1104,1019,229,240,2452,2452,249,3203,983,0
20:01:48,9721.15,Fox,4904,469,208,74,117,32,24,14,4904,4696,4622,3453,1104,1019,229,240,2452,2452,249,3203,983,0
20:01:48,9722.65,Fox,4906,471,208,76,115,34,24,14,4906,4698,4622,3455,1104,1019,229,242,2452,2454,249,3203,983,0
20:01:49,9723.25,Fox,4910,474,212,76,115,33,24,14,4910,4698,4622,3455,1104,1019,230,244,2453,2457,249,3204,983,0
20:01:49,9724.15,Fox,4912,475,212,78,110,37,24,14,4912,4700,4622,3460,1104,1019,230,245,2454,2458,249,3205,983,0
20:01:49,9725.051,Fox,4916,476,216,78,108,36,24,14,4916,4700,4622,3460,1104,1019,229,247,2456,2460,249,3208,983,0
20:01:50,9725.65,Fox,4920,477,220,78,102,39,24,14,4920,4700,4622,3465,1104,1019,231,246,2459,2461,249,3211,983,0
20:01:50,9725.95,Fox,4920,476,220,76,104,38,24,14,4920,4700,4624,3465,1104,1019,230,246,2459,2461,249,3212,983,0
20:01:50,9726.851,Fox,4924,478,222,74,106,38,24,14,4924,4702,4628,3465,1104,1019,230,248,2461,2463,249,3214,983,0
20:01:50,9727.45,Fox,4928,477,224,72,106,35,24,14,4926,4702,4630,3465,1104,1019,228,249,2462,2466,249,3219,983,0
20:01:51,9728.051,Fox,4928,477,226,70,107,36,24,14,4928,4702,4632,3466,1104,1019,228,249,2462,2466,249,3219,983,0
20:01:51,9728.65,Fox,4930,478,226,64,112,36,24,14,4928,4702,4638,3466,1104,1019,229,249,2464,2466,249,3220,983,0
20:01:51,9728.95,Fox,4930,478,228,64,111,37,24,14,4930,4702,4638,3467,1104,1019,229,249,2464,2466,249,3220,983,0
20:01:51,9729.851,Fox,4932,479,224,68,112,37,24,14,4932,4708,4640,3467,1104,1019,230,249,2466,2466,249,3221,983,0
20:01:52,9730.75,Fox,4934,479,224,66,115,37,23,14,4934,4710,4644,3467,1104,1019,229,250,2467,2467,249,3223,983,0
20:01:52,9731.351,Fox,4936,481,218,72,113,39,23,14,4934,4716,4644,3469,1104,1019,231,250,2469,2467,249,3223,983,0
20:01:52,9731.95,Fox,4936,481,218,72,115,39,23,14,4936,4718,4646,3469,1104,1019,231,250,2469,2467,249,3223,983,0
20:01:53,9732.551,Fox,4936,481,214,74,117,39,23,14,4936,4722,4648,3469,1104,1019,231,250,2469,2467,249,3223,983,0
20:01:53,9733.15,Fox,4936,479,212,74,119,37,23,14,4936,4724,4650,3469,1104,1019,231,248,2469,2467,249,3225,983,0
20:01:53,9733.75,Fox,4936,479,210,76,119,35,25,14,4936,4726,4650,3469,1106,1019,231,248,2469,2467,249,3225,983,0
20:01:54,9734.65,Fox,4938,475,212,76,115,33,25,14,4938,4726,4650,3472,1106,1019,230,245,2470,2468,249,3231,983,0
20:01:54,9735.25,Fox,4938,475,204,82,117,33,25,14,4938,4734,4652,3472,1106,1019,230,245,2470,2468,249,3231,983,0
20:01:54,9736.15,Fox,4940,471,200,86,115,28,26,14,4938,4738,4652,3473,1107,1019,229,242,2470,2470,249,3237,983,0
20:01:55,9736.75,Fox,4940,471,192,96,115,28,26,14,4940,4748,4652,3473,1107,1019,229,242,2470,2470,249,3237,983,0
20:01:55,9737.351,Fox,4944,473,194,98,111,30,26,14,4944,4750,4652,3475,1107,1019,230,243,2473,2471,249,3239,983,0
20:01:55,9737.65,Fox,4944,473,192,98,113,30,26,14,4944,4752,4654,3475,1107,1019,230,243,2473,2471,249,3239,983,0
20:01:55,9738.551,Fox,4944,472,192,96,113,31,26,14,4944,4752,4656,3477,1107,1019,230,242,2473,2471,249,3240,983,0
20:01:56,9739.15,Fox,4944,472,188,100,110,32,28,14,4944,4756,4656,3480,1109,1019,230,242,2473,2471,249,3240,983,0
20:01:56,9739.45,Fox,4944,470,188,100,110,31,28,13,4944,4756,4656,3480,1109,1019,229,241,2473,2471,249,3241,984,0
20:01:56,9740.65,Fox,4946,470,188,94,115,31,28,12,4944,4756,4662,3480,1109,1019,229,241,2475,2471,249,3242,985,0
20:01:56,9741.25,Fox,4946,470,190,94,114,31,29,12,4946,4756,4662,3481,1110,1019,229,241,2475,2471,249,3242,985,0
20:01:57,9741.851,Fox,4946,467,188,94,114,30,30,11,4946,4758,4664,3483,1111,1019,227,240,2475,2471,249,3244,986,0
20:01:57,9742.75,Fox,4948,468,186,96,113,30,30,11,4946,4760,4664,3483,1111,1019,227,241,2476,2472,249,3245,986,0
20:01:57,9743.351,Fox,4950,469,188,96,108,34,30,11,4948,4760,4664,3487,1111,1019,226,243,2476,2474,249,3246,986,0
20:01:58,9743.95,Fox,4952,470,190,98,103,38,30,11,4952,4762,4664,3491,1111,1019,227,243,2478,2474,249,3247,986,0
20:01:58,9744.551,Fox,4952,469,186,102,103,38,30,10,4952,4766,4664,3491,1111,1019,226,243,2478,2474,249,3247,987,0
20:01:58,9745.15,Fox,4952,466,184,104,103,35,30,10,4952,4768,4664,3491,1111,1019,224,242,2478,2474,249,3250,987,0
20:01:58,9745.75,Fox,4954,467,186,102,104,35,30,10,4954,4768,4666,3491,1111,1019,224,243,2479,2475,249,3251,987,0
20:01:59,9746.351,Fox,4954,466,186,102,102,36,28,12,4954,4768,4666,3493,1111,1021,224,242,2479,2475,249,3252,987,0
20:01:59,9746.65,Fox,4954,466,184,104,102,36,28,12,4954,4770,4666,3493,1111,1021,224,242,2479,2475,249,3252,987,0
20:01:59,9747.551,Fox,4954,464,176,110,103,35,28,12,4954,4778,4668,3494,1111,1021,222,242,2479,2475,249,3254,987,0
20:02:00,9748.15,Fox,4954,464,176,104,107,37,28,12,4954,4778,4674,3496,1111,1021,222,242,2479,2475,249,3254,987,0
20:02:00,9748.75,Fox,4956,463,176,100,107,38,28,12,4954,4778,4678,3499,1111,1021,222,241,2480,2476,249,3257,987,0
20:02:00,9749.351,Fox,4960,464,174,102,108,36,27,13,4956,4782,4680,3499,1111,1022,220,244,2481,2479,249,3260,987,0
20:02:00,9749.95,Fox,4962,465,178,102,105,38,27,13,4960,4782,4680,3501,1111,1022,220,245,2482,2480,249,3261,987,0
20:02:01,9750.551,Fox,4964,466,178,104,104,38,25,15,4962,4784,4680,3501,1111,1024,220,246,2483,2481,249,3262,987,0
20:02:01,9750.851,Fox,4964,465,180,104,104,38,25,14,4964,4784,4680,3501,1111,1024,220,245,2483,2481,249,3262,988,0
20:02:01,9751.75,Fox,4964,463,178,106,102,39,25,13,4964,4786,4680,3503,1111,1024,219,244,2483,2481,249,3263,989,0
20:02:01,9752.351,Fox,4964,461,174,110,100,39,25,13,4964,4790,4680,3505,1111,1024,219,242,2483,2481,249,3265,989,0
20:02:02,9752.95,Fox,4964,461,172,110,101,40,25,13,4964,4792,4682,3506,1111,1024,219,242,2483,2481,249,3265,989,0
20:02:02,9753.851,Fox,4964,457,168,112,103,36,25,13,4964,4796,4684,3506,1111,1024,218,239,2483,2481,249,3269,989,0
20:02:03,9754.75,Fox,4966,456,166,116,102,34,25,13,4966,4800,4684,3506,1111,1024,219,237,2485,2481,249,3272,989,0
20:02:03,9755.351,Fox,4968,458,166,114,104,34,25,13,4966,4800,4686,3506,1111,1024,219,239,2485,2483,249,3272,989,0
20:02:03,9755.95,Fox,4968,458,166,116,101,37,25,13,4968,4802,4686,3509,1111,1024,219,239,2485,2483,249,3272,989,0
20:02:04,9756.551,Fox,4970,458,162,116,103,38,25,12,4968,4806,4690,3511,1111,1024,217,241,2485,2485,249,3273,990,0
20:02:04,9757.15,Fox,4970,456,164,116,103,36,23,14,4970,4806,4690,3511,1111,1026,216,240,2485,2485,249,3275,990,0
20:02:04,9757.75,Fox,4970,455,162,118,103,35,23,14,4970,4808,4690,3511,1111,1026,215,240,2485,2485,249,3276,990,0
20:02:04,9758.051,Fox,4970,455,162,116,105,35,23,14,4970,4808,4692,3511,1111,1026,215,240,2485,2485,249,3276,990,0
20:02:04,9758.65,Fox,4970,455,162,116,104,36,23,14,4970,4808,4692,3512,1111,1026,215,240,2485,2485,249,3276,990,0
20:02:05,9759.551,Fox,4972,455,162,116,102,36,23,14,4970,4808,4692,3513,1111,1026,213,242,2485,2487,249,3278,990,0
20:02:05,9760.15,Fox,4972,454,164,112,106,35,23,14,4972,4808,4696,3513,1111,1026,213,241,2485,2487,249,3279,990,0
20:02:05,9760.75,Fox,4972,453,158,118,106,34,23,14,4972,4814,4696,3513,1111,1026,213,240,2485,2487,249,3280,990,0
20:02:05,9761.051,Fox,4972,452,158,116,108,34,23,13,4972,4814,4698,3513,1111,1026,213,239,2485,2487,249,3280,991,0
20:02:06,9762.25,Fox,4972,450,154,120,105,35,23,13,4972,4818,4698,3516,1111,1026,213,237,2485,2487,249,3282,991,0
20:02:06,9762.851,Fox,4972,448,152,120,105,35,23,13,4972,4820,4700,3518,1111,1026,211,237,2485,2487,249,3284,991,0
20:02:07,9763.75,Fox,4972,447,152,120,103,37,22,13,4972,4820,4700,3520,1111,1027,210,237,2485,2487,249,3284,992,0
20:02:07,9764.051,Fox,4972,447,152,120,103,37,20,15,4972,4820,4700,3520,1111,1029,210,237,2485,2487,249,3284,992,0
20:02:07,9765.25,Fox,4974,449,148,124,104,38,20,15,4974,4826,4702,3521,1111,1029,211,238,2486,2488,249,3284,992,0
20:02:07,9765.851,Fox,4976,450,146,126,101,40,20,15,4974,4828,4702,3523,1111,1029,211,239,2487,2489,249,3285,992,0
20:02:08,9766.45,Fox,4976,447,148,126,98,40,20,15,4976,4828,4702,3526,1111,1029,210,237,2487,2489,251,3286,992,0
20:02:08,9767.351,Fox,4978,446,150,126,97,38,20,15,4978,4828,4702,3526,1111,1029,209,237,2489,2489,251,3289,992,0
20:02:08,9768.25,Fox,4980,447,150,120,99,40,21,15,4978,4828,4708,3529,1112,1029,210,237,2491,2489,251,3290,992,0
20:02:09,9768.851,Fox,4980,447,148,124,98,41,21,15,4980,4832,4708,3530,1112,1029,210,237,2491,2489,251,3290,992,0
20:02:09,9769.45,Fox,4982,447,146,124,99,40,21,15,4980,4834,4710,3530,1112,1029,210,237,2492,2490,251,3292,992,0
20:02:09,9770.051,Fox,4982,446,144,122,105,39,21,15,4982,4838,4716,3530,1112,1029,210,236,2492,2490,251,3293,992,0
20:02:09,9770.351,Fox,4982,446,144,120,107,39,21,15,4982,4838,4718,3530,1112,1029,210,236,2492,2490,251,3293,992,0
20:02:10,9771.25,Fox,4982,446,142,118,111,39,21,15,4982,4840,4722,3530,1112,1029,210,236,2492,2490,251,3293,992,0
20:02:10,9771.851,Fox,4984,447,142,118,112,39,21,15,4984,4842,4724,3531,1112,1029,210,237,2493,2491,251,3294,992,0
20:02:10,9772.75,Fox,4988,446,144,116,112,36,21,15,4986,4842,4726,3531,1112,1029,212,234,2497,2491,251,3299,992,0
20:02:10,9773.351,Fox,4988,444,142,120,110,36,21,15,4988,4846,4726,3533,1112,1029,212,232,2497,2491,251,3301,992,0
20:02:11,9773.95,Fox,4988,441,142,112,117,34,21,15,4988,4846,4734,3534,1112,1029,211,230,2497,2491,251,3304,992,0
20:02:11,9775.15,Fox,4988,441,140,110,115,40,21,15,4988,4848,4738,3540,1112,1029,211,230,2497,2491,251,3304,992,0
20:02:11,9775.75,Fox,4992,443,136,104,124,39,21,15,4988,4852,4748,3540,1112,1029,211,232,2498,2494,251,3306,992,0
20:02:12,9776.351,Fox,4992,441,140,100,128,37,21,15,4992,4852,4752,3540,1112,1029,211,230,2498,2494,251,3308,992,0
20:02:12,9776.95,Fox,4992,439,138,102,128,35,21,15,4992,4854,4752,3540,1112,1029,210,229,2498,2494,251,3310,992,0
20:02:12,9777.551,Fox,4992,438,134,104,130,35,21,14,4992,4858,4754,3540,1112,1029,210,228,2498,2494,251,3310,993,0
20:02:12,9778.15,Fox,4994,439,134,102,130,37,20,14,4992,4858,4756,3542,1112,1029,210,229,2499,2495,251,3311,993,0
20:02:13,9778.75,Fox,4994,436,136,102,130,34,20,14,4994,4858,4756,3542,1112,1029,210,226,2499,2495,251,3314,993,0
20:02:13,9779.351,Fox,4996,436,136,104,127,35,20,14,4996,4860,4756,3544,1112,1029,210,226,2500,2496,251,3316,993,0
20:02:13,9780.25,Fox,4996,435,136,102,128,36,20,13,4996,4860,4758,3545,1112,1029,209,226,2500,2496,251,3316,994,0
20:02:14,9781.45,Fox,4996,435,136,100,129,37,20,13,4996,4860,4760,3546,1112,1029,209,226,2500,2496,251,3316,994,0
20:02:14,9782.051,Fox,4998,436,138,100,128,37,20,13,4998,4860,4760,3546,1112,1029,209,227,2501,2497,251,3317,994,0
20:02:14,9782.65,Fox,5002,439,142,98,130,36,20,13,5002,4860,4762,3546,1112,1029,212,227,2504,2498,251,3318,994,0
20:02:15,9783.25,Fox,5002,439,140,96,134,36,20,13,5002,4862,4766,3546,1112,1029,212,227,2504,2498,251,3318,994,0
20:02:15,9783.851,Fox,5002,437,138,96,136,34,20,13,5002,4864,4768,3546,1112,1029,212,225,2504,2498,251,3320,994,0
20:02:15,9784.45,Fox,5004,438,136,98,136,30,23,13,5002,4866,4768,3546,1115,1029,213,225,2505,2499,251,3321,994,0
20:02:15,9785.051,Fox,5006,440,140,98,136,30,23,13,5006,4866,4768,3546,1115,1029,214,226,2506,2500,251,3321,994,0
20:02:16,9785.65,Fox,5008,435,138,100,137,22,25,13,5008,4870,4770,3546,1117,1029,212,223,2507,2501,251,3328,994,0
20:02:16,9786.25,Fox,5008,435,136,94,144,23,25,13,5008,4872,4778,3547,1117,1029,212,223,2507,2501,251,3328,994,0
20:02:16,9787.15,Fox,5010,436,136,94,140,26,25,13,5008,4872,4778,3550,1117,1029,212,224,2508,2502,251,3329,994,0
20:02:16,9787.75,Fox,5012,438,140,92,140,28,25,13,5012,4872,4780,3552,1117,1029,213,225,2509,2503,251,3329,994,0
20:02:17,9788.351,Fox,5014,439,140,90,139,28,27,13,5012,4872,4782,3554,1119,1029,214,225,2511,2503,251,3330,994,0
20:02:17,9788.95,Fox,5016,438,142,90,135,29,29,13,5016,4874,4784,3560,1121,1029,214,224,2512,2504,251,3333,994,0
20:02:17,9789.551,Fox,5018,436,140,92,135,27,29,11,5016,4876,4784,3560,1121,1029,215,221,2513,2505,251,3335,996,0
20:02:17,9790.15,Fox,5024,440,144,90,134,26,31,11,5020,4876,4786,3561,1123,1029,215,225,2515,2509,251,3337,996,0
20:02:18,9790.75,Fox,5026,440,148,90,134,26,31,11,5026,4878,4788,3562,1123,1029,214,226,2515,2511,251,3339,996,0
20:02:18,9791.351,Fox,5028,440,148,88,137,26,31,10,5028,4880,4792,3562,1123,1029,215,225,2517,2511,251,3340,997,0
20:02:18,9792.25,Fox,5028,439,146,90,135,27,31,10,5028,4882,4792,3564,1123,1029,215,224,2517,2511,251,3341,997,0
20:02:19,9792.851,Fox,5030,440,146,86,137,28,31,10,5028,4882,4796,3565,1123,1029,216,224,2519,2511,251,3342,997,0
20:02:19,9793.45,Fox,5032,441,148,82,139,29,31,10,5030,4882,4800,3566,1123,1029,217,224,2521,2511,251,3343,997,0
20:02:19,9793.75,Fox,5032,441,150,82,139,29,31,10,5032,4882,4800,3566,1123,1029,217,224,2521,2511,251,3343,997,0
20:02:19,9794.65,Fox,5032,440,150,80,141,29,31,9,5032,4882,4802,3566,1123,1029,216,224,2521,2511,251,3343,998,0
20:02:20,9795.25,Fox,5032,440,144,82,143,31,31,9,5032,4888,4806,3568,1123,1029,216,224,2521,2511,251,3343,998,0
20:02:20,9796.15,Fox,5032,440,142,82,145,31,31,9,5032,4890,4808,3568,1123,1029,216,224,2521,2511,251,3343,998,0
20:02:20,9796.75,Fox,5032,439,140,84,145,30,31,9,5032,4892,4808,3568,1123,1029,216,223,2521,2511,251,3344,998,0
20:02:21,9797.65,Fox,5034,438,136,88,144,28,31,9,5032,4896,4808,3568,1123,1029,217,221,2523,2511,251,3347,998,0
20:02:21,9798.25,Fox,5036,437,140,88,142,27,31,9,5036,4896,4808,3569,1123,1029,217,220,2524,2512,251,3350,998,0
20:02:21,9798.851,Fox,5038,437,140,90,141,26,31,9,5038,4898,4808,3569,1123,1029,216,221,2524,2514,251,3352,998,0
20:02:22,9799.45,Fox,5040,436,140,86,147,23,31,9,5040,4900,4814,3569,1123,1029,215,221,2524,2516,251,3355,998,0
20:02:22,9800.351,Fox,5040,434,140,86,147,22,31,8,5040,4900,4814,3569,1123,1029,214,220,2524,2516,251,3356,999,0
20:02:22,9800.95,Fox,5040,434,140,82,145,28,31,8,5040,4900,4818,3575,1123,1029,214,220,2524,2516,251,3356,999,0
20:02:23,9801.551,Fox,5040,432,138,82,147,27,31,7,5040,4902,4820,3575,1123,1029,213,219,2524,2516,251,3357,1000,0
20:02:23,9801.851,Fox,5040,431,138,82,146,28,31,6,5040,4902,4820,3576,1123,1029,212,219,2524,2516,251,3357,1001,0
20:02:23,9803.051,Fox,5040,428,136,84,146,25,31,6,5040,4904,4820,3576,1123,1029,209,219,2524,2516,251,3360,1001,0
20:02:24,9803.95,Fox,5040,426,136,78,152,24,30,6,5040,4904,4826,3576,1123,1029,208,218,2524,2516,251,3362,1001,0
20:02:24,9804.25,Fox,5040,426,136,76,154,24,30,6,5040,4904,4828,3576,1123,1029,208,218,2524,2516,251,3362,1001,0
20:02:24,9805.45,Fox,5042,427,136,78,153,24,30,6,5042,4906,4828,3576,1123,1029,208,219,2525,2517,251,3363,1001,0
20:02:25,9806.051,Fox,5042,425,132,82,152,23,30,6,5042,4910,4828,3577,1123,1029,207,218,2525,2517,251,3365,1001,0
20:02:25,9806.95,Fox,5046,428,132,84,151,23,30,6,5044,4912,4828,3577,1123,1029,208,220,2527,2519,251,3366,1001,0
20:02:25,9807.551,Fox,5046,428,130,84,153,25,30,6,5046,4916,4832,3579,1123,1029,208,220,2527,2519,251,3366,1001,0
20:02:26,9808.45,Fox,5048,428,126,84,150,30,30,6,5046,4920,4836,3585,1123,1029,209,219,2529,2519,251,3368,1001,0
20:02:26,9809.051,Fox,5052,430,128,82,148,32,30,6,5048,4920,4838,3587,1123,1029,207,223,2529,2523,251,3370,1001,0
20:02:26,9809.65,Fox,5052,430,128,84,148,34,30,6,5052,4924,4840,3589,1123,1029,207,223,2529,2523,251,3370,1001,0
20:02:27,9810.25,Fox,5056,433,126,88,147,34,30,6,5054,4928,4840,3589,1123,1029,206,227,2529,2527,251,3371,1001,0
20:02:27,9810.851,Fox,5058,433,128,86,148,33,30,6,5056,4928,4842,3589,1123,1029,205,228,2529,2529,251,3373,1001,0
20:02:28,9811.45,Fox,5060,432,128,88,147,31,30,6,5058,4930,4842,3589,1123,1029,203,229,2530,2530,251,3376,1001,0
20:02:28,9812.051,Fox,5060,432,130,84,151,31,30,6,5060,4930,4846,3589,1123,1029,203,229,2530,2530,251,3376,1001,0
20:02:28,9812.351,Fox,5060,431,128,86,151,30,28,8,5060,4932,4846,3589,1123,1031,203,228,2530,2530,251,3377,1001,0
20:02:28,9813.551,Fox,5060,431,126,86,151,32,28,8,5060,4934,4848,3591,1123,1031,203,228,2530,2530,251,3377,1001,0
20:02:29,9814.45,Fox,5064,433,126,84,151,34,28,8,5062,4936,4852,3593,1123,1031,205,228,2534,2530,251,3379,1001,0
20:02:29,9815.051,Fox,5066,433,128,84,150,34,28,7,5064,4936,4852,3593,1123,1031,205,228,2535,2531,251,3380,1002,0
20:02:29,9815.65,Fox,5068,434,130,82,149,36,28,7,5066,4936,4854,3595,1123,1031,204,230,2535,2533,251,3381,1002,0
20:02:29,9815.95,Fox,5068,434,132,78,153,36,28,7,5068,4936,4858,3595,1123,1031,204,230,2535,2533,251,3381,1002,0
20:02:30,9816.851,Fox,5070,434,134,78,150,37,28,7,5070,4936,4858,3597,1123,1031,205,229,2537,2533,251,3383,1002,0
20:02:30,9817.45,Fox,5072,433,134,80,149,37,28,5,5072,4938,4858,3597,1123,1031,205,228,2538,2534,251,3384,1004,0
20:02:30,9818.351,Fox,5072,431,134,78,149,38,28,4,5072,4938,4860,3599,1123,1031,205,226,2538,2534,251,3385,1005,0
20:02:31,9818.95,Fox,5074,426,132,80,149,31,28,4,5072,4940,4860,3599,1123,1031,202,224,2539,2535,251,3392,1005,0
20:02:31,9819.551,Fox,5080,428,136,80,147,29,28,4,5076,4940,4860,3599,1123,1031,202,226,2541,2539,251,3396,1005,0
20:02:31,9820.15,Fox,5082,427,138,84,145,28,28,4,5082,4944,4860,3600,1123,1031,202,225,2542,2540,251,3399,1005,0
20:02:31,9820.75,Fox,5082,427,138,84,145,28,26,6,5082,4944,4860,3600,1123,1033,202,225,2542,2540,251,3399,1005,0
20:02:32,9821.65,Fox,5088,430,142,84,141,29,26,6,5086,4944,4860,3601,1123,1033,201,229,2544,2544,251,3402,1005,0
20:02:32,9821.95,Fox,5088,430,144,82,143,29,26,6,5088,4944,4862,3601,1123,1033,201,229,2544,2544,251,3402,1005,0
20:02:32,9822.851,Fox,5090,430,144,80,143,30,26,5,5088,4944,4864,3602,1123,1033,201,229,2546,2544,251,3403,1006,0
20:02:32,9823.45,Fox,5090,430,144,80,145,30,26,5,5090,4946,4866,3602,1123,1033,201,229,2546,2544,251,3403,1006,0
20:02:33,9824.051,Fox,5090,428,144,76,149,28,26,5,5090,4946,4870,3602,1123,1033,200,228,2546,2544,251,3405,1006,0
20:02:33,9824.95,Fox,5092,429,144,74,150,28,26,5,5090,4946,4872,3602,1123,1033,201,228,2548,2544,251,3406,1006,0
20:02:33,9825.551,Fox,5094,431,144,76,148,30,26,5,5092,4948,4872,3604,1123,1033,203,228,2550,2544,251,3406,1006,0
20:02:34,9826.15,Fox,5096,431,146,78,148,28,26,5,5096,4950,4872,3604,1123,1033,203,228,2551,2545,251,3408,1006,0
20:02:34,9826.45,Fox,5096,431,144,80,148,28,26,5,5096,4952,4872,3604,1123,1033,203,228,2551,2545,251,3408,1006,0
20:02:34,9827.65,Fox,5100,433,146,78,149,27,25,6,5098,4952,4874,3604,1123,1034,204,229,2553,2547,251,3410,1006,0
20:02:34,9828.25,Fox,5102,434,148,78,150,27,25,6,5102,4954,4876,3604,1123,1034,204,230,2554,2548,251,3411,1006,0
20:02:35,9828.851,Fox,5104,433,150,78,144,30,25,6,5104,4954,4876,3609,1123,1034,203,230,2555,2549,251,3414,1006,0
20:02:35,9829.45,Fox,5106,434,152,76,144,31,25,6,5106,4954,4878,3610,1123,1034,202,232,2555,2551,251,3415,1006,0
20:02:35,9830.051,Fox,5108,435,152,74,143,33,25,6,5106,4954,4880,3612,1123,1034,202,233,2556,2552,251,3416,1006,0
20:02:35,9830.65,Fox,5108,434,154,72,143,34,25,6,5108,4954,4882,3614,1123,1034,202,232,2556,2552,251,3417,1006,0
20:02:36,9831.551,Fox,5112,437,154,74,139,37,25,6,5110,4956,4882,3617,1123,1034,202,235,2557,2555,251,3418,1006,0
20:02:36,9832.15,Fox,5112,436,152,78,138,37,25,6,5112,4960,4882,3618,1123,1034,202,234,2557,2555,251,3419,1006,0
20:02:36,9832.75,Fox,5114,437,150,80,137,35,27,6,5112,4962,4882,3619,1125,1034,201,236,2557,2557,251,3420,1006,0
20:02:37,9833.351,Fox,5114,436,150,82,137,34,27,6,5114,4964,4882,3619,1125,1034,201,235,2557,2557,251,3421,1006,0
20:02:37,9833.95,Fox,5116,437,150,76,140,36,27,6,5114,4964,4888,3621,1125,1034,202,235,2559,2557,251,3422,1006,0
20:02:37,9834.551,Fox,5118,438,152,76,136,39,27,6,5116,4964,4888,3624,1125,1034,201,237,2559,2559,251,3423,1006,0
20:02:37,9835.15,Fox,5118,438,154,74,136,41,27,6,5118,4964,4890,3626,1125,1034,201,237,2559,2559,251,3423,1006,0
20:02:38,9835.75,Fox,5120,439,156,72,131,48,27,5,5120,4964,4892,3633,1125,1034,201,238,2560,2560,251,3423,1007,0
20:02:38,9836.351,Fox,5120,437,156,68,133,49,27,4,5120,4964,4896,3635,1125,1034,201,236,2560,2560,252,3423,1008,0
20:02:38,9836.95,Fox,5124,439,156,68,130,50,27,4,5120,4964,4896,3637,1125,1034,202,237,2563,2561,252,3425,1008,0
20:02:38,9837.551,Fox,5126,440,160,68,131,48,29,4,5126,4966,4898,3637,1127,1034,203,237,2565,2561,252,3426,1008,0
20:02:39,9838.15,Fox,5126,440,158,68,129,52,29,4,5126,4968,4900,3641,1127,1034,203,237,2565,2561,252,3426,1008,0
20:02:39,9838.75,Fox,5130,442,162,68,128,51,28,5,5130,4968,4900,3641,1127,1035,204,238,2568,2562,252,3428,1008,0
20:02:39,9839.351,Fox,5132,440,162,70,128,47,28,5,5132,4970,4900,3641,1127,1035,204,236,2569,2563,252,3432,1008,0
20:02:39,9839.95,Fox,5132,439,162,68,130,46,28,5,5132,4970,4902,3641,1127,1035,204,235,2569,2563,252,3433,1008,0
20:02:40,9840.851,Fox,5132,436,162,68,129,44,27,6,5132,4970,4902,3642,1127,1036,204,232,2569,2563,252,3436,1008,0
20:02:40,9841.45,Fox,5134,437,164,66,129,45,27,6,5134,4970,4904,3644,1127,1036,204,233,2569,2565,252,3437,1008,0
20:02:40,9842.051,Fox,5136,435,166,66,128,40,29,6,5136,4970,4904,3644,1129,1036,203,232,2570,2566,252,3441,1008,0
20:02:40,9842.65,Fox,5136,434,164,68,128,39,29,6,5136,4972,4904,3644,1129,1036,203,231,2570,2566,252,3442,1008,0
20:02:41,9843.25,Fox,5138,434,164,68,125,40,29,6,5136,4972,4904,3646,1129,1036,202,232,2570,2568,252,3444,1008,0
20:02:41,9843.851,Fox,5140,435,166,66,124,42,29,6,5138,4972,4906,3648,1129,1036,201,234,2570,2570,252,3445,1008,0
20:02:41,9844.45,Fox,5140,433,168,62,126,42,29,6,5140,4972,4910,3650,1129,1036,201,232,2570,2570,252,3447,1008,0
20:02:42,9845.051,Fox,5148,436,172,62,124,39,29,6,5144,4972,4910,3650,1129,1036,201,235,2573,2575,252,3452,1008,0
20:02:42,9845.65,Fox,5150,435,176,60,124,38,29,6,5148,4972,4912,3651,1129,1036,202,233,2575,2575,252,3455,1008,0
20:02:42,9846.25,Fox,5150,428,178,56,122,37,29,6,5150,4972,4916,3657,1129,1036,200,228,2575,2575,252,3462,1008,0
20:02:42,9846.851,Fox,5152,427,180,52,125,34,30,6,5152,4972,4920,3657,1130,1036,200,227,2576,2576,252,3465,1008,0
20:02:43,9847.45,Fox,5158,429,182,52,123,32,30,6,5154,4972,4920,3657,1130,1036,202,227,2580,2578,252,3469,1008,0
20:02:43,9848.051,Fox,5158,429,184,50,126,33,30,6,5158,4974,4924,3658,1130,1036,202,227,2580,2578,252,3469,1008,0
20:02:43,9848.65,Fox,5160,428,182,50,126,32,30,6,5158,4976,4926,3659,1130,1036,203,225,2582,2578,252,3472,1008,0
20:02:44,9849.25,Fox,5162,429,184,48,125,34,30,6,5160,4976,4928,3661,1130,1036,203,226,2583,2579,252,3473,1008,0
20:02:44,9849.851,Fox,5162,429,184,50,125,34,30,6,5162,4978,4928,3661,1130,1036,203,226,2583,2579,252,3473,1008,0
20:02:44,9850.45,Fox,5162,429,184,48,125,36,30,6,5162,4978,4930,3663,1130,1036,203,226,2583,2579,252,3473,1008,0
20:02:44,9851.051,Fox,5166,431,184,48,125,36,30,6,5164,4980,4932,3664,1130,1036,204,227,2585,2581,252,3475,1008,0
20:02:44,9851.65,Fox,5170,433,186,48,121,38,30,6,5166,4980,4932,3666,1130,1036,204,229,2587,2583,252,3477,1008,0
20:02:45,9852.25,Fox,5172,433,188,48,123,36,29,7,5170,4982,4934,3666,1130,1037,206,227,2589,2583,252,3479,1008,0
20:02:45,9852.851,Fox,5174,434,190,46,121,39,27,9,5172,4982,4936,3670,1130,1039,206,228,2590,2584,252,3480,1008,0
20:02:45,9853.45,Fox,5174,433,192,46,121,38,27,9,5174,4982,4936,3670,1130,1039,205,228,2590,2584,252,3481,1008,0
20:02:45,9854.051,Fox,5174,431,192,46,117,40,27,9,5174,4982,4936,3674,1130,1039,205,226,2590,2584,252,3483,1008,0
20:02:46,9854.65,Fox,5174,429,190,48,117,38,27,9,5174,4984,4936,3674,1130,1039,205,224,2590,2584,252,3485,1008,0
20:02:46,9855.25,Fox,5174,429,188,50,112,43,25,11,5174,4986,4936,3679,1130,1041,205,224,2590,2584,252,3485,1008,0
20:02:46,9855.851,Fox,5174,429,186,50,114,43,25,11,5174,4988,4938,3679,1130,1041,205,224,2590,2584,252,3485,1008,0
20:02:46,9856.45,Fox,5174,428,186,50,113,43,25,11,5174,4988,4938,3680,1130,1041,205,223,2590,2584,252,3486,1008,0
20:02:47,9857.051,Fox,5176,424,188,50,112,38,25,11,5176,4988,4938,3680,1130,1041,201,223,2590,2586,252,3492,1008,0
20:02:47,9857.65,Fox,5176,424,188,48,114,38,25,11,5176,4988,4940,3680,1130,1041,201,223,2590,2586,252,3492,1008,0
20:02:47,9858.851,Fox,5176,422,184,48,118,36,25,11,5176,4992,4944,3680,1130,1041,201,221,2590,2586,252,3494,1008,0
20:02:48,9859.45,Fox,5178,424,186,48,118,36,25,11,5178,4992,4944,3680,1130,1041,201,223,2590,2588,252,3494,1008,0
20:02:48,9859.75,Fox,5178,422,186,48,117,35,25,11,5178,4992,4944,3681,1130,1041,201,221,2590,2588,252,3496,1008,0
20:02:48,9860.65,Fox,5180,422,188,48,116,35,25,10,5180,4992,4944,3681,1130,1041,199,223,2590,2590,252,3498,1008,0
20:02:48,9860.95,Fox,5180,420,186,50,112,37,25,10,5180,4994,4944,3685,1130,1041,199,221,2590,2590,252,3500,1008,0
20:02:49,9861.851,Fox,5184,420,188,52,109,36,25,10,5184,4996,4944,3686,1130,1041,198,222,2591,2593,252,3504,1008,0
20:02:49,9862.45,Fox,5186,420,188,50,110,35,25,10,5184,4996,4946,3686,1130,1041,198,222,2593,2593,252,3506,1008,0
20:02:49,9862.75,Fox,5186,420,190,50,110,35,25,10,5186,4996,4946,3686,1130,1041,198,222,2593,2593,252,3506,1008,0
20:02:49,9863.351,Fox,5186,416,190,50,110,31,25,10,5186,4996,4946,3686,1130,1041,194,222,2593,2593,252,3510,1008,0
20:02:49,9864.25,Fox,5186,412,190,48,108,31,25,10,5186,4996,4948,3690,1130,1041,193,219,2593,2593,252,3514,1008,0
20:02:50,9864.851,Fox,5186,412,188,48,109,32,25,10,5186,4998,4950,3691,1130,1041,193,219,2593,2593,252,3514,1008,0
20:02:50,9865.45,Fox,5186,411,184,50,111,31,25,10,5186,5002,4952,3691,1130,1041,193,218,2593,2593,252,3515,1008,0
20:02:50,9866.051,Fox,5188,408,184,50,110,27,25,10,5186,5002,4952,3691,1130,1041,191,217,2593,2595,252,3520,1008,0
20:02:50,9866.65,Fox,5192,410,190,50,108,27,25,10,5192,5002,4952,3691,1130,1041,190,220,2594,2598,252,3522,1008,0
20:02:51,9867.25,Fox,5192,409,188,50,110,26,25,10,5192,5004,4954,3691,1130,1041,190,219,2594,2598,252,3523,1008,0
20:02:51,9867.851,Fox,5192,409,186,52,107,29,25,10,5192,5006,4954,3694,1130,1041,190,219,2594,2598,252,3523,1008,0
20:02:51,9868.45,Fox,5194,410,186,54,104,31,25,10,5194,5008,4954,3696,1130,1041,191,219,2596,2598,252,3524,1008,0
20:02:51,9869.051,Fox,5194,410,186,54,103,32,25,10,5194,5008,4954,3697,1130,1041,191,219,2596,2598,252,3524,1008,0
20:02:52,9870.25,Fox,5194,409,182,56,104,32,25,10,5194,5012,4956,3698,1130,1041,190,219,2596,2598,252,3525,1008,0
20:02:52,9871.15,Fox,5196,410,180,54,106,33,23,12,5194,5014,4960,3700,1130,1043,190,220,2597,2599,252,3526,1008,0
20:02:52,9871.45,Fox,5196,407,180,54,108,30,23,12,5196,5016,4962,3700,1130,1043,188,219,2597,2599,252,3529,1008,0
20:02:53,9872.351,Fox,5196,406,178,54,107,32,23,12,5196,5018,4964,3703,1130,1043,187,219,2597,2599,252,3530,1008,0
20:02:53,9872.95,Fox,5196,406,172,60,107,32,23,12,5196,5024,4964,3703,1130,1043,187,219,2597,2599,252,3530,1008,0
20:02:53,9873.551,Fox,5196,406,170,62,107,32,22,13,5196,5026,4964,3703,1130,1044,187,219,2597,2599,252,3530,1008,0
20:02:54,9874.15,Fox,5198,407,168,64,105,33,22,13,5196,5028,4964,3704,1130,1044,186,221,2597,2601,252,3531,1008,0
20:02:54,9874.75,Fox,5200,405,172,64,101,33,22,13,5200,5028,4964,3708,1130,1044,188,217,2599,2601,252,3535,1008,0
20:02:54,9875.051,Fox,5200,404,172,64,101,32,22,13,5200,5028,4964,3708,1130,1044,188,216,2599,2601,252,3536,1008,0
20:02:54,9875.95,Fox,5200,404,170,64,102,33,22,13,5200,5030,4966,3709,1130,1044,188,216,2599,2601,252,3536,1008,0
20:02:54,9876.551,Fox,5202,405,170,66,97,37,20,15,5202,5032,4966,3713,1130,1046,189,216,2601,2601,252,3537,1008,0
20:02:55,9877.15,Fox,5204,406,172,64,99,36,20,15,5204,5032,4968,3713,1130,1046,189,217,2602,2602,252,3538,1008,0
20:02:55,9877.75,Fox,5206,407,174,64,99,35,20,15,5206,5032,4968,3713,1130,1046,188,219,2602,2604,252,3539,1008,0
20:02:55,9878.351,Fox,5208,405,174,62,98,34,19,16,5206,5032,4970,3715,1130,1047,186,219,2602,2606,252,3543,1008,0
20:02:55,9878.95,Fox,5210,405,178,62,97,33,19,16,5210,5032,4970,3715,1130,1047,186,219,2603,2607,252,3545,1008,0
20:02:56,9879.551,Fox,5210,402,178,62,97,32,18,15,5210,5032,4970,3715,1130,1048,184,218,2603,2607,252,3547,1009,0
20:02:56,9880.15,Fox,5212,403,180,62,97,31,18,15,5212,5032,4970,3715,1130,1048,184,219,2604,2608,252,3548,1009,0
20:02:56,9880.75,Fox,5214,403,176,66,96,30,18,15,5212,5036,4970,3715,1130,1048,185,218,2606,2608,252,3550,1009,0
20:02:56,9881.351,Fox,5216,403,176,66,98,28,18,15,5214,5038,4972,3715,1130,1048,186,217,2608,2608,252,3552,1009,0
20:02:57,9881.95,Fox,5216,403,176,68,98,27,19,15,5216,5040,4972,3715,1131,1048,186,217,2608,2608,252,3552,1009,0
20:02:57,9882.551,Fox,5218,403,176,68,95,26,21,15,5216,5040,4972,3717,1133,1048,185,218,2608,2610,252,3554,1009,0
20:02:57,9882.851,Fox,5218,401,178,68,94,25,21,15,5218,5040,4972,3718,1133,1048,184,217,2608,2610,252,3556,1009,0
20:02:57,9883.45,Fox,5218,401,178,68,93,26,21,15,5218,5040,4972,3719,1133,1048,184,217,2608,2610,252,3556,1009,0
20:02:58,9884.351,Fox,5218,400,178,68,90,28,21,15,5218,5040,4972,3722,1133,1048,184,216,2608,2610,252,3557,1009,0
20:02:58,9884.95,Fox,5218,397,178,68,90,25,21,15,5218,5040,4972,3722,1133,1048,183,214,2608,2610,252,3560,1009,0
20:02:58,9885.551,Fox,5218,396,178,68,90,25,21,14,5218,5040,4972,3722,1133,1048,183,213,2608,2610,252,3560,1010,0
20:02:59,9886.75,Fox,5222,394,182,66,90,21,21,14,5222,5040,4974,3722,1133,1048,183,211,2610,2612,252,3566,1010,0
20:02:59,9887.351,Fox,5226,396,186,64,90,21,21,14,5226,5040,4976,3722,1133,1048,183,213,2612,2614,252,3568,1010,0
20:02:59,9887.95,Fox,5230,398,184,66,87,22,21,14,5226,5042,4976,3723,1133,1048,184,214,2615,2615,252,3570,1010,0
20:02:59,9888.551,Fox,5230,397,188,64,88,23,21,13,5230,5042,4978,3724,1133,1048,183,214,2615,2615,252,3570,1011,0
20:02:59,9888.851,Fox,5230,395,188,64,88,21,21,13,5230,5042,4978,3724,1133,1048,183,212,2615,2615,252,3572,1011,0
20:03:00,9889.75,Fox,5230,395,184,66,88,23,21,13,5230,5046,4980,3726,1133,1048,183,212,2615,2615,252,3572,1011,0
20:03:00,9890.351,Fox,5232,396,184,66,85,25,21,13,5230,5046,4980,3728,1133,1048,184,212,2617,2615,252,3573,1011,0
20:03:00,9890.95,Fox,5236,398,188,64,84,26,21,13,5234,5046,4982,3730,1133,1048,184,214,2619,2617,252,3575,1011,0
20:03:00,9891.25,Fox,5236,397,188,66,84,26,21,12,5236,5048,4982,3730,1133,1048,184,213,2619,2617,252,3575,1012,0
20:03:01,9892.15,Fox,5240,398,188,70,82,26,21,11,5240,5052,4982,3730,1133,1048,185,213,2622,2618,252,3577,1013,0
20:03:01,9892.75,Fox,5242,397,188,72,81,24,21,11,5242,5054,4982,3730,1133,1048,184,213,2623,2619,252,3580,1013,0
20:03:01,9893.351,Fox,5242,396,186,72,83,23,21,11,5242,5056,4984,3730,1133,1048,184,212,2623,2619,252,3581,1013,0
20:03:01,9893.95,Fox,5242,394,184,72,81,26,21,10,5242,5058,4986,3734,1133,1048,183,211,2623,2619,252,3582,1014,0
20:03:02,9894.551,Fox,5242,394,182,72,83,22,25,10,5242,5060,4988,3734,1137,1048,183,211,2623,2619,252,3582,1014,0
20:03:02,9895.15,Fox,5246,395,186,72,80,22,25,10,5246,5060,4988,3736,1137,1048,183,212,2625,2621,252,3585,1014,0
20:03:02,9896.051,Fox,5248,396,188,72,77,24,25,10,5248,5060,4988,3738,1137,1048,184,212,2627,2621,252,3586,1014,0
20:03:03,9896.95,Fox,5252,398,188,74,73,26,25,10,5250,5062,4988,3740,1137,1048,184,214,2629,2623,252,3588,1014,0
20:03:03,9897.551,Fox,5252,398,188,72,75,28,25,10,5252,5064,4992,3742,1137,1048,184,214,2629,2623,252,3588,1014,0
20:03:03,9898.15,Fox,5252,397,186,74,75,27,25,10,5252,5066,4992,3742,1137,1048,184,213,2629,2623,252,3589,1014,0
20:03:03,9898.75,Fox,5252,396,184,76,75,26,25,10,5252,5068,4992,3742,1137,1048,184,212,2629,2623,252,3590,1014,0
20:03:04,9899.65,Fox,5252,396,182,76,77,26,25,10,5252,5070,4994,3742,1137,1048,184,212,2629,2623,252,3590,1014,0
20:03:04,9900.25,Fox,5254,395,182,78,75,25,25,10,5254,5072,4994,3743,1137,1048,185,210,2631,2623,252,3593,1014,0
20:03:04,9900.551,Fox,5254,393,182,76,77,23,25,10,5254,5072,4996,3743,1137,1048,184,209,2631,2623,252,3595,1014,0
20:03:05,9901.45,Fox,5256,393,184,76,77,20,26,10,5256,5072,4996,3743,1138,1048,185,208,2632,2624,252,3597,1014,0
20:03:05,9902.051,Fox,5256,393,180,80,76,21,26,10,5256,5076,4996,3744,1138,1048,185,208,2632,2624,252,3597,1014,0
20:03:05,9902.65,Fox,5256,393,174,86,76,21,26,10,5256,5082,4996,3744,1138,1048,185,208,2632,2624,252,3597,1014,0
20:03:05,9903.25,Fox,5256,393,174,84,78,21,26,10,5256,5082,4998,3744,1138,1048,185,208,2632,2624,252,3597,1014,0
20:03:06,9904.15,Fox,5256,393,170,84,80,23,26,10,5256,5086,5002,3746,1138,1048,185,208,2632,2624,252,3597,1014,0
20:03:06,9904.75,Fox,5256,390,168,86,77,23,26,10,5256,5088,5002,3749,1138,1048,184,206,2632,2624,252,3600,1014,0
20:03:06,9905.65,Fox,5256,388,166,88,75,23,25,11,5256,5090,5002,3751,1138,1049,184,204,2632,2624,252,3602,1014,0
20:03:06,9906.25,Fox,5258,387,168,84,78,21,25,11,5258,5090,5006,3751,1138,1049,182,205,2633,2625,252,3605,1014,0
20:03:07,9906.851,Fox,5258,387,168,82,78,23,25,11,5258,5090,5008,3753,1138,1049,182,205,2633,2625,252,3605,1014,0
20:03:07,9907.45,Fox,5260,386,170,82,75,23,25,11,5260,5090,5008,3755,1138,1049,182,204,2634,2626,252,3608,1014,0
20:03:07,9908.051,Fox,5260,384,168,84,75,19,27,11,5260,5092,5008,3755,1140,1049,182,202,2634,2626,252,3610,1014,0
20:03:07,9908.65,Fox,5260,384,164,86,73,23,27,11,5260,5096,5010,3759,1140,1049,182,202,2634,2626,252,3610,1014,0
20:03:08,9909.25,Fox,5262,385,166,84,71,26,27,11,5262,5096,5012,3762,1140,1049,182,203,2635,2627,252,3611,1014,0
20:03:08,9910.15,Fox,5264,386,166,82,75,25,27,11,5264,5098,5016,3762,1140,1049,182,204,2636,2628,252,3612,1014,0
20:03:08,9910.75,Fox,5264,385,162,86,73,26,27,11,5264,5102,5016,3764,1140,1049,182,203,2636,2628,252,3613,1014,0
20:03:08,9911.351,Fox,5264,385,160,84,77,26,27,11,5264,5104,5020,3764,1140,1049,182,203,2636,2628,252,3613,1014,0
20:03:09,9911.95,Fox,5264,385,158,80,83,26,27,11,5264,5106,5026,3764,1140,1049,182,203,2636,2628,252,3613,1014,0
20:03:09,9912.551,Fox,5264,383,158,78,84,26,27,10,5264,5106,5028,3765,1140,1049,182,201,2636,2628,252,3614,1015,0
20:03:09,9912.851,Fox,5264,383,156,80,84,26,27,10,5264,5108,5028,3765,1140,1049,182,201,2636,2628,252,3614,1015,0
20:03:10,9914.051,Fox,5264,382,154,82,84,26,27,9,5264,5110,5028,3765,1140,1049,182,200,2636,2628,252,3614,1016,0
20:03:10,9914.65,Fox,5266,381,152,82,86,23,27,9,5264,5112,5030,3765,1140,1049,182,199,2637,2629,252,3617,1016,0
20:03:10,9915.25,Fox,5266,378,154,80,88,20,27,9,5266,5112,5032,3765,1140,1049,182,196,2637,2629,252,3620,1016,0
20:03:10,9915.851,Fox,5268,379,152,82,87,20,27,9,5266,5114,5032,3765,1140,1049,182,197,2638,2630,252,3621,1016,0
20:03:10,9916.45,Fox,5270,378,156,82,85,20,27,8,5270,5114,5032,3767,1140,1049,182,196,2640,2630,252,3623,1017,0
20:03:11,9917.051,Fox,5270,376,154,84,85,18,27,8,5270,5116,5032,3767,1140,1049,182,194,2640,2630,252,3625,1017,0
20:03:11,9917.65,Fox,5270,373,152,86,85,16,27,7,5270,5118,5032,3767,1140,1049,181,192,2640,2630,252,3627,1018,0
20:03:11,9918.25,Fox,5270,373,150,88,83,18,27,7,5270,5120,5032,3769,1140,1049,181,192,2640,2630,252,3627,1018,0
20:03:11,9919.15,Fox,5270,371,150,86,83,17,28,7,5270,5120,5034,3771,1141,1049,181,190,2640,2630,252,3629,1018,0
20:03:12,9919.75,Fox,5270,368,146,88,85,14,28,7,5270,5124,5036,3771,1141,1049,181,187,2640,2630,252,3632,1018,0
20:03:12,9920.051,Fox,5270,368,144,88,87,14,28,7,5270,5126,5038,3771,1141,1049,181,187,2640,2630,252,3632,1018,0
20:03:12,9920.95,Fox,5270,367,144,86,89,13,28,7,5270,5126,5040,3771,1141,1049,180,187,2640,2630,252,3633,1018,0
20:03:12,9921.525,Fox,5272,368,140,90,88,13,28,7,5270,5130,5040,3771,1141,1049,179,189,2640,2632,252,3634,1018,0
20:03:12,9922.125,Fox,5272,368,140,92,88,13,26,9,5272,5132,5040,3771,1141,1051,179,189,2640,2632,252,3634,1018,0
20:03:13,9922.726,Fox,5272,366,140,92,86,14,26,8,5272,5132,5040,3773,1141,1051,179,187,2640,2632,252,3635,1019,0
20:03:13,9923.325,Fox,5272,366,140,92,86,14,24,10,5272,5132,5040,3773,1141,1053,179,187,2640,2632,252,3635,1019,0
20:03:13,9924.521,Fox,5272,365,138,94,86,14,24,9,5272,5134,5040,3773,1141,1053,178,187,2640,2632,252,3635,1020,0
20:03:13,9924.788,Fox,5272,365,136,96,85,15,24,9,5272,5136,5040,3774,1141,1053,178,187,2640,2632,252,3635,1020,0
20:03:14,9925.651,Fox,5272,365,136,96,82,18,22,11,5272,5136,5040,3777,1141,1055,178,187,2640,2632,252,3635,1020,0
20:03:14,9926.525,Fox,5274,367,134,96,84,18,20,13,5272,5138,5042,3777,1141,1057,178,189,2640,2634,252,3635,1020,0
20:03:14,9926.825,Fox,5274,365,134,98,84,16,20,13,5274,5140,5042,3777,1141,1057,177,188,2640,2634,252,3637,1020,0
20:03:15,9927.726,Fox,5276,366,132,102,81,18,18,15,5276,5144,5042,3779,1141,1059,177,189,2641,2635,252,3638,1020,0
20:03:15,9928.318,Fox,5276,366,128,102,85,18,18,15,5276,5148,5046,3779,1141,1059,177,189,2641,2635,252,3638,1020,0
20:03:15,9928.899,Fox,5280,366,128,104,83,16,18,15,5278,5150,5046,3779,1141,1059,177,189,2643,2637,252,3642,1020,0
20:03:15,9929.5,Fox,5280,364,128,106,83,14,18,15,5280,5152,5046,3779,1141,1059,176,188,2643,2637,252,3644,1020,0
20:03:15,9930.088,Fox,5280,363,126,106,85,14,18,14,5280,5154,5048,3779,1141,1059,176,187,2643,2637,252,3644,1021,0
20:03:16,9930.688,Fox,5280,363,122,106,87,16,18,14,5280,5158,5052,3781,1141,1059,176,187,2643,2637,252,3644,1021,0
20:03:16,9931.588,Fox,5280,363,120,104,88,19,18,14,5280,5160,5056,3784,1141,1059,176,187,2643,2637,252,3644,1021,0
20:03:16,9932.188,Fox,5284,365,120,104,87,20,18,14,5282,5162,5058,3785,1141,1059,175,190,2644,2640,252,3646,1021,0
20:03:16,9932.787,Fox,5286,366,124,102,87,21,18,14,5286,5162,5060,3786,1141,1059,174,192,2644,2642,252,3647,1021,0
20:03:16,9933.088,Fox,5286,364,124,102,87,19,18,14,5286,5162,5060,3786,1141,1059,172,192,2644,2642,252,3649,1021,0
20:03:17,9933.987,Fox,5288,365,120,106,87,19,18,13,5286,5166,5060,3786,1141,1059,172,193,2644,2644,252,3649,1022,0
20:03:17,9934.581,Fox,5288,365,118,110,87,19,18,13,5288,5170,5060,3786,1141,1059,172,193,2644,2644,252,3649,1022,0
20:03:17,9935.153,Fox,5288,363,116,112,87,18,18,12,5288,5172,5060,3786,1141,1059,171,192,2644,2644,252,3651,1022,0
20:03:17,9935.72,Fox,5288,360,114,112,89,16,18,11,5288,5174,5062,3786,1141,1059,171,189,2644,2644,252,3653,1023,0
20:03:18,9936.319,Fox,5290,360,114,110,88,17,18,11,5288,5174,5064,3788,1141,1059,169,191,2644,2646,252,3655,1023,0
20:03:18,9936.92,Fox,5290,360,116,108,90,16,19,11,5290,5174,5066,3788,1142,1059,169,191,2644,2646,252,3655,1023,0
20:03:18,9937.518,Fox,5292,362,116,106,90,18,19,11,5290,5174,5068,3790,1142,1059,171,191,2646,2646,252,3655,1023,0
20:03:18,9938.118,Fox,5292,360,118,104,92,16,19,11,5292,5174,5070,3790,1142,1059,170,190,2646,2646,252,3657,1023,0
20:03:18,9938.718,Fox,5292,360,118,102,92,18,19,11,5292,5174,5072,3792,1142,1059,170,190,2646,2646,252,3657,1023,0
20:03:19,9939.614,Fox,5292,360,116,104,92,18,19,11,5292,5176,5072,3792,1142,1059,170,190,2646,2646,252,3657,1023,0
20:03:19,9940.51,Fox,5294,361,118,102,93,18,19,11,5294,5176,5074,3792,1142,1059,170,191,2647,2647,252,3658,1023,0
20:03:19,9941.097,Fox,5296,361,118,96,99,16,19,11,5294,5176,5080,3792,1142,1059,171,190,2649,2647,252,3660,1023,0
20:03:19,9941.696,Fox,5298,359,122,94,98,15,19,11,5298,5176,5082,3794,1142,1059,171,188,2650,2648,252,3664,1023,0
20:03:20,9942.297,Fox,5298,358,120,96,98,14,19,11,5298,5178,5082,3794,1142,1059,171,187,2650,2648,252,3665,1023,0
20:03:20,9943.196,Fox,5298,357,118,92,104,13,19,11,5298,5180,5088,3794,1142,1059,171,186,2650,2648,252,3666,1023,0
20:03:20,9944.097,Fox,5300,358,120,92,103,13,19,11,5300,5180,5088,3794,1142,1059,171,187,2651,2649,252,3667,1023,0
20:03:20,9944.396,Fox,5300,358,116,94,105,13,19,11,5300,5184,5090,3794,1142,1059,171,187,2651,2649,252,3667,1023,0
20:03:21,9945.287,Fox,5300,358,114,96,105,13,19,11,5300,5186,5090,3794,1142,1059,171,187,2651,2649,252,3667,1023,0
20:03:21,9946.787,Fox,5300,356,114,94,105,13,19,11,5300,5186,5092,3796,1142,1059,169,187,2651,2649,252,3669,1023,0
20:03:21,9947.387,Fox,5300,356,114,90,109,13,19,11,5300,5186,5096,3796,1142,1059,169,187,2651,2649,252,3669,1023,0
20:03:22,9947.987,Fox,5302,355,114,90,107,12,19,11,5300,5186,5096,3797,1142,1059,170,185,2653,2649,252,3672,1023,0
20:03:22,9948.287,Fox,5302,355,116,90,107,12,19,11,5302,5186,5096,3797,1142,1059,170,185,2653,2649,252,3672,1023,0
20:03:22,9949.187,Fox,5306,355,112,92,109,10,19,11,5304,5192,5100,3797,1142,1059,170,185,2655,2651,252,3676,1023,0
20:03:22,9949.487,Fox,5306,355,114,90,111,10,19,11,5306,5192,5102,3797,1142,1059,170,185,2655,2651,252,3676,1023,0
20:03:22,9950.085,Fox,5306,355,114,88,111,12,19,11,5306,5192,5104,3799,1142,1059,170,185,2655,2651,252,3676,1023,0
20:03:23,9950.981,Fox,5306,355,112,88,113,12,19,11,5306,5194,5106,3799,1142,1059,170,185,2655,2651,252,3676,1023,0
20:03:23,9951.569,Fox,5306,355,112,86,114,13,19,11,5306,5194,5108,3800,1142,1059,170,185,2655,2651,252,3676,1023,0
20:03:23,9952.169,Fox,5310,356,114,86,113,11,19,11,5308,5194,5108,3800,1142,1059,170,186,2656,2654,252,3679,1023,0
20:03:23,9952.769,Fox,5310,355,116,84,115,11,19,10,5310,5194,5110,3800,1142,1059,170,185,2656,2654,252,3679,1024,0
20:03:24,9953.369,Fox,5310,355,116,82,116,12,19,10,5310,5194,5112,3801,1142,1059,170,185,2656,2654,252,3679,1024,0
20:03:24,9954.257,Fox,5310,355,114,82,118,12,19,10,5310,5196,5114,3801,1142,1059,170,185,2656,2654,252,3679,1024,0
20:03:24,9954.851,Fox,5312,356,116,82,115,14,19,10,5312,5196,5114,3803,1142,1059,170,186,2657,2655,252,3680,1024,0
20:03:24,9955.45,Fox,5312,356,116,80,117,14,19,10,5312,5196,5116,3803,1142,1059,170,186,2657,2655,252,3680,1024,0
20:03:25,9956.351,Fox,5314,356,116,78,118,14,19,9,5312,5196,5118,3803,1142,1059,171,185,2659,2655,252,3681,1025,0
20:03:25,9956.95,Fox,5314,355,116,78,120,14,18,9,5314,5198,5120,3803,1142,1059,171,184,2659,2655,252,3682,1025,0
20:03:25,9957.55,Fox,5314,353,114,80,117,15,18,9,5314,5200,5120,3806,1142,1059,170,183,2659,2655,252,3684,1025,0
20:03:26,9958.143,Fox,5316,353,116,80,116,14,18,9,5316,5200,5120,3806,1142,1059,170,183,2660,2656,252,3686,1025,0
20:03:26,9958.735,Fox,5316,353,116,74,122,14,18,9,5316,5200,5126,3806,1142,1059,170,183,2660,2656,252,3686,1025,0
20:03:26,9959.336,Fox,5316,353,114,76,122,14,18,9,5316,5202,5126,3806,1142,1059,170,183,2660,2656,252,3686,1025,0
20:03:26,9960.23,Fox,5316,353,112,74,125,15,18,9,5316,5204,5130,3807,1142,1059,170,183,2660,2656,252,3686,1025,0
20:03:26,9960.513,Fox,5316,351,110,74,127,13,18,9,5316,5206,5132,3807,1142,1059,168,183,2660,2656,252,3688,1025,0
20:03:27,9961.394,Fox,5316,351,108,76,125,15,18,9,5316,5208,5132,3809,1142,1059,168,183,2660,2656,252,3688,1025,0
20:03:27,9961.652,Fox,5316,350,106,78,125,14,18,9,5316,5210,5132,3809,1142,1059,168,182,2660,2656,252,3689,1025,0
20:03:27,9962.778,Fox,5316,349,104,78,127,14,18,8,5316,5212,5134,3809,1142,1059,167,182,2660,2656,252,3689,1026,0
20:03:27,9963.029,Fox,5316,349,104,76,129,14,18,8,5316,5212,5136,3809,1142,1059,167,182,2660,2656,252,3689,1026,0
20:03:27,9963.863,Fox,5320,349,102,78,125,15,18,7,5316,5214,5136,3811,1142,1059,166,183,2662,2658,252,3692,1027,0
20:03:28,9964.163,Fox,5320,349,104,80,123,17,18,7,5320,5216,5136,3813,1142,1059,166,183,2662,2658,252,3692,1027,0
20:03:28,9965.001,Fox,5322,348,104,78,125,14,18,7,5320,5216,5138,3813,1142,1059,164,184,2663,2659,252,3695,1027,0
20:03:28,9965.586,Fox,5322,348,104,78,127,14,18,7,5322,5218,5140,3813,1142,1059,164,184,2663,2659,252,3695,1027,0
20:03:28,9966.434,Fox,5322,348,104,70,134,15,18,7,5322,5218,5148,3814,1142,1059,164,184,2663,2659,252,3695,1027,0
20:03:28,9966.952,Fox,5322,348,104,68,134,17,18,7,5322,5218,5150,3816,1142,1059,164,184,2663,2659,252,3695,1027,0
20:03:29,9967.239,Fox,5322,348,104,68,132,19,18,7,5322,5218,5150,3818,1142,1059,164,184,2663,2659,252,3695,1027,0
20:03:29,9968.315,Fox,5324,347,104,66,134,16,18,7,5322,5218,5152,3818,1142,1059,166,181,2665,2659,252,3698,1027,0
20:03:29,9968.916,Fox,5328,351,106,60,140,16,18,7,5324,5218,5158,3818,1142,1059,169,182,2668,2660,252,3698,1027,0
20:03:29,9969.516,Fox,5330,352,106,64,137,18,18,7,5328,5222,5158,3820,1142,1059,168,184,2668,2662,252,3699,1027,0
20:03:30,9970.115,Fox,5330,352,104,66,139,18,16,9,5330,5226,5160,3820,1142,1061,168,184,2668,2662,252,3699,1027,0
20:03:30,9970.685,Fox,5330,351,104,64,137,21,16,9,5330,5226,5162,3824,1142,1061,168,183,2668,2662,252,3700,1027,0
20:03:30,9971.259,Fox,5330,349,100,68,137,19,16,9,5330,5230,5162,3824,1142,1061,167,182,2668,2662,252,3702,1027,0
20:03:30,9971.858,Fox,5332,350,102,68,133,22,16,9,5332,5230,5162,3827,1142,1061,166,184,2668,2664,252,3703,1027,0
20:03:31,9972.458,Fox,5334,351,104,64,132,26,16,9,5334,5230,5166,3832,1142,1061,166,185,2669,2665,252,3704,1027,0
20:03:31,9973.358,Fox,5338,353,104,62,132,28,16,9,5336,5232,5170,3834,1142,1061,167,186,2672,2666,252,3706,1027,0
20:03:31,9973.958,Fox,5338,351,102,64,134,26,16,9,5338,5236,5172,3834,1142,1061,166,185,2672,2666,252,3708,1027,0
20:03:31,9974.559,Fox,5340,351,104,62,135,25,16,9,5340,5236,5174,3834,1142,1061,166,185,2673,2667,252,3710,1027,0
20:03:32,9975.158,Fox,5342,352,102,66,134,25,14,11,5342,5240,5174,3834,1142,1063,166,186,2674,2668,252,3711,1027,0
20:03:32,9975.458,Fox,5342,352,100,68,133,26,14,11,5342,5242,5174,3835,1142,1063,166,186,2674,2668,252,3711,1027,0
20:03:32,9976.854,Fox,5348,355,104,68,131,25,14,11,5346,5242,5174,3835,1142,1063,166,189,2676,2672,252,3714,1027,0
20:03:32,9977.153,Fox,5348,352,106,68,131,23,14,10,5348,5242,5174,3835,1142,1063,165,187,2676,2672,252,3716,1028,0
20:03:33,9978.054,Fox,5352,351,104,70,131,20,15,9,5350,5246,5176,3835,1143,1063,164,187,2678,2674,252,3720,1029,0
20:03:33,9978.653,Fox,5354,352,104,72,130,20,15,9,5352,5248,5176,3835,1143,1063,163,189,2678,2676,252,3721,1029,0
20:03:33,9979.253,Fox,5358,355,108,72,129,20,13,11,5356,5248,5176,3835,1143,1065,164,191,2680,2678,252,3722,1029,0
20:03:33,9979.854,Fox,5358,353,106,76,126,21,13,11,5358,5252,5176,3838,1143,1065,164,189,2680,2678,252,3724,1029,0
20:03:34,9980.753,Fox,5358,351,106,74,126,21,13,11,5358,5252,5178,3840,1143,1065,162,189,2680,2678,252,3726,1029,0
20:03:34,9981.054,Fox,5358,350,106,74,124,22,13,11,5358,5252,5178,3842,1143,1065,162,188,2680,2678,252,3727,1029,0
20:03:34,9981.953,Fox,5364,352,110,72,124,20,13,11,5362,5252,5180,3842,1143,1065,162,190,2683,2681,252,3731,1029,0
20:03:34,9982.554,Fox,5364,347,112,72,124,15,13,11,5364,5252,5180,3842,1143,1065,161,186,2683,2681,252,3736,1029,0
20:03:34,9982.854,Fox,5364,345,110,70,128,13,13,11,5364,5254,5184,3842,1143,1065,161,184,2683,2681,252,3738,1029,0
20:03:35,9983.753,Fox,5364,344,110,68,130,12,13,11,5364,5254,5186,3842,1143,1065,160,184,2683,2681,252,3739,1029,0
20:03:35,9984.054,Fox,5364,344,108,70,130,12,12,12,5364,5256,5186,3842,1143,1066,160,184,2683,2681,252,3739,1029,0
20:03:35,9985.828,Fox,5364,343,108,70,130,11,12,12,5364,5256,5186,3842,1143,1066,159,184,2683,2681,252,3740,1029,0
20:03:36,9986.729,Fox,5368,345,112,70,129,10,12,12,5368,5256,5186,3842,1143,1066,159,186,2685,2683,253,3741,1029,0
20:03:36,9987.028,Fox,5368,345,112,70,128,11,12,12,5368,5256,5186,3843,1143,1066,159,186,2685,2683,253,3741,1029,0
20:03:36,9987.92,Fox,5368,345,112,64,134,11,12,12,5368,5256,5192,3843,1143,1066,159,186,2685,2683,253,3741,1029,0
20:03:37,9988.805,Fox,5368,345,110,66,130,15,12,12,5368,5258,5192,3847,1143,1066,159,186,2685,2683,253,3741,1029,0
20:03:37,9989.957,Fox,5368,343,108,66,132,14,12,11,5368,5260,5194,3847,1143,1066,158,185,2685,2683,253,3742,1030,0
20:03:37,9990.25,Fox,5368,341,108,66,132,13,12,10,5368,5260,5194,3847,1143,1066,158,183,2685,2683,253,3743,1031,0
20:03:37,9991.136,Fox,5372,341,108,66,126,15,12,10,5368,5260,5194,3851,1143,1066,158,183,2687,2685,253,3747,1031,0
20:03:37,9991.436,Fox,5372,339,112,66,126,13,12,10,5372,5260,5194,3851,1143,1066,158,181,2687,2685,253,3749,1031,0
20:03:38,9992.326,Fox,5372,339,110,68,122,17,12,10,5372,5262,5194,3855,1143,1066,158,181,2687,2685,253,3749,1031,0
20:03:38,9992.926,Fox,5372,339,108,68,122,19,12,10,5372,5264,5196,3857,1143,1066,158,181,2687,2685,253,3749,1031,0
20:03:38,9993.526,Fox,5374,340,110,68,120,20,12,10,5374,5264,5196,3858,1143,1066,158,182,2688,2686,253,3750,1031,0
20:03:39,9995.322,Fox,5378,342,112,68,118,20,12,10,5376,5264,5196,3858,1143,1066,157,185,2689,2689,253,3752,1031,0
20:03:39,9995.922,Fox,5378,342,114,64,122,20,12,10,5378,5264,5200,3858,1143,1066,157,185,2689,2689,253,3752,1031,0
20:03:39,9996.491,Fox,5382,344,118,64,118,22,12,10,5382,5264,5200,3860,1143,1066,158,186,2692,2690,253,3754,1031,0
20:03:39,9997.042,Fox,5382,344,118,64,117,23,12,10,5382,5264,5200,3861,1143,1066,158,186,2692,2690,253,3754,1031,0
20:03:40,9997.886,Fox,5384,344,116,64,116,24,12,10,5382,5266,5202,3863,1143,1066,158,186,2693,2691,253,3756,1031,0
20:03:40,9998.474,Fox,5384,343,118,62,118,24,12,9,5384,5266,5204,3863,1143,1066,158,185,2693,2691,253,3756,1032,0
20:03:40,9999.065,Fox,5386,342,116,64,118,23,12,9,5386,5270,5206,3864,1143,1066,156,186,2694,2692,253,3759,1032,0
20:03:40,9999.665,Fox,5388,341,118,62,119,20,13,9,5388,5270,5208,3864,1144,1066,155,186,2694,2694,253,3762,1032,0
20:03:40,9999.966,Fox,5388,341,118,60,121,20,13,9,5388,5270,5210,3864,1144,1066,155,186,2694,2694,253,3762,1032,0
20:03:41,10001.09,Fox,5390,342,118,60,119,21,13,9,5388,5270,5210,3866,1144,1066,155,187,2695,2695,253,3763,1032,0
20:03:41,10001.66,Fox,5392,339,120,58,116,21,13,9,5390,5270,5212,3870,1144,1066,156,183,2697,2695,253,3768,1032,0
20:03:41,10002.26,Fox,5394,339,122,56,117,20,13,9,5392,5270,5214,3870,1144,1066,156,183,2698,2696,253,3770,1032,0
20:03:42,10002.86,Fox,5394,337,124,54,119,18,13,9,5394,5270,5216,3870,1144,1066,156,181,2698,2696,253,3772,1032,0
20:03:42,10003.46,Fox,5394,335,124,54,114,21,13,9,5394,5270,5216,3875,1144,1066,156,179,2698,2696,253,3774,1032,0
20:03:42,10004.05,Fox,5396,335,126,52,115,20,13,9,5396,5270,5218,3875,1144,1066,157,178,2700,2696,253,3776,1032,0
20:03:42,10004.34,Fox,5396,335,124,54,115,20,13,9,5396,5272,5218,3875,1144,1066,157,178,2700,2696,253,3776,1032,0
20:03:42,10005.15,Fox,5396,334,124,54,115,20,13,8,5396,5272,5218,3875,1144,1066,157,177,2700,2696,253,3776,1033,0
20:03:43,10006,Fox,5398,335,126,54,114,20,13,8,5398,5272,5218,3875,1144,1066,156,179,2700,2698,253,3777,1033,0
20:03:43,10006.59,Fox,5400,335,128,54,113,19,13,8,5400,5272,5218,3875,1144,1066,155,180,2701,2699,253,3779,1033,0
20:03:43,10007.19,Fox,5404,337,130,54,109,21,13,8,5402,5272,5218,3877,1144,1066,155,182,2703,2701,253,3781,1033,0
20:03:43,10007.79,Fox,5406,337,132,50,109,23,13,8,5404,5272,5222,3880,1144,1066,156,181,2705,2701,253,3783,1033,0
20:03:43,10008.39,Fox,5410,337,136,46,111,21,13,8,5408,5272,5226,3880,1144,1066,156,181,2707,2703,253,3787,1033,0
20:03:44,10008.69,Fox,5410,337,138,46,111,21,13,8,5410,5272,5226,3880,1144,1066,156,181,2707,2703,253,3787,1033,0
20:03:44,10009.55,Fox,5412,337,136,44,111,23,13,8,5410,5274,5230,3883,1144,1066,155,182,2707,2705,253,3789,1033,0
20:03:44,10010.15,Fox,5416,339,142,44,109,23,13,8,5416,5274,5230,3884,1144,1066,155,184,2709,2707,253,3791,1033,0
20:03:44,10010.45,Fox,5416,339,140,46,108,24,13,8,5416,5276,5230,3885,1144,1066,155,184,2709,2707,253,3791,1033,0
20:03:44,10011.33,Fox,5416,338,140,46,106,25,13,8,5416,5276,5230,3887,1144,1066,155,183,2709,2707,253,3792,1033,0
20:03:45,10011.93,Fox,5418,335,138,48,106,22,13,8,5418,5280,5232,3888,1144,1066,154,181,2709,2709,253,3797,1033,0
20:03:45,10012.53,Fox,5424,337,142,44,107,21,13,8,5422,5280,5236,3888,1144,1066,155,182,2713,2711,253,3801,1033,0
20:03:45,10013.13,Fox,5426,338,146,44,104,23,13,8,5426,5280,5236,3890,1144,1066,155,183,2714,2712,253,3802,1033,0
20:03:46,10013.73,Fox,5426,334,146,40,107,20,13,8,5426,5280,5240,3891,1144,1066,155,179,2714,2712,253,3806,1033,0
20:03:46,10014.01,Fox,5426,334,146,38,109,20,13,8,5426,5280,5242,3891,1144,1066,155,179,2714,2712,253,3806,1033,0
20:03:46,10014.92,Fox,5426,334,144,40,107,22,13,8,5426,5282,5242,3893,1144,1066,155,179,2714,2712,253,3806,1033,0
20:03:46,10015.51,Fox,5428,335,140,44,106,22,13,8,5426,5286,5242,3893,1144,1066,154,181,2714,2714,253,3807,1033,0
20:03:47,10015.81,Fox,5428,335,142,44,104,24,13,8,5428,5286,5242,3895,1144,1066,154,181,2714,2714,253,3807,1033,0
20:03:47,10016.42,Fox,5428,335,142,40,106,26,13,8,5428,5286,5246,3897,1144,1066,154,181,2714,2714,253,3807,1033,0
20:03:47,10017.3,Fox,5428,333,140,40,107,25,13,8,5428,5288,5248,3898,1144,1066,152,181,2714,2714,253,3809,1033,0
20:03:47,10018.13,Fox,5432,333,142,38,108,23,12,8,5430,5288,5250,3898,1144,1066,152,181,2717,2715,253,3813,1033,0
20:03:48,10018.72,Fox,5434,333,144,36,109,23,12,7,5432,5288,5252,3898,1144,1066,150,183,2717,2717,253,3814,1034,0
20:03:48,10019.32,Fox,5434,333,144,38,106,26,11,8,5434,5290,5252,3901,1144,1067,150,183,2717,2717,253,3814,1034,0
20:03:48,10019.91,Fox,5434,330,144,38,106,23,10,9,5434,5290,5252,3901,1144,1068,149,181,2717,2717,253,3817,1034,0
20:03:48,10020.51,Fox,5434,329,142,40,103,25,10,9,5434,5292,5252,3904,1144,1068,149,180,2717,2717,253,3818,1034,0
20:03:48,10021.09,Fox,5434,328,142,40,102,25,10,9,5434,5292,5252,3905,1144,1068,149,179,2717,2717,253,3819,1034,0
20:03:48,10021.39,Fox,5434,326,142,38,104,23,10,9,5434,5292,5254,3905,1144,1068,149,177,2717,2717,253,3821,1034,0
20:03:49,10022.56,Fox,5436,326,144,36,105,22,10,9,5436,5292,5256,3905,1144,1068,150,176,2719,2717,254,3822,1034,0
20:03:49,10023.45,Fox,5436,324,142,38,103,22,10,9,5436,5294,5256,3907,1144,1068,150,174,2719,2717,254,3824,1034,0
20:03:49,10024.03,Fox,5436,323,140,40,102,22,10,9,5436,5296,5256,3908,1144,1068,150,173,2719,2717,254,3825,1034,0
20:03:49,10024.33,Fox,5436,323,138,42,102,22,10,9,5436,5298,5256,3908,1144,1068,150,173,2719,2717,254,3825,1034,0
20:03:50,10025.19,Fox,5436,321,138,42,100,22,10,9,5436,5298,5256,3910,1144,1068,150,171,2719,2717,254,3827,1034,0
20:03:50,10025.75,Fox,5436,321,138,42,98,24,10,9,5436,5298,5256,3912,1144,1068,150,171,2719,2717,254,3827,1034,0
20:03:50,10026.61,Fox,5436,319,136,44,94,26,10,9,5436,5300,5256,3916,1144,1068,148,171,2719,2717,254,3829,1034,0
20:03:50,10027.21,Fox,5438,318,138,44,91,26,10,9,5438,5300,5256,3918,1144,1068,148,170,2720,2718,254,3832,1034,0
20:03:51,10027.79,Fox,5438,317,138,42,93,25,10,9,5438,5300,5258,3918,1144,1068,148,169,2720,2718,254,3833,1034,0
20:03:51,10028.65,Fox,5438,317,138,40,94,26,10,9,5438,5300,5260,3919,1144,1068,148,169,2720,2718,254,3833,1034,0
20:03:51,10029.51,Fox,5440,316,140,40,90,27,10,9,5440,5300,5260,3923,1144,1068,146,170,2720,2720,254,3836,1034,0
20:03:51,10030.37,Fox,5440,315,140,38,92,27,10,8,5440,5300,5262,3923,1144,1068,146,169,2720,2720,254,3836,1035,0
20:03:52,10030.96,Fox,5444,315,140,40,92,23,10,8,5442,5302,5262,3923,1144,1068,145,170,2722,2722,254,3840,1035,0
20:03:52,10031.56,Fox,5444,314,142,38,92,24,10,8,5444,5302,5264,3925,1144,1068,145,169,2722,2722,254,3841,1035,0
20:03:52,10032.16,Fox,5444,314,138,42,92,24,6,12,5444,5306,5264,3925,1144,1072,145,169,2722,2722,254,3841,1035,0
20:03:52,10033.03,Fox,5444,314,138,42,89,27,6,12,5444,5306,5264,3928,1144,1072,145,169,2722,2722,254,3841,1035,0
20:03:53,10033.63,Fox,5444,312,138,42,87,27,6,12,5444,5306,5264,3930,1144,1072,145,167,2722,2722,254,3843,1035,0
20:03:53,10034.2,Fox,5444,311,138,42,87,26,6,12,5444,5306,5264,3930,1144,1072,145,166,2722,2722,254,3844,1035,0
20:03:53,10035.06,Fox,5446,312,134,46,84,28,6,12,5444,5310,5264,3932,1144,1072,145,167,2723,2723,254,3845,1035,0
20:03:53,10035.66,Fox,5446,309,136,46,84,26,6,11,5446,5310,5264,3932,1144,1072,144,165,2723,2723,254,3847,1036,0
20:03:53,10036.26,Fox,5448,308,138,44,85,24,6,11,5448,5310,5266,3932,1144,1072,144,164,2724,2724,254,3850,1036,0
20:03:54,10037.46,Fox,5448,303,136,42,89,19,6,11,5448,5312,5270,3932,1144,1072,144,159,2724,2724,254,3855,1036,0
20:03:54,10038.34,Fox,5450,304,138,42,88,19,6,11,5450,5312,5270,3932,1144,1072,144,160,2725,2725,254,3856,1036,0
20:03:54,10038.9,Fox,5452,305,138,42,86,20,6,11,5450,5312,5270,3934,1144,1072,146,159,2727,2725,254,3857,1036,0
20:03:55,10039.4,Fox,5452,303,138,44,86,18,6,11,5452,5314,5270,3934,1144,1072,146,157,2727,2725,254,3859,1036,0
20:03:55,10039.67,Fox,5452,301,138,44,86,16,6,11,5452,5314,5270,3934,1144,1072,144,157,2727,2725,254,3861,1036,0
20:03:55,10041,Fox,5452,301,136,46,84,18,6,11,5452,5316,5270,3936,1144,1072,144,157,2727,2725,254,3861,1036,0
20:03:55,10041.78,Fox,5454,300,136,46,83,16,6,11,5452,5316,5270,3936,1144,1072,143,157,2728,2726,254,3864,1036,0
20:03:56,10042.36,Fox,5454,300,138,46,81,18,6,11,5454,5316,5270,3938,1144,1072,143,157,2728,2726,254,3864,1036,0
20:03:56,10043.09,Fox,5456,300,140,44,82,17,6,11,5456,5316,5272,3938,1144,1072,143,157,2730,2726,255,3865,1036,0
20:03:56,10043.67,Fox,5458,299,142,44,79,17,6,11,5458,5316,5272,3941,1144,1072,143,156,2731,2727,255,3868,1036,0
20:03:56,10043.93,Fox,5458,297,142,44,79,15,6,11,5458,5316,5272,3941,1144,1072,143,154,2731,2727,255,3870,1036,0
20:03:56,10044.45,Fox,5458,296,142,44,77,16,6,11,5458,5316,5272,3943,1144,1072,142,154,2731,2727,255,3871,1036,0
20:03:57,10045.46,Fox,5460,296,142,44,76,15,4,13,5458,5316,5272,3943,1144,1074,143,153,2733,2727,255,3873,1036,0
20:03:57,10045.99,Fox,5462,297,144,44,75,15,4,13,5460,5316,5272,3943,1144,1074,143,154,2734,2728,255,3874,1036,0
20:03:57,10046.26,Fox,5462,297,146,44,75,15,4,13,5462,5316,5272,3943,1144,1074,143,154,2734,2728,255,3874,1036,0
20:03:57,10046.78,Fox,5462,297,142,48,75,15,4,13,5462,5320,5272,3943,1144,1074,143,154,2734,2728,255,3874,1036,0
20:03:57,10047.32,Fox,5462,296,142,48,75,15,4,12,5462,5320,5272,3943,1144,1074,143,153,2734,2728,255,3874,1037,0
20:03:57,10047.85,Fox,5462,296,140,48,75,17,4,12,5462,5322,5274,3945,1144,1074,143,153,2734,2728,255,3874,1037,0
20:03:58,10048.38,Fox,5462,296,140,48,72,20,4,12,5462,5322,5274,3948,1144,1074,143,153,2734,2728,255,3874,1037,0
20:03:58,10049.22,Fox,5462,294,140,46,74,18,4,12,5462,5322,5276,3948,1144,1074,143,151,2734,2728,255,3876,1037,0
20:03:58,10049.8,Fox,5466,296,142,46,72,18,4,12,5464,5322,5276,3948,1144,1074,144,152,2737,2729,255,3878,1037,0
20:03:58,10050.38,Fox,5468,297,146,42,74,19,4,12,5468,5322,5280,3949,1144,1074,143,154,2737,2731,255,3879,1037,0
20:03:59,10051.48,Fox,5470,296,144,44,73,17,4,12,5468,5324,5280,3949,1144,1074,144,152,2739,2731,255,3882,1037,0
20:03:59,10052.07,Fox,5470,295,142,48,73,17,4,11,5470,5328,5280,3949,1144,1074,144,151,2739,2731,255,3882,1038,0
20:03:59,10052.61,Fox,5470,293,140,50,73,15,4,11,5470,5330,5280,3949,1144,1074,144,149,2739,2731,255,3884,1038,0
20:03:59,10053.44,Fox,5470,293,140,46,75,17,4,11,5470,5330,5284,3951,1144,1074,144,149,2739,2731,255,3884,1038,0
20:04:00,10053.96,Fox,5470,290,140,44,77,14,4,11,5470,5330,5286,3951,1144,1074,144,146,2739,2731,255,3887,1038,0
20:04:00,10054.72,Fox,5470,288,138,46,77,12,4,11,5470,5332,5286,3951,1144,1074,142,146,2739,2731,255,3889,1038,0
20:04:00,10054.97,Fox,5470,288,136,48,77,12,4,11,5470,5334,5286,3951,1144,1074,142,146,2739,2731,255,3889,1038,0
20:04:00,10055.47,Fox,5470,288,136,46,79,12,4,11,5470,5334,5288,3951,1144,1074,142,146,2739,2731,255,3889,1038,0
20:04:00,10056.21,Fox,5470,288,132,50,75,16,4,11,5470,5338,5288,3955,1144,1074,142,146,2739,2731,255,3889,1038,0
20:04:01,10056.98,Fox,5472,289,132,50,74,16,3,12,5470,5338,5288,3955,1144,1075,141,148,2739,2733,255,3890,1038,0
20:04:01,10057.56,Fox,5474,290,134,52,73,16,3,12,5474,5340,5288,3955,1144,1075,141,149,2740,2734,255,3891,1038,0
20:04:01,10058.13,Fox,5476,291,132,52,73,17,3,12,5474,5342,5290,3956,1144,1075,140,151,2740,2736,255,3892,1038,0
20:04:01,10058.64,Fox,5476,286,134,52,72,13,3,12,5476,5342,5290,3957,1144,1075,140,146,2740,2736,255,3897,1038,0
20:04:01,10058.91,Fox,5476,286,134,50,74,13,3,12,5476,5342,5292,3957,1144,1075,140,146,2740,2736,255,3897,1038,0
20:04:02,10059.68,Fox,5476,286,128,56,72,15,3,12,5476,5348,5292,3959,1144,1075,140,146,2740,2736,255,3897,1038,0
20:04:02,10060.39,Fox,5476,283,128,56,70,16,3,10,5476,5348,5292,3961,1144,1075,138,145,2740,2736,255,3898,1040,0
20:04:02,10060.9,Fox,5476,283,124,60,69,17,3,10,5476,5352,5292,3962,1144,1075,138,145,2740,2736,255,3898,1040,0
20:04:02,10061.42,Fox,5478,283,126,60,68,17,3,9,5478,5352,5292,3962,1144,1075,138,145,2741,2737,255,3899,1041,0
20:04:02,10061.92,Fox,5478,283,122,62,68,19,3,9,5478,5356,5294,3964,1144,1075,138,145,2741,2737,255,3899,1041,0
20:04:02,10062.42,Fox,5478,283,120,62,70,19,3,9,5478,5358,5296,3964,1144,1075,138,145,2741,2737,255,3899,1041,0
20:04:03,10062.65,Fox,5478,283,120,60,72,19,3,9,5478,5358,5298,3964,1144,1075,138,145,2741,2737,255,3899,1041,0
20:04:03,10063.08,Fox,5478,283,120,60,70,21,3,9,5478,5358,5298,3966,1144,1075,138,145,2741,2737,255,3899,1041,0
20:04:03,10063.52,Fox,5478,281,120,60,70,19,3,9,5478,5358,5298,3966,1144,1075,137,144,2741,2737,255,3901,1041,0
20:04:03,10064.72,Fox,5478,281,114,66,68,21,3,9,5478,5364,5298,3968,1144,1075,137,144,2741,2737,255,3901,1041,0
20:04:03,10065.14,Fox,5478,280,114,64,70,21,3,8,5478,5364,5300,3968,1144,1075,137,143,2741,2737,255,3901,1042,0
20:04:04,10066.24,Fox,5480,281,116,64,69,21,3,8,5480,5364,5300,3968,1144,1075,138,143,2743,2737,255,3902,1042,0
20:04:04,10066.69,Fox,5482,278,116,64,68,17,3,8,5480,5364,5300,3968,1144,1075,135,143,2743,2739,255,3907,1042,0
20:04:04,10066.99,Fox,5482,278,118,64,68,17,3,8,5482,5364,5300,3968,1144,1075,135,143,2743,2739,255,3907,1042,0
20:04:05,10068.48,Fox,5482,277,118,64,66,18,3,8,5482,5364,5300,3970,1144,1075,134,143,2743,2739,255,3908,1042,0
20:04:05,10069.21,Fox,5486,278,114,68,61,20,3,8,5482,5368,5300,3974,1144,1075,134,144,2745,2741,255,3911,1042,0
20:04:05,10069.74,Fox,5486,276,118,66,60,21,3,8,5486,5368,5302,3977,1144,1075,134,142,2745,2741,255,3913,1042,0
20:04:05,10070.48,Fox,5486,276,118,62,64,21,3,8,5486,5368,5306,3977,1144,1075,134,142,2745,2741,255,3913,1042,0
20:04:05,10070.9,Fox,5486,273,118,62,64,18,3,8,5486,5368,5306,3977,1144,1075,134,139,2745,2741,255,3916,1042,0
20:04:06,10072.48,Fox,5488,271,120,62,61,18,3,7,5488,5368,5306,3979,1144,1075,134,137,2747,2741,255,3919,1043,0
20:04:06,10072.71,Fox,5488,271,120,62,59,20,3,7,5488,5368,5306,3981,1144,1075,134,137,2747,2741,255,3919,1043,0
20:04:06,10073.42,Fox,5490,272,120,58,62,20,3,7,5488,5368,5310,3981,1144,1075,134,138,2748,2742,255,3920,1043,0
20:04:06,10073.89,Fox,5490,272,118,62,59,23,3,7,5490,5372,5310,3984,1144,1075,134,138,2748,2742,255,3920,1043,0
20:04:07,10074.33,Fox,5490,272,118,62,57,25,2,8,5490,5372,5310,3986,1144,1076,134,138,2748,2742,255,3920,1043,0
20:04:07,10074.93,Fox,5490,270,118,62,57,23,2,8,5490,5372,5310,3986,1144,1076,134,136,2748,2742,255,3922,1043,0
20:04:07,10075.59,Fox,5492,270,120,62,56,23,2,7,5492,5372,5310,3986,1144,1076,133,137,2749,2743,255,3923,1044,0
20:04:07,10076.05,Fox,5492,270,118,62,58,23,2,7,5492,5374,5312,3986,1144,1076,133,137,2749,2743,255,3923,1044,0
20:04:07,10076.71,Fox,5492,270,118,62,54,27,2,7,5492,5374,5312,3990,1144,1076,133,137,2749,2743,255,3923,1044,0
20:04:08,10077.84,Fox,5492,270,116,62,55,28,2,7,5492,5376,5314,3991,1144,1076,133,137,2749,2743,255,3923,1044,0
20:04:08,10078.07,Fox,5492,270,114,64,55,28,2,7,5492,5378,5314,3991,1144,1076,133,137,2749,2743,255,3923,1044,0
20:04:08,10078.76,Fox,5492,268,114,64,53,28,2,7,5492,5378,5314,3993,1144,1076,133,135,2749,2743,255,3925,1044,0
20:04:08,10079.23,Fox,5492,268,110,66,55,28,2,7,5492,5382,5316,3993,1144,1076,133,135,2749,2743,255,3925,1044,0
20:04:08,10079.68,Fox,5494,267,110,66,54,26,2,7,5492,5382,5316,3993,1144,1076,132,135,2749,2745,255,3928,1044,0
20:04:08,10079.91,Fox,5494,267,112,66,54,26,2,7,5494,5382,5316,3993,1144,1076,132,135,2749,2745,255,3928,1044,0
20:04:09,10080.64,Fox,5494,264,110,68,54,23,2,7,5494,5384,5316,3993,1144,1076,130,134,2749,2745,255,3931,1044,0
20:04:09,10081.81,Fox,5494,264,108,70,52,25,2,7,5494,5386,5316,3995,1144,1076,130,134,2749,2745,255,3931,1044,0
20:04:09,10082.26,Fox,5494,264,106,72,52,25,2,7,5494,5388,5316,3995,1144,1076,130,134,2749,2745,255,3931,1044,0
20:04:09,10083.23,Fox,5494,262,106,72,50,25,2,7,5494,5388,5316,3997,1144,1076,128,134,2749,2745,255,3933,1044,0
20:04:10,10084.23,Fox,5494,259,104,74,50,22,2,7,5494,5390,5316,3997,1144,1076,126,133,2749,2745,255,3936,1044,0
20:04:10,10084.75,Fox,5496,258,104,76,50,19,2,7,5496,5392,5316,3997,1144,1076,125,133,2750,2746,255,3939,1044,0
20:04:10,10085.28,Fox,5496,258,102,74,54,18,3,7,5496,5394,5320,3997,1145,1076,125,133,2750,2746,255,3939,1044,0
20:04:11,10086.48,Fox,5496,258,100,74,56,18,3,7,5496,5396,5322,3997,1145,1076,125,133,2750,2746,255,3939,1044,0
20:04:11,10086.97,Fox,5500,261,102,74,55,18,3,7,5498,5396,5322,3997,1145,1076,126,135,2752,2748,255,3940,1044,0
20:04:11,10087.25,Fox,5500,258,104,74,55,15,3,7,5500,5396,5322,3997,1145,1076,125,133,2752,2748,255,3943,1044,0
20:04:11,10088.01,Fox,5500,257,104,74,54,15,3,7,5500,5396,5322,3998,1145,1076,124,133,2752,2748,255,3944,1044,0
20:04:11,10088.45,Fox,5500,257,102,76,54,15,3,7,5500,5398,5322,3998,1145,1076,124,133,2752,2748,255,3944,1044,0
20:04:12,10089.24,Fox,5502,256,100,78,53,13,3,7,5500,5400,5322,3999,1145,1076,123,133,2752,2750,255,3947,1044,0
20:04:12,10089.74,Fox,5502,256,100,78,55,13,3,7,5502,5402,5324,3999,1145,1076,123,133,2752,2750,255,3947,1044,0
20:04:12,10090.2,Fox,5502,256,98,76,59,13,3,7,5502,5404,5328,3999,1145,1076,123,133,2752,2750,255,3947,1044,0
20:04:12,10090.89,Fox,5502,255,94,78,60,13,3,7,5502,5408,5330,4000,1145,1076,122,133,2752,2750,255,3948,1044,0
20:04:12,10091.42,Fox,5504,257,94,80,60,13,3,7,5504,5410,5330,4000,1145,1076,124,133,2754,2750,255,3948,1044,0
20:04:12,10091.65,Fox,5504,257,94,80,59,14,3,7,5504,5410,5330,4001,1145,1076,124,133,2754,2750,255,3948,1044,0
20:04:13,10092.67,Fox,5504,257,88,86,59,14,3,7,5504,5416,5330,4001,1145,1076,124,133,2754,2750,255,3948,1044,0
20:04:13,10092.88,Fox,5504,257,88,84,61,14,3,7,5504,5416,5332,4001,1145,1076,124,133,2754,2750,255,3948,1044,0
20:04:13,10093.48,Fox,5504,255,88,82,63,12,3,7,5504,5416,5334,4001,1145,1076,123,132,2754,2750,255,3950,1044,0
20:04:13,10094.67,Fox,5504,255,86,80,67,12,3,7,5504,5418,5338,4001,1145,1076,123,132,2754,2750,255,3950,1044,0
20:04:14,10095.33,Fox,5504,255,80,86,67,12,3,7,5504,5424,5338,4001,1145,1076,123,132,2754,2750,255,3950,1044,0
20:04:14,10095.56,Fox,5504,255,78,86,69,12,3,7,5504,5426,5340,4001,1145,1076,123,132,2754,2750,255,3950,1044,0
20:04:14,10096.45,Fox,5504,255,78,84,70,13,3,7,5504,5426,5342,4002,1145,1076,123,132,2754,2750,255,3950,1044,0
20:04:15,10098.02,Fox,5504,255,78,80,72,15,3,7,5504,5426,5346,4004,1145,1076,123,132,2754,2750,255,3950,1044,0
20:04:15,10098.39,Fox,5506,255,76,80,73,14,3,7,5504,5428,5348,4004,1145,1076,123,132,2755,2751,255,3952,1044,0
20:04:15,10098.66,Fox,5506,255,78,80,73,14,3,7,5506,5428,5348,4004,1145,1076,123,132,2755,2751,255,3952,1044,0
20:04:15,10099.31,Fox,5506,255,78,76,77,14,3,7,5506,5428,5352,4004,1145,1076,123,132,2755,2751,255,3952,1044,0
20:04:15,10099.52,Fox,5506,254,78,76,77,13,3,7,5506,5428,5352,4004,1145,1076,123,131,2755,2751,255,3953,1044,0
20:04:15,10099.95,Fox,5506,254,78,74,79,13,3,7,5506,5428,5354,4004,1145,1076,123,131,2755,2751,255,3953,1044,0
20:04:15,10100.57,Fox,5506,253,76,72,83,13,3,6,5506,5430,5358,4004,1145,1076,123,130,2755,2751,255,3953,1045,0
20:04:16,10101.19,Fox,5506,252,74,74,83,12,3,6,5506,5432,5358,4004,1145,1076,123,129,2755,2751,255,3954,1045,0
20:04:16,10101.83,Fox,5508,253,74,76,82,12,3,6,5508,5434,5358,4004,1145,1076,122,131,2755,2753,255,3955,1045,0
20:04:16,10102.26,Fox,5508,252,74,76,82,11,3,6,5508,5434,5358,4004,1145,1076,122,130,2755,2753,255,3956,1045,0
20:04:16,10102.91,Fox,5508,252,74,72,86,11,3,6,5508,5434,5362,4004,1145,1076,122,130,2755,2753,255,3956,1045,0
20:04:16,10103.41,Fox,5508,252,74,70,86,13,3,6,5508,5434,5364,4006,1145,1076,122,130,2755,2753,255,3956,1045,0
20:04:17,10105.04,Fox,5510,253,74,72,85,13,3,6,5510,5436,5364,4006,1145,1076,122,131,2756,2754,255,3957,1045,0
20:04:17,10105.92,Fox,5512,253,74,72,84,13,3,5,5510,5436,5364,4006,1145,1076,122,131,2757,2755,255,3958,1046,0
20:04:17,10106.17,Fox,5512,253,76,72,84,13,3,5,5512,5436,5364,4006,1145,1076,122,131,2757,2755,255,3958,1046,0
20:04:18,10107.07,Fox,5512,252,76,72,84,12,3,5,5512,5436,5364,4006,1145,1076,122,130,2757,2755,255,3959,1046,0
20:04:18,10108.08,Fox,5512,251,76,68,88,11,3,5,5512,5436,5368,4006,1145,1076,122,129,2757,2755,255,3960,1046,0
20:04:18,10108.51,Fox,5512,250,76,68,86,12,3,5,5512,5436,5368,4008,1145,1076,121,129,2757,2755,255,3961,1046,0
20:04:18,10109.2,Fox,5512,250,76,68,84,14,3,5,5512,5436,5368,4010,1145,1076,121,129,2757,2755,255,3961,1046,0
20:04:18,10109.64,Fox,5512,250,74,70,84,14,3,5,5512,5438,5368,4010,1145,1076,121,129,2757,2755,255,3961,1046,0
20:04:19,10110.69,Fox,5512,250,74,70,81,17,3,5,5512,5438,5368,4013,1145,1076,121,129,2757,2755,255,3961,1046,0
20:04:19,10112.14,Fox,5514,251,74,72,80,17,3,5,5514,5440,5368,4013,1145,1076,121,130,2758,2756,255,3962,1046,0
20:04:19,10112.35,Fox,5514,251,74,68,84,17,3,5,5514,5440,5372,4013,1145,1076,121,130,2758,2756,255,3962,1046,0
20:04:20,10113.01,Fox,5514,250,74,68,84,17,3,4,5514,5440,5372,4013,1145,1076,120,130,2758,2756,255,3962,1047,0
20:04:20,10113.67,Fox,5514,250,72,70,82,19,3,4,5514,5442,5372,4015,1145,1076,120,130,2758,2756,255,3962,1047,0
20:04:20,10114.09,Fox,5514,248,70,72,80,19,3,4,5514,5444,5372,4017,1145,1076,120,128,2758,2756,255,3964,1047,0
20:04:20,10114.53,Fox,5514,248,70,70,80,21,3,4,5514,5444,5374,4019,1145,1076,120,128,2758,2756,255,3964,1047,0
20:04:20,10115.3,Fox,5514,248,70,70,80,21,2,5,5514,5444,5374,4019,1145,1077,120,128,2758,2756,255,3964,1047,0
20:04:20,10115.73,Fox,5514,248,70,70,78,23,2,5,5514,5444,5374,4021,1145,1077,120,128,2758,2756,255,3964,1047,0
20:04:21,10116.53,Fox,5514,247,70,66,82,23,2,4,5514,5444,5378,4021,1145,1077,119,128,2758,2756,255,3964,1048,0
20:04:21,10117.3,Fox,5516,249,72,66,82,23,2,4,5516,5444,5378,4021,1145,1077,120,129,2759,2757,255,3964,1048,0
20:04:21,10117.49,Fox,5516,249,72,62,86,23,2,4,5516,5444,5382,4021,1145,1077,120,129,2759,2757,255,3964,1048,0
20:04:21,10118.1,Fox,5516,249,70,64,84,25,2,4,5516,5446,5382,4023,1145,1077,120,129,2759,2757,255,3964,1048,0
20:04:21,10118.66,Fox,5518,250,70,66,83,25,2,4,5518,5448,5382,4023,1145,1077,120,130,2760,2758,255,3965,1048,0
20:04:22,10119.07,Fox,5520,250,72,66,82,24,2,4,5520,5448,5382,4023,1145,1077,120,130,2761,2759,255,3967,1048,0
20:04:22,10119.29,Fox,5520,250,72,64,83,25,2,4,5520,5448,5384,4024,1145,1077,120,130,2761,2759,255,3967,1048,0
20:04:22,10119.71,Fox,5520,249,72,64,83,24,2,4,5520,5448,5384,4024,1145,1077,120,129,2761,2759,255,3968,1048,0
20:04:22,10120.18,Fox,5520,249,72,62,85,24,2,4,5520,5448,5386,4024,1145,1077,120,129,2761,2759,255,3968,1048,0
20:04:22,10120.76,Fox,5520,249,70,62,87,24,2,4,5520,5450,5388,4024,1145,1077,120,129,2761,2759,255,3968,1048,0
20:04:22,10121.18,Fox,5520,246,70,62,87,21,2,4,5520,5450,5388,4024,1145,1077,119,127,2761,2759,255,3971,1048,0
20:04:22,10121.61,Fox,5520,246,68,64,87,21,2,4,5520,5452,5388,4024,1145,1077,119,127,2761,2759,255,3971,1048,0
20:04:23,10122.07,Fox,5520,246,68,64,86,22,2,4,5520,5452,5388,4025,1145,1077,119,127,2761,2759,255,3971,1048,0
20:04:23,10122.44,Fox,5520,246,68,62,88,22,2,4,5520,5452,5390,4025,1145,1077,119,127,2761,2759,255,3971,1048,0
20:04:23,10123.03,Fox,5520,245,68,60,89,23,2,3,5520,5452,5392,4026,1145,1077,118,127,2761,2759,255,3971,1049,0
20:04:23,10123.21,Fox,5520,245,68,60,87,25,2,3,5520,5452,5392,4028,1145,1077,118,127,2761,2759,255,3971,1049,0
20:04:23,10123.81,Fox,5522,246,68,58,89,24,2,3,5520,5452,5394,4028,1145,1077,119,127,2763,2759,255,3972,1049,0
20:04:23,10124.18,Fox,5522,244,70,58,89,22,2,3,5522,5452,5394,4028,1145,1077,119,125,2763,2759,255,3974,1049,0
20:04:23,10124.83,Fox,5522,240,68,60,89,18,2,3,5522,5454,5394,4028,1145,1077,118,122,2763,2759,255,3978,1049,0
20:04:24,10125.05,Fox,5522,240,68,58,91,18,2,3,5522,5454,5396,4028,1145,1077,118,122,2763,2759,255,3978,1049,0
20:04:24,10125.67,Fox,5522,240,66,60,90,19,2,3,5522,5456,5396,4029,1145,1077,118,122,2763,2759,255,3978,1049,0
20:04:24,10126.28,Fox,5522,238,64,62,90,17,2,3,5522,5458,5396,4029,1145,1077,118,120,2763,2759,255,3980,1049,0
20:04:24,10127.01,Fox,5522,238,64,60,92,17,2,3,5522,5458,5398,4029,1145,1077,118,120,2763,2759,255,3980,1049,0
20:04:24,10127.68,Fox,5522,238,64,58,94,17,2,3,5522,5458,5400,4029,1145,1077,118,120,2763,2759,255,3980,1049,0
20:04:25,10128.52,Fox,5522,238,62,56,98,17,2,3,5522,5460,5404,4029,1145,1077,118,120,2763,2759,255,3980,1049,0
20:04:25,10128.74,Fox,5522,236,60,58,98,15,2,3,5522,5462,5404,4029,1145,1077,118,118,2763,2759,255,3982,1049,0
20:04:25,10129.54,Fox,5522,236,60,54,102,15,2,3,5522,5462,5408,4029,1145,1077,118,118,2763,2759,255,3982,1049,0
20:04:25,10129.79,Fox,5522,235,60,52,103,15,2,3,5522,5462,5410,4030,1145,1077,117,118,2763,2759,255,3983,1049,0
20:04:26,10131.03,Fox,5524,236,60,50,101,18,2,3,5522,5462,5412,4033,1145,1077,118,118,2765,2759,255,3984,1049,0
20:04:26,10131.28,Fox,5524,236,62,46,105,18,2,3,5524,5462,5416,4033,1145,1077,118,118,2765,2759,255,3984,1049,0
20:04:26,10132.65,Fox,5528,238,60,50,104,17,2,3,5526,5466,5416,4033,1145,1077,117,121,2766,2762,255,3986,1049,0
20:04:26,10132.89,Fox,5528,238,60,50,106,17,2,3,5528,5468,5418,4033,1145,1077,117,121,2766,2762,255,3986,1049,0
20:04:27,10133.57,Fox,5534,241,62,46,107,17,2,3,5530,5468,5422,4033,1145,1077,116,125,2768,2766,255,3989,1049,0
20:04:27,10134.06,Fox,5536,239,68,44,104,19,2,2,5536,5468,5424,4037,1145,1077,115,124,2770,2766,255,3993,1049,0
20:04:27,10134.54,Fox,5538,240,68,44,105,19,2,2,5538,5470,5426,4037,1145,1077,114,126,2770,2768,255,3994,1049,0
20:04:27,10136.3,Fox,5538,239,68,44,104,19,2,2,5538,5470,5426,4038,1145,1077,114,125,2770,2768,255,3995,1049,0
20:04:28,10136.89,Fox,5542,241,70,42,104,19,1,3,5540,5470,5428,4038,1145,1078,114,127,2772,2770,255,3997,1049,0
20:04:28,10137.17,Fox,5542,241,72,42,104,19,1,3,5542,5470,5428,4038,1145,1078,114,127,2772,2770,255,3997,1049,0
20:04:28,10138.45,Fox,5544,242,74,42,101,21,1,3,5544,5470,5428,4040,1145,1078,114,128,2773,2771,255,3998,1049,0
20:04:28,10139.43,Fox,5544,242,74,38,105,21,1,3,5544,5470,5432,4040,1145,1078,114,128,2773,2771,255,3998,1049,0
20:04:29,10139.93,Fox,5546,243,72,40,103,22,1,3,5544,5472,5432,4041,1145,1078,113,130,2773,2773,255,3999,1049,0
20:04:29,10140.21,Fox,5546,243,72,40,105,22,1,3,5546,5474,5434,4041,1145,1078,113,130,2773,2773,255,3999,1049,0
20:04:29,10141.31,Fox,5546,241,70,42,105,20,1,3,5546,5476,5434,4041,1145,1078,112,129,2773,2773,255,4001,1049,0
20:04:29,10141.6,Fox,5546,240,70,42,105,19,1,3,5546,5476,5434,4041,1145,1078,112,128,2773,2773,255,4002,1049,0
20:04:30,10142.65,Fox,5548,241,72,42,104,19,1,3,5548,5476,5434,4041,1145,1078,113,128,2775,2773,255,4003,1049,0
20:04:30,10143.51,Fox,5548,241,72,40,106,19,1,3,5548,5476,5436,4041,1145,1078,113,128,2775,2773,255,4003,1049,0
20:04:30,10144.2,Fox,5548,239,70,42,106,17,1,3,5548,5478,5436,4041,1145,1078,112,127,2775,2773,255,4005,1049,0
20:04:30,10144.42,Fox,5548,237,70,42,106,15,1,3,5548,5478,5436,4041,1145,1078,112,125,2775,2773,255,4007,1049,0
20:04:31,10145.59,Fox,5548,237,70,42,103,18,1,3,5548,5478,5436,4044,1145,1078,112,125,2775,2773,255,4007,1049,0
20:04:31,10146.88,Fox,5548,236,70,42,101,19,1,3,5548,5478,5436,4046,1145,1078,112,124,2775,2773,255,4008,1049,0
20:04:31,10148.17,Fox,5548,236,70,40,103,19,1,3,5548,5478,5438,4046,1145,1078,112,124,2775,2773,255,4008,1049,0
20:04:32,10148.97,Fox,5548,234,68,42,103,17,1,3,5548,5480,5438,4046,1145,1078,110,124,2775,2773,255,4010,1049,0
20:04:32,10149.43,Fox,5548,234,66,44,103,17,1,3,5548,5482,5438,4046,1145,1078,110,124,2775,2773,255,4010,1049,0
20:04:32,10150.15,Fox,5548,233,66,44,101,18,1,3,5548,5482,5438,4048,1145,1078,110,123,2775,2773,255,4011,1049,0
20:04:32,10150.81,Fox,5548,233,66,42,99,22,1,3,5548,5482,5440,4052,1145,1078,110,123,2775,2773,255,4011,1049,0
20:04:33,10151.46,Fox,5550,234,66,42,96,24,1,3,5548,5482,5440,4054,1145,1078,109,125,2775,2775,255,4012,1049,0
20:04:33,10151.92,Fox,5550,234,68,40,98,24,1,3,5550,5482,5442,4054,1145,1078,109,125,2775,2775,255,4012,1049,0
20:04:33,10152.38,Fox,5550,234,64,42,100,24,1,3,5550,5486,5444,4054,1145,1078,109,125,2775,2775,255,4012,1049,0
20:04:33,10152.77,Fox,5552,235,66,42,99,24,1,3,5552,5486,5444,4054,1145,1078,109,126,2776,2776,255,4013,1049,0
20:04:33,10153.49,Fox,5552,235,66,42,97,26,1,3,5552,5486,5444,4056,1145,1078,109,126,2776,2776,255,4013,1049,0
20:04:33,10153.95,Fox,5552,235,66,42,96,27,1,3,5552,5486,5444,4057,1145,1078,109,126,2776,2776,255,4013,1049,0
20:04:34,10154.65,Fox,5554,236,68,42,95,27,1,3,5554,5486,5444,4057,1145,1078,110,126,2778,2776,255,4014,1049,0
20:04:34,10155.11,Fox,5554,236,66,44,93,29,1,3,5554,5488,5444,4059,1145,1078,110,126,2778,2776,255,4014,1049,0
20:04:34,10156.17,Fox,5554,232,64,46,92,27,1,2,5554,5490,5444,4060,1145,1078,108,124,2778,2776,255,4017,1050,0
20:04:34,10156.63,Fox,5554,232,64,44,93,27,2,2,5554,5490,5446,4061,1146,1078,108,124,2778,2776,255,4017,1050,0
20:04:34,10157.24,Fox,5554,230,64,42,95,25,2,2,5554,5490,5448,4061,1146,1078,107,123,2778,2776,255,4019,1050,0
20:04:35,10158.09,Fox,5556,230,64,44,94,25,2,1,5556,5492,5448,4061,1146,1078,105,125,2778,2778,255,4020,1051,0
20:04:35,10158.31,Fox,5556,230,64,44,91,28,2,1,5556,5492,5448,4064,1146,1078,105,125,2778,2778,255,4020,1051,0
20:04:35,10158.81,Fox,5556,230,64,44,90,29,2,1,5556,5492,5448,4065,1146,1078,105,125,2778,2778,255,4020,1051,0
20:04:35,10159.5,Fox,5556,230,64,42,91,30,2,1,5556,5492,5450,4066,1146,1078,105,125,2778,2778,255,4020,1051,0
20:04:35,10160.12,Fox,5556,230,64,40,92,31,2,1,5556,5492,5452,4067,1146,1078,105,125,2778,2778,255,4020,1051,0
20:04:36,10160.8,Fox,5558,229,64,40,87,33,2,1,5556,5492,5452,4071,1146,1078,104,125,2780,2778,255,4023,1051,0
20:04:36,10161.06,Fox,5558,229,66,40,85,35,2,1,5558,5492,5452,4073,1146,1078,104,125,2780,2778,255,4023,1051,0
20:04:36,10161.81,Fox,5558,227,66,40,85,33,2,1,5558,5492,5452,4073,1146,1078,104,123,2780,2778,255,4025,1051,0
20:04:36,10162.52,Fox,5558,227,64,42,85,33,2,1,5558,5494,5452,4073,1146,1078,104,123,2780,2778,255,4025,1051,0
20:04:37,10163.45,Fox,5558,227,64,40,83,37,2,1,5558,5494,5454,4077,1146,1078,104,123,2780,2778,255,4025,1051,0
20:04:37,10163.88,Fox,5558,225,64,40,82,36,2,1,5558,5494,5454,4078,1146,1078,104,121,2780,2778,255,4027,1051,0
20:04:37,10164.09,Fox,5558,225,64,38,84,36,2,1,5558,5494,5456,4078,1146,1078,104,121,2780,2778,255,4027,1051,0
20:04:37,10164.77,Fox,5562,226,66,36,85,34,2,1,5560,5494,5458,4078,1146,1078,103,123,2781,2781,255,4030,1051,0
20:04:37,10165.31,Fox,5564,226,70,36,84,33,2,1,5564,5494,5458,4078,1146,1078,102,124,2781,2783,255,4032,1051,0
20:04:38,10166.27,Fox,5566,227,70,36,83,31,4,1,5564,5494,5458,4078,1148,1078,103,124,2783,2783,255,4033,1051,0
20:04:38,10166.71,Fox,5566,226,72,34,85,30,4,1,5566,5494,5460,4078,1148,1078,103,123,2783,2783,255,4034,1051,0
20:04:38,10167.45,Fox,5566,225,70,34,87,29,4,1,5566,5496,5462,4078,1148,1078,103,122,2783,2783,255,4035,1051,0
20:04:38,10168.36,Fox,5566,225,70,34,83,33,4,1,5566,5496,5462,4082,1148,1078,103,122,2783,2783,255,4035,1051,0
20:04:39,10169.25,Fox,5568,222,72,34,82,29,4,1,5568,5496,5462,4082,1148,1078,102,120,2783,2785,255,4040,1051,0
20:04:39,10169.77,Fox,5568,222,68,38,82,29,4,1,5568,5500,5462,4082,1148,1078,102,120,2783,2785,255,4040,1051,0
20:04:39,10170.22,Fox,5570,222,68,38,81,28,4,1,5568,5500,5462,4082,1148,1078,101,121,2783,2787,255,4042,1051,0
20:04:39,10170.7,Fox,5574,223,72,38,79,27,4,1,5572,5500,5462,4082,1148,1078,101,122,2785,2789,255,4045,1051,0
20:04:39,10171.18,Fox,5574,219,74,34,83,23,4,1,5574,5500,5466,4082,1148,1078,101,118,2785,2789,255,4049,1051,0
20:04:39,10171.68,Fox,5576,218,76,32,84,21,4,1,5576,5500,5468,4082,1148,1078,99,119,2786,2790,255,4052,1051,0
20:04:39,10172.15,Fox,5576,218,74,34,84,21,4,1,5576,5502,5468,4082,1148,1078,99,119,2786,2790,255,4052,1051,0
20:04:40,10173.02,Fox,5580,220,78,32,81,24,4,1,5580,5502,5470,4085,1148,1078,100,120,2789,2791,255,4054,1051,0
20:04:40,10174.1,Fox,5584,218,80,34,79,20,4,1,5584,5504,5470,4085,1148,1078,98,120,2791,2793,255,4060,1051,0
20:04:40,10174.62,Fox,5588,219,80,34,77,19,4,1,5584,5504,5470,4085,1148,1078,99,120,2794,2794,255,4063,1051,0
20:04:40,10175.1,Fox,5588,219,84,34,75,21,4,1,5588,5504,5470,4087,1148,1078,99,120,2794,2794,255,4063,1051,0
20:04:41,10175.57,Fox,5590,221,84,34,75,19,6,1,5588,5504,5470,4087,1150,1078,99,122,2794,2796,255,4063,1051,0
20:04:41,10175.82,Fox,5590,221,86,34,75,19,6,1,5590,5504,5470,4087,1150,1078,99,122,2794,2796,255,4063,1051,0
20:04:41,10176.99,Fox,5592,222,86,34,72,21,6,1,5590,5504,5470,4089,1150,1078,98,124,2794,2798,255,4064,1051,0
20:04:41,10177.25,Fox,5592,222,88,34,71,22,6,1,5592,5504,5470,4090,1150,1078,98,124,2794,2798,255,4064,1051,0
20:04:41,10177.98,Fox,5592,222,88,34,68,25,6,1,5592,5504,5470,4093,1150,1078,98,124,2794,2798,255,4064,1051,0
20:04:42,10178.67,Fox,5592,220,88,30,72,23,6,1,5592,5504,5474,4093,1150,1078,96,124,2794,2798,255,4066,1051,0
20:04:42,10179.73,Fox,5592,220,88,28,73,24,6,1,5592,5504,5476,4094,1150,1078,96,124,2794,2798,255,4066,1051,0
20:04:42,10180.16,Fox,5594,221,90,28,72,24,6,1,5594,5504,5476,4094,1150,1078,97,124,2796,2798,255,4067,1051,0
20:04:42,10180.6,Fox,5594,221,90,28,71,25,6,1,5594,5504,5476,4095,1150,1078,97,124,2796,2798,255,4067,1051,0
20:04:43,10181.25,Fox,5594,221,88,30,69,27,6,1,5594,5506,5476,4097,1150,1078,97,124,2796,2798,255,4067,1051,0
20:04:43,10182.55,Fox,5594,221,88,28,71,27,6,1,5594,5506,5478,4097,1150,1078,97,124,2796,2798,255,4067,1051,0
20:04:43,10182.99,Fox,5594,221,88,28,70,28,6,1,5594,5506,5478,4098,1150,1078,97,124,2796,2798,255,4067,1051,0
20:04:43,10183.43,Fox,5594,218,88,28,68,27,6,1,5594,5506,5478,4100,1150,1078,96,122,2796,2798,255,4070,1051,0
20:04:43,10184.04,Fox,5594,218,88,28,67,28,6,1,5594,5506,5478,4101,1150,1078,96,122,2796,2798,255,4070,1051,0
20:04:44,10184.47,Fox,5594,218,86,30,67,28,6,1,5594,5508,5478,4101,1150,1078,96,122,2796,2798,255,4070,1051,0
20:04:44,10185.76,Fox,5598,218,88,30,65,26,6,1,5596,5508,5478,4101,1150,1078,95,123,2798,2800,255,4074,1051,0
20:04:44,10186.03,Fox,5598,218,90,30,65,26,6,1,5598,5508,5478,4101,1150,1078,95,123,2798,2800,255,4074,1051,0
20:04:45,10187.51,Fox,5598,215,88,30,65,25,6,1,5598,5510,5480,4103,1150,1078,95,120,2798,2800,255,4077,1051,0
20:04:45,10188.12,Fox,5598,215,88,28,65,27,6,1,5598,5510,5482,4105,1150,1078,95,120,2798,2800,255,4077,1051,0
20:04:45,10188.89,Fox,5600,213,86,30,63,25,6,1,5598,5512,5482,4106,1150,1078,93,120,2799,2801,255,4081,1051,0
20:04:45,10189.15,Fox,5600,213,88,30,62,26,6,1,5600,5512,5482,4107,1150,1078,93,120,2799,2801,255,4081,1051,0
20:04:46,10190.24,Fox,5600,212,88,30,59,28,6,1,5600,5512,5482,4110,1150,1078,93,119,2799,2801,255,4082,1051,0
20:04:46,10190.77,Fox,5604,215,92,26,62,28,6,1,5604,5512,5486,4110,1150,1078,93,122,2800,2804,255,4083,1051,0
20:04:46,10191,Fox,5604,214,92,26,62,27,6,1,5604,5512,5486,4110,1150,1078,93,121,2800,2804,255,4084,1051,0
20:04:46,10191.74,Fox,5604,212,92,26,58,29,6,1,5604,5512,5486,4114,1150,1078,93,119,2800,2804,255,4086,1051,0
20:04:46,10192.44,Fox,5606,214,94,26,58,29,6,1,5606,5512,5486,4114,1150,1078,95,119,2802,2804,255,4086,1051,0
20:04:47,10193.57,Fox,5606,213,94,24,58,30,6,1,5606,5512,5488,4116,1150,1078,95,118,2802,2804,255,4087,1051,0
20:04:47,10194.42,Fox,5606,211,94,24,53,33,6,1,5606,5512,5488,4121,1150,1078,93,118,2802,2804,255,4089,1051,0
20:04:47,10194.94,Fox,5608,211,92,24,53,33,6,1,5606,5514,5490,4122,1150,1078,92,119,2802,2806,255,4091,1051,0
20:04:47,10195.19,Fox,5608,211,94,24,53,33,6,1,5608,5514,5490,4122,1150,1078,92,119,2802,2806,255,4091,1051,0
20:04:48,10196.93,Fox,5612,213,94,22,53,33,6,1,5608,5514,5492,4122,1150,1078,93,120,2805,2807,255,4093,1051,0
20:04:48,10197.42,Fox,5612,213,98,22,51,35,6,1,5612,5514,5492,4124,1150,1078,93,120,2805,2807,255,4093,1051,0
20:04:48,10198.09,Fox,5612,210,98,22,51,33,6,0,5612,5514,5492,4124,1150,1078,93,117,2805,2807,255,4095,1052,0
20:04:48,10198.54,Fox,5612,208,98,22,51,31,6,0,5612,5514,5492,4124,1150,1078,92,116,2805,2807,255,4097,1052,0
20:04:49,10199.4,Fox,5612,206,98,22,51,29,6,0,5612,5514,5492,4124,1150,1078,92,114,2805,2807,255,4099,1052,0
20:04:49,10199.87,Fox,5612,206,96,24,50,30,6,0,5612,5516,5492,4125,1150,1078,92,114,2805,2807,255,4099,1052,0
20:04:49,10200.34,Fox,5612,205,96,24,49,30,6,0,5612,5516,5492,4126,1150,1078,92,113,2805,2807,255,4100,1052,0
20:04:49,10200.83,Fox,5614,204,98,24,46,30,6,0,5614,5516,5492,4128,1150,1078,92,112,2807,2807,255,4103,1052,0
20:04:49,10201.32,Fox,5614,204,96,24,48,30,6,0,5614,5518,5494,4128,1150,1078,92,112,2807,2807,255,4103,1052,0
20:04:50,10202.06,Fox,5614,200,94,26,48,25,7,0,5614,5520,5494,4128,1151,1078,92,108,2807,2807,255,4107,1052,0
20:04:50,10202.89,Fox,5614,200,94,26,48,24,8,0,5614,5520,5494,4128,1152,1078,92,108,2807,2807,255,4107,1052,0
20:04:50,10204.21,Fox,5616,199,96,26,48,21,8,0,5616,5520,5494,4128,1152,1078,93,106,2809,2807,255,4110,1052,0
20:04:50,10204.84,Fox,5616,196,96,26,48,18,8,0,5616,5520,5494,4128,1152,1078,92,104,2809,2807,255,4113,1052,0
20:04:51,10205.06,Fox,5616,195,96,26,48,17,8,0,5616,5520,5494,4128,1152,1078,92,103,2809,2807,255,4114,1052,0
20:04:51,10205.78,Fox,5616,195,96,24,50,17,8,0,5616,5520,5496,4128,1152,1078,92,103,2809,2807,255,4114,1052,0
20:04:51,10206.65,Fox,5616,195,94,26,50,17,8,0,5616,5522,5496,4128,1152,1078,92,103,2809,2807,255,4114,1052,0
20:04:52,10207.75,Fox,5618,194,96,26,49,15,8,0,5618,5522,5496,4128,1152,1078,93,101,2811,2807,255,4117,1052,0
20:04:52,10208.22,Fox,5618,194,96,22,53,15,8,0,5618,5522,5500,4128,1152,1078,93,101,2811,2807,255,4117,1052,0
20:04:52,10208.87,Fox,5620,195,98,22,51,16,8,0,5620,5522,5500,4129,1152,1078,93,102,2812,2808,255,4118,1052,0
20:04:52,10210.04,Fox,5620,194,98,22,51,15,8,0,5620,5522,5500,4129,1152,1078,92,102,2812,2808,255,4119,1052,0
20:04:52,10210.57,Fox,5620,193,98,20,53,14,8,0,5620,5522,5502,4129,1152,1078,92,101,2812,2808,255,4120,1052,0
20:04:53,10211.31,Fox,5622,192,100,20,51,13,8,0,5622,5522,5502,4131,1152,1078,92,100,2813,2809,255,4123,1052,0
20:04:53,10212.43,Fox,5622,192,100,18,52,14,8,0,5622,5522,5504,4132,1152,1078,92,100,2813,2809,255,4123,1052,0
20:04:53,10212.91,Fox,5622,192,100,18,51,15,8,0,5622,5522,5504,4133,1152,1078,92,100,2813,2809,255,4123,1052,0
20:04:54,10213.89,Fox,5622,192,98,20,51,15,8,0,5622,5524,5504,4133,1152,1078,92,100,2813,2809,255,4123,1052,0
20:04:54,10215.08,Fox,5624,193,100,20,50,15,8,0,5624,5524,5504,4133,1152,1078,92,101,2814,2810,255,4124,1052,0
20:04:54,10215.48,Fox,5624,193,96,24,50,14,9,0,5624,5528,5504,4133,1153,1078,92,101,2814,2810,255,4124,1052,0
20:04:54,10216.39,Fox,5624,193,90,30,50,14,9,0,5624,5534,5504,4133,1153,1078,92,101,2814,2810,255,4124,1052,0
20:04:54,10216.83,Fox,5624,193,88,32,49,15,9,0,5624,5536,5504,4134,1153,1078,92,101,2814,2810,255,4124,1052,0
20:04:55,10217.03,Fox,5624,193,86,34,49,15,9,0,5624,5538,5504,4134,1153,1078,92,101,2814,2810,255,4124,1052,0
20:04:55,10217.75,Fox,5624,193,86,34,47,17,9,0,5624,5538,5504,4136,1153,1078,92,101,2814,2810,255,4124,1052,0
20:04:55,10219.38,Fox,5624,192,84,36,47,16,9,0,5624,5540,5504,4136,1153,1078,92,100,2814,2810,255,4125,1052,0
20:04:56,10219.97,Fox,5626,193,84,36,46,18,9,0,5626,5542,5506,4138,1153,1078,92,101,2815,2811,255,4126,1052,0
20:04:56,10220.88,Fox,5626,193,82,38,46,18,9,0,5626,5544,5506,4138,1153,1078,92,101,2815,2811,255,4126,1052,0
20:04:56,10221.41,Fox,5626,191,82,38,46,16,9,0,5626,5544,5506,4138,1153,1078,92,99,2815,2811,255,4128,1052,0
20:04:57,10223,Fox,5626,190,80,38,48,15,8,1,5626,5546,5508,4138,1153,1079,92,98,2815,2811,255,4129,1052,0
20:04:57,10223.25,Fox,5626,189,80,38,48,14,8,1,5626,5546,5508,4138,1153,1079,92,97,2815,2811,255,4130,1052,0
20:04:57,10223.75,Fox,5626,189,80,38,47,15,8,1,5626,5546,5508,4139,1153,1079,92,97,2815,2811,255,4130,1052,0
20:04:57,10224.67,Fox,5626,189,80,38,46,16,8,1,5626,5546,5508,4140,1153,1079,92,97,2815,2811,255,4130,1052,0
20:04:57,10225.28,Fox,5626,189,78,40,44,18,8,1,5626,5548,5508,4142,1153,1079,92,97,2815,2811,255,4130,1052,0
20:04:58,10226.13,Fox,5628,190,80,38,46,17,8,1,5628,5548,5510,4142,1153,1079,91,99,2815,2813,255,4131,1052,0
20:04:58,10227.33,Fox,5628,189,80,36,46,18,8,1,5628,5548,5512,4144,1153,1079,91,98,2815,2813,255,4132,1052,0
20:04:58,10227.67,Fox,5628,189,80,36,45,19,8,1,5628,5548,5512,4145,1153,1079,91,98,2815,2813,255,4132,1052,0
20:04:58,10228.21,Fox,5628,187,80,36,45,17,8,1,5628,5548,5512,4145,1153,1079,90,97,2815,2813,255,4134,1052,0
20:04:59,10229.45,Fox,5630,188,82,36,45,16,8,1,5630,5548,5512,4145,1153,1079,90,98,2816,2814,255,4135,1052,0
20:04:59,10230.35,Fox,5630,187,82,36,45,15,8,1,5630,5548,5512,4145,1153,1079,90,97,2816,2814,255,4136,1052,0
20:04:59,10231.54,Fox,5630,187,82,36,42,18,8,1,5630,5548,5512,4148,1153,1079,90,97,2816,2814,255,4136,1052,0
20:05:00,10232.05,Fox,5632,188,82,36,39,20,8,1,5630,5548,5512,4150,1153,1079,89,99,2816,2816,255,4137,1052,0
20:05:00,10232.23,Fox,5632,188,84,36,39,20,8,1,5632,5548,5512,4150,1153,1079,89,99,2816,2816,255,4137,1052,0
20:05:00,10233.19,Fox,5634,189,86,34,41,19,8,1,5634,5548,5514,4150,1153,1079,89,100,2817,2817,255,4138,1052,0
20:05:00,10233.39,Fox,5634,189,86,34,39,21,8,1,5634,5548,5514,4152,1153,1079,89,100,2817,2817,255,4138,1052,0
20:05:00,10234.17,Fox,5634,188,84,36,39,20,8,1,5634,5550,5514,4152,1153,1079,89,99,2817,2817,255,4139,1052,0
20:05:01,10234.75,Fox,5636,189,86,36,38,20,8,1,5636,5550,5514,4152,1153,1079,88,101,2817,2819,255,4140,1052,0
20:05:01,10235.32,Fox,5636,189,84,38,38,20,8,1,5636,5552,5514,4152,1153,1079,88,101,2817,2819,255,4140,1052,0
20:05:01,10235.71,Fox,5636,188,84,38,38,19,8,1,5636,5552,5514,4152,1153,1079,88,100,2817,2819,255,4141,1052,0
20:05:01,10237.3,Fox,5638,189,82,40,38,18,8,1,5636,5554,5514,4152,1153,1079,88,101,2818,2820,255,4142,1052,0
20:05:02,10237.69,Fox,5638,187,84,40,38,16,8,1,5638,5554,5514,4152,1153,1079,86,101,2818,2820,255,4144,1052,0
20:05:02,10238.49,Fox,5638,186,84,38,40,15,8,1,5638,5554,5516,4152,1153,1079,86,100,2818,2820,255,4145,1052,0
20:05:02,10238.68,Fox,5638,186,84,38,38,17,8,1,5638,5554,5516,4154,1153,1079,86,100,2818,2820,255,4145,1052,0
20:05:02,10239.1,Fox,5638,186,84,38,37,18,8,1,5638,5554,5516,4155,1153,1079,86,100,2818,2820,255,4145,1052,0
20:05:02,10239.93,Fox,5638,186,84,36,37,20,8,1,5638,5554,5518,4157,1153,1079,86,100,2818,2820,255,4145,1052,0
20:05:02,10240.14,Fox,5638,186,84,34,39,20,8,1,5638,5554,5520,4157,1153,1079,86,100,2818,2820,255,4145,1052,0
20:05:03,10240.75,Fox,5638,186,82,36,39,20,8,1,5638,5556,5520,4157,1153,1079,86,100,2818,2820,255,4145,1052,0
20:05:03,10241.9,Fox,5640,186,84,36,38,19,8,1,5640,5556,5520,4157,1153,1079,85,101,2819,2821,255,4147,1052,0
20:05:03,10242.38,Fox,5640,182,84,36,38,15,8,1,5640,5556,5520,4157,1153,1079,84,98,2819,2821,255,4151,1052,0
20:05:03,10243.15,Fox,5640,182,84,36,36,17,8,1,5640,5556,5520,4159,1153,1079,84,98,2819,2821,255,4151,1052,0
20:05:03,10243.5,Fox,5640,182,82,38,36,17,8,1,5640,5558,5520,4159,1153,1079,84,98,2819,2821,255,4151,1052,0
20:05:04,10243.87,Fox,5640,181,82,38,36,16,8,1,5640,5558,5520,4159,1153,1079,83,98,2819,2821,255,4152,1052,0
20:05:04,10244.27,Fox,5640,181,82,38,36,12,12,1,5640,5558,5520,4159,1157,1079,83,98,2819,2821,255,4152,1052,0
20:05:04,10245.01,Fox,5640,181,82,36,38,12,12,1,5640,5558,5522,4159,1157,1079,83,98,2819,2821,255,4152,1052,0
20:05:05,10247.55,Fox,5640,181,78,40,38,12,12,1,5640,5562,5522,4159,1157,1079,83,98,2819,2821,255,4152,1052,0
20:05:05,10247.86,Fox,5640,181,76,42,36,14,12,1,5640,5564,5522,4161,1157,1079,83,98,2819,2821,255,4152,1052,0
20:05:05,10248.36,Fox,5640,181,76,42,34,16,12,1,5640,5564,5522,4163,1157,1079,83,98,2819,2821,255,4152,1052,0
20:05:05,10249.24,Fox,5640,179,74,44,34,14,12,1,5640,5566,5522,4163,1157,1079,83,96,2819,2821,255,4154,1052,0
20:05:05,10249.6,Fox,5640,178,74,44,34,13,12,1,5640,5566,5522,4163,1157,1079,83,95,2819,2821,255,4155,1052,0
20:05:06,10250.13,Fox,5642,179,76,44,33,13,12,1,5642,5566,5522,4163,1157,1079,82,97,2819,2823,255,4156,1052,0
20:05:06,10250.48,Fox,5642,177,76,44,33,11,12,1,5642,5566,5522,4163,1157,1079,82,95,2819,2823,255,4158,1052,0
20:05:06,10251,Fox,5642,177,76,44,29,15,12,1,5642,5566,5522,4167,1157,1079,82,95,2819,2823,255,4158,1052,0
20:05:06,10251.75,Fox,5642,177,74,46,29,15,12,1,5642,5568,5522,4167,1157,1079,82,95,2819,2823,255,4158,1052,0
20:05:06,10252.2,Fox,5642,177,74,44,31,15,12,1,5642,5568,5524,4167,1157,1079,82,95,2819,2823,255,4158,1052,0
20:05:07,10252.93,Fox,5642,177,72,46,31,15,12,1,5642,5570,5524,4167,1157,1079,82,95,2819,2823,255,4158,1052,0
20:05:07,10253.38,Fox,5642,175,68,50,31,13,12,1,5642,5574,5524,4167,1157,1079,81,94,2819,2823,255,4160,1052,0
20:05:07,10253.88,Fox,5642,175,68,46,35,13,12,1,5642,5574,5528,4167,1157,1079,81,94,2819,2823,255,4160,1052,0
20:05:07,10254.21,Fox,5642,175,66,48,35,13,12,1,5642,5576,5528,4167,1157,1079,81,94,2819,2823,255,4160,1052,0
20:05:07,10254.79,Fox,5642,175,66,42,41,13,12,1,5642,5576,5534,4167,1157,1079,81,94,2819,2823,255,4160,1052,0
20:05:07,10255.09,Fox,5644,177,68,40,41,15,12,1,5644,5576,5536,4169,1157,1079,82,95,2820,2824,255,4160,1052,0
20:05:08,10255.74,Fox,5646,178,66,42,43,15,11,1,5646,5580,5538,4169,1157,1079,83,95,2822,2824,255,4161,1052,0
20:05:08,10256.6,Fox,5646,178,62,46,43,15,11,1,5646,5584,5538,4169,1157,1079,83,95,2822,2824,255,4161,1052,0
20:05:08,10257.05,Fox,5646,178,62,46,42,16,11,1,5646,5584,5538,4170,1157,1079,83,95,2822,2824,255,4161,1052,0
20:05:08,10257.4,Fox,5646,178,58,50,42,16,11,1,5646,5588,5538,4170,1157,1079,83,95,2822,2824,255,4161,1052,0
20:05:08,10258.1,Fox,5646,178,58,46,46,16,11,1,5646,5588,5542,4170,1157,1079,83,95,2822,2824,255,4161,1052,0
20:05:09,10258.31,Fox,5646,176,56,48,46,14,11,1,5646,5590,5542,4170,1157,1079,81,95,2822,2824,255,4163,1052,0
20:05:09,10259.06,Fox,5646,174,56,48,46,12,11,1,5646,5590,5542,4170,1157,1079,81,93,2822,2824,255,4165,1052,0
20:05:09,10259.43,Fox,5646,174,56,46,48,12,11,1,5646,5590,5544,4170,1157,1079,81,93,2822,2824,255,4165,1052,0
20:05:09,10259.76,Fox,5646,174,54,48,48,12,11,1,5646,5592,5544,4170,1157,1079,81,93,2822,2824,255,4165,1052,0
20:05:09,10260.5,Fox,5648,176,56,48,48,12,11,1,5648,5592,5544,4170,1157,1079,83,93,2824,2824,255,4165,1052,0
20:05:10,10261.45,Fox,5648,172,56,46,48,10,11,1,5648,5592,5546,4172,1157,1079,81,91,2824,2824,255,4169,1052,0
20:05:10,10261.64,Fox,5648,172,56,46,48,8,13,1,5648,5592,5546,4172,1159,1079,81,91,2824,2824,255,4169,1052,0
20:05:10,10262.71,Fox,5648,172,54,48,48,8,13,1,5648,5594,5546,4172,1159,1079,81,91,2824,2824,255,4169,1052,0
20:05:10,10263.53,Fox,5650,173,56,46,49,8,13,1,5650,5594,5548,4172,1159,1079,81,92,2825,2825,255,4170,1052,0
20:05:11,10265.67,Fox,5650,171,56,46,49,6,13,1,5650,5594,5548,4172,1159,1079,80,91,2825,2825,255,4172,1052,0
20:05:11,10266.28,Fox,5650,171,56,46,48,7,13,1,5650,5594,5548,4173,1159,1079,80,91,2825,2825,255,4172,1052,0
20:05:12,10267.6,Fox,5650,170,56,46,48,6,13,1,5650,5594,5548,4173,1159,1079,80,90,2825,2825,255,4173,1052,0
20:05:12,10268.2,Fox,5650,170,54,48,48,6,13,1,5650,5596,5548,4173,1159,1079,80,90,2825,2825,255,4173,1052,0
20:05:12,10268.75,Fox,5650,170,52,50,44,10,13,1,5650,5598,5548,4177,1159,1079,80,90,2825,2825,255,4173,1052,0
20:05:13,10270.75,Fox,5652,171,54,50,43,10,13,1,5652,5598,5548,4177,1159,1079,80,91,2826,2826,255,4174,1052,0
20:05:13,10271,Fox,5652,171,54,50,41,12,13,1,5652,5598,5548,4179,1159,1079,80,91,2826,2826,255,4174,1052,0
20:05:13,10271.7,Fox,5652,171,52,52,41,12,13,1,5652,5600,5548,4179,1159,1079,80,91,2826,2826,255,4174,1052,0
20:05:13,10272.19,Fox,5654,171,52,52,41,10,13,1,5652,5600,5548,4179,1159,1079,81,90,2827,2827,255,4176,1052,0
20:05:13,10272.4,Fox,5654,171,54,52,41,10,13,1,5654,5600,5548,4179,1159,1079,81,90,2827,2827,255,4176,1052,0
20:05:13,10272.97,Fox,5654,171,54,50,41,12,13,1,5654,5600,5550,4181,1159,1079,81,90,2827,2827,255,4176,1052,0
20:05:13,10273.16,Fox,5654,171,50,54,41,12,13,1,5654,5604,5550,4181,1159,1079,81,90,2827,2827,255,4176,1052,0
20:05:14,10273.89,Fox,5654,171,50,52,43,12,13,1,5654,5604,5552,4181,1159,1079,81,90,2827,2827,255,4176,1052,0
20:05:14,10274.99,Fox,5654,171,48,54,43,12,13,1,5654,5606,5552,4181,1159,1079,81,90,2827,2827,255,4176,1052,0
20:05:14,10275.63,Fox,5654,171,48,52,45,12,13,1,5654,5606,5554,4181,1159,1079,81,90,2827,2827,255,4176,1052,0
20:05:15,10276.35,Fox,5656,172,50,52,44,12,13,1,5656,5606,5554,4181,1159,1079,80,92,2827,2829,255,4177,1052,0
20:05:15,10276.75,Fox,5656,171,50,52,44,11,13,1,5656,5606,5554,4181,1159,1079,80,91,2827,2829,255,4178,1052,0
20:05:15,10277.77,Fox,5656,171,48,54,44,11,13,1,5656,5608,5554,4181,1159,1079,80,91,2827,2829,255,4178,1052,0
20:05:16,10279.3,Fox,5658,170,50,52,45,9,13,1,5658,5608,5556,4181,1159,1079,79,91,2829,2829,255,4181,1052,0
20:05:16,10279.66,Fox,5658,170,46,56,45,9,13,1,5658,5612,5556,4181,1159,1079,79,91,2829,2829,255,4181,1052,0
20:05:16,10280.16,Fox,5658,170,46,56,43,11,13,1,5658,5612,5556,4183,1159,1079,79,91,2829,2829,255,4181,1052,0
20:05:16,10281.52,Fox,5658,168,46,56,43,9,13,1,5658,5612,5556,4183,1159,1079,79,89,2829,2829,255,4183,1052,0
20:05:16,10282,Fox,5658,168,46,54,45,9,13,1,5658,5612,5558,4183,1159,1079,79,89,2829,2829,255,4183,1052,0
20:05:17,10283.35,Fox,5658,165,44,56,43,9,13,0,5658,5614,5558,4185,1159,1079,77,88,2829,2829,255,4185,1053,0
20:05:18,10286.03,Fox,5658,165,44,52,47,9,13,0,5658,5614,5562,4185,1159,1079,77,88,2829,2829,255,4185,1053,0
20:05:18,10286.51,Fox,5658,165,44,50,48,10,13,0,5658,5614,5564,4186,1159,1079,77,88,2829,2829,255,4185,1053,0
20:05:18,10286.67,Fox,5658,165,42,52,48,10,13,0,5658,5616,5564,4186,1159,1079,77,88,2829,2829,255,4185,1053,0
20:05:18,10287.6,Fox,5658,165,42,50,48,12,13,0,5658,5616,5566,4188,1159,1079,77,88,2829,2829,255,4185,1053,0
20:05:19,10290.47,Fox,5660,166,40,50,49,12,13,0,5658,5618,5568,4188,1159,1079,78,88,2831,2829,255,4186,1053,0
20:05:19,10290.65,Fox,5660,166,42,50,49,12,13,0,5660,5618,5568,4188,1159,1079,78,88,2831,2829,255,4186,1053,0
20:05:20,10291.59,Fox,5662,167,42,50,50,12,13,0,5662,5620,5570,4188,1159,1079,79,88,2833,2829,255,4187,1053,0
20:05:20,10291.94,Fox,5662,167,42,46,54,12,13,0,5662,5620,5574,4188,1159,1079,79,88,2833,2829,255,4187,1053,0
20:05:20,10292.47,Fox,5664,168,44,46,53,12,13,0,5664,5620,5574,4188,1159,1079,80,88,2835,2829,255,4188,1053,0
20:05:20,10292.67,Fox,5664,168,44,44,55,12,13,0,5664,5620,5576,4188,1159,1079,80,88,2835,2829,255,4188,1053,0
20:05:20,10293.61,Fox,5668,170,48,44,53,12,13,0,5668,5620,5576,4188,1159,1079,80,90,2837,2831,256,4189,1053,0
20:05:21,10293.96,Fox,5668,168,46,42,56,11,13,0,5668,5622,5580,4189,1159,1079,80,88,2837,2831,256,4191,1053,0
20:05:21,10294.33,Fox,5672,170,48,42,54,11,12,1,5670,5622,5580,4189,1159,1080,81,89,2840,2832,256,4193,1053,0
20:05:21,10294.54,Fox,5672,170,50,42,54,11,12,1,5672,5622,5580,4189,1159,1080,81,89,2840,2832,256,4193,1053,0
20:05:21,10295.01,Fox,5672,170,50,38,58,11,12,1,5672,5622,5584,4189,1159,1080,81,89,2840,2832,256,4193,1053,0
20:05:21,10295.87,Fox,5672,170,50,34,62,11,12,1,5672,5622,5588,4189,1159,1080,81,89,2840,2832,256,4193,1053,0
20:05:21,10296.75,Fox,5672,170,50,32,64,11,12,1,5672,5622,5590,4189,1159,1080,81,89,2840,2832,256,4193,1053,0
20:05:22,10297.03,Fox,5672,169,50,32,64,10,12,1,5672,5622,5590,4189,1159,1080,81,88,2840,2832,256,4194,1053,0
20:05:22,10297.61,Fox,5672,169,48,34,64,10,12,1,5672,5624,5590,4189,1159,1080,81,88,2840,2832,256,4194,1053,0
20:05:22,10298.26,Fox,5672,167,48,32,66,8,12,1,5672,5624,5592,4189,1159,1080,80,87,2840,2832,256,4196,1053,0
20:05:22,10298.88,Fox,5672,167,48,32,64,10,12,1,5672,5624,5592,4191,1159,1080,80,87,2840,2832,256,4196,1053,0
20:05:23,10300.03,Fox,5674,168,50,32,63,10,12,1,5674,5624,5592,4191,1159,1080,81,87,2842,2832,256,4197,1053,0
20:05:23,10300.18,Fox,5674,168,50,32,62,11,12,1,5674,5624,5592,4192,1159,1080,81,87,2842,2832,256,4197,1053,0
20:05:23,10300.56,Fox,5674,168,50,32,61,12,12,1,5674,5624,5592,4193,1159,1080,81,87,2842,2832,256,4197,1053,0
20:05:23,10301.26,Fox,5674,168,50,30,63,12,12,1,5674,5624,5594,4193,1159,1080,81,87,2842,2832,256,4197,1053,0
20:05:23,10302.53,Fox,5674,168,48,32,63,12,12,1,5674,5626,5594,4193,1159,1080,81,87,2842,2832,256,4197,1053,0
20:05:24,10303.41,Fox,5674,168,48,32,63,12,10,3,5674,5626,5594,4193,1159,1082,81,87,2842,2832,256,4197,1053,0
20:05:24,10304.24,Fox,5674,167,48,32,63,11,10,3,5674,5626,5594,4193,1159,1082,81,86,2842,2832,256,4198,1053,0
20:05:24,10305.55,Fox,5674,167,48,32,61,13,10,3,5674,5626,5594,4195,1159,1082,81,86,2842,2832,256,4198,1053,0
20:05:25,10306.68,Fox,5674,167,48,30,63,13,10,3,5674,5626,5596,4195,1159,1082,81,86,2842,2832,256,4198,1053,0
20:05:25,10306.94,Fox,5674,167,48,28,65,13,10,3,5674,5626,5598,4195,1159,1082,81,86,2842,2832,256,4198,1053,0
20:05:25,10308.8,Fox,5674,167,46,30,65,13,10,3,5674,5628,5598,4195,1159,1082,81,86,2842,2832,256,4198,1053,0
20:05:26,10309.37,Fox,5674,165,46,30,65,11,10,3,5674,5628,5598,4195,1159,1082,80,85,2842,2832,256,4200,1053,0
20:05:26,10310.16,Fox,5674,165,46,28,67,11,10,3,5674,5628,5600,4195,1159,1082,80,85,2842,2832,256,4200,1053,0
20:05:26,10310.72,Fox,5674,164,46,28,67,10,10,3,5674,5628,5600,4195,1159,1082,80,84,2842,2832,256,4201,1053,0
20:05:26,10311.11,Fox,5674,163,46,28,67,9,10,3,5674,5628,5600,4195,1159,1082,80,83,2842,2832,256,4202,1053,0
20:05:26,10311.76,Fox,5676,164,48,24,70,9,10,3,5676,5628,5604,4195,1159,1082,79,85,2842,2834,256,4203,1053,0
20:05:27,10311.93,Fox,5676,164,46,26,70,9,10,3,5676,5630,5604,4195,1159,1082,79,85,2842,2834,256,4203,1053,0
20:05:27,10312.77,Fox,5676,164,46,26,70,9,8,5,5676,5630,5604,4195,1159,1084,79,85,2842,2834,256,4203,1053,0
20:05:27,10313.72,Fox,5676,164,46,24,72,9,8,5,5676,5630,5606,4195,1159,1084,79,85,2842,2834,256,4203,1053,0
20:05:27,10314.39,Fox,5676,164,46,24,69,12,8,5,5676,5630,5606,4198,1159,1084,79,85,2842,2834,256,4203,1053,0
20:05:28,10314.72,Fox,5676,164,44,26,69,12,8,5,5676,5632,5606,4198,1159,1084,79,85,2842,2834,256,4203,1053,0
20:05:28,10315.03,Fox,5676,164,44,26,68,13,8,5,5676,5632,5606,4199,1159,1084,79,85,2842,2834,256,4203,1053,0
20:05:28,10315.34,Fox,5676,164,44,26,64,17,8,5,5676,5632,5606,4203,1159,1084,79,85,2842,2834,256,4203,1053,0
20:05:28,10315.71,Fox,5676,164,42,28,64,17,8,5,5676,5634,5606,4203,1159,1084,79,85,2842,2834,256,4203,1053,0
20:05:28,10316.41,Fox,5676,162,42,26,64,17,8,5,5676,5634,5608,4205,1159,1084,77,85,2842,2834,256,4205,1053,0
20:05:28,10317.27,Fox,5676,162,40,28,64,17,8,5,5676,5636,5608,4205,1159,1084,77,85,2842,2834,256,4205,1053,0
20:05:29,10318.38,Fox,5676,162,40,24,67,18,8,5,5676,5636,5612,4206,1159,1084,77,85,2842,2834,256,4205,1053,0
20:05:29,10318.68,Fox,5676,162,40,24,66,19,8,5,5676,5636,5612,4207,1159,1084,77,85,2842,2834,256,4205,1053,0
20:05:29,10319.11,Fox,5678,163,42,24,65,19,8,5,5678,5636,5612,4207,1159,1084,76,87,2842,2836,256,4206,1053,0
20:05:29,10320.03,Fox,5678,163,40,26,64,20,8,5,5678,5638,5612,4208,1159,1084,76,87,2842,2836,256,4206,1053,0
20:05:30,10321,Fox,5680,164,42,26,63,20,8,5,5680,5638,5612,4208,1159,1084,76,88,2843,2837,256,4207,1053,0
20:05:30,10321.79,Fox,5680,164,42,24,63,22,8,5,5680,5638,5614,4210,1159,1084,76,88,2843,2837,256,4207,1053,0
20:05:31,10324.1,Fox,5680,164,42,24,61,24,8,5,5680,5638,5614,4212,1159,1084,76,88,2843,2837,256,4207,1053,0
20:05:31,10324.37,Fox,5680,164,40,26,61,24,8,5,5680,5640,5614,4212,1159,1084,76,88,2843,2837,256,4207,1053,0
20:05:31,10324.81,Fox,5682,163,40,26,60,22,8,5,5680,5640,5614,4212,1159,1084,76,87,2844,2838,256,4210,1053,0
20:05:31,10324.97,Fox,5682,162,42,26,60,21,8,5,5682,5640,5614,4212,1159,1084,76,86,2844,2838,256,4211,1053,0
20:05:31,10325.33,Fox,5682,162,42,24,62,21,8,5,5682,5640,5616,4212,1159,1084,76,86,2844,2838,256,4211,1053,0
20:05:31,10325.89,Fox,5682,157,42,24,62,16,8,5,5682,5640,5616,4212,1159,1084,75,82,2844,2838,256,4216,1053,0
20:05:32,10326.58,Fox,5682,155,42,24,62,14,8,5,5682,5640,5616,4212,1159,1084,75,80,2844,2838,256,4218,1053,0
20:05:32,10327.38,Fox,5684,155,42,24,61,14,7,5,5682,5640,5616,4212,1159,1084,74,81,2844,2840,256,4220,1053,0
20:05:32,10327.73,Fox,5686,156,46,24,60,14,7,5,5686,5640,5616,4212,1159,1084,74,82,2845,2841,256,4221,1053,0
20:05:32,10328.75,Fox,5688,157,48,22,61,14,7,5,5688,5640,5618,4212,1159,1084,73,84,2845,2843,256,4222,1053,0
20:05:32,10329.24,Fox,5688,155,48,22,61,12,7,5,5688,5640,5618,4212,1159,1084,73,82,2845,2843,257,4223,1053,0
20:05:33,10329.92,Fox,5688,155,48,20,63,12,7,5,5688,5640,5620,4212,1159,1084,73,82,2845,2843,257,4223,1053,0
20:05:33,10330.68,Fox,5690,155,50,20,62,11,7,5,5690,5640,5620,4212,1159,1084,72,83,2845,2845,257,4225,1053,0
20:05:33,10331.23,Fox,5692,156,52,20,61,11,7,5,5692,5640,5620,4212,1159,1084,73,83,2847,2845,257,4226,1053,0
20:05:33,10331.61,Fox,5694,157,54,20,60,11,7,5,5694,5640,5620,4212,1159,1084,73,84,2848,2846,257,4227,1053,0
20:05:34,10332.16,Fox,5698,157,56,20,58,9,7,5,5696,5640,5620,4212,1159,1084,72,85,2849,2849,257,4231,1053,0
20:05:34,10332.35,Fox,5698,157,58,18,60,9,7,5,5698,5640,5622,4212,1159,1084,72,85,2849,2849,257,4231,1053,0
20:05:34,10332.71,Fox,5698,157,56,20,60,9,7,5,5698,5642,5622,4212,1159,1084,72,85,2849,2849,257,4231,1053,0
20:05:34,10333.17,Fox,5700,158,58,20,57,11,7,5,5700,5642,5622,4214,1159,1084,72,86,2850,2850,257,4232,1053,0
20:05:34,10334.35,Fox,5700,158,58,20,55,13,7,5,5700,5642,5622,4216,1159,1084,72,86,2850,2850,257,4232,1053,0
20:05:34,10334.7,Fox,5700,156,58,20,55,11,7,5,5700,5642,5622,4216,1159,1084,70,86,2850,2850,257,4234,1053,0
20:05:35,10335.87,Fox,5702,158,60,20,55,11,7,5,5702,5642,5622,4216,1159,1084,71,87,2851,2851,257,4234,1053,0
20:05:35,10336.22,Fox,5702,158,60,18,56,12,7,5,5702,5642,5624,4217,1159,1084,71,87,2851,2851,257,4234,1053,0
20:05:35,10336.81,Fox,5704,159,62,18,56,11,7,5,5704,5642,5624,4217,1159,1084,71,88,2852,2852,257,4235,1053,0
20:05:35,10337.69,Fox,5704,159,60,20,56,11,7,5,5704,5644,5624,4217,1159,1084,71,88,2852,2852,257,4235,1053,0
20:05:36,10338.33,Fox,5704,159,58,22,56,11,7,5,5704,5646,5624,4217,1159,1084,71,88,2852,2852,257,4235,1053,0
20:05:36,10339.35,Fox,5704,159,58,22,56,11,6,6,5704,5646,5624,4217,1159,1085,71,88,2852,2852,257,4235,1053,0
20:05:36,10339.67,Fox,5704,159,58,22,54,13,6,6,5704,5646,5624,4219,1159,1085,71,88,2852,2852,257,4235,1053,0
20:05:36,10341.11,Fox,5704,159,58,20,56,13,6,6,5704,5646,5626,4219,1159,1085,71,88,2852,2852,257,4235,1053,0
20:05:37,10342.5,Fox,5704,159,58,20,55,14,6,6,5704,5646,5626,4220,1159,1085,71,88,2852,2852,257,4235,1053,0
20:05:37,10343.08,Fox,5704,159,56,22,55,14,6,6,5704,5648,5626,4220,1159,1085,71,88,2852,2852,257,4235,1053,0
20:05:37,10343.79,Fox,5704,158,56,22,55,13,6,6,5704,5648,5626,4220,1159,1085,71,87,2852,2852,257,4236,1053,0
20:05:38,10344.83,Fox,5708,159,60,22,53,12,6,6,5708,5648,5626,4220,1159,1085,72,87,2855,2853,257,4239,1053,0
20:05:38,10346.17,Fox,5708,159,58,24,52,13,6,6,5708,5650,5626,4221,1159,1085,72,87,2855,2853,257,4239,1053,0
20:05:38,10346.63,Fox,5708,158,58,24,50,14,6,6,5708,5650,5626,4223,1159,1085,71,87,2855,2853,257,4240,1053,0
20:05:38,10346.79,Fox,5708,158,58,24,48,16,6,6,5708,5650,5626,4225,1159,1085,71,87,2855,2853,257,4240,1053,0
20:05:38,10347.13,Fox,5708,158,58,22,50,16,6,6,5708,5650,5628,4225,1159,1085,71,87,2855,2853,257,4240,1053,0
20:05:39,10348.09,Fox,5710,160,60,22,50,16,6,6,5710,5650,5628,4225,1159,1085,71,89,2855,2855,257,4240,1053,0
20:05:39,10348.8,Fox,5712,161,62,22,49,16,6,6,5712,5650,5628,4225,1159,1085,70,91,2855,2857,257,4241,1053,0
20:05:40,10350.29,Fox,5714,161,62,22,49,14,6,6,5712,5650,5628,4225,1159,1085,71,90,2856,2858,257,4243,1053,0
20:05:40,10350.47,Fox,5714,161,64,20,51,14,6,6,5714,5650,5630,4225,1159,1085,71,90,2856,2858,257,4243,1053,0
20:05:40,10350.8,Fox,5714,161,64,20,49,16,6,6,5714,5650,5630,4227,1159,1085,71,90,2856,2858,257,4243,1053,0
20:05:40,10351.31,Fox,5716,162,66,20,48,16,6,6,5716,5650,5630,4227,1159,1085,70,92,2856,2860,257,4244,1053,0
20:05:40,10351.96,Fox,5716,162,66,20,46,18,6,6,5716,5650,5630,4229,1159,1085,70,92,2856,2860,257,4244,1053,0
20:05:40,10352.41,Fox,5718,163,66,20,43,20,6,6,5716,5650,5630,4231,1159,1085,71,92,2858,2860,257,4245,1053,0
20:05:40,10352.58,Fox,5718,163,68,20,43,20,6,6,5718,5650,5630,4231,1159,1085,71,92,2858,2860,257,4245,1053,0
20:05:41,10353.35,Fox,5718,162,66,20,44,20,6,6,5718,5652,5632,4232,1159,1085,70,92,2858,2860,257,4246,1053,0
20:05:41,10354.2,Fox,5720,163,68,20,43,20,6,6,5720,5652,5632,4232,1159,1085,69,94,2858,2862,257,4247,1053,0
20:05:41,10354.64,Fox,5720,163,68,18,44,21,6,6,5720,5652,5634,4233,1159,1085,69,94,2858,2862,257,4247,1053,0
20:05:41,10354.99,Fox,5720,163,66,20,44,21,6,6,5720,5654,5634,4233,1159,1085,69,94,2858,2862,257,4247,1053,0
20:05:41,10355.87,Fox,5720,163,66,18,44,23,6,6,5720,5654,5636,4235,1159,1085,69,94,2858,2862,257,4247,1053,0
20:05:42,10356.33,Fox,5720,163,66,18,42,25,6,6,5720,5654,5636,4237,1159,1085,69,94,2858,2862,257,4247,1053,0
20:05:42,10357.02,Fox,5720,160,66,18,42,22,6,6,5720,5654,5636,4237,1159,1085,69,91,2858,2862,257,4250,1053,0
20:05:42,10357.37,Fox,5720,158,66,18,40,22,6,6,5720,5654,5636,4239,1159,1085,69,89,2858,2862,257,4252,1053,0
20:05:42,10358.72,Fox,5720,158,66,16,40,24,6,6,5720,5654,5638,4241,1159,1085,69,89,2858,2862,257,4252,1053,0
20:05:42,10358.87,Fox,5720,158,64,18,40,24,6,6,5720,5656,5638,4241,1159,1085,69,89,2858,2862,257,4252,1053,0
20:05:43,10360.83,Fox,5722,159,66,18,39,24,6,6,5722,5656,5638,4241,1159,1085,69,90,2859,2863,257,4253,1053,0
20:05:43,10361.29,Fox,5722,157,66,18,39,22,6,6,5722,5656,5638,4241,1159,1085,69,88,2859,2863,257,4255,1053,0
20:05:44,10361.96,Fox,5722,157,64,20,38,21,8,6,5722,5658,5638,4242,1161,1085,69,88,2859,2863,257,4255,1053,0
20:05:44,10363,Fox,5724,153,64,18,39,17,8,5,5722,5658,5640,4242,1161,1085,67,86,2859,2865,257,4260,1054,0
20:05:44,10363.3,Fox,5724,153,66,18,39,17,8,5,5724,5658,5640,4242,1161,1085,67,86,2859,2865,257,4260,1054,0
20:05:44,10363.91,Fox,5724,150,66,18,39,16,8,3,5724,5658,5640,4242,1161,1085,67,83,2859,2865,257,4261,1056,0
20:05:45,10365.19,Fox,5726,150,68,18,38,15,8,3,5726,5658,5640,4242,1161,1085,66,84,2859,2867,257,4263,1056,0
20:05:45,10366.25,Fox,5728,149,70,18,37,13,8,3,5728,5658,5640,4242,1161,1085,67,82,2861,2867,257,4266,1056,0
20:05:45,10366.85,Fox,5728,147,70,18,37,11,8,3,5728,5658,5640,4242,1161,1085,66,81,2861,2867,257,4268,1056,0
20:05:46,10367.55,Fox,5728,147,70,18,35,13,8,3,5728,5658,5640,4244,1161,1085,66,81,2861,2867,257,4268,1056,0
20:05:46,10369.18,Fox,5730,148,72,18,34,13,8,3,5730,5658,5640,4244,1161,1085,66,82,2862,2868,257,4269,1056,0
20:05:46,10369.33,Fox,5730,146,72,18,34,11,8,3,5730,5658,5640,4244,1161,1085,66,80,2862,2868,257,4271,1056,0
20:05:46,10370.02,Fox,5732,147,74,18,33,11,8,3,5732,5658,5640,4244,1161,1085,67,80,2864,2868,257,4272,1056,0
20:05:47,10370.68,Fox,5732,147,74,18,32,12,8,3,5732,5658,5640,4245,1161,1085,67,80,2864,2868,257,4272,1056,0
20:05:47,10371.32,Fox,5734,148,76,16,33,12,8,3,5734,5658,5642,4245,1161,1085,66,82,2864,2870,257,4273,1056,0
20:05:47,10372.09,Fox,5736,149,78,16,32,12,8,3,5736,5658,5642,4245,1161,1085,65,84,2864,2872,257,4274,1056,0
20:05:47,10372.25,Fox,5736,148,78,16,28,15,8,3,5736,5658,5642,4249,1161,1085,64,84,2864,2872,257,4275,1056,0
20:05:48,10373.26,Fox,5736,148,76,18,28,15,8,3,5736,5660,5642,4249,1161,1085,64,84,2864,2872,257,4275,1056,0
20:05:48,10373.56,Fox,5736,148,76,18,28,13,10,3,5736,5660,5642,4249,1163,1085,64,84,2864,2872,257,4275,1056,0
20:05:48,10374.12,Fox,5736,148,74,20,26,15,10,3,5736,5662,5642,4251,1163,1085,64,84,2864,2872,257,4275,1056,0
20:05:48,10375.03,Fox,5736,148,72,22,26,15,10,3,5736,5664,5642,4251,1163,1085,64,84,2864,2872,257,4275,1056,0
20:05:48,10376.11,Fox,5736,148,68,24,28,15,10,3,5736,5668,5644,4251,1163,1085,64,84,2864,2872,257,4275,1056,0
20:05:49,10376.62,Fox,5738,149,70,24,28,14,10,3,5738,5668,5644,4251,1163,1085,64,85,2865,2873,257,4276,1056,0
20:05:49,10377.03,Fox,5738,149,66,26,28,16,10,3,5738,5672,5646,4253,1163,1085,64,85,2865,2873,257,4276,1056,0
20:05:49,10377.77,Fox,5738,148,66,26,28,15,10,3,5738,5672,5646,4253,1163,1085,64,84,2865,2873,257,4277,1056,0
20:05:49,10378.06,Fox,5738,147,66,26,28,14,10,3,5738,5672,5646,4253,1163,1085,64,83,2865,2873,257,4278,1056,0
20:05:49,10378.76,Fox,5738,147,66,26,25,17,10,3,5738,5672,5646,4256,1163,1085,64,83,2865,2873,257,4278,1056,0
20:05:50,10381.1,Fox,5738,146,66,26,25,16,10,3,5738,5672,5646,4256,1163,1085,64,82,2865,2873,257,4279,1056,0
20:05:50,10381.72,Fox,5738,146,66,24,27,16,6,7,5738,5672,5648,4256,1163,1089,64,82,2865,2873,257,4279,1056,0
20:05:51,10382.54,Fox,5740,147,68,24,26,16,6,7,5740,5672,5648,4256,1163,1089,63,84,2865,2875,257,4280,1056,0
20:05:51,10382.69,Fox,5740,144,66,26,26,13,6,7,5740,5674,5648,4256,1163,1089,63,81,2865,2875,257,4283,1056,0
20:05:51,10383.12,Fox,5740,143,66,26,26,13,6,6,5740,5674,5648,4256,1163,1089,62,81,2865,2875,257,4283,1057,0
20:05:51,10384.6,Fox,5740,143,66,24,28,13,6,6,5740,5674,5650,4256,1163,1089,62,81,2865,2875,257,4283,1057,0
20:05:51,10385.16,Fox,5740,142,66,24,28,13,6,5,5740,5674,5650,4256,1163,1089,61,81,2865,2875,257,4283,1058,0
20:05:52,10385.74,Fox,5740,142,66,24,27,14,6,5,5740,5674,5650,4257,1163,1089,61,81,2865,2875,257,4283,1058,0
20:05:52,10387.22,Fox,5740,140,66,24,27,12,6,5,5740,5674,5650,4257,1163,1089,61,79,2865,2875,257,4285,1058,0
20:05:53,10389.24,Fox,5740,137,66,24,27,9,6,5,5740,5674,5650,4257,1163,1089,59,78,2865,2875,257,4288,1058,0
20:05:53,10389.84,Fox,5740,136,66,24,27,9,6,4,5740,5674,5650,4257,1163,1089,59,77,2865,2875,257,4288,1059,0
20:05:53,10390.39,Fox,5742,137,68,24,25,10,6,4,5742,5674,5650,4258,1163,1089,58,79,2865,2877,257,4289,1059,0
20:05:53,10390.82,Fox,5744,138,70,24,25,9,6,4,5744,5674,5650,4258,1163,1089,58,80,2866,2878,257,4290,1059,0
20:05:54,10391.8,Fox,5744,138,70,22,27,9,6,4,5744,5674,5652,4258,1163,1089,58,80,2866,2878,257,4290,1059,0
20:05:54,10393.02,Fox,5744,138,70,22,25,11,6,4,5744,5674,5652,4260,1163,1089,58,80,2866,2878,257,4290,1059,0
20:05:54,10393.5,Fox,5744,138,70,20,27,11,6,4,5744,5674,5654,4260,1163,1089,58,80,2866,2878,257,4290,1059,0
20:05:55,10394.32,Fox,5744,138,68,22,27,11,6,4,5744,5676,5654,4260,1163,1089,58,80,2866,2878,257,4290,1059,0
20:05:55,10396.55,Fox,5744,138,68,22,25,13,6,4,5744,5676,5654,4262,1163,1089,58,80,2866,2878,257,4290,1059,0
20:05:56,10397.4,Fox,5744,138,68,20,27,13,6,4,5744,5676,5656,4262,1163,1089,58,80,2866,2878,257,4290,1059,0
20:05:56,10399.1,Fox,5744,138,68,20,27,13,4,6,5744,5676,5656,4262,1163,1091,58,80,2866,2878,257,4290,1059,0
20:05:57,10400.27,Fox,5746,140,70,18,29,13,4,6,5746,5676,5658,4262,1163,1091,60,80,2868,2878,257,4290,1059,0
20:05:57,10400.94,Fox,5746,139,70,18,29,12,4,6,5746,5676,5658,4262,1163,1091,60,79,2868,2878,257,4291,1059,0
20:05:57,10401.6,Fox,5746,139,68,20,28,13,4,6,5746,5678,5658,4263,1163,1091,60,79,2868,2878,257,4291,1059,0
20:05:58,10403.3,Fox,5746,137,68,20,28,11,4,6,5746,5678,5658,4263,1163,1091,59,78,2868,2878,257,4293,1059,0
20:05:58,10403.57,Fox,5746,137,66,22,28,11,4,6,5746,5680,5658,4263,1163,1091,59,78,2868,2878,257,4293,1059,0
20:05:59,10407.19,Fox,5746,135,66,22,28,9,4,6,5746,5680,5658,4263,1163,1091,58,77,2868,2878,257,4295,1059,0
20:05:59,10407.58,Fox,5746,135,64,24,26,11,4,6,5746,5682,5658,4265,1163,1091,58,77,2868,2878,257,4295,1059,0
20:06:00,10410.23,Fox,5748,137,62,28,26,11,4,6,5748,5686,5658,4265,1163,1091,59,78,2869,2879,257,4295,1059,0
20:06:00,10410.73,Fox,5750,138,64,28,25,11,4,6,5750,5686,5658,4265,1163,1091,59,79,2870,2880,257,4296,1059,0
20:06:00,10410.99,Fox,5750,138,64,28,23,13,4,6,5750,5686,5658,4267,1163,1091,59,79,2870,2880,257,4296,1059,0
20:06:00,10411.25,Fox,5750,138,62,30,23,13,4,6,5750,5688,5658,4267,1163,1091,59,79,2870,2880,257,4296,1059,0
20:06:00,10411.62,Fox,5750,138,62,28,25,13,4,6,5750,5688,5660,4267,1163,1091,59,79,2870,2880,257,4296,1059,0
20:06:01,10412.03,Fox,5750,137,62,28,25,12,4,6,5750,5688,5660,4267,1163,1091,59,78,2870,2880,257,4297,1059,0
20:06:01,10412.69,Fox,5750,137,62,26,27,12,4,6,5750,5688,5662,4267,1163,1091,59,78,2870,2880,257,4297,1059,0
20:06:01,10413.2,Fox,5750,137,60,28,27,12,4,6,5750,5690,5662,4267,1163,1091,59,78,2870,2880,257,4297,1059,0
20:06:01,10413.43,Fox,5750,137,60,26,29,12,4,6,5750,5690,5664,4267,1163,1091,59,78,2870,2880,257,4297,1059,0
20:06:01,10413.66,Fox,5750,137,58,28,27,14,4,6,5750,5692,5664,4269,1163,1091,59,78,2870,2880,257,4297,1059,0
20:06:01,10414.11,Fox,5750,137,56,30,27,14,4,6,5750,5694,5664,4269,1163,1091,59,78,2870,2880,257,4297,1059,0
20:06:02,10414.66,Fox,5750,137,54,28,30,15,4,6,5750,5696,5668,4270,1163,1091,59,78,2870,2880,257,4297,1059,0
20:06:02,10414.92,Fox,5750,137,52,30,30,15,4,6,5750,5698,5668,4270,1163,1091,59,78,2870,2880,257,4297,1059,0
20:06:02,10415.27,Fox,5750,137,52,28,32,15,4,6,5750,5698,5670,4270,1163,1091,59,78,2870,2880,257,4297,1059,0
20:06:02,10415.5,Fox,5750,137,52,26,34,15,4,6,5750,5698,5672,4270,1163,1091,59,78,2870,2880,257,4297,1059,0
20:06:02,10415.73,Fox,5750,137,50,28,34,15,4,6,5750,5700,5672,4270,1163,1091,59,78,2870,2880,257,4297,1059,0
20:06:02,10416.16,Fox,5750,137,50,28,32,17,4,6,5750,5700,5672,4272,1163,1091,59,78,2870,2880,257,4297,1059,0
20:06:03,10418.18,Fox,5750,135,50,28,32,15,4,6,5750,5700,5672,4272,1163,1091,59,76,2870,2880,257,4299,1059,0
20:06:03,10418.41,Fox,5750,135,48,30,32,15,4,6,5750,5702,5672,4272,1163,1091,59,76,2870,2880,257,4299,1059,0
20:06:03,10418.99,Fox,5750,135,48,30,31,16,4,6,5750,5702,5672,4273,1163,1091,59,76,2870,2880,257,4299,1059,0
20:06:03,10419.35,Fox,5750,135,46,32,31,16,4,6,5750,5704,5672,4273,1163,1091,59,76,2870,2880,257,4299,1059,0
20:06:04,10421.14,Fox,5750,135,46,30,33,16,4,6,5750,5704,5674,4273,1163,1091,59,76,2870,2880,257,4299,1059,0
20:06:04,10421.54,Fox,5750,133,46,30,33,14,4,6,5750,5704,5674,4273,1163,1091,58,75,2870,2880,257,4301,1059,0
20:06:04,10423.31,Fox,5750,133,46,30,31,16,4,6,5750,5704,5674,4275,1163,1091,58,75,2870,2880,257,4301,1059,0
20:06:05,10424.3,Fox,5750,131,46,30,31,14,4,6,5750,5704,5674,4275,1163,1091,58,73,2870,2880,257,4303,1059,0
20:06:05,10425.13,Fox,5752,133,48,30,31,14,4,6,5752,5704,5674,4275,1163,1091,58,75,2870,2882,257,4303,1059,0
20:06:06,10426.86,Fox,5752,131,48,30,31,11,5,6,5752,5704,5674,4275,1164,1091,58,73,2870,2882,257,4305,1059,0
20:06:06,10427.42,Fox,5752,131,44,34,31,11,5,6,5752,5708,5674,4275,1164,1091,58,73,2870,2882,257,4305,1059,0
20:06:07,10429.68,Fox,5752,130,44,34,31,10,5,6,5752,5708,5674,4275,1164,1091,58,72,2870,2882,257,4306,1059,0
20:06:07,10430.86,Fox,5752,130,42,36,31,10,5,6,5752,5710,5674,4275,1164,1091,58,72,2870,2882,257,4306,1059,0
20:06:07,10431.29,Fox,5752,130,40,38,31,10,5,6,5752,5712,5674,4275,1164,1091,58,72,2870,2882,257,4306,1059,0
20:06:07,10431.9,Fox,5752,130,40,38,29,12,5,6,5752,5712,5674,4277,1164,1091,58,72,2870,2882,257,4306,1059,0
20:06:08,10432.93,Fox,5754,132,42,36,31,12,5,6,5754,5712,5676,4277,1164,1091,59,73,2871,2883,257,4306,1059,0
20:06:08,10433.12,Fox,5754,132,40,38,31,12,5,6,5754,5714,5676,4277,1164,1091,59,73,2871,2883,257,4306,1059,0
20:06:08,10434.01,Fox,5754,132,38,40,31,12,5,6,5754,5716,5676,4277,1164,1091,59,73,2871,2883,257,4306,1059,0
20:06:09,10435.4,Fox,5754,132,36,42,31,12,5,6,5754,5718,5676,4277,1164,1091,59,73,2871,2883,257,4306,1059,0
20:06:09,10436.7,Fox,5754,132,34,44,29,14,5,6,5754,5720,5676,4279,1164,1091,59,73,2871,2883,257,4306,1059,0
20:06:09,10437.25,Fox,5754,132,34,44,27,16,5,6,5754,5720,5676,4281,1164,1091,59,73,2871,2883,257,4306,1059,0
20:06:09,10438.25,Fox,5756,134,36,44,27,16,5,6,5756,5720,5676,4281,1164,1091,60,74,2872,2884,257,4306,1059,0
20:06:10,10439.28,Fox,5756,133,36,44,27,16,5,5,5756,5720,5676,4281,1164,1091,60,73,2872,2884,257,4306,1060,0
20:06:10,10440.19,Fox,5756,133,36,42,29,16,5,5,5756,5720,5678,4281,1164,1091,60,73,2872,2884,257,4306,1060,0
20:06:11,10442.09,Fox,5756,131,36,40,29,18,5,3,5756,5720,5680,4283,1164,1091,58,73,2872,2884,257,4306,1062,0
20:06:11,10443.3,Fox,5756,131,34,42,29,18,5,3,5756,5722,5680,4283,1164,1091,58,73,2872,2884,257,4306,1062,0
20:06:12,10445.08,Fox,5756,131,34,42,27,20,5,3,5756,5722,5680,4285,1164,1091,58,73,2872,2884,257,4306,1062,0
20:06:12,10445.72,Fox,5756,131,32,44,27,20,5,3,5756,5724,5680,4285,1164,1091,58,73,2872,2884,257,4306,1062,0
20:06:12,10445.96,Fox,5756,131,32,42,29,20,5,3,5756,5724,5682,4285,1164,1091,58,73,2872,2884,257,4306,1062,0
20:06:13,10447.79,Fox,5756,130,30,44,29,19,5,3,5756,5726,5682,4285,1164,1091,57,73,2872,2884,257,4307,1062,0
20:06:13,10448.52,Fox,5756,130,30,42,31,19,5,3,5756,5726,5684,4285,1164,1091,57,73,2872,2884,257,4307,1062,0
20:06:13,10448.75,Fox,5756,130,28,42,33,19,5,3,5756,5728,5686,4285,1164,1091,57,73,2872,2884,257,4307,1062,0
20:06:13,10449.59,Fox,5758,131,30,42,32,19,5,3,5758,5728,5686,4285,1164,1091,58,73,2874,2884,257,4308,1062,0
20:06:13,10449.73,Fox,5758,131,30,40,34,19,5,3,5758,5728,5688,4285,1164,1091,58,73,2874,2884,257,4308,1062,0
20:06:14,10450.76,Fox,5758,131,30,40,34,17,7,3,5758,5728,5688,4285,1166,1091,58,73,2874,2884,257,4308,1062,0
20:06:14,10451.79,Fox,5760,133,28,40,36,17,7,3,5758,5730,5690,4285,1166,1091,58,75,2874,2886,257,4308,1062,0
20:06:14,10451.92,Fox,5760,133,30,40,36,17,7,3,5760,5730,5690,4285,1166,1091,58,75,2874,2886,257,4308,1062,0
20:06:14,10452.3,Fox,5760,133,30,38,36,19,7,3,5760,5730,5692,4287,1166,1091,58,75,2874,2886,257,4308,1062,0
20:06:14,10452.54,Fox,5760,131,28,38,38,17,7,3,5760,5732,5694,4287,1166,1091,56,75,2874,2886,257,4310,1062,0
20:06:15,10453.02,Fox,5766,134,32,38,36,16,7,3,5764,5732,5694,4287,1166,1091,56,78,2877,2889,257,4313,1062,0
20:06:15,10453.36,Fox,5766,134,34,34,40,16,7,3,5766,5732,5698,4287,1166,1091,56,78,2877,2889,257,4313,1062,0
20:06:15,10453.92,Fox,5766,134,32,36,38,18,7,3,5766,5734,5698,4289,1166,1091,56,78,2877,2889,257,4313,1062,0
20:06:15,10454.19,Fox,5766,134,32,34,40,18,7,3,5766,5734,5700,4289,1166,1091,56,78,2877,2889,257,4313,1062,0
20:06:15,10454.56,Fox,5766,134,30,36,40,18,7,3,5766,5736,5700,4289,1166,1091,56,78,2877,2889,257,4313,1062,0
20:06:15,10455.61,Fox,5766,133,30,36,40,17,7,3,5766,5736,5700,4289,1166,1091,56,77,2877,2889,257,4314,1062,0
20:06:16,10456.82,Fox,5766,133,30,34,42,17,7,3,5766,5736,5702,4289,1166,1091,56,77,2877,2889,257,4314,1062,0
20:06:16,10457.86,Fox,5766,133,30,32,42,19,7,3,5766,5736,5704,4291,1166,1091,56,77,2877,2889,257,4314,1062,0
20:06:17,10459.11,Fox,5766,133,28,34,42,19,7,3,5766,5738,5704,4291,1166,1091,56,77,2877,2889,257,4314,1062,0
20:06:17,10459.38,Fox,5766,132,28,34,42,19,7,2,5766,5738,5704,4291,1166,1091,56,76,2877,2889,257,4314,1063,0
20:06:17,10460.86,Fox,5766,132,28,34,40,21,7,2,5766,5738,5704,4293,1166,1091,56,76,2877,2889,257,4314,1063,0
20:06:18,10462.87,Fox,5766,130,28,34,40,19,7,2,5766,5738,5704,4293,1166,1091,55,75,2877,2889,257,4316,1063,0
20:06:19,10465.06,Fox,5766,130,26,36,40,19,7,2,5766,5740,5704,4293,1166,1091,55,75,2877,2889,257,4316,1063,0
20:06:19,10465.84,Fox,5766,130,26,32,44,19,7,2,5766,5740,5708,4293,1166,1091,55,75,2877,2889,257,4316,1063,0
20:06:19,10467.4,Fox,5766,130,26,32,44,17,9,2,5766,5740,5708,4293,1168,1091,55,75,2877,2889,257,4316,1063,0
20:06:20,10468.43,Fox,5766,129,26,32,44,16,9,2,5766,5740,5708,4293,1168,1091,55,74,2877,2889,257,4317,1063,0
20:06:20,10469.1,Fox,5766,129,26,30,46,16,9,2,5766,5740,5710,4293,1168,1091,55,74,2877,2889,257,4317,1063,0
20:06:20,10469.8,Fox,5766,129,26,28,48,16,9,2,5766,5740,5712,4293,1168,1091,55,74,2877,2889,257,4317,1063,0
20:06:21,10471.44,Fox,5766,127,26,26,50,14,9,2,5766,5740,5714,4293,1168,1091,53,74,2877,2889,257,4319,1063,0
20:06:21,10472.09,Fox,5766,127,26,26,48,16,9,2,5766,5740,5714,4295,1168,1091,53,74,2877,2889,257,4319,1063,0
20:06:21,10472.29,Fox,5766,127,26,24,50,16,9,2,5766,5740,5716,4295,1168,1091,53,74,2877,2889,257,4319,1063,0
20:06:21,10472.9,Fox,5766,127,24,26,50,16,9,2,5766,5742,5716,4295,1168,1091,53,74,2877,2889,257,4319,1063,0
20:06:21,10473.11,Fox,5766,127,24,26,49,17,9,2,5766,5742,5716,4296,1168,1091,53,74,2877,2889,257,4319,1063,0
20:06:21,10473.32,Fox,5766,127,22,28,49,17,9,2,5766,5744,5716,4296,1168,1091,53,74,2877,2889,257,4319,1063,0
20:06:21,10473.52,Fox,5766,127,22,26,51,17,9,2,5766,5744,5718,4296,1168,1091,53,74,2877,2889,257,4319,1063,0
20:06:21,10473.95,Fox,5766,127,22,26,49,19,9,2,5766,5744,5718,4298,1168,1091,53,74,2877,2889,257,4319,1063,0
20:06:22,10475.09,Fox,5766,127,22,24,49,21,9,2,5766,5744,5720,4300,1168,1091,53,74,2877,2889,257,4319,1063,0
20:06:22,10476.07,Fox,5766,127,22,24,45,25,9,2,5766,5744,5720,4304,1168,1091,53,74,2877,2889,257,4319,1063,0
20:06:22,10476.73,Fox,5768,129,24,24,45,25,9,2,5768,5744,5720,4304,1168,1091,54,75,2878,2890,257,4319,1063,0
20:06:23,10478.37,Fox,5770,130,26,24,45,24,9,2,5770,5744,5720,4304,1168,1091,53,77,2878,2892,257,4320,1063,0
20:06:24,10481.57,Fox,5770,130,26,24,43,26,9,2,5770,5744,5720,4306,1168,1091,53,77,2878,2892,257,4320,1063,0
20:06:24,10481.79,Fox,5770,130,26,22,45,26,9,2,5770,5744,5722,4306,1168,1091,53,77,2878,2892,257,4320,1063,0
20:06:24,10482.37,Fox,5770,129,26,22,45,26,9,1,5770,5744,5722,4306,1168,1091,53,76,2878,2892,257,4320,1064,0
20:06:25,10482.91,Fox,5772,128,26,24,44,24,9,1,5772,5746,5722,4306,1168,1091,52,76,2880,2892,257,4323,1064,0
20:06:25,10483.76,Fox,5774,129,28,24,43,24,9,1,5774,5746,5722,4306,1168,1091,53,76,2882,2892,257,4324,1064,0
20:06:25,10484.21,Fox,5774,129,28,22,45,24,9,1,5774,5746,5724,4306,1168,1091,53,76,2882,2892,257,4324,1064,0
20:06:25,10484.46,Fox,5774,127,28,22,45,22,9,1,5774,5746,5724,4306,1168,1091,51,76,2882,2892,257,4326,1064,0
20:06:26,10485.68,Fox,5774,126,28,22,45,21,9,1,5774,5746,5724,4306,1168,1091,51,75,2882,2892,257,4327,1064,0
20:06:26,10486.39,Fox,5776,127,30,20,47,20,9,1,5776,5746,5726,4306,1168,1091,51,76,2883,2893,257,4328,1064,0
20:06:26,10486.99,Fox,5780,129,32,20,45,20,9,1,5778,5746,5726,4306,1168,1091,53,76,2887,2893,257,4330,1064,0
20:06:26,10487.36,Fox,5780,129,34,18,47,20,9,1,5780,5746,5728,4306,1168,1091,53,76,2887,2893,257,4330,1064,0
20:06:27,10489.05,Fox,5782,130,36,18,46,20,9,1,5782,5746,5728,4306,1168,1091,53,77,2888,2894,257,4331,1064,0
20:06:27,10489.87,Fox,5784,131,38,18,45,20,9,1,5784,5746,5728,4306,1168,1091,52,79,2888,2896,257,4332,1064,0
20:06:27,10490.15,Fox,5784,131,38,16,47,20,9,1,5784,5746,5730,4306,1168,1091,52,79,2888,2896,257,4332,1064,0
20:06:27,10491,Fox,5784,131,38,14,49,20,9,1,5784,5746,5732,4306,1168,1091,52,79,2888,2896,257,4332,1064,0
20:06:28,10492.15,Fox,5784,129,38,14,49,18,9,1,5784,5746,5732,4306,1168,1091,50,79,2888,2896,257,4334,1064,0
20:06:28,10492.36,Fox,5784,129,38,12,51,18,9,1,5784,5746,5734,4306,1168,1091,50,79,2888,2896,257,4334,1064,0
20:06:28,10492.85,Fox,5784,129,36,14,51,18,9,1,5784,5748,5734,4306,1168,1091,50,79,2888,2896,257,4334,1064,0
20:06:28,10493.23,Fox,5784,129,36,12,51,20,9,1,5784,5748,5736,4308,1168,1091,50,79,2888,2896,257,4334,1064,0
20:06:28,10493.41,Fox,5784,129,34,14,51,20,9,1,5784,5750,5736,4308,1168,1091,50,79,2888,2896,257,4334,1064,0
20:06:29,10495.34,Fox,5786,130,36,14,50,20,9,1,5786,5750,5736,4308,1168,1091,49,81,2888,2898,257,4335,1064,0
20:06:30,10497.63,Fox,5786,130,36,12,52,20,9,1,5786,5750,5738,4308,1168,1091,49,81,2888,2898,257,4335,1064,0
20:06:30,10499.51,Fox,5786,130,36,12,52,20,7,3,5786,5750,5738,4308,1168,1093,49,81,2888,2898,257,4335,1064,0
20:06:31,10500.64,Fox,5786,130,36,12,50,22,7,3,5786,5750,5738,4310,1168,1093,49,81,2888,2898,257,4335,1064,0
20:06:31,10502.54,Fox,5786,129,36,12,49,23,7,2,5786,5750,5738,4311,1168,1093,48,81,2888,2898,257,4335,1065,0
20:06:32,10503.58,Fox,5786,129,36,10,51,23,7,2,5786,5750,5740,4311,1168,1093,48,81,2888,2898,257,4335,1065,0
20:06:32,10503.86,Fox,5786,127,36,10,51,21,7,2,5786,5750,5740,4311,1168,1093,48,79,2888,2898,257,4337,1065,0
20:06:32,10506.49,Fox,5786,127,36,10,50,22,7,2,5786,5750,5740,4312,1168,1093,48,79,2888,2898,257,4337,1065,0
20:06:33,10507.5,Fox,5786,127,34,12,50,22,7,2,5786,5752,5740,4312,1168,1093,48,79,2888,2898,257,4337,1065,0
20:06:33,10507.98,Fox,5788,128,36,12,49,22,7,2,5788,5752,5740,4312,1168,1093,48,80,2889,2899,257,4338,1065,0
20:06:33,10508.09,Fox,5788,128,36,12,49,21,8,2,5788,5752,5740,4312,1169,1093,48,80,2889,2899,257,4338,1065,0
20:06:33,10509.2,Fox,5788,128,36,12,46,24,8,2,5788,5752,5740,4315,1169,1093,48,80,2889,2899,257,4338,1065,0
20:06:34,10510.33,Fox,5788,128,36,12,44,26,8,2,5788,5752,5740,4317,1169,1093,48,80,2889,2899,257,4338,1065,0
20:06:34,10510.85,Fox,5790,129,38,12,43,26,8,2,5790,5752,5740,4317,1169,1093,47,82,2889,2901,257,4339,1065,0
20:06:34,10511.14,Fox,5790,127,38,12,43,24,6,4,5790,5752,5740,4317,1169,1095,47,80,2889,2901,257,4341,1065,0
20:06:34,10511.47,Fox,5790,127,38,10,45,24,6,4,5790,5752,5742,4317,1169,1095,47,80,2889,2901,257,4341,1065,0
20:06:34,10511.82,Fox,5790,127,38,8,47,24,6,4,5790,5752,5744,4317,1169,1095,47,80,2889,2901,257,4341,1065,0
20:06:34,10512.17,Fox,5790,127,38,8,45,26,6,4,5790,5752,5744,4319,1169,1095,47,80,2889,2901,257,4341,1065,0
20:06:35,10513.17,Fox,5790,126,38,8,44,26,6,4,5790,5752,5744,4320,1169,1095,47,79,2889,2901,257,4342,1065,0
20:06:35,10513.82,Fox,5790,126,38,8,40,30,6,4,5790,5752,5744,4324,1169,1095,47,79,2889,2901,257,4342,1065,0
20:06:35,10514.92,Fox,5790,126,38,8,39,31,6,4,5790,5752,5744,4325,1169,1095,47,79,2889,2901,257,4342,1065,0
20:06:36,10515.72,Fox,5792,127,38,10,38,31,6,4,5792,5754,5744,4325,1169,1095,47,80,2890,2902,257,4343,1065,0
20:06:36,10517.16,Fox,5792,126,38,10,38,28,8,4,5792,5754,5744,4325,1171,1095,47,79,2890,2902,257,4344,1065,0
20:06:36,10517.44,Fox,5792,126,38,10,37,29,8,4,5792,5754,5744,4326,1171,1095,47,79,2890,2902,257,4344,1065,0
20:06:37,10518.27,Fox,5794,127,40,10,34,31,8,4,5794,5754,5744,4328,1171,1095,47,80,2891,2903,257,4345,1065,0
20:06:37,10519.6,Fox,5794,125,40,10,34,29,8,4,5794,5754,5744,4328,1171,1095,47,78,2891,2903,257,4347,1065,0
20:06:37,10519.86,Fox,5794,124,40,10,34,28,8,4,5794,5754,5744,4328,1171,1095,47,77,2891,2903,257,4348,1065,0
20:06:37,10520.84,Fox,5794,122,38,12,34,26,8,4,5794,5756,5744,4328,1171,1095,47,75,2891,2903,257,4350,1065,0
20:06:38,10521.3,Fox,5794,122,38,10,36,26,8,4,5794,5756,5746,4328,1171,1095,47,75,2891,2903,257,4350,1065,0
20:06:38,10522.1,Fox,5796,124,40,10,36,26,8,4,5796,5756,5746,4328,1171,1095,49,75,2893,2903,257,4350,1065,0
20:06:38,10522.85,Fox,5796,122,40,10,36,24,8,4,5796,5756,5746,4328,1171,1095,49,73,2893,2903,257,4352,1065,0
20:06:38,10523.66,Fox,5796,121,40,10,36,23,8,4,5796,5756,5746,4328,1171,1095,49,72,2893,2903,257,4353,1065,0
20:06:39,10524.19,Fox,5796,119,40,10,36,21,8,4,5796,5756,5746,4328,1171,1095,48,71,2893,2903,257,4355,1065,0
20:06:39,10524.45,Fox,5796,117,40,10,36,19,8,4,5796,5756,5746,4328,1171,1095,48,69,2893,2903,257,4357,1065,0
20:06:39,10524.8,Fox,5798,118,42,10,36,18,8,4,5798,5756,5746,4328,1171,1095,49,69,2895,2903,257,4358,1065,0
20:06:39,10525.23,Fox,5798,117,42,10,36,15,10,4,5798,5756,5746,4328,1173,1095,49,68,2895,2903,257,4359,1065,0
20:06:39,10525.47,Fox,5800,119,44,10,36,15,10,4,5800,5756,5746,4328,1173,1095,49,70,2895,2905,257,4359,1065,0
20:06:39,10526.07,Fox,5802,121,46,10,36,15,10,4,5802,5756,5746,4328,1173,1095,50,71,2896,2906,257,4359,1065,0
20:06:39,10526.27,Fox,5802,121,46,10,32,19,10,4,5802,5756,5746,4332,1173,1095,50,71,2896,2906,257,4359,1065,0
20:06:40,10527.07,Fox,5806,123,50,10,31,18,10,4,5806,5756,5746,4332,1173,1095,49,74,2897,2909,257,4361,1065,0
20:06:40,10528.02,Fox,5808,124,52,10,31,17,10,4,5808,5756,5746,4332,1173,1095,50,74,2898,2910,257,4362,1065,0
20:06:40,10528.9,Fox,5808,123,52,10,31,16,10,4,5808,5756,5746,4332,1173,1095,50,73,2898,2910,257,4363,1065,0
20:06:40,10529.64,Fox,5808,122,52,10,29,18,10,3,5808,5756,5746,4334,1173,1095,50,72,2898,2910,257,4363,1066,0
20:06:41,10530.1,Fox,5808,122,52,10,29,16,12,3,5808,5756,5746,4334,1175,1095,50,72,2898,2910,257,4363,1066,0
20:06:41,10530.47,Fox,5810,123,52,10,27,17,12,3,5808,5756,5746,4336,1175,1095,50,73,2899,2911,257,4364,1066,0
20:06:41,10530.72,Fox,5810,123,54,10,27,16,13,3,5810,5756,5746,4336,1176,1095,50,73,2899,2911,257,4364,1066,0
20:06:41,10531.34,Fox,5810,123,54,8,29,16,13,3,5810,5756,5748,4336,1176,1095,50,73,2899,2911,257,4364,1066,0
20:06:41,10531.93,Fox,5812,124,56,6,28,18,13,3,5812,5756,5750,4338,1176,1095,49,75,2899,2913,257,4365,1066,0
20:06:41,10532.28,Fox,5814,125,54,8,27,18,13,3,5812,5758,5750,4338,1176,1095,50,75,2901,2913,257,4366,1066,0
20:06:41,10532.4,Fox,5814,125,56,8,27,18,13,3,5814,5758,5750,4338,1176,1095,50,75,2901,2913,257,4366,1066,0
20:06:41,10532.79,Fox,5814,125,56,8,25,20,13,3,5814,5758,5750,4340,1176,1095,50,75,2901,2913,257,4366,1066,0
20:06:42,10534.53,Fox,5814,125,54,10,25,20,13,3,5814,5760,5750,4340,1176,1095,50,75,2901,2913,257,4366,1066,0
20:06:42,10535.66,Fox,5814,125,48,16,23,22,13,3,5814,5766,5750,4342,1176,1095,50,75,2901,2913,257,4366,1066,0
20:06:43,10536.89,Fox,5814,123,48,16,23,20,13,3,5814,5766,5750,4342,1176,1095,49,74,2901,2913,257,4368,1066,0
20:06:44,10540.26,Fox,5814,122,48,16,23,19,13,3,5814,5766,5750,4342,1176,1095,49,73,2901,2913,257,4369,1066,0
20:06:44,10540.81,Fox,5814,120,48,16,23,17,13,3,5814,5766,5750,4342,1176,1095,49,71,2901,2913,257,4371,1066,0
20:06:45,10542.12,Fox,5816,122,50,16,23,17,13,3,5816,5766,5750,4342,1176,1095,51,71,2903,2913,257,4371,1066,0
20:06:45,10542.36,Fox,5816,122,50,16,22,18,13,3,5816,5766,5750,4343,1176,1095,51,71,2903,2913,257,4371,1066,0
20:06:45,10542.6,Fox,5816,121,50,16,22,17,13,3,5816,5766,5750,4343,1176,1095,51,70,2903,2913,257,4372,1066,0
20:06:45,10543.41,Fox,5816,119,50,16,22,15,13,3,5816,5766,5750,4343,1176,1095,51,68,2903,2913,257,4374,1066,0
20:06:45,10544.08,Fox,5818,120,52,16,21,15,13,3,5818,5766,5750,4343,1176,1095,50,70,2903,2915,257,4375,1066,0
20:06:45,10544.69,Fox,5818,120,52,16,19,17,13,3,5818,5766,5750,4345,1176,1095,50,70,2903,2915,257,4375,1066,0
20:06:46,10546.13,Fox,5818,118,52,14,21,15,13,3,5818,5766,5752,4345,1176,1095,50,68,2903,2915,257,4377,1066,0
20:06:46,10546.8,Fox,5818,118,52,14,19,17,13,3,5818,5766,5752,4347,1176,1095,50,68,2903,2915,257,4377,1066,0
20:06:46,10547.39,Fox,5818,118,52,14,19,15,15,3,5818,5766,5752,4347,1178,1095,50,68,2903,2915,257,4377,1066,0
20:06:48,10550.71,Fox,5818,118,52,14,18,16,15,3,5818,5766,5752,4348,1178,1095,50,68,2903,2915,257,4377,1066,0
20:06:48,10551.08,Fox,5820,120,54,14,18,16,15,3,5820,5766,5752,4348,1178,1095,51,69,2904,2916,257,4377,1066,0
20:06:48,10551.33,Fox,5820,120,54,14,18,15,16,3,5820,5766,5752,4348,1179,1095,51,69,2904,2916,257,4377,1066,0
20:06:48,10551.6,Fox,5820,120,54,14,17,16,16,3,5820,5766,5752,4349,1179,1095,51,69,2904,2916,257,4377,1066,0
20:06:48,10552.86,Fox,5820,119,54,14,15,17,16,3,5820,5766,5752,4351,1179,1095,51,68,2904,2916,257,4378,1066,0
20:06:48,10553.59,Fox,5820,119,54,14,13,19,16,3,5820,5766,5752,4353,1179,1095,51,68,2904,2916,257,4378,1066,0
20:06:49,10553.93,Fox,5820,119,54,12,15,19,16,3,5820,5766,5754,4353,1179,1095,51,68,2904,2916,257,4378,1066,0
20:06:49,10555.31,Fox,5820,117,54,12,15,17,16,3,5820,5766,5754,4353,1179,1095,51,66,2904,2916,257,4380,1066,0
20:06:50,10557.21,Fox,5820,115,54,12,15,15,16,3,5820,5766,5754,4353,1179,1095,51,64,2904,2916,257,4382,1066,0
20:06:50,10558.06,Fox,5820,115,54,12,13,17,16,3,5820,5766,5754,4355,1179,1095,51,64,2904,2916,257,4382,1066,0
20:06:50,10559.22,Fox,5820,115,52,12,15,17,16,3,5820,5768,5756,4355,1179,1095,51,64,2904,2916,257,4382,1066,0
20:06:51,10560.04,Fox,5820,114,52,12,15,17,16,2,5820,5768,5756,4355,1179,1095,51,63,2904,2916,257,4382,1067,0
20:06:51,10560.87,Fox,5820,114,50,14,15,17,16,2,5820,5770,5756,4355,1179,1095,51,63,2904,2916,257,4382,1067,0
20:06:51,10561.2,Fox,5820,113,50,14,15,16,16,2,5820,5770,5756,4355,1179,1095,51,62,2904,2916,257,4383,1067,0
20:06:51,10561.39,Fox,5820,112,50,14,15,16,16,1,5820,5770,5756,4355,1179,1095,50,62,2904,2916,257,4383,1068,0
20:06:51,10562.12,Fox,5820,111,50,14,15,15,16,1,5820,5770,5756,4355,1179,1095,49,62,2904,2916,257,4384,1068,0
20:06:52,10563.37,Fox,5820,109,50,14,15,13,16,1,5820,5770,5756,4355,1179,1095,49,60,2904,2916,257,4386,1068,0
20:06:52,10564.07,Fox,5820,109,50,14,13,15,15,2,5820,5770,5756,4357,1179,1096,49,60,2904,2916,257,4386,1068,0
20:06:52,10564.17,Fox,5820,107,50,14,13,13,15,2,5820,5770,5756,4357,1179,1096,49,58,2904,2916,257,4388,1068,0
20:06:53,10565.37,Fox,5820,107,48,16,13,13,15,2,5820,5772,5756,4357,1179,1096,49,58,2904,2916,257,4388,1068,0
20:06:53,10566.33,Fox,5820,107,46,18,13,13,15,2,5820,5774,5756,4357,1179,1096,49,58,2904,2916,257,4388,1068,0
20:06:53,10566.61,Fox,5820,107,46,18,13,12,16,2,5820,5774,5756,4357,1180,1096,49,58,2904,2916,257,4388,1068,0
20:06:54,10568.63,Fox,5820,106,46,18,13,10,17,2,5820,5774,5756,4357,1181,1096,48,58,2904,2916,257,4389,1068,0
20:06:54,10568.85,Fox,5820,106,44,20,13,10,17,2,5820,5776,5756,4357,1181,1096,48,58,2904,2916,257,4389,1068,0
20:06:54,10569.23,Fox,5820,106,44,20,13,8,19,2,5820,5776,5756,4357,1183,1096,48,58,2904,2916,257,4389,1068,0
20:06:54,10569.41,Fox,5820,106,42,22,13,8,19,2,5820,5778,5756,4357,1183,1096,48,58,2904,2916,257,4389,1068,0
20:06:54,10569.58,Fox,5820,106,40,24,13,8,19,2,5820,5780,5756,4357,1183,1096,48,58,2904,2916,257,4389,1068,0
20:06:54,10570.59,Fox,5820,106,40,22,15,8,19,2,5820,5780,5758,4357,1183,1096,48,58,2904,2916,257,4389,1068,0
20:06:55,10571.64,Fox,5820,106,38,24,15,8,19,2,5820,5782,5758,4357,1183,1096,48,58,2904,2916,257,4389,1068,0
20:06:55,10571.91,Fox,5820,106,38,24,13,10,19,2,5820,5782,5758,4359,1183,1096,48,58,2904,2916,257,4389,1068,0
20:06:55,10572.37,Fox,5820,106,36,26,11,12,19,2,5820,5784,5758,4361,1183,1096,48,58,2904,2916,257,4389,1068,0
20:06:55,10572.9,Fox,5820,106,36,24,13,12,19,2,5820,5784,5760,4361,1183,1096,48,58,2904,2916,257,4389,1068,0
20:06:55,10574.13,Fox,5820,106,36,18,19,12,19,2,5820,5784,5766,4361,1183,1096,48,58,2904,2916,257,4389,1068,0
20:06:56,10574.59,Fox,5820,104,36,18,19,10,19,2,5820,5784,5766,4361,1183,1096,48,56,2904,2916,257,4391,1068,0
20:06:56,10577.12,Fox,5820,103,36,18,19,10,18,2,5820,5784,5766,4361,1183,1096,47,56,2904,2916,257,4392,1068,0
20:06:57,10577.83,Fox,5820,103,34,20,19,10,18,2,5820,5786,5766,4361,1183,1096,47,56,2904,2916,257,4392,1068,0
20:06:58,10581.76,Fox,5820,103,34,20,17,12,18,2,5820,5786,5766,4363,1183,1096,47,56,2904,2916,257,4392,1068,0
20:06:58,10582.49,Fox,5820,102,34,20,17,11,18,2,5820,5786,5766,4363,1183,1096,47,55,2904,2916,257,4393,1068,0
20:06:58,10582.95,Fox,5820,100,34,20,17,9,18,2,5820,5786,5766,4363,1183,1096,46,54,2904,2916,257,4395,1068,0
20:07:00,10588.26,Fox,5820,100,34,20,17,9,16,4,5820,5786,5766,4363,1183,1098,46,54,2904,2916,257,4395,1068,0
20:07:01,10589.75,Fox,5822,101,36,20,16,9,16,4,5822,5786,5766,4363,1183,1098,46,55,2905,2917,257,4396,1068,0
20:07:01,10590.64,Fox,5824,103,36,22,16,9,16,4,5824,5788,5766,4363,1183,1098,48,55,2907,2917,257,4396,1068,0
20:07:01,10591.71,Fox,5824,103,36,22,14,11,16,4,5824,5788,5766,4365,1183,1098,48,55,2907,2917,257,4396,1068,0
20:07:02,10592.36,Fox,5824,101,36,22,12,11,16,4,5824,5788,5766,4367,1183,1098,46,55,2907,2917,257,4398,1068,0
20:07:02,10593.33,Fox,5824,101,34,24,12,11,16,4,5824,5790,5766,4367,1183,1098,46,55,2907,2917,257,4398,1068,0
20:07:02,10593.79,Fox,5826,103,36,24,12,11,16,4,5826,5790,5766,4367,1183,1098,46,57,2907,2919,257,4398,1068,0
20:07:03,10597.79,Fox,5826,103,36,22,14,11,16,4,5826,5790,5768,4367,1183,1098,46,57,2907,2919,257,4398,1068,0
20:07:04,10598.38,Fox,5826,103,34,24,14,11,16,4,5826,5792,5768,4367,1183,1098,46,57,2907,2919,257,4398,1068,0
20:07:04,10599.48,Fox,5826,103,34,22,16,11,16,4,5826,5792,5770,4367,1183,1098,46,57,2907,2919,257,4398,1068,0
20:07:04,10600.07,Fox,5828,104,36,22,15,11,16,4,5828,5792,5770,4367,1183,1098,47,57,2909,2919,257,4399,1068,0
20:07:04,10600.77,Fox,5830,106,36,24,15,11,16,4,5830,5794,5770,4367,1183,1098,48,58,2910,2920,257,4399,1068,0
20:07:05,10602.88,Fox,5830,105,36,24,15,10,16,4,5830,5794,5770,4367,1183,1098,48,57,2910,2920,257,4400,1068,0
20:07:05,10603.9,Fox,5830,105,36,22,17,10,16,4,5830,5794,5772,4367,1183,1098,48,57,2910,2920,257,4400,1068,0
20:07:06,10604.36,Fox,5830,104,36,22,17,10,16,3,5830,5794,5772,4367,1183,1098,48,56,2910,2920,257,4400,1069,0
20:07:06,10604.77,Fox,5830,104,34,22,19,10,16,3,5830,5796,5774,4367,1183,1098,48,56,2910,2920,257,4400,1069,0
20:07:06,10604.9,Fox,5830,104,34,22,19,10,14,5,5830,5796,5774,4367,1183,1100,48,56,2910,2920,257,4400,1069,0
20:07:06,10606.48,Fox,5830,104,34,22,17,12,14,5,5830,5796,5774,4369,1183,1100,48,56,2910,2920,257,4400,1069,0
20:07:07,10607.36,Fox,5830,104,32,22,19,12,14,5,5830,5798,5776,4369,1183,1100,48,56,2910,2920,257,4400,1069,0
20:07:07,10608.02,Fox,5830,104,30,22,21,12,14,5,5830,5800,5778,4369,1183,1100,48,56,2910,2920,257,4400,1069,0
20:07:07,10608.1,Fox,5830,104,30,20,23,12,14,5,5830,5800,5780,4369,1183,1100,48,56,2910,2920,257,4400,1069,0
20:07:07,10608.61,Fox,5830,104,28,22,23,12,14,5,5830,5802,5780,4369,1183,1100,48,56,2910,2920,257,4400,1069,0
20:07:07,10609.42,Fox,5830,104,24,26,23,12,14,5,5830,5806,5780,4369,1183,1100,48,56,2910,2920,257,4400,1069,0
20:07:08,10610.08,Fox,5830,104,24,24,25,12,14,5,5830,5806,5782,4369,1183,1100,48,56,2910,2920,257,4400,1069,0
20:07:08,10610.5,Fox,5830,104,22,26,25,12,14,5,5830,5808,5782,4369,1183,1100,48,56,2910,2920,257,4400,1069,0
20:07:08,10610.87,Fox,5830,104,22,24,27,12,14,5,5830,5808,5784,4369,1183,1100,48,56,2910,2920,257,4400,1069,0
20:07:08,10611.78,Fox,5830,103,22,24,27,12,14,4,5830,5808,5784,4369,1183,1100,48,55,2910,2920,257,4400,1070,0
20:07:09,10613.08,Fox,5830,103,20,26,27,12,14,4,5830,5810,5784,4369,1183,1100,48,55,2910,2920,257,4400,1070,0
20:07:09,10614.44,Fox,5830,103,18,28,26,13,14,4,5830,5812,5784,4370,1183,1100,48,55,2910,2920,257,4400,1070,0
20:07:09,10614.92,Fox,5830,103,16,30,26,13,14,4,5830,5814,5784,4370,1183,1100,48,55,2910,2920,257,4400,1070,0
20:07:09,10615.47,Fox,5832,105,18,30,26,13,14,4,5832,5814,5784,4370,1183,1100,48,57,2910,2922,257,4400,1070,0
20:07:10,10616.38,Fox,5832,105,18,28,28,13,14,4,5832,5814,5786,4370,1183,1100,48,57,2910,2922,257,4400,1070,0
20:07:10,10617.69,Fox,5834,107,20,28,28,13,14,4,5834,5814,5786,4370,1183,1100,49,58,2911,2923,257,4400,1070,0
20:07:10,10618.46,Fox,5836,108,22,28,28,13,14,3,5836,5814,5786,4370,1183,1100,49,59,2911,2925,257,4400,1071,0
20:07:11,10619.68,Fox,5836,108,22,28,27,14,14,3,5836,5814,5786,4371,1183,1100,49,59,2911,2925,257,4400,1071,0
20:07:12,10623.1,Fox,5836,108,22,28,27,13,15,3,5836,5814,5786,4371,1184,1100,49,59,2911,2925,257,4400,1071,0
20:07:12,10624.55,Fox,5836,108,20,30,27,13,15,3,5836,5816,5786,4371,1184,1100,49,59,2911,2925,257,4400,1071,0
20:07:13,10625.05,Fox,5836,107,20,30,27,12,15,3,5836,5816,5786,4371,1184,1100,49,58,2911,2925,257,4401,1071,0
20:07:13,10625.4,Fox,5836,107,20,30,27,11,16,3,5836,5816,5786,4371,1185,1100,49,58,2911,2925,257,4401,1071,0
20:07:13,10626.58,Fox,5836,107,18,32,27,11,16,3,5836,5818,5786,4371,1185,1100,49,58,2911,2925,257,4401,1071,0
20:07:13,10627.71,Fox,5838,108,20,32,26,11,16,3,5838,5818,5786,4371,1185,1100,50,58,2913,2925,257,4402,1071,0
20:07:14,10629.07,Fox,5838,108,20,30,28,11,16,3,5838,5818,5788,4371,1185,1100,50,58,2913,2925,257,4402,1071,0
20:07:14,10630.39,Fox,5838,107,20,30,28,10,16,3,5838,5818,5788,4371,1185,1100,50,57,2913,2925,257,4403,1071,0
20:07:15,10631.2,Fox,5838,107,20,30,26,12,16,3,5838,5818,5788,4373,1185,1100,50,57,2913,2925,257,4403,1071,0
20:07:15,10631.85,Fox,5838,107,20,28,28,12,16,3,5838,5818,5790,4373,1185,1100,50,57,2913,2925,257,4403,1071,0
20:07:15,10633.44,Fox,5838,107,20,28,26,14,16,3,5838,5818,5790,4375,1185,1100,50,57,2913,2925,257,4403,1071,0
20:07:15,10633.63,Fox,5838,107,18,30,26,14,16,3,5838,5820,5790,4375,1185,1100,50,57,2913,2925,257,4403,1071,0
20:07:16,10634.77,Fox,5838,107,18,30,21,19,16,3,5838,5820,5790,4380,1185,1100,50,57,2913,2925,257,4403,1071,0
20:07:16,10636.05,Fox,5840,108,20,30,20,19,16,3,5840,5820,5790,4380,1185,1100,50,58,2914,2926,257,4404,1071,0
20:07:16,10636.64,Fox,5840,108,20,28,22,19,16,3,5840,5820,5792,4380,1185,1100,50,58,2914,2926,257,4404,1071,0
20:07:17,10638.58,Fox,5840,107,20,28,22,19,16,2,5840,5820,5792,4380,1185,1100,50,57,2914,2926,257,4404,1072,0
20:07:17,10639.38,Fox,5842,108,20,26,23,19,16,2,5840,5820,5794,4380,1185,1100,50,58,2915,2927,257,4405,1072,0
20:07:17,10639.5,Fox,5842,108,22,26,23,19,16,2,5842,5820,5794,4380,1185,1100,50,58,2915,2927,257,4405,1072,0
20:07:18,10641.38,Fox,5844,109,24,26,22,19,16,2,5844,5820,5794,4380,1185,1100,50,59,2916,2928,257,4406,1072,0
20:07:19,10643.2,Fox,5844,109,24,24,24,19,16,2,5844,5820,5796,4380,1185,1100,50,59,2916,2928,257,4406,1072,0
20:07:19,10645.27,Fox,5844,106,24,24,24,16,16,2,5844,5820,5796,4380,1185,1100,50,56,2916,2928,257,4409,1072,0
20:07:19,10645.67,Fox,5844,106,24,24,24,16,15,3,5844,5820,5796,4380,1185,1101,50,56,2916,2928,257,4409,1072,0
20:07:20,10645.91,Fox,5844,106,24,22,26,16,15,3,5844,5820,5798,4380,1185,1101,50,56,2916,2928,257,4409,1072,0
20:07:20,10646.52,Fox,5844,106,24,20,28,16,15,3,5844,5820,5800,4380,1185,1101,50,56,2916,2928,257,4409,1072,0
20:07:20,10647.16,Fox,5844,106,24,18,30,16,15,3,5844,5820,5802,4380,1185,1101,50,56,2916,2928,257,4409,1072,0
20:07:20,10647.5,Fox,5846,107,26,18,29,16,15,3,5846,5820,5802,4380,1185,1101,50,57,2917,2929,257,4410,1072,0
20:07:20,10647.99,Fox,5846,107,26,14,33,16,15,3,5846,5820,5806,4380,1185,1101,50,57,2917,2929,257,4410,1072,0
20:07:21,10648.99,Fox,5846,107,26,12,35,16,15,3,5846,5820,5808,4380,1185,1101,50,57,2917,2929,257,4410,1072,0
20:07:21,10651.58,Fox,5846,107,26,10,37,15,16,3,5846,5820,5810,4380,1186,1101,50,57,2917,2929,257,4410,1072,0
20:07:22,10653.02,Fox,5846,107,26,8,39,15,16,3,5846,5820,5812,4380,1186,1101,50,57,2917,2929,257,4410,1072,0
20:07:22,10653.54,Fox,5848,108,28,6,40,15,16,3,5848,5820,5814,4380,1186,1101,49,59,2917,2931,257,4411,1072,0
20:07:22,10654.31,Fox,5848,108,28,6,40,15,14,5,5848,5820,5814,4380,1186,1103,49,59,2917,2931,257,4411,1072,0
20:07:23,10655.08,Fox,5848,107,28,6,40,15,14,4,5848,5820,5814,4380,1186,1103,48,59,2917,2931,257,4411,1073,0
20:07:24,10658.33,Fox,5848,107,28,6,39,16,14,4,5848,5820,5814,4381,1186,1103,48,59,2917,2931,257,4411,1073,0
20:07:24,10658.87,Fox,5850,108,30,6,38,16,14,4,5850,5820,5814,4381,1186,1103,49,59,2919,2931,257,4412,1073,0
20:07:24,10659.91,Fox,5850,108,30,6,36,18,14,4,5850,5820,5814,4383,1186,1103,49,59,2919,2931,257,4412,1073,0
20:07:25,10662.56,Fox,5850,108,30,6,36,18,12,6,5850,5820,5814,4383,1186,1105,49,59,2919,2931,257,4412,1073,0
20:07:25,10663.14,Fox,5850,108,30,4,38,18,12,6,5850,5820,5816,4383,1186,1105,49,59,2919,2931,257,4412,1073,0
20:07:26,10664.35,Fox,5850,108,30,4,37,19,12,6,5850,5820,5816,4384,1186,1105,49,59,2919,2931,257,4412,1073,0
20:07:26,10665.06,Fox,5850,108,30,2,39,19,12,6,5850,5820,5818,4384,1186,1105,49,59,2919,2931,257,4412,1073,0
20:07:26,10665.35,Fox,5850,108,30,2,38,19,13,6,5850,5820,5818,4385,1187,1105,49,59,2919,2931,257,4412,1073,0
20:07:26,10665.91,Fox,5852,109,32,2,37,19,13,6,5852,5820,5818,4385,1187,1105,49,60,2920,2932,257,4413,1073,0
20:07:27,10667.55,Fox,5852,109,32,2,37,19,11,8,5852,5820,5818,4385,1187,1107,49,60,2920,2932,257,4413,1073,0
20:07:27,10668.09,Fox,5854,110,32,2,35,20,11,8,5852,5820,5818,4386,1187,1107,49,61,2921,2933,257,4414,1073,0
20:07:27,10668.24,Fox,5854,110,34,2,35,20,10,9,5854,5820,5818,4386,1187,1108,49,61,2921,2933,257,4414,1073,0
20:07:27,10668.7,Fox,5856,111,36,2,34,20,10,9,5856,5820,5818,4387,1187,1108,50,61,2923,2933,257,4415,1073,0
20:07:27,10668.83,Fox,5856,110,36,2,34,19,10,9,5856,5820,5818,4387,1187,1108,50,60,2923,2933,257,4416,1073,0
20:07:28,10669.88,Fox,5858,112,38,2,34,19,10,9,5858,5820,5818,4387,1187,1108,50,62,2923,2935,257,4416,1073,0
20:07:28,10670.43,Fox,5858,110,38,2,34,17,10,9,5858,5820,5818,4387,1187,1108,50,60,2923,2935,257,4418,1073,0
20:07:28,10670.77,Fox,5860,111,38,2,33,17,10,9,5858,5820,5818,4388,1187,1108,51,60,2925,2935,257,4419,1073,0
20:07:28,10670.9,Fox,5860,111,40,2,33,17,10,9,5860,5820,5818,4388,1187,1108,51,60,2925,2935,257,4419,1073,0
20:07:28,10671.37,Fox,5860,111,40,2,31,19,10,9,5860,5820,5818,4390,1187,1108,51,60,2925,2935,257,4419,1073,0
20:07:28,10672.1,Fox,5862,112,42,0,33,18,10,9,5862,5820,5820,4390,1187,1108,50,62,2925,2937,257,4420,1073,0
20:07:28,10672.34,Fox,5862,112,40,2,33,18,10,9,5862,5822,5820,4390,1187,1108,50,62,2925,2937,257,4420,1073,0
20:07:29,10673.14,Fox,5862,112,38,4,33,18,10,9,5862,5824,5820,4390,1187,1108,50,62,2925,2937,257,4420,1073,0
20:07:29,10675.09,Fox,5866,114,42,4,31,18,10,9,5866,5824,5820,4390,1187,1108,50,64,2927,2939,257,4422,1073,0
20:07:30,10676.38,Fox,5866,114,40,6,31,18,10,9,5866,5826,5820,4390,1187,1108,50,64,2927,2939,257,4422,1073,0
20:07:30,10676.87,Fox,5866,114,40,6,29,20,10,9,5866,5826,5820,4392,1187,1108,50,64,2927,2939,257,4422,1073,0
20:07:30,10677.66,Fox,5866,113,40,6,29,20,9,9,5866,5826,5820,4392,1187,1108,50,63,2927,2939,257,4423,1073,0
20:07:31,10678.51,Fox,5866,112,40,6,29,19,9,9,5866,5826,5820,4392,1187,1108,50,62,2927,2939,257,4424,1073,0
20:07:31,10680.05,Fox,5868,113,42,6,28,19,9,9,5868,5826,5820,4392,1187,1108,50,63,2928,2940,257,4425,1073,0
20:07:31,10681.16,Fox,5868,112,42,6,28,18,9,9,5868,5826,5820,4392,1187,1108,50,62,2928,2940,257,4426,1073,0
20:07:32,10681.89,Fox,5868,110,42,6,28,16,9,9,5868,5826,5820,4392,1187,1108,50,60,2928,2940,257,4428,1073,0
20:07:32,10682.61,Fox,5868,110,40,8,28,16,9,9,5868,5828,5820,4392,1187,1108,50,60,2928,2940,257,4428,1073,0
20:07:32,10683.28,Fox,5868,110,38,10,28,16,9,9,5868,5830,5820,4392,1187,1108,50,60,2928,2940,257,4428,1073,0
20:07:33,10685.23,Fox,5872,112,40,10,27,16,9,8,5870,5830,5820,4392,1187,1108,51,61,2931,2941,257,4429,1074,0
20:07:33,10685.48,Fox,5874,113,44,10,26,14,11,8,5874,5830,5820,4392,1189,1108,51,62,2932,2942,257,4430,1074,0
20:07:33,10685.74,Fox,5874,113,44,10,26,13,12,8,5874,5830,5820,4392,1190,1108,51,62,2932,2942,257,4430,1074,0
20:07:34,10687.54,Fox,5876,112,46,10,25,11,12,8,5876,5830,5820,4392,1190,1108,52,60,2934,2942,257,4433,1074,0
20:07:34,10688.85,Fox,5878,113,46,10,24,11,11,9,5876,5830,5820,4392,1190,1109,52,61,2935,2943,257,4434,1074,0
20:07:34,10688.96,Fox,5878,113,48,10,24,11,11,9,5878,5830,5820,4392,1190,1109,52,61,2935,2943,257,4434,1074,0
20:07:34,10689.42,Fox,5882,115,50,10,22,11,11,9,5880,5830,5820,4392,1190,1109,52,63,2937,2945,257,4436,1074,0
20:07:34,10689.54,Fox,5882,115,52,10,21,12,11,9,5882,5830,5820,4393,1190,1109,52,63,2937,2945,257,4436,1074,0
20:07:35,10692.44,Fox,5884,117,54,10,19,14,11,9,5884,5830,5820,4395,1190,1109,53,64,2938,2946,257,4436,1074,0
20:07:36,10693.79,Fox,5886,119,56,10,19,14,11,9,5886,5830,5820,4395,1190,1109,54,65,2939,2947,257,4436,1074,0
20:07:36,10694.6,Fox,5888,121,58,10,19,14,11,9,5888,5830,5820,4395,1190,1109,55,66,2940,2948,257,4436,1074,0
20:07:37,10697.2,Fox,5888,121,58,10,18,15,11,9,5888,5830,5820,4396,1190,1109,55,66,2940,2948,257,4436,1074,0
20:07:37,10697.99,Fox,5888,121,56,12,18,15,11,9,5888,5832,5820,4396,1190,1109,55,66,2940,2948,257,4436,1074,0
20:07:37,10698.41,Fox,5888,120,56,12,18,15,11,8,5888,5832,5820,4396,1190,1109,54,66,2940,2948,257,4436,1075,0
20:07:38,10699.81,Fox,5888,120,56,12,17,16,11,8,5888,5832,5820,4397,1190,1109,54,66,2940,2948,257,4436,1075,0
20:07:38,10700.14,Fox,5888,119,56,12,17,13,13,8,5888,5832,5820,4397,1192,1109,54,65,2940,2948,257,4437,1075,0
20:07:38,10700.27,Fox,5888,119,54,14,17,13,13,8,5888,5834,5820,4397,1192,1109,54,65,2940,2948,257,4437,1075,0
20:07:38,10700.65,Fox,5890,121,56,14,17,13,13,8,5890,5834,5820,4397,1192,1109,55,66,2941,2949,257,4437,1075,0
20:07:38,10700.92,Fox,5892,122,58,14,16,13,13,8,5892,5834,5820,4397,1192,1109,55,67,2942,2950,257,4438,1075,0
20:07:38,10701.04,Fox,5892,122,56,16,16,13,13,8,5892,5836,5820,4397,1192,1109,55,67,2942,2950,257,4438,1075,0
20:07:39,10702.96,Fox,5892,119,56,16,16,11,13,7,5892,5836,5820,4397,1192,1109,55,64,2942,2950,257,4440,1076,0
20:07:39,10703.6,Fox,5892,119,56,16,14,13,13,7,5892,5836,5820,4399,1192,1109,55,64,2942,2950,257,4440,1076,0
20:07:39,10704.12,Fox,5892,119,56,16,14,13,12,8,5892,5836,5820,4399,1192,1110,55,64,2942,2950,257,4440,1076,0
20:07:39,10704.53,Fox,5892,118,56,16,14,13,12,7,5892,5836,5820,4399,1192,1110,55,63,2942,2950,257,4440,1077,0
20:07:40,10705.81,Fox,5894,120,58,16,14,13,12,7,5894,5836,5820,4399,1192,1110,56,64,2943,2951,257,4440,1077,0
20:07:40,10706.04,Fox,5894,120,58,16,14,13,11,8,5894,5836,5820,4399,1192,1111,56,64,2943,2951,257,4440,1077,0
20:07:40,10706.41,Fox,5894,120,58,16,12,15,11,8,5894,5836,5820,4401,1192,1111,56,64,2943,2951,257,4440,1077,0
20:07:40,10706.82,Fox,5894,120,58,16,12,15,9,10,5894,5836,5820,4401,1192,1113,56,64,2943,2951,257,4440,1077,0
20:07:40,10707.03,Fox,5894,120,58,16,10,17,9,10,5894,5836,5820,4403,1192,1113,56,64,2943,2951,257,4440,1077,0
20:07:40,10707.75,Fox,5894,119,58,16,9,17,9,10,5894,5836,5820,4404,1192,1113,56,63,2943,2951,257,4441,1077,0
20:07:41,10708.43,Fox,5894,119,58,16,6,20,9,10,5894,5836,5820,4407,1192,1113,56,63,2943,2951,257,4441,1077,0
20:07:41,10709.47,Fox,5894,119,58,16,5,21,9,10,5894,5836,5820,4408,1192,1113,56,63,2943,2951,257,4441,1077,0
20:07:41,10709.82,Fox,5896,120,60,16,4,21,9,10,5896,5836,5820,4408,1192,1113,56,64,2944,2952,257,4442,1077,0
20:07:41,10710.41,Fox,5896,119,58,18,4,20,9,10,5896,5838,5820,4408,1192,1113,56,63,2944,2952,257,4443,1077,0
20:07:41,10710.76,Fox,5896,119,58,16,6,20,9,10,5896,5838,5822,4408,1192,1113,56,63,2944,2952,257,4443,1077,0
20:07:42,10711.66,Fox,5896,119,58,14,8,20,9,10,5896,5838,5824,4408,1192,1113,56,63,2944,2952,257,4443,1077,0
20:07:42,10712.11,Fox,5896,119,58,14,7,21,9,10,5896,5838,5824,4409,1192,1113,56,63,2944,2952,257,4443,1077,0
20:07:42,10713.48,Fox,5896,119,58,14,5,23,9,10,5896,5838,5824,4411,1192,1113,56,63,2944,2952,257,4443,1077,0
20:07:42,10714.21,Fox,5896,117,58,14,5,21,9,10,5896,5838,5824,4411,1192,1113,54,63,2944,2952,257,4445,1077,0
20:07:43,10714.65,Fox,5896,116,58,14,5,21,9,9,5896,5838,5824,4411,1192,1113,53,63,2944,2952,257,4445,1078,0
20:07:43,10714.9,Fox,5896,116,58,12,7,21,9,9,5896,5838,5826,4411,1192,1113,53,63,2944,2952,257,4445,1078,0
20:07:43,10716.94,Fox,5896,114,58,12,7,19,9,9,5896,5838,5826,4411,1192,1113,51,63,2944,2952,257,4447,1078,0
20:07:44,10717.56,Fox,5896,112,58,12,7,17,9,9,5896,5838,5826,4411,1192,1113,51,61,2944,2952,257,4449,1078,0
20:07:44,10718.22,Fox,5896,111,58,12,7,16,9,9,5896,5838,5826,4411,1192,1113,51,60,2944,2952,257,4450,1078,0
20:07:44,10718.61,Fox,5896,111,56,14,7,16,9,9,5896,5840,5826,4411,1192,1113,51,60,2944,2952,257,4450,1078,0
20:07:44,10719,Fox,5896,108,56,14,7,13,9,9,5896,5840,5826,4411,1192,1113,51,57,2944,2952,257,4453,1078,0
20:07:44,10720.08,Fox,5896,107,56,14,7,12,9,9,5896,5840,5826,4411,1192,1113,51,56,2944,2952,257,4454,1078,0
20:07:45,10721.11,Fox,5896,107,56,12,9,12,9,9,5896,5840,5828,4411,1192,1113,51,56,2944,2952,257,4454,1078,0
20:07:45,10721.74,Fox,5896,107,56,10,11,12,9,9,5896,5840,5830,4411,1192,1113,51,56,2944,2952,257,4454,1078,0
20:07:45,10722.1,Fox,5896,107,54,12,11,12,9,9,5896,5842,5830,4411,1192,1113,51,56,2944,2952,257,4454,1078,0
20:07:45,10722.69,Fox,5896,106,54,12,11,11,9,9,5896,5842,5830,4411,1192,1113,51,55,2944,2952,257,4455,1078,0
20:07:46,10724.01,Fox,5896,104,52,14,11,9,9,9,5896,5844,5830,4411,1192,1113,51,53,2944,2952,257,4457,1078,0
20:07:46,10724.65,Fox,5896,104,52,14,11,7,11,9,5896,5844,5830,4411,1194,1113,51,53,2944,2952,257,4457,1078,0
20:07:46,10725.61,Fox,5896,104,52,14,9,9,11,9,5896,5844,5830,4413,1194,1113,51,53,2944,2952,257,4457,1078,0
20:07:46,10725.93,Fox,5896,103,52,14,9,9,11,8,5896,5844,5830,4413,1194,1113,51,52,2944,2952,257,4457,1079,0
20:07:47,10726.97,Fox,5896,103,52,14,9,7,13,8,5896,5844,5830,4413,1196,1113,51,52,2944,2952,257,4457,1079,0
20:07:47,10727.99,Fox,5896,103,52,14,9,5,15,8,5896,5844,5830,4413,1198,1113,51,52,2944,2952,257,4457,1079,0
20:07:47,10728.87,Fox,5896,102,52,14,9,5,15,7,5896,5844,5830,4413,1198,1113,51,51,2944,2952,257,4457,1080,0
20:07:48,10730.01,Fox,5896,102,50,16,9,5,15,7,5896,5846,5830,4413,1198,1113,51,51,2944,2952,257,4457,1080,0
20:07:49,10732.57,Fox,5896,102,50,16,7,7,15,7,5896,5846,5830,4415,1198,1113,51,51,2944,2952,257,4457,1080,0
20:07:49,10733.2,Fox,5896,101,50,16,7,7,15,6,5896,5846,5830,4415,1198,1113,51,50,2944,2952,257,4457,1081,0
20:07:50,10736.17,Fox,5896,99,48,18,7,5,15,6,5896,5848,5830,4415,1198,1113,51,48,2944,2952,257,4459,1081,0
20:07:50,10736.61,Fox,5896,99,48,16,9,5,15,6,5896,5848,5832,4415,1198,1113,51,48,2944,2952,257,4459,1081,0
20:07:51,10738.32,Fox,5896,98,48,16,9,5,15,5,5896,5848,5832,4415,1198,1113,50,48,2944,2952,257,4459,1082,0
20:07:51,10738.75,Fox,5896,98,48,14,11,5,15,5,5896,5848,5834,4415,1198,1113,50,48,2944,2952,257,4459,1082,0
20:07:51,10739.46,Fox,5896,98,48,12,13,5,15,5,5896,5848,5836,4415,1198,1113,50,48,2944,2952,257,4459,1082,0
20:07:52,10741.36,Fox,5896,98,46,14,13,5,15,5,5896,5850,5836,4415,1198,1113,50,48,2944,2952,257,4459,1082,0
20:07:53,10746.01,Fox,5898,100,48,14,13,5,15,5,5898,5850,5836,4415,1198,1113,52,48,2946,2952,257,4459,1082,0
20:07:54,10748.28,Fox,5900,102,50,14,13,5,15,5,5900,5850,5836,4415,1198,1113,52,50,2946,2954,257,4459,1082,0
20:07:54,10748.47,Fox,5900,102,48,16,13,5,15,5,5900,5852,5836,4415,1198,1113,52,50,2946,2954,257,4459,1082,0
20:07:54,10748.83,Fox,5900,102,48,14,15,5,15,5,5900,5852,5838,4415,1198,1113,52,50,2946,2954,257,4459,1082,0
20:07:54,10749.5,Fox,5902,103,50,14,14,5,15,5,5902,5852,5838,4415,1198,1113,52,51,2947,2955,257,4460,1082,0
20:07:55,10750.77,Fox,5902,103,48,16,14,5,15,5,5902,5854,5838,4415,1198,1113,52,51,2947,2955,257,4460,1082,0
20:07:55,10751.27,Fox,5902,103,46,18,14,5,15,5,5902,5856,5838,4415,1198,1113,52,51,2947,2955,257,4460,1082,0
20:07:55,10752.44,Fox,5902,103,44,20,14,5,15,5,5902,5858,5838,4415,1198,1113,52,51,2947,2955,257,4460,1082,0
20:07:56,10753.45,Fox,5902,103,42,22,14,5,15,5,5902,5860,5838,4415,1198,1113,52,51,2947,2955,257,4460,1082,0
20:07:56,10754.65,Fox,5902,103,40,24,14,5,15,5,5902,5862,5838,4415,1198,1113,52,51,2947,2955,257,4460,1082,0
20:07:57,10757.15,Fox,5902,103,40,22,16,5,15,5,5902,5862,5840,4415,1198,1113,52,51,2947,2955,257,4460,1082,0
20:07:57,10757.68,Fox,5904,104,36,26,15,5,15,5,5902,5866,5840,4415,1198,1113,52,52,2948,2956,257,4461,1082,0
20:07:57,10757.81,Fox,5904,104,38,26,15,5,15,5,5904,5866,5840,4415,1198,1113,52,52,2948,2956,257,4461,1082,0
20:07:58,10760.21,Fox,5904,103,38,26,15,5,14,5,5904,5866,5840,4415,1198,1113,52,51,2948,2956,257,4462,1082,0
20:07:58,10760.57,Fox,5904,103,38,24,17,5,13,6,5904,5866,5842,4415,1198,1114,52,51,2948,2956,257,4462,1082,0
20:07:58,10761.63,Fox,5906,105,40,24,17,5,13,6,5906,5866,5842,4415,1198,1114,54,51,2950,2956,257,4462,1082,0
20:07:59,10762.41,Fox,5906,105,40,22,19,5,13,6,5906,5866,5844,4415,1198,1114,54,51,2950,2956,257,4462,1082,0
20:07:59,10762.6,Fox,5906,105,38,24,19,5,13,6,5906,5868,5844,4415,1198,1114,54,51,2950,2956,257,4462,1082,0
20:07:59,10762.9,Fox,5906,105,38,24,19,5,12,7,5906,5868,5844,4415,1198,1115,54,51,2950,2956,257,4462,1082,0
20:08:00,10767.12,Fox,5906,103,38,24,19,5,12,5,5906,5868,5844,4415,1198,1115,53,50,2950,2956,257,4462,1084,0
20:08:00,10767.73,Fox,5906,103,36,26,19,5,12,5,5906,5870,5844,4415,1198,1115,53,50,2950,2956,257,4462,1084,0
20:08:01,10768.03,Fox,5906,103,32,30,19,5,12,5,5906,5874,5844,4415,1198,1115,53,50,2950,2956,257,4462,1084,0
20:08:01,10768.48,Fox,5906,103,32,28,21,5,12,5,5906,5874,5846,4415,1198,1115,53,50,2950,2956,257,4462,1084,0
20:08:01,10770.01,Fox,5906,103,30,30,21,5,12,5,5906,5876,5846,4415,1198,1115,53,50,2950,2956,257,4462,1084,0
20:08:02,10771.29,Fox,5906,103,30,30,20,6,12,5,5906,5876,5846,4416,1198,1115,53,50,2950,2956,257,4462,1084,0
20:08:02,10771.46,Fox,5906,103,28,32,20,6,12,5,5906,5878,5846,4416,1198,1115,53,50,2950,2956,257,4462,1084,0
20:08:02,10772.05,Fox,5906,103,24,36,20,6,12,5,5906,5882,5846,4416,1198,1115,53,50,2950,2956,257,4462,1084,0
20:08:02,10772.14,Fox,5906,103,24,36,18,8,12,5,5906,5882,5846,4418,1198,1115,53,50,2950,2956,257,4462,1084,0
20:08:02,10773.65,Fox,5908,104,26,36,17,8,12,5,5908,5882,5846,4418,1198,1115,52,52,2950,2958,257,4463,1084,0
20:08:03,10774.55,Fox,5908,104,26,34,19,8,12,5,5908,5882,5848,4418,1198,1115,52,52,2950,2958,257,4463,1084,0
20:08:03,10774.93,Fox,5908,104,24,36,19,8,12,5,5908,5884,5848,4418,1198,1115,52,52,2950,2958,257,4463,1084,0
20:08:03,10775.3,Fox,5908,104,24,36,17,10,12,5,5908,5884,5848,4420,1198,1115,52,52,2950,2958,257,4463,1084,0
20:08:03,10776.3,Fox,5908,104,22,38,17,10,12,5,5908,5886,5848,4420,1198,1115,52,52,2950,2958,257,4463,1084,0
20:08:04,10777.02,Fox,5910,106,24,38,17,10,12,5,5910,5886,5848,4420,1198,1115,53,53,2951,2959,257,4463,1084,0
20:08:04,10777.12,Fox,5910,106,22,40,17,10,12,5,5910,5888,5848,4420,1198,1115,53,53,2951,2959,257,4463,1084,0
20:08:04,10777.4,Fox,5912,107,24,40,16,10,12,5,5912,5888,5848,4420,1198,1115,52,55,2951,2961,257,4464,1084,0
20:08:04,10778.58,Fox,5912,106,24,40,16,10,12,4,5912,5888,5848,4420,1198,1115,52,54,2951,2961,257,4464,1085,0
20:08:04,10779.08,Fox,5914,108,26,40,16,10,12,4,5914,5888,5848,4420,1198,1115,53,55,2952,2962,257,4464,1085,0
20:08:04,10779.51,Fox,5914,107,26,40,16,10,11,4,5914,5888,5848,4420,1198,1115,53,54,2952,2962,257,4465,1085,0
20:08:04,10779.83,Fox,5914,107,26,38,18,10,11,4,5914,5888,5850,4420,1198,1115,53,54,2952,2962,257,4465,1085,0
20:08:05,10781.61,Fox,5914,107,26,38,17,11,11,4,5914,5888,5850,4421,1198,1115,53,54,2952,2962,257,4465,1085,0
20:08:05,10781.89,Fox,5914,106,26,38,17,10,11,4,5914,5888,5850,4421,1198,1115,53,53,2952,2962,257,4466,1085,0
20:08:05,10782.26,Fox,5914,106,26,38,16,11,11,4,5914,5888,5850,4422,1198,1115,53,53,2952,2962,257,4466,1085,0
20:08:05,10782.78,Fox,5914,104,26,38,16,9,11,4,5914,5888,5850,4422,1198,1115,51,53,2952,2962,259,4466,1085,0
20:08:06,10783.21,Fox,5914,104,24,40,16,9,11,4,5914,5890,5850,4422,1198,1115,51,53,2952,2962,259,4466,1085,0
20:08:06,10783.4,Fox,5914,104,22,42,16,9,11,4,5914,5892,5850,4422,1198,1115,51,53,2952,2962,259,4466,1085,0
20:08:06,10784.52,Fox,5914,103,22,42,16,9,11,3,5914,5892,5850,4422,1198,1115,50,53,2952,2962,259,4466,1086,0
20:08:07,10785.94,Fox,5914,101,22,42,16,7,11,3,5914,5892,5850,4422,1198,1115,50,51,2952,2962,259,4468,1086,0
20:08:07,10786.36,Fox,5914,100,22,42,16,7,11,2,5914,5892,5850,4422,1198,1115,50,50,2952,2962,259,4468,1087,0
20:08:07,10787,Fox,5914,100,22,40,18,7,11,2,5914,5892,5852,4422,1198,1115,50,50,2952,2962,259,4468,1087,0
20:08:07,10788.52,Fox,5916,102,20,42,18,7,11,2,5914,5894,5852,4422,1198,1115,51,51,2953,2963,259,4468,1087,0
20:08:07,10788.67,Fox,5916,102,22,42,18,7,11,2,5916,5894,5852,4422,1198,1115,51,51,2953,2963,259,4468,1087,0
20:08:08,10789.19,Fox,5916,102,22,40,20,7,10,3,5916,5894,5854,4422,1198,1116,51,51,2953,2963,259,4468,1087,0
20:08:08,10789.79,Fox,5916,102,22,38,22,7,10,3,5916,5894,5856,4422,1198,1116,51,51,2953,2963,259,4468,1087,0
20:08:08,10790.9,Fox,5916,102,22,36,24,7,10,3,5916,5894,5858,4422,1198,1116,51,51,2953,2963,259,4468,1087,0
20:08:09,10791.96,Fox,5916,102,22,34,26,7,10,3,5916,5894,5860,4422,1198,1116,51,51,2953,2963,259,4468,1087,0
20:08:09,10792.39,Fox,5916,102,20,36,26,7,10,3,5916,5896,5860,4422,1198,1116,51,51,2953,2963,259,4468,1087,0
20:08:09,10792.83,Fox,5916,101,20,36,26,6,10,3,5916,5896,5860,4422,1198,1116,51,50,2953,2963,259,4469,1087,0
20:08:09,10793.17,Fox,5916,101,20,34,28,6,10,3,5916,5896,5862,4422,1198,1116,51,50,2953,2963,259,4469,1087,0
20:08:10,10795.54,Fox,5918,102,22,34,27,6,10,3,5918,5896,5862,4422,1198,1116,51,51,2954,2964,259,4470,1087,0
20:08:10,10796.13,Fox,5918,102,22,30,31,6,10,3,5918,5896,5866,4422,1198,1116,51,51,2954,2964,259,4470,1087,0
20:08:10,10797.07,Fox,5918,102,22,30,29,8,10,3,5918,5896,5866,4424,1198,1116,51,51,2954,2964,259,4470,1087,0
20:08:10,10797.49,Fox,5920,103,24,30,28,8,10,3,5920,5896,5866,4424,1198,1116,52,51,2956,2964,259,4471,1087,0
20:08:11,10799.26,Fox,5920,103,24,30,27,9,10,3,5920,5896,5866,4425,1198,1116,52,51,2956,2964,259,4471,1087,0
20:08:11,10799.96,Fox,5920,103,24,30,25,11,10,3,5920,5896,5866,4427,1198,1116,52,51,2956,2964,259,4471,1087,0
20:08:12,10801.11,Fox,5920,103,24,28,27,11,10,3,5920,5896,5868,4427,1198,1116,52,51,2956,2964,259,4471,1087,0
20:08:13,10806.47,Fox,5920,103,24,24,31,11,10,3,5920,5896,5872,4427,1198,1116,52,51,2956,2964,259,4471,1087,0
20:08:13,10806.6,Fox,5920,103,24,22,33,11,10,3,5920,5896,5874,4427,1198,1116,52,51,2956,2964,259,4471,1087,0
20:08:14,10808.54,Fox,5922,104,26,22,32,11,10,3,5922,5896,5874,4427,1198,1116,53,51,2958,2964,259,4472,1087,0
20:08:14,10808.72,Fox,5922,104,26,20,34,11,10,3,5922,5896,5876,4427,1198,1116,53,51,2958,2964,259,4472,1087,0
20:08:14,10809.25,Fox,5922,104,26,20,33,12,10,3,5922,5896,5876,4428,1198,1116,53,51,2958,2964,259,4472,1087,0
20:08:14,10809.81,Fox,5922,103,26,20,33,11,10,3,5922,5896,5876,4428,1198,1116,53,50,2958,2964,259,4473,1087,0
20:08:15,10810.03,Fox,5922,103,26,18,35,11,10,3,5922,5896,5878,4428,1198,1116,53,50,2958,2964,259,4473,1087,0
20:08:15,10810.58,Fox,5922,101,26,14,39,9,10,3,5922,5896,5882,4428,1198,1116,53,48,2958,2964,259,4475,1087,0
20:08:16,10812.81,Fox,5924,102,28,14,38,9,10,3,5924,5896,5882,4428,1198,1116,54,48,2960,2964,259,4476,1087,0
20:08:16,10813.53,Fox,5924,102,28,12,40,9,10,3,5924,5896,5884,4428,1198,1116,54,48,2960,2964,259,4476,1087,0
20:08:16,10814.77,Fox,5924,102,28,10,42,9,10,3,5924,5896,5886,4428,1198,1116,54,48,2960,2964,259,4476,1087,0
20:08:16,10815.69,Fox,5924,102,28,8,44,9,10,3,5924,5896,5888,4428,1198,1116,54,48,2960,2964,259,4476,1087,0
20:08:17,10817.6,Fox,5924,102,28,8,43,10,10,3,5924,5896,5888,4429,1198,1116,54,48,2960,2964,259,4476,1087,0
20:08:18,10819.82,Fox,5924,101,28,8,43,9,10,3,5924,5896,5888,4429,1198,1116,53,48,2960,2964,259,4477,1087,0
20:08:18,10821.06,Fox,5924,101,28,8,42,10,10,3,5924,5896,5888,4430,1198,1116,53,48,2960,2964,259,4477,1087,0
20:08:18,10821.66,Fox,5924,101,28,6,44,10,10,3,5924,5896,5890,4430,1198,1116,53,48,2960,2964,259,4477,1087,0
20:08:19,10821.97,Fox,5924,101,28,4,46,10,10,3,5924,5896,5892,4430,1198,1116,53,48,2960,2964,259,4477,1087,0
20:08:19,10822.91,Fox,5924,101,28,4,45,11,9,4,5924,5896,5892,4431,1198,1117,53,48,2960,2964,259,4477,1087,0
20:08:19,10823.42,Fox,5924,101,28,4,45,11,8,5,5924,5896,5892,4431,1198,1118,53,48,2960,2964,259,4477,1087,0
20:08:20,10824.95,Fox,5926,102,30,4,44,11,8,5,5926,5896,5892,4431,1198,1118,52,50,2960,2966,259,4478,1087,0
20:08:20,10826.11,Fox,5926,102,30,4,44,9,10,5,5926,5896,5892,4431,1200,1118,52,50,2960,2966,259,4478,1087,0
20:08:20,10826.8,Fox,5926,102,30,2,46,9,10,5,5926,5896,5894,4431,1200,1118,52,50,2960,2966,259,4478,1087,0
20:08:21,10828.19,Fox,5926,101,30,2,46,8,10,5,5926,5896,5894,4431,1200,1118,52,49,2960,2966,259,4479,1087,0
20:08:21,10828.56,Fox,5926,101,28,4,46,8,10,5,5926,5898,5894,4431,1200,1118,52,49,2960,2966,259,4479,1087,0
20:08:21,10828.98,Fox,5926,101,28,4,44,10,10,5,5926,5898,5894,4433,1200,1118,52,49,2960,2966,259,4479,1087,0
20:08:22,10830.85,Fox,5926,101,26,4,46,10,10,5,5926,5900,5896,4433,1200,1118,52,49,2960,2966,259,4479,1087,0
20:08:22,10831.34,Fox,5928,102,28,4,45,10,10,5,5928,5900,5896,4433,1200,1118,52,50,2961,2967,259,4480,1087,0
20:08:22,10831.64,Fox,5928,101,28,4,45,9,10,5,5928,5900,5896,4433,1200,1118,52,49,2961,2967,259,4481,1087,0
20:08:22,10832.1,Fox,5928,101,26,6,45,9,10,5,5928,5902,5896,4433,1200,1118,52,49,2961,2967,259,4481,1087,0
20:08:22,10833.5,Fox,5928,100,26,6,45,8,10,5,5928,5902,5896,4433,1200,1118,52,48,2961,2967,259,4482,1087,0
20:08:23,10834.58,Fox,5930,101,28,6,44,8,10,5,5930,5902,5896,4433,1200,1118,53,48,2963,2967,259,4483,1087,0
20:08:23,10835.17,Fox,5930,101,28,6,42,10,10,5,5930,5902,5896,4435,1200,1118,53,48,2963,2967,259,4483,1087,0
20:08:24,10837.55,Fox,5930,101,28,6,42,10,8,7,5930,5902,5896,4435,1200,1120,53,48,2963,2967,259,4483,1087,0
20:08:25,10839.75,Fox,5932,100,30,6,41,8,8,7,5932,5902,5896,4435,1200,1120,52,48,2964,2968,259,4486,1087,0
20:08:25,10840.36,Fox,5932,100,28,8,41,8,8,7,5932,5904,5896,4435,1200,1120,52,48,2964,2968,259,4486,1087,0
20:08:26,10844.16,Fox,5932,100,26,10,41,8,8,7,5932,5906,5896,4435,1200,1120,52,48,2964,2968,259,4486,1087,0
20:08:27,10845.61,Fox,5932,98,26,10,41,6,8,7,5932,5906,5896,4435,1200,1120,52,46,2964,2968,259,4488,1087,0
20:08:27,10846.03,Fox,5934,99,28,10,40,6,8,7,5934,5906,5896,4435,1200,1120,53,46,2966,2968,259,4489,1087,0
20:08:27,10846.38,Fox,5936,101,30,10,40,6,8,7,5936,5906,5896,4435,1200,1120,55,46,2968,2968,259,4489,1087,0
20:08:27,10847.55,Fox,5936,101,30,10,39,7,8,7,5936,5906,5896,4436,1200,1120,55,46,2968,2968,259,4489,1087,0
20:08:28,10849.72,Fox,5936,101,30,10,37,9,8,7,5936,5906,5896,4438,1200,1120,55,46,2968,2968,259,4489,1087,0
20:08:28,10850.41,Fox,5940,103,30,10,34,11,8,6,5936,5906,5896,4440,1200,1120,56,47,2971,2969,259,4491,1087,0
20:08:28,10850.57,Fox,5940,103,34,10,34,11,8,6,5940,5906,5896,4440,1200,1120,56,47,2971,2969,259,4491,1087,0
20:08:28,10851.5,Fox,5944,107,36,10,32,13,8,6,5942,5906,5896,4442,1200,1120,60,47,2975,2969,259,4491,1087,0
20:08:29,10851.74,Fox,5946,108,38,10,31,13,8,6,5944,5906,5896,4442,1200,1120,61,47,2977,2969,259,4492,1087,0
20:08:29,10852.02,Fox,5948,110,40,10,31,13,8,6,5946,5906,5896,4442,1200,1120,62,48,2978,2970,259,4492,1087,0
20:08:29,10852.16,Fox,5948,110,42,10,31,13,8,6,5948,5906,5896,4442,1200,1120,62,48,2978,2970,259,4492,1087,0
20:08:29,10852.44,Fox,5948,110,42,10,29,15,8,6,5948,5906,5896,4444,1200,1120,62,48,2978,2970,259,4492,1087,0
20:08:29,10853.29,Fox,5952,114,44,10,29,15,8,6,5950,5906,5896,4444,1200,1120,64,50,2980,2972,259,4492,1087,0
20:08:29,10853.63,Fox,5952,113,46,10,29,15,8,5,5952,5906,5896,4444,1200,1120,63,50,2980,2972,259,4492,1088,0
20:08:29,10853.76,Fox,5952,113,46,10,27,17,8,5,5952,5906,5896,4446,1200,1120,63,50,2980,2972,259,4492,1088,0
20:08:30,10856.22,Fox,5952,113,44,12,27,17,8,5,5952,5908,5896,4446,1200,1120,63,50,2980,2972,259,4492,1088,0
20:08:30,10856.6,Fox,5952,113,44,12,24,20,8,5,5952,5908,5896,4449,1200,1120,63,50,2980,2972,259,4492,1088,0
20:08:31,10857.71,Fox,5952,112,44,12,24,20,8,4,5952,5908,5896,4449,1200,1120,63,49,2980,2972,259,4492,1089,0
20:08:31,10858.12,Fox,5952,111,44,12,24,19,8,4,5952,5908,5896,4449,1200,1120,63,48,2980,2972,259,4493,1089,0
20:08:31,10859.42,Fox,5952,110,44,12,24,19,8,3,5952,5908,5896,4449,1200,1120,63,47,2980,2972,259,4493,1090,0
20:08:31,10859.72,Fox,5952,110,42,14,24,19,8,3,5952,5910,5896,4449,1200,1120,63,47,2980,2972,259,4493,1090,0
20:08:32,10860.17,Fox,5952,110,40,16,24,19,8,3,5952,5912,5896,4449,1200,1120,63,47,2980,2972,259,4493,1090,0
20:08:32,10860.77,Fox,5954,111,42,16,23,19,8,3,5954,5912,5896,4449,1200,1120,63,48,2981,2973,259,4494,1090,0
20:08:32,10861.07,Fox,5956,110,42,16,22,17,8,3,5954,5912,5896,4449,1200,1120,61,49,2982,2974,259,4497,1090,0
20:08:32,10861.22,Fox,5956,109,44,16,22,17,8,2,5956,5912,5896,4449,1200,1120,61,48,2982,2974,259,4497,1091,0
20:08:32,10861.65,Fox,5956,109,42,18,20,19,8,2,5956,5914,5896,4451,1200,1120,61,48,2982,2974,259,4497,1091,0
20:08:32,10862.19,Fox,5956,107,42,18,20,17,6,4,5956,5914,5896,4451,1200,1122,61,46,2982,2974,259,4499,1091,0
20:08:32,10862.98,Fox,5956,106,42,18,20,16,6,4,5956,5914,5896,4451,1200,1122,60,46,2982,2974,259,4500,1091,0
20:08:33,10863.88,Fox,5958,108,44,18,20,16,6,4,5958,5914,5896,4451,1200,1122,62,46,2984,2974,259,4500,1091,0
20:08:33,10864.48,Fox,5958,106,44,18,20,14,4,6,5958,5914,5896,4451,1200,1124,62,44,2984,2974,259,4502,1091,0
20:08:33,10865.44,Fox,5960,107,46,18,19,14,4,6,5960,5914,5896,4451,1200,1124,62,45,2985,2975,259,4503,1091,0
20:08:33,10865.58,Fox,5960,107,46,18,19,14,2,8,5960,5914,5896,4451,1200,1126,62,45,2985,2975,259,4503,1091,0
20:08:34,10866.94,Fox,5960,107,46,18,16,17,2,8,5960,5914,5896,4454,1200,1126,62,45,2985,2975,259,4503,1091,0
20:08:34,10867.21,Fox,5960,104,46,16,17,15,2,8,5960,5914,5898,4455,1200,1126,61,43,2985,2975,259,4506,1091,0
20:08:34,10868.81,Fox,5964,106,48,16,15,15,2,8,5962,5914,5898,4455,1200,1126,60,46,2986,2978,259,4508,1091,0
20:08:34,10869.07,Fox,5964,106,50,16,14,16,2,8,5964,5914,5898,4456,1200,1126,60,46,2986,2978,259,4508,1091,0
20:08:35,10869.38,Fox,5964,106,50,14,16,16,2,8,5964,5914,5900,4456,1200,1126,60,46,2986,2978,259,4508,1091,0
20:08:35,10870.6,Fox,5964,106,50,12,16,18,2,8,5964,5914,5902,4458,1200,1126,60,46,2986,2978,259,4508,1091,0
20:08:35,10871.09,Fox,5964,106,50,12,13,21,2,8,5964,5914,5902,4461,1200,1126,60,46,2986,2978,259,4508,1091,0
20:08:35,10871.21,Fox,5964,106,48,14,13,21,2,8,5964,5916,5902,4461,1200,1126,60,46,2986,2978,259,4508,1091,0
20:08:36,10872.18,Fox,5964,104,48,14,13,19,2,8,5964,5916,5902,4461,1200,1126,59,45,2986,2978,259,4510,1091,0
20:08:36,10872.85,Fox,5966,105,50,14,13,18,2,8,5966,5916,5902,4461,1200,1126,59,46,2987,2979,259,4511,1091,0
20:08:36,10873.98,Fox,5966,105,50,14,11,20,2,8,5966,5916,5902,4463,1200,1126,59,46,2987,2979,259,4511,1091,0
20:08:36,10875.12,Fox,5966,105,50,14,11,19,3,8,5966,5916,5902,4463,1201,1126,59,46,2987,2979,259,4511,1091,0
20:08:37,10875.33,Fox,5966,105,50,14,9,21,3,8,5966,5916,5902,4465,1201,1126,59,46,2987,2979,259,4511,1091,0
20:08:37,10876.1,Fox,5966,105,50,14,8,22,3,8,5966,5916,5902,4466,1201,1126,59,46,2987,2979,259,4511,1091,0
20:08:37,10877.52,Fox,5966,102,50,14,8,19,3,8,5966,5916,5902,4466,1201,1126,57,45,2987,2979,259,4514,1091,0
20:08:37,10877.63,Fox,5966,101,50,14,8,18,3,8,5966,5916,5902,4466,1201,1126,57,44,2987,2979,259,4515,1091,0
20:08:38,10878.13,Fox,5966,101,48,16,8,18,3,8,5966,5918,5902,4466,1201,1126,57,44,2987,2979,259,4515,1091,0
20:08:38,10878.85,Fox,5966,101,48,14,10,18,3,8,5966,5918,5904,4466,1201,1126,57,44,2987,2979,259,4515,1091,0
20:08:38,10879.63,Fox,5966,100,48,14,10,17,3,8,5966,5918,5904,4466,1201,1126,56,44,2987,2979,259,4516,1091,0
20:08:38,10880,Fox,5966,100,46,16,10,17,3,8,5966,5920,5904,4466,1201,1126,56,44,2987,2979,259,4516,1091,0
20:08:39,10881.15,Fox,5966,98,46,16,10,15,3,8,5966,5920,5904,4466,1201,1126,55,43,2987,2979,259,4518,1091,0
20:08:39,10881.64,Fox,5966,95,46,16,10,12,3,8,5966,5920,5904,4466,1201,1126,54,41,2987,2979,259,4521,1091,0
20:08:39,10882.16,Fox,5966,95,46,16,8,14,3,8,5966,5920,5904,4468,1201,1126,54,41,2987,2979,259,4521,1091,0
20:08:39,10882.62,Fox,5966,95,46,14,9,15,3,8,5966,5920,5906,4469,1201,1126,54,41,2987,2979,259,4521,1091,0
20:08:40,10884.63,Fox,5966,94,46,14,9,15,3,7,5966,5920,5906,4469,1201,1126,54,40,2987,2979,259,4521,1092,0
20:08:40,10886.69,Fox,5966,93,46,14,9,14,3,7,5966,5920,5906,4469,1201,1126,54,39,2987,2979,259,4522,1092,0
20:08:41,10887.49,Fox,5968,95,48,14,8,15,3,7,5968,5920,5906,4470,1201,1126,56,39,2989,2979,259,4522,1092,0
20:08:42,10890.6,Fox,5968,95,48,14,8,13,5,7,5968,5920,5906,4470,1203,1126,56,39,2989,2979,259,4522,1092,0
20:08:42,10891.04,Fox,5968,95,46,16,8,13,5,7,5968,5922,5906,4470,1203,1126,56,39,2989,2979,259,4522,1092,0
20:08:42,10891.35,Fox,5968,95,46,16,7,14,5,7,5968,5922,5906,4471,1203,1126,56,39,2989,2979,259,4522,1092,0
20:08:42,10892.82,Fox,5968,93,46,16,7,12,5,7,5968,5922,5906,4471,1203,1126,55,38,2989,2979,259,4524,1092,0
20:08:42,10893.05,Fox,5968,92,46,16,7,11,5,7,5968,5922,5906,4471,1203,1126,55,37,2989,2979,259,4525,1092,0
20:08:43,10894.71,Fox,5968,92,46,14,9,11,5,7,5968,5922,5908,4471,1203,1126,55,37,2989,2979,259,4525,1092,0
20:08:43,10895.36,Fox,5968,92,44,16,9,11,5,7,5968,5924,5908,4471,1203,1126,55,37,2989,2979,259,4525,1092,0
20:08:44,10898.12,Fox,5968,91,44,14,11,10,5,7,5968,5924,5910,4471,1203,1126,55,36,2989,2979,259,4526,1092,0
20:08:44,10898.45,Fox,5968,91,44,12,13,10,5,7,5968,5924,5912,4471,1203,1126,55,36,2989,2979,259,4526,1092,0
20:08:45,10900.18,Fox,5968,91,44,10,15,10,5,7,5968,5924,5914,4471,1203,1126,55,36,2989,2979,259,4526,1092,0
20:08:46,10901.99,Fox,5968,90,44,10,15,9,5,7,5968,5924,5914,4471,1203,1126,55,35,2989,2979,259,4527,1092,0
20:08:46,10902.55,Fox,5968,89,44,10,15,9,5,6,5968,5924,5914,4471,1203,1126,54,35,2989,2979,259,4527,1093,0
20:08:46,10903.9,Fox,5968,88,44,10,15,9,5,5,5968,5924,5914,4471,1203,1126,53,35,2989,2979,259,4527,1094,0
20:08:47,10907.48,Fox,5968,88,42,12,15,9,5,5,5968,5926,5914,4471,1203,1126,53,35,2989,2979,259,4527,1094,0
20:08:48,10909.03,Fox,5970,89,44,12,14,9,5,5,5970,5926,5914,4471,1203,1126,53,36,2990,2980,259,4528,1094,0
20:08:48,10909.75,Fox,5970,89,44,10,16,9,5,5,5970,5926,5916,4471,1203,1126,53,36,2990,2980,259,4528,1094,0
20:08:49,10912.57,Fox,5970,88,44,10,16,9,5,4,5970,5926,5916,4471,1203,1126,52,36,2990,2980,259,4528,1095,0
20:08:50,10914.25,Fox,5970,88,42,12,16,9,5,4,5970,5928,5916,4471,1203,1126,52,36,2990,2980,259,4528,1095,0
20:08:50,10915.84,Fox,5970,87,42,12,16,9,5,3,5970,5928,5916,4471,1203,1126,51,36,2990,2980,259,4528,1096,0
20:08:50,10916.65,Fox,5970,87,42,10,18,9,5,3,5970,5928,5918,4471,1203,1126,51,36,2990,2980,259,4528,1096,0
20:08:51,10917.17,Fox,5970,87,40,12,18,9,5,3,5970,5930,5918,4471,1203,1126,51,36,2990,2980,259,4528,1096,0
20:08:51,10918.49,Fox,5970,87,40,10,20,9,5,3,5970,5930,5920,4471,1203,1126,51,36,2990,2980,259,4528,1096,0
20:08:52,10921.09,Fox,5972,88,42,10,19,9,5,3,5972,5930,5920,4471,1203,1126,52,36,2992,2980,259,4529,1096,0
20:08:52,10921.42,Fox,5974,90,44,10,19,9,5,3,5974,5930,5920,4471,1203,1126,53,37,2993,2981,259,4529,1096,0
20:08:52,10922.01,Fox,5976,91,46,10,18,9,5,3,5976,5930,5920,4471,1203,1126,52,39,2993,2983,259,4530,1096,0
20:08:52,10922.26,Fox,5976,91,44,12,18,9,5,3,5976,5932,5920,4471,1203,1126,52,39,2993,2983,259,4530,1096,0
20:08:54,10927.81,Fox,5978,93,44,12,16,11,5,3,5976,5932,5920,4473,1203,1126,54,39,2995,2983,259,4530,1096,0
20:08:54,10927.98,Fox,5978,93,46,12,16,11,5,3,5978,5932,5920,4473,1203,1126,54,39,2995,2983,259,4530,1096,0
20:08:54,10928.62,Fox,5978,93,44,14,16,11,5,3,5978,5934,5920,4473,1203,1126,54,39,2995,2983,259,4530,1096,0
20:08:55,10928.92,Fox,5978,93,42,16,16,11,5,3,5978,5936,5920,4473,1203,1126,54,39,2995,2983,259,4530,1096,0
20:08:55,10929.6,Fox,5978,93,42,14,18,11,5,3,5978,5936,5922,4473,1203,1126,54,39,2995,2983,259,4530,1096,0
20:08:55,10929.86,Fox,5978,93,42,14,16,13,5,3,5978,5936,5922,4475,1203,1126,54,39,2995,2983,259,4530,1096,0
20:08:55,10931.13,Fox,5978,93,42,14,15,14,5,3,5978,5936,5922,4476,1203,1126,54,39,2995,2983,259,4530,1096,0
20:08:56,10933.22,Fox,5978,93,38,18,15,14,5,3,5978,5940,5922,4476,1203,1126,54,39,2995,2983,259,4530,1096,0
20:08:56,10934,Fox,5978,93,36,18,17,14,5,3,5978,5942,5924,4476,1203,1126,54,39,2995,2983,259,4530,1096,0
20:08:56,10934.16,Fox,5978,93,34,20,17,14,5,3,5978,5944,5924,4476,1203,1126,54,39,2995,2983,259,4530,1096,0
20:08:56,10934.44,Fox,5978,93,32,22,17,14,5,3,5978,5946,5924,4476,1203,1126,54,39,2995,2983,259,4530,1096,0
20:08:56,10934.7,Fox,5978,93,30,24,17,14,5,3,5978,5948,5924,4476,1203,1126,54,39,2995,2983,259,4530,1096,0
20:08:57,10934.93,Fox,5978,92,30,24,17,14,5,2,5978,5948,5924,4476,1203,1126,54,38,2995,2983,259,4530,1097,0
20:08:57,10935.98,Fox,5978,92,26,28,17,14,5,2,5978,5952,5924,4476,1203,1126,54,38,2995,2983,259,4530,1097,0
20:08:58,10938.15,Fox,5978,90,26,28,17,12,5,2,5978,5952,5924,4476,1203,1126,52,38,2995,2983,259,4532,1097,0
20:08:58,10939.35,Fox,5978,90,26,28,16,13,5,2,5978,5952,5924,4477,1203,1126,52,38,2995,2983,259,4532,1097,0
20:08:59,10940.45,Fox,5978,88,26,28,16,11,5,2,5978,5952,5924,4477,1203,1126,52,36,2995,2983,259,4534,1097,0
20:08:59,10941.13,Fox,5980,90,28,28,16,11,5,2,5980,5952,5924,4477,1203,1126,54,36,2997,2983,259,4534,1097,0
20:08:59,10941.7,Fox,5980,89,28,28,16,10,5,2,5980,5952,5924,4477,1203,1126,54,35,2997,2983,259,4535,1097,0
20:08:59,10943.32,Fox,5980,89,26,30,15,9,7,2,5980,5954,5924,4478,1205,1126,54,35,2997,2983,259,4535,1097,0
20:09:00,10943.71,Fox,5980,89,24,32,15,9,7,2,5980,5956,5924,4478,1205,1126,54,35,2997,2983,259,4535,1097,0
20:09:00,10945.96,Fox,5980,89,24,30,17,9,7,2,5980,5956,5926,4478,1205,1126,54,35,2997,2983,259,4535,1097,0
20:09:01,10946.5,Fox,5980,89,22,32,17,9,7,2,5980,5958,5926,4478,1205,1126,54,35,2997,2983,259,4535,1097,0
20:09:01,10948.04,Fox,5982,90,22,34,16,9,7,2,5982,5960,5926,4478,1205,1126,54,36,2998,2984,259,4536,1097,0
20:09:01,10949.19,Fox,5984,91,24,34,16,8,7,2,5984,5960,5926,4478,1205,1126,54,37,2999,2985,259,4537,1097,0
20:09:02,10950.12,Fox,5986,92,24,34,16,7,7,2,5984,5960,5926,4478,1205,1126,55,37,3000,2986,259,4538,1097,0
20:09:02,10950.25,Fox,5986,92,26,34,16,7,7,2,5986,5960,5926,4478,1205,1126,55,37,3000,2986,259,4538,1097,0
20:09:02,10951.54,Fox,5986,92,22,38,16,7,7,2,5986,5964,5926,4478,1205,1126,55,37,3000,2986,259,4538,1097,0
20:09:02,10952.38,Fox,5986,92,22,36,18,7,7,2,5986,5964,5928,4478,1205,1126,55,37,3000,2986,259,4538,1097,0
20:09:03,10953.33,Fox,5988,93,24,36,17,7,7,2,5988,5964,5928,4478,1205,1126,54,39,3000,2988,259,4539,1097,0
20:09:03,10955.36,Fox,5988,93,22,38,15,9,7,2,5988,5966,5928,4480,1205,1126,54,39,3000,2988,259,4539,1097,0
20:09:04,10955.59,Fox,5988,93,22,36,17,9,7,2,5988,5966,5930,4480,1205,1126,54,39,3000,2988,259,4539,1097,0
20:09:04,10956.11,Fox,5990,94,24,36,16,9,7,2,5990,5966,5930,4480,1205,1126,54,40,3001,2989,259,4540,1097,0
20:09:05,10958.64,Fox,5990,94,24,36,14,11,7,2,5990,5966,5930,4482,1205,1126,54,40,3001,2989,259,4540,1097,0
20:09:05,10959.05,Fox,5990,94,24,36,12,13,7,2,5990,5966,5930,4484,1205,1126,54,40,3001,2989,259,4540,1097,0
20:09:05,10960.83,Fox,5992,96,24,34,12,15,7,2,5990,5966,5932,4486,1205,1126,56,40,3003,2989,259,4540,1097,0
20:09:05,10961.04,Fox,5992,96,26,34,12,15,7,2,5992,5966,5932,4486,1205,1126,56,40,3003,2989,259,4540,1097,0
20:09:06,10961.5,Fox,5994,97,28,34,11,15,7,2,5994,5966,5932,4486,1205,1126,57,40,3005,2989,259,4541,1097,0
20:09:06,10963.67,Fox,5994,97,28,34,11,15,5,4,5994,5966,5932,4486,1205,1128,57,40,3005,2989,259,4541,1097,0
20:09:07,10965.77,Fox,5994,95,28,34,11,13,5,4,5994,5966,5932,4486,1205,1128,57,38,3005,2989,259,4543,1097,0
20:09:07,10967.11,Fox,5994,95,28,32,13,13,5,4,5994,5966,5934,4486,1205,1128,57,38,3005,2989,259,4543,1097,0
20:09:08,10967.49,Fox,5994,95,28,30,15,11,7,4,5994,5966,5936,4486,1207,1128,57,38,3005,2989,259,4543,1097,0
20:09:08,10968.04,Fox,5996,97,30,30,15,11,7,4,5996,5966,5936,4486,1207,1128,58,39,3006,2990,259,4543,1097,0
20:09:08,10968.79,Fox,5996,97,30,30,15,9,9,4,5996,5966,5936,4486,1209,1128,58,39,3006,2990,259,4543,1097,0
20:09:08,10969.23,Fox,5996,95,30,30,15,7,9,4,5996,5966,5936,4486,1209,1128,57,38,3006,2990,259,4545,1097,0
20:09:08,10969.56,Fox,5996,93,30,30,15,5,9,4,5996,5966,5936,4486,1209,1128,57,36,3006,2990,259,4547,1097,0
20:09:08,10970.3,Fox,5996,93,28,32,14,6,9,4,5996,5968,5936,4487,1209,1128,57,36,3006,2990,259,4547,1097,0
20:09:09,10971.15,Fox,5996,91,28,32,14,4,9,4,5996,5968,5936,4487,1209,1128,56,35,3006,2990,259,4549,1097,0
20:09:09,10971.58,Fox,5996,91,28,28,18,4,9,4,5996,5968,5940,4487,1209,1128,56,35,3006,2990,259,4549,1097,0
20:09:09,10972.79,Fox,5996,91,28,24,22,4,9,4,5996,5968,5944,4487,1209,1128,56,35,3006,2990,259,4549,1097,0
20:09:09,10972.94,Fox,5996,91,28,22,24,4,9,4,5996,5968,5946,4487,1209,1128,56,35,3006,2990,259,4549,1097,0
20:09:09,10973.25,Fox,5996,91,28,20,26,4,9,4,5996,5968,5948,4487,1209,1128,56,35,3006,2990,259,4549,1097,0
20:09:10,10974.51,Fox,5996,91,28,16,30,4,9,4,5996,5968,5952,4487,1209,1128,56,35,3006,2990,259,4549,1097,0
20:09:11,10977.12,Fox,5996,91,28,16,29,5,9,4,5996,5968,5952,4488,1209,1128,56,35,3006,2990,259,4549,1097,0
20:09:12,10980.79,Fox,5996,90,28,16,29,4,9,4,5996,5968,5952,4488,1209,1128,56,34,3006,2990,259,4550,1097,0
20:09:12,10981.8,Fox,5996,90,28,14,31,4,9,4,5996,5968,5954,4488,1209,1128,56,34,3006,2990,259,4550,1097,0
20:09:13,10982.33,Fox,5996,90,28,12,33,4,9,4,5996,5968,5956,4488,1209,1128,56,34,3006,2990,259,4550,1097,0
20:09:13,10984.92,Fox,5996,90,28,10,35,4,9,4,5996,5968,5958,4488,1209,1128,56,34,3006,2990,259,4550,1097,0
20:09:14,10986.49,Fox,5996,90,28,8,37,4,9,4,5996,5968,5960,4488,1209,1128,56,34,3006,2990,259,4550,1097,0
20:09:14,10987.83,Fox,5996,89,28,8,37,3,9,4,5996,5968,5960,4488,1209,1128,56,33,3006,2990,259,4551,1097,0
20:09:15,10988.6,Fox,5996,88,28,8,37,3,9,3,5996,5968,5960,4488,1209,1128,56,32,3006,2990,259,4551,1098,0
20:09:15,10990.25,Fox,5996,88,28,4,39,5,9,3,5996,5968,5964,4490,1209,1128,56,32,3006,2990,259,4551,1098,0
20:09:16,10991.59,Fox,5996,88,26,6,39,5,9,3,5996,5970,5964,4490,1209,1128,56,32,3006,2990,259,4551,1098,0
20:09:16,10993.8,Fox,5998,89,28,6,38,5,9,3,5998,5970,5964,4490,1209,1128,56,33,3007,2991,259,4552,1098,0
20:09:17,10993.93,Fox,5998,88,28,4,40,5,9,2,5998,5970,5966,4490,1209,1128,56,32,3007,2991,259,4552,1099,0
20:09:17,10994.36,Fox,5998,88,28,4,38,7,9,2,5998,5970,5966,4492,1209,1128,56,32,3007,2991,259,4552,1099,0
20:09:17,10996.37,Fox,5998,87,28,4,38,7,9,1,5998,5970,5966,4492,1209,1128,55,32,3007,2991,259,4552,1100,0
20:09:18,10998.84,Fox,6000,88,30,4,37,7,9,1,6000,5970,5966,4492,1209,1128,56,32,3009,2991,259,4553,1100,0
20:09:18,10999.29,Fox,6002,89,32,4,36,7,9,1,6002,5970,5966,4492,1209,1128,55,34,3009,2993,259,4554,1100,0
20:09:19,11000.6,Fox,6002,88,32,4,36,6,9,1,6002,5970,5966,4492,1209,1128,54,34,3009,2993,259,4555,1100,0
20:09:20,11003.64,Fox,6002,88,30,6,36,6,9,1,6002,5972,5966,4492,1209,1128,54,34,3009,2993,259,4555,1100,0
20:09:20,11003.9,Fox,6002,88,28,8,36,6,9,1,6002,5974,5966,4492,1209,1128,54,34,3009,2993,259,4555,1100,0
20:09:20,11004.55,Fox,6002,88,26,10,36,6,9,1,6002,5976,5966,4492,1209,1128,54,34,3009,2993,259,4555,1100,0
20:09:20,11004.92,Fox,6002,86,26,10,36,4,9,1,6002,5976,5966,4492,1209,1128,52,34,3009,2993,259,4557,1100,0
20:09:21,11006.54,Fox,6002,86,26,10,34,6,9,1,6002,5976,5966,4494,1209,1128,52,34,3009,2993,259,4557,1100,0
20:09:21,11008.55,Fox,6002,86,26,8,36,6,9,1,6002,5976,5968,4494,1209,1128,52,34,3009,2993,259,4557,1100,0
20:09:22,11009.8,Fox,6006,88,28,8,34,6,9,1,6004,5976,5968,4494,1209,1128,53,35,3012,2994,259,4559,1100,0
20:09:22,11009.99,Fox,6006,88,30,8,34,6,9,1,6006,5976,5968,4494,1209,1128,53,35,3012,2994,259,4559,1100,0
20:09:22,11010.48,Fox,6006,88,28,10,34,6,9,1,6006,5978,5968,4494,1209,1128,53,35,3012,2994,259,4559,1100,0
20:09:23,11012.68,Fox,6006,88,28,10,34,6,8,2,6006,5978,5968,4494,1209,1129,53,35,3012,2994,259,4559,1100,0
20:09:23,11012.99,Fox,6006,88,28,10,32,8,8,2,6006,5978,5968,4496,1209,1129,53,35,3012,2994,259,4559,1100,0
20:09:23,11014.21,Fox,6008,89,30,10,31,8,8,2,6008,5978,5968,4496,1209,1129,54,35,3014,2994,259,4560,1100,0
20:09:24,11015.59,Fox,6010,90,32,10,30,8,8,2,6010,5978,5968,4496,1209,1129,53,37,3014,2996,259,4561,1100,0
20:09:24,11017.29,Fox,6012,89,34,10,29,6,8,2,6012,5978,5968,4496,1209,1129,53,36,3015,2997,259,4564,1100,0
20:09:26,11021.31,Fox,6012,89,34,10,28,7,8,2,6012,5978,5968,4497,1209,1129,53,36,3015,2997,259,4564,1100,0
20:09:27,11023.67,Fox,6012,87,32,12,28,5,8,2,6012,5980,5968,4497,1209,1129,52,35,3015,2997,259,4566,1100,0
20:09:27,11024.35,Fox,6012,86,32,12,28,5,8,1,6012,5980,5968,4497,1209,1129,51,35,3015,2997,259,4566,1101,0
20:09:27,11026.22,Fox,6014,87,34,12,27,5,8,1,6014,5980,5968,4497,1209,1129,51,36,3016,2998,259,4567,1101,0
20:09:28,11027.79,Fox,6016,88,34,12,25,6,8,1,6014,5980,5968,4498,1209,1129,50,38,3016,3000,259,4568,1101,0
20:09:28,11028.11,Fox,6016,88,36,12,25,6,6,3,6016,5980,5968,4498,1209,1131,50,38,3016,3000,259,4568,1101,0
20:09:29,11030.14,Fox,6016,88,36,10,27,6,6,3,6016,5980,5970,4498,1209,1131,50,38,3016,3000,259,4568,1101,0
20:09:29,11030.6,Fox,6016,88,34,12,27,6,6,3,6016,5982,5970,4498,1209,1131,50,38,3016,3000,259,4568,1101,0
20:09:29,11031.99,Fox,6018,88,34,14,26,5,6,3,6018,5984,5970,4498,1209,1131,49,39,3016,3002,259,4570,1101,0
20:09:29,11032.2,Fox,6018,88,34,14,22,9,6,3,6018,5984,5970,4502,1209,1131,49,39,3016,3002,259,4570,1101,0
20:09:30,11032.84,Fox,6018,88,32,16,22,9,6,3,6018,5986,5970,4502,1209,1131,49,39,3016,3002,259,4570,1101,0
20:09:30,11033.44,Fox,6018,88,32,16,18,13,6,3,6018,5986,5970,4506,1209,1131,49,39,3016,3002,259,4570,1101,0
20:09:30,11033.73,Fox,6018,88,32,16,16,15,6,3,6018,5986,5970,4508,1209,1131,49,39,3016,3002,259,4570,1101,0
20:09:30,11034.59,Fox,6020,90,34,16,16,15,6,3,6020,5986,5970,4508,1209,1131,50,40,3017,3003,259,4570,1101,0
20:09:30,11035.06,Fox,6020,90,34,16,13,18,6,3,6020,5986,5970,4511,1209,1131,50,40,3017,3003,259,4570,1101,0
20:09:31,11035.99,Fox,6022,91,34,18,13,17,6,3,6022,5988,5970,4511,1209,1131,49,42,3017,3005,259,4571,1101,0
20:09:32,11038.67,Fox,6022,91,32,20,13,17,6,3,6022,5990,5970,4511,1209,1131,49,42,3017,3005,259,4571,1101,0
20:09:33,11042.34,Fox,6022,91,32,18,14,18,6,3,6022,5990,5972,4512,1209,1131,49,42,3017,3005,259,4571,1101,0
20:09:33,11042.68,Fox,6022,89,32,16,16,16,6,3,6022,5990,5974,4512,1209,1131,48,41,3017,3005,259,4573,1101,0
20:09:33,11042.83,Fox,6022,89,32,16,14,18,6,3,6022,5990,5974,4514,1209,1131,48,41,3017,3005,259,4573,1101,0
20:09:33,11043.12,Fox,6022,89,32,14,16,18,6,3,6022,5990,5976,4514,1209,1131,48,41,3017,3005,259,4573,1101,0
20:09:33,11043.78,Fox,6022,87,30,16,16,16,6,3,6022,5992,5976,4514,1209,1131,46,41,3017,3005,259,4575,1101,0
20:09:33,11044.13,Fox,6022,85,28,18,16,14,6,3,6022,5994,5976,4514,1209,1131,44,41,3017,3005,259,4577,1101,0
20:09:33,11044.29,Fox,6022,83,28,18,16,12,6,3,6022,5994,5976,4514,1209,1131,43,40,3017,3005,259,4579,1101,0
20:09:34,11045.63,Fox,6022,80,28,18,14,11,6,3,6022,5994,5976,4516,1209,1131,42,38,3017,3005,259,4582,1101,0
20:09:34,11046.98,Fox,6022,80,28,18,13,12,6,3,6022,5994,5976,4517,1209,1131,42,38,3017,3005,259,4582,1101,0
20:09:35,11048.97,Fox,6022,80,28,16,15,12,6,3,6022,5994,5978,4517,1209,1131,42,38,3017,3005,259,4582,1101,0
20:09:36,11050.52,Fox,6022,80,28,16,11,16,6,3,6022,5994,5978,4521,1209,1131,42,38,3017,3005,259,4582,1101,0
20:09:36,11050.67,Fox,6022,80,26,18,11,16,6,3,6022,5996,5978,4521,1209,1131,42,38,3017,3005,259,4582,1101,0
20:09:36,11052.94,Fox,6022,79,26,18,11,15,6,3,6022,5996,5978,4521,1209,1131,42,37,3017,3005,259,4583,1101,0
20:09:36,11053.28,Fox,6022,77,26,18,11,13,6,3,6022,5996,5978,4521,1209,1131,41,36,3017,3005,259,4585,1101,0
20:09:37,11054.4,Fox,6022,77,26,18,9,15,6,3,6022,5996,5978,4523,1209,1131,41,36,3017,3005,259,4585,1101,0
20:09:37,11055.96,Fox,6022,75,26,18,9,13,6,3,6022,5996,5978,4523,1209,1131,39,36,3017,3005,261,4585,1101,0
20:09:38,11057.52,Fox,6022,74,26,18,9,12,6,3,6022,5996,5978,4523,1209,1131,39,35,3017,3005,261,4586,1101,0
20:09:39,11061.13,Fox,6022,70,26,18,9,8,6,3,6022,5996,5978,4523,1209,1131,38,32,3017,3005,261,4590,1101,0
20:09:39,11062.13,Fox,6022,70,26,16,11,8,6,3,6022,5996,5980,4523,1209,1131,38,32,3017,3005,261,4590,1101,0
20:09:40,11064.94,Fox,6022,68,26,16,11,6,6,3,6022,5996,5980,4523,1209,1131,37,31,3017,3005,261,4592,1101,0
20:09:42,11069.21,Fox,6022,68,26,14,11,8,6,3,6022,5996,5982,4525,1209,1131,37,31,3017,3005,261,4592,1101,0
20:09:42,11070.23,Fox,6022,68,26,12,13,8,6,3,6022,5996,5984,4525,1209,1131,37,31,3017,3005,261,4592,1101,0
20:09:43,11071.43,Fox,6022,68,26,10,15,8,6,3,6022,5996,5986,4525,1209,1131,37,31,3017,3005,261,4592,1101,0
20:09:44,11074.16,Fox,6024,70,28,10,15,8,6,3,6024,5996,5986,4525,1209,1131,38,32,3018,3006,261,4592,1101,0
20:09:44,11074.59,Fox,6024,70,28,8,17,8,6,3,6024,5996,5988,4525,1209,1131,38,32,3018,3006,261,4592,1101,0
20:09:44,11076.38,Fox,6024,70,26,10,17,8,6,3,6024,5998,5988,4525,1209,1131,38,32,3018,3006,261,4592,1101,0
20:09:45,11077.48,Fox,6026,71,28,8,18,8,6,3,6026,5998,5990,4525,1209,1131,37,34,3018,3008,261,4593,1101,0
20:09:45,11079.71,Fox,6026,69,28,8,18,6,6,3,6026,5998,5990,4525,1209,1131,35,34,3018,3008,261,4595,1101,0
20:09:46,11080.81,Fox,6026,69,28,8,18,6,4,5,6026,5998,5990,4525,1209,1133,35,34,3018,3008,261,4595,1101,0
20:09:46,11081.49,Fox,6026,69,26,10,18,6,4,5,6026,6000,5990,4525,1209,1133,35,34,3018,3008,261,4595,1101,0
20:09:46,11081.81,Fox,6026,69,24,12,18,6,4,5,6026,6002,5990,4525,1209,1133,35,34,3018,3008,261,4595,1101,0
20:09:46,11082.12,Fox,6026,69,24,10,20,6,4,5,6026,6002,5992,4525,1209,1133,35,34,3018,3008,261,4595,1101,0
20:09:46,11082.72,Fox,6026,69,24,8,22,6,4,5,6026,6002,5994,4525,1209,1133,35,34,3018,3008,261,4595,1101,0
20:09:47,11083.76,Fox,6026,69,24,8,22,5,5,5,6026,6002,5994,4525,1210,1133,35,34,3018,3008,261,4595,1101,0
20:09:49,11089.23,Fox,6026,69,24,6,24,5,5,5,6026,6002,5996,4525,1210,1133,35,34,3018,3008,261,4595,1101,0
20:09:49,11090.61,Fox,6026,69,24,6,22,7,5,5,6026,6002,5996,4527,1210,1133,35,34,3018,3008,261,4595,1101,0
20:09:50,11092.55,Fox,6026,69,20,10,22,7,5,5,6026,6006,5996,4527,1210,1133,35,34,3018,3008,261,4595,1101,0
20:09:51,11096.81,Fox,6026,69,18,12,22,7,5,5,6026,6008,5996,4527,1210,1133,35,34,3018,3008,261,4595,1101,0
20:09:52,11098.15,Fox,6026,69,16,14,22,7,5,5,6026,6010,5996,4527,1210,1133,35,34,3018,3008,261,4595,1101,0
20:09:52,11099.86,Fox,6026,69,14,16,22,7,5,5,6026,6012,5996,4527,1210,1133,35,34,3018,3008,261,4595,1101,0
20:09:53,11101.2,Fox,6026,68,14,16,22,6,5,5,6026,6012,5996,4527,1210,1133,34,34,3018,3008,261,4596,1101,0
20:09:53,11102.17,Fox,6028,70,16,16,22,6,5,5,6028,6012,5996,4527,1210,1133,36,34,3020,3008,261,4596,1101,0
20:09:53,11102.57,Fox,6030,71,18,16,21,6,5,5,6030,6012,5996,4527,1210,1133,37,34,3022,3008,261,4597,1101,0
20:09:53,11102.96,Fox,6030,71,18,16,19,8,5,5,6030,6012,5996,4529,1210,1133,37,34,3022,3008,261,4597,1101,0
20:09:53,11103.74,Fox,6030,70,18,16,17,10,5,4,6030,6012,5996,4531,1210,1133,36,34,3022,3008,261,4597,1102,0
20:09:54,11105.09,Fox,6030,70,18,16,17,10,3,6,6030,6012,5996,4531,1210,1135,36,34,3022,3008,261,4597,1102,0
20:09:54,11106.14,Fox,6032,71,20,16,16,10,3,6,6032,6012,5996,4531,1210,1135,36,35,3023,3009,261,4598,1102,0
20:09:54,11106.51,Fox,6032,71,20,16,16,10,1,8,6032,6012,5996,4531,1210,1137,36,35,3023,3009,261,4598,1102,0
20:09:55,11107.8,Fox,6034,72,22,16,15,10,1,8,6034,6012,5996,4531,1210,1137,36,36,3024,3010,261,4599,1102,0
20:09:55,11109.03,Fox,6036,74,22,18,15,10,1,8,6036,6014,5996,4531,1210,1137,37,37,3025,3011,261,4599,1102,0
20:09:55,11109.68,Fox,6036,74,22,18,13,12,1,8,6036,6014,5996,4533,1210,1137,37,37,3025,3011,261,4599,1102,0
20:09:56,11110.55,Fox,6036,74,20,20,13,12,1,8,6036,6016,5996,4533,1210,1137,37,37,3025,3011,261,4599,1102,0
20:09:56,11111.36,Fox,6038,76,22,20,13,12,1,8,6038,6016,5996,4533,1210,1137,39,37,3027,3011,261,4599,1102,0
20:09:57,11113.16,Fox,6038,75,22,20,13,11,1,8,6038,6016,5996,4533,1210,1137,38,37,3027,3011,261,4600,1102,0
20:09:57,11113.5,Fox,6038,74,22,20,13,10,1,8,6038,6016,5996,4533,1210,1137,38,36,3027,3011,261,4601,1102,0
20:09:57,11114.25,Fox,6038,72,22,20,13,8,1,8,6038,6016,5996,4533,1210,1137,38,34,3027,3011,261,4603,1102,0
20:09:57,11114.62,Fox,6038,72,20,22,13,8,1,8,6038,6018,5996,4533,1210,1137,38,34,3027,3011,261,4603,1102,0
20:09:57,11115.02,Fox,6038,72,20,20,15,8,1,8,6038,6018,5998,4533,1210,1137,38,34,3027,3011,261,4603,1102,0
20:09:58,11117.17,Fox,6038,72,18,22,15,8,1,8,6038,6020,5998,4533,1210,1137,38,34,3027,3011,261,4603,1102,0
20:09:58,11118.81,Fox,6038,71,16,24,15,8,1,7,6038,6022,5998,4533,1210,1137,38,33,3027,3011,261,4603,1103,0
20:09:59,11120.1,Fox,6040,71,16,22,17,6,1,7,6038,6022,6000,4533,1210,1137,36,35,3027,3013,261,4605,1103,0
20:09:59,11120.47,Fox,6040,71,18,20,19,6,1,7,6040,6022,6002,4533,1210,1137,36,35,3027,3013,261,4605,1103,0
20:10:00,11122.75,Fox,6040,71,18,20,17,8,1,7,6040,6022,6002,4535,1210,1137,36,35,3027,3013,261,4605,1103,0
20:10:01,11125.74,Fox,6040,71,18,20,17,6,3,7,6040,6022,6002,4535,1212,1137,36,35,3027,3013,261,4605,1103,0
20:10:02,11127.94,Fox,6042,73,20,20,17,6,3,7,6042,6022,6002,4535,1212,1137,36,37,3027,3015,261,4605,1103,0
20:10:04,11129.68,Fox,6042,73,20,20,16,7,3,7,6042,6022,6002,4536,1212,1137,36,37,3027,3015,261,4605,1103,0
20:10:04,11130.9,Fox,6042,73,20,18,17,8,3,7,6042,6022,6004,4537,1212,1137,36,37,3027,3015,261,4605,1103,0
20:10:04,11131.24,Fox,6042,72,20,16,19,8,3,6,6042,6022,6006,4537,1212,1137,35,37,3027,3015,261,4605,1104,0
20:10:04,11131.93,Fox,6042,72,20,16,17,10,3,6,6042,6022,6006,4539,1212,1137,35,37,3027,3015,261,4605,1104,0
20:10:05,11133.26,Fox,6042,70,20,16,17,8,3,6,6042,6022,6006,4539,1212,1137,33,37,3027,3015,261,4607,1104,0
20:10:06,11135.17,Fox,6042,70,20,14,17,10,3,6,6042,6022,6008,4541,1212,1137,33,37,3027,3015,261,4607,1104,0
20:10:06,11136.77,Fox,6042,69,20,12,19,10,3,5,6042,6022,6010,4541,1212,1137,33,36,3027,3015,261,4607,1105,0
20:10:06,11137.7,Fox,6042,69,20,12,17,12,3,5,6042,6022,6010,4543,1212,1137,33,36,3027,3015,261,4607,1105,0
20:10:07,11138.4,Fox,6042,69,20,10,19,12,3,5,6042,6022,6012,4543,1212,1137,33,36,3027,3015,261,4607,1105,0
20:10:07,11139.08,Fox,6042,68,20,10,19,12,3,4,6042,6022,6012,4543,1212,1137,33,35,3027,3015,261,4607,1106,0
20:10:07,11140.11,Fox,6042,67,20,10,19,11,3,4,6042,6022,6012,4543,1212,1137,33,34,3027,3015,261,4608,1106,0
20:10:08,11141.29,Fox,6042,66,20,10,19,10,3,4,6042,6022,6012,4543,1212,1137,33,33,3027,3015,261,4609,1106,0
20:10:08,11142.81,Fox,6042,64,20,10,17,10,3,4,6042,6022,6012,4545,1212,1137,32,32,3027,3015,261,4611,1106,0
20:10:08,11143.2,Fox,6042,64,20,10,15,12,3,4,6042,6022,6012,4547,1212,1137,32,32,3027,3015,261,4611,1106,0
20:10:09,11145.49,Fox,6042,62,20,10,15,10,3,4,6042,6022,6012,4547,1212,1137,32,30,3027,3015,261,4613,1106,0
20:10:10,11147.35,Fox,6042,62,20,8,17,10,3,4,6042,6022,6014,4547,1212,1137,32,30,3027,3015,261,4613,1106,0
20:10:10,11148.19,Fox,6042,60,20,8,17,8,3,4,6042,6022,6014,4547,1212,1137,31,29,3027,3015,261,4615,1106,0
20:10:10,11149.02,Fox,6042,60,20,6,19,8,3,4,6042,6022,6016,4547,1212,1137,31,29,3027,3015,261,4615,1106,0
20:10:11,11149.78,Fox,6042,60,20,6,17,10,3,4,6042,6022,6016,4549,1212,1137,31,29,3027,3015,261,4615,1106,0
20:10:12,11153.11,Fox,6042,58,20,4,19,8,3,4,6042,6022,6018,4549,1212,1137,29,29,3027,3015,261,4617,1106,0
20:10:12,11153.71,Fox,6042,56,20,4,19,6,3,4,6042,6022,6018,4549,1212,1137,27,29,3027,3015,261,4619,1106,0
20:10:13,11155.72,Fox,6042,56,20,2,21,6,3,4,6042,6022,6020,4549,1212,1137,27,29,3027,3015,261,4619,1106,0
20:10:13,11156.96,Fox,6042,55,18,4,21,6,3,3,6042,6024,6020,4549,1212,1137,26,29,3027,3015,261,4619,1107,0
20:10:13,11157.16,Fox,6042,55,18,2,23,6,3,3,6042,6024,6022,4549,1212,1137,26,29,3027,3015,261,4619,1107,0
20:10:14,11160.08,Fox,6042,55,16,4,23,6,3,3,6042,6026,6022,4549,1212,1137,26,29,3027,3015,261,4619,1107,0
20:10:14,11161.37,Fox,6042,54,16,4,23,6,3,2,6042,6026,6022,4549,1212,1137,26,28,3027,3015,261,4619,1108,0
20:10:16,11165.76,Fox,6042,53,16,4,23,6,3,1,6042,6026,6022,4549,1212,1137,25,28,3027,3015,261,4619,1109,0
20:10:16,11166.44,Fox,6044,55,18,4,23,6,3,1,6044,6026,6022,4549,1212,1137,25,30,3027,3017,261,4619,1109,0
20:10:19,11175.05,Fox,6046,56,20,4,22,6,3,1,6046,6026,6022,4549,1212,1137,25,31,3028,3018,261,4620,1109,0
20:10:19,11175.57,Fox,6048,57,22,4,19,8,3,1,6048,6026,6022,4551,1212,1137,25,32,3029,3019,261,4621,1109,0
20:10:21,11180.58,Fox,6048,57,22,4,18,9,3,1,6048,6026,6022,4552,1212,1137,25,32,3029,3019,261,4621,1109,0
20:10:21,11180.97,Fox,6048,57,22,4,16,11,3,1,6048,6026,6022,4554,1212,1137,25,32,3029,3019,261,4621,1109,0
20:10:22,11184.12,Fox,6048,57,22,4,16,10,4,1,6048,6026,6022,4554,1213,1137,25,32,3029,3019,261,4621,1109,0
20:10:22,11184.77,Fox,6048,57,20,6,16,10,4,1,6048,6028,6022,4554,1213,1137,25,32,3029,3019,261,4621,1109,0
20:10:22,11185.12,Fox,6048,57,18,8,16,10,4,1,6048,6030,6022,4554,1213,1137,25,32,3029,3019,261,4621,1109,0
20:10:23,11185.98,Fox,6048,55,18,8,16,8,4,1,6048,6030,6022,4554,1213,1137,24,31,3029,3019,261,4623,1109,0
20:10:23,11187.89,Fox,6050,56,20,8,15,8,4,1,6050,6030,6022,4554,1213,1137,24,32,3030,3020,261,4624,1109,0
20:10:24,11188.93,Fox,6050,56,18,10,15,8,4,1,6050,6032,6022,4554,1213,1137,24,32,3030,3020,261,4624,1109,0
20:10:24,11190.27,Fox,6050,56,16,12,15,8,4,1,6050,6034,6022,4554,1213,1137,24,32,3030,3020,261,4624,1109,0
20:10:25,11190.97,Fox,6050,55,16,12,15,7,4,1,6050,6034,6022,4554,1213,1137,23,32,3030,3020,261,4625,1109,0
20:10:25,11191.51,Fox,6050,53,14,14,11,9,4,1,6050,6036,6022,4558,1213,1137,23,30,3030,3020,261,4627,1109,0
20:10:26,11193.87,Fox,6050,53,12,16,11,9,4,1,6050,6038,6022,4558,1213,1137,23,30,3030,3020,261,4627,1109,0
20:10:26,11194.43,Fox,6052,54,14,16,10,9,4,1,6052,6038,6022,4558,1213,1137,23,31,3031,3021,261,4628,1109,0
20:10:26,11195.25,Fox,6054,55,16,14,11,9,4,1,6054,6038,6024,4558,1213,1137,24,31,3033,3021,261,4629,1109,0
20:10:26,11196.01,Fox,6054,55,16,14,10,10,4,1,6054,6038,6024,4559,1213,1137,24,31,3033,3021,261,4629,1109,0
20:10:27,11197.42,Fox,6054,55,16,14,8,12,4,1,6054,6038,6024,4561,1213,1137,24,31,3033,3021,261,4629,1109,0
20:10:27,11198.56,Fox,6054,55,16,12,10,12,4,1,6054,6038,6026,4561,1213,1137,24,31,3033,3021,261,4629,1109,0
20:10:27,11198.97,Fox,6054,55,16,12,9,13,4,1,6054,6038,6026,4562,1213,1137,24,31,3033,3021,261,4629,1109,0
20:10:28,11202.07,Fox,6054,52,16,12,9,10,4,1,6054,6038,6026,4562,1213,1137,22,30,3033,3021,261,4632,1109,0
20:10:29,11202.95,Fox,6054,52,14,14,9,10,4,1,6054,6040,6026,4562,1213,1137,22,30,3033,3021,261,4632,1109,0
20:10:30,11206.25,Fox,6056,52,16,14,9,9,4,0,6056,6040,6026,4562,1213,1137,21,31,3033,3023,261,4633,1110,0
20:10:30,11207.9,Fox,6056,50,16,14,8,8,4,0,6056,6040,6026,4563,1213,1137,21,29,3033,3023,261,4635,1110,0
20:10:31,11209.74,Fox,6056,49,16,14,6,9,4,0,6056,6040,6026,4565,1213,1137,21,28,3033,3023,261,4636,1110,0
20:10:31,11210.44,Fox,6056,49,14,16,6,9,4,0,6056,6042,6026,4565,1213,1137,21,28,3033,3023,261,4636,1110,0
20:10:32,11213.49,Fox,6056,49,14,16,4,11,4,0,6056,6042,6026,4567,1213,1137,21,28,3033,3023,261,4636,1110,0
20:10:33,11216.22,Fox,6056,49,14,16,3,12,4,0,6056,6042,6026,4568,1213,1137,21,28,3033,3023,261,4636,1110,0
20:10:34,11217.6,Fox,6056,49,14,16,1,14,4,0,6056,6042,6026,4570,1213,1137,21,28,3033,3023,261,4636,1110,0
20:10:34,11218.46,Fox,6056,48,14,16,1,13,4,0,6056,6042,6026,4570,1213,1137,21,27,3033,3023,261,4637,1110,0
20:10:35,11220.06,Fox,6056,46,14,16,1,11,4,0,6056,6042,6026,4570,1213,1137,21,25,3033,3023,261,4639,1110,0
20:10:35,11221.32,Fox,6056,46,14,16,1,11,3,1,6056,6042,6026,4570,1213,1138,21,25,3033,3023,261,4639,1110,0
20:10:36,11223.61,Fox,6056,46,14,12,5,11,3,1,6056,6042,6030,4570,1213,1138,21,25,3033,3023,261,4639,1110,0
20:10:36,11224.02,Fox,6056,44,14,12,5,9,3,1,6056,6042,6030,4570,1213,1138,21,23,3033,3023,261,4641,1110,0
20:10:37,11226.72,Fox,6056,43,14,12,5,8,3,1,6056,6042,6030,4570,1213,1138,21,22,3033,3023,261,4642,1110,0
20:10:37,11227.29,Fox,6056,43,14,10,7,8,3,1,6056,6042,6032,4570,1213,1138,21,22,3033,3023,261,4642,1110,0
20:10:37,11228.15,Fox,6056,41,14,10,7,6,3,1,6056,6042,6032,4570,1213,1138,21,20,3033,3023,261,4644,1110,0
20:10:37,11228.91,Fox,6056,41,14,8,9,6,3,1,6056,6042,6034,4570,1213,1138,21,20,3033,3023,261,4644,1110,0
20:10:38,11230.13,Fox,6056,41,14,6,11,6,3,1,6056,6042,6036,4570,1213,1138,21,20,3033,3023,261,4644,1110,0
20:10:39,11232.5,Fox,6056,41,14,4,13,6,3,1,6056,6042,6038,4570,1213,1138,21,20,3033,3023,261,4644,1110,0
20:10:39,11234.2,Fox,6058,43,16,4,13,6,3,1,6058,6042,6038,4570,1213,1138,22,21,3034,3024,261,4644,1110,0
20:10:40,11236.17,Fox,6060,44,18,4,12,6,3,1,6060,6042,6038,4570,1213,1138,21,23,3034,3026,261,4645,1110,0
20:10:42,11241.44,Fox,6060,44,18,2,14,6,3,1,6060,6042,6040,4570,1213,1138,21,23,3034,3026,261,4645,1110,0
20:10:42,11241.94,Fox,6062,46,20,2,14,6,3,1,6062,6042,6040,4570,1213,1138,22,24,3035,3027,261,4645,1110,0
20:10:42,11243.28,Fox,6062,46,20,2,14,4,5,1,6062,6042,6040,4570,1215,1138,22,24,3035,3027,261,4645,1110,0
20:10:44,11248.59,Fox,6064,48,22,2,14,4,5,1,6064,6042,6040,4570,1215,1138,22,26,3035,3029,261,4645,1110,0
20:10:44,11249.16,Fox,6064,48,20,2,16,4,5,1,6064,6044,6042,4570,1215,1138,22,26,3035,3029,261,4645,1110,0
20:10:45,11251.45,Fox,6064,47,20,2,16,4,5,0,6064,6044,6042,4570,1215,1138,21,26,3035,3029,261,4645,1111,0
20:10:46,11255.64,Fox,6064,47,20,2,15,5,5,0,6064,6044,6042,4571,1215,1138,21,26,3035,3029,261,4645,1111,0
20:10:47,11257.56,Fox,6064,47,18,4,15,5,5,0,6064,6046,6042,4571,1215,1138,21,26,3035,3029,261,4645,1111,0
20:10:47,11258.07,Fox,6064,47,16,6,15,5,5,0,6064,6048,6042,4571,1215,1138,21,26,3035,3029,261,4645,1111,0
20:10:48,11258.93,Fox,6064,47,16,6,13,7,5,0,6064,6048,6042,4573,1215,1138,21,26,3035,3029,261,4645,1111,0
20:10:49,11263.22,Fox,6064,47,16,6,13,7,3,2,6064,6048,6042,4573,1215,1140,21,26,3035,3029,261,4645,1111,0
20:10:50,11265.78,Fox,6066,48,18,6,12,7,3,2,6066,6048,6042,4573,1215,1140,21,27,3036,3030,261,4646,1111,0
20:10:50,11266.28,Fox,6066,47,18,6,12,6,3,2,6066,6048,6042,4573,1215,1140,21,26,3036,3030,261,4647,1111,0
20:10:51,11269.63,Fox,6066,45,18,6,12,4,3,2,6066,6048,6042,4573,1215,1140,21,24,3036,3030,261,4649,1111,0
20:10:51,11270.52,Fox,6066,45,16,8,12,4,3,2,6066,6050,6042,4573,1215,1140,21,24,3036,3030,261,4649,1111,0
20:10:53,11274.28,Fox,6068,46,18,8,11,4,3,2,6068,6050,6042,4573,1215,1140,21,25,3037,3031,261,4650,1111,0
20:10:54,11276.9,Fox,6068,46,16,10,11,4,3,2,6068,6052,6042,4573,1215,1140,21,25,3037,3031,261,4650,1111,0
20:10:54,11277.74,Fox,6068,46,14,12,11,4,3,2,6068,6054,6042,4573,1215,1140,21,25,3037,3031,261,4650,1111,0
20:10:54,11278.67,Fox,6070,48,16,12,11,4,3,2,6070,6054,6042,4573,1215,1140,22,26,3038,3032,261,4650,1111,0
20:10:56,11283.69,Fox,6070,48,16,12,9,6,3,2,6070,6054,6042,4575,1215,1140,22,26,3038,3032,261,4650,1111,0
20:10:56,11284.2,Fox,6070,48,16,12,8,7,3,2,6070,6054,6042,4576,1215,1140,22,26,3038,3032,261,4650,1111,0
20:10:56,11284.83,Fox,6070,48,16,12,8,6,4,2,6070,6054,6042,4576,1216,1140,22,26,3038,3032,261,4650,1111,0
20:10:57,11287.42,Fox,6070,48,16,10,10,6,4,2,6070,6054,6044,4576,1216,1140,22,26,3038,3032,261,4650,1111,0
20:10:57,11287.76,Fox,6070,48,16,10,8,8,4,2,6070,6054,6044,4578,1216,1140,22,26,3038,3032,261,4650,1111,0
20:10:58,11288.83,Fox,6070,48,14,12,8,8,4,2,6070,6056,6044,4578,1216,1140,22,26,3038,3032,261,4650,1111,0
20:10:58,11289.4,Fox,6070,48,14,12,6,10,4,2,6070,6056,6044,4580,1216,1140,22,26,3038,3032,261,4650,1111,0
20:10:58,11290.58,Fox,6070,48,14,12,4,12,4,2,6070,6056,6044,4582,1216,1140,22,26,3038,3032,261,4650,1111,0
20:10:59,11292.95,Fox,6070,48,14,12,3,13,4,2,6070,6056,6044,4583,1216,1140,22,26,3038,3032,261,4650,1111,0
20:11:00,11294.59,Fox,6070,47,14,12,3,12,4,2,6070,6056,6044,4583,1216,1140,21,26,3038,3032,261,4651,1111,0
20:11:00,11296.04,Fox,6070,47,14,10,5,12,4,2,6070,6056,6046,4583,1216,1140,21,26,3038,3032,261,4651,1111,0
20:11:00,11296.54,Fox,6070,47,14,8,7,12,4,2,6070,6056,6048,4583,1216,1140,21,26,3038,3032,261,4651,1111,0
20:11:01,11298.24,Fox,6070,45,14,8,7,10,4,2,6070,6056,6048,4583,1216,1140,20,25,3038,3032,261,4653,1111,0
20:11:01,11299.8,Fox,6070,44,14,8,7,9,4,2,6070,6056,6048,4583,1216,1140,19,25,3038,3032,261,4654,1111,0
20:11:02,11301.11,Fox,6070,42,14,8,7,7,4,2,6070,6056,6048,4583,1216,1140,18,24,3038,3032,261,4656,1111,0
20:11:02,11301.97,Fox,6070,42,14,8,5,9,4,2,6070,6056,6048,4585,1216,1140,18,24,3038,3032,261,4656,1111,0
20:11:03,11303.46,Fox,6070,41,14,8,5,8,4,2,6070,6056,6048,4585,1216,1140,17,24,3038,3032,261,4657,1111,0
20:11:04,11308.94,Fox,6070,41,14,6,7,8,4,2,6070,6056,6050,4585,1216,1140,17,24,3038,3032,261,4657,1111,0
20:11:05,11309.52,Fox,6070,41,14,6,5,10,4,2,6070,6056,6050,4587,1216,1140,17,24,3038,3032,261,4657,1111,0
20:11:07,11315.43,Fox,6070,41,14,4,7,10,4,2,6070,6056,6052,4587,1216,1140,17,24,3038,3032,261,4657,1111,0
20:11:07,11316.21,Fox,6070,41,14,2,9,10,4,2,6070,6056,6054,4587,1216,1140,17,24,3038,3032,261,4657,1111,0
20:11:07,11316.78,Fox,6070,41,12,4,9,10,4,2,6070,6058,6054,4587,1216,1140,17,24,3038,3032,261,4657,1111,0
20:11:08,11318.74,Fox,6070,41,10,6,9,10,4,2,6070,6060,6054,4587,1216,1140,17,24,3038,3032,261,4657,1111,0
20:11:08,11319.33,Fox,6074,45,12,6,9,10,4,2,6072,6060,6054,4587,1216,1140,19,26,3040,3034,261,4657,1111,0
20:11:08,11319.53,Fox,6074,45,14,6,9,10,4,2,6074,6060,6054,4587,1216,1140,19,26,3040,3034,261,4657,1111,0
20:11:09,11321.63,Fox,6074,45,14,6,9,10,3,3,6074,6060,6054,4587,1216,1141,19,26,3040,3034,261,4657,1111,0
20:11:09,11323.79,Fox,6074,44,14,6,9,10,3,2,6074,6060,6054,4587,1216,1141,18,26,3040,3034,261,4657,1112,0
20:11:10,11324.57,Fox,6074,44,12,8,9,10,3,2,6074,6062,6054,4587,1216,1141,18,26,3040,3034,261,4657,1112,0
20:11:11,11327.4,Fox,6074,44,12,6,11,10,3,2,6074,6062,6056,4587,1216,1141,18,26,3040,3034,261,4657,1112,0
20:11:12,11331.07,Fox,6074,44,10,8,11,10,3,2,6074,6064,6056,4587,1216,1141,18,26,3040,3034,261,4657,1112,0
20:11:13,11333.88,Fox,6074,43,10,8,11,10,3,1,6074,6064,6056,4587,1216,1141,17,26,3040,3034,261,4657,1113,0
20:11:13,11334.92,Fox,6076,44,12,8,10,10,3,1,6076,6064,6056,4587,1216,1141,17,27,3041,3035,261,4658,1113,0
20:11:16,11344.35,Fox,6078,45,14,8,9,10,3,1,6078,6064,6056,4587,1216,1141,16,29,3041,3037,261,4659,1113,0
20:11:17,11347.06,Fox,6080,47,16,8,9,10,3,1,6080,6064,6056,4587,1216,1141,17,30,3042,3038,261,4659,1113,0
20:11:18,11348.05,Fox,6080,47,16,8,7,12,3,1,6080,6064,6056,4589,1216,1141,17,30,3042,3038,261,4659,1113,0
20:11:18,11348.4,Fox,6080,47,14,10,7,12,3,1,6080,6066,6056,4589,1216,1141,17,30,3042,3038,261,4659,1113,0
20:11:18,11349.3,Fox,6082,49,16,10,7,12,3,1,6082,6066,6056,4589,1216,1141,19,30,3044,3038,261,4659,1113,0
20:11:20,11355.18,Fox,6082,49,16,8,9,12,3,1,6082,6066,6058,4589,1216,1141,19,30,3044,3038,261,4659,1113,0
20:11:20,11355.96,Fox,6082,48,16,8,9,11,3,1,6082,6066,6058,4589,1216,1141,19,29,3044,3038,261,4660,1113,0
20:11:21,11356.71,Fox,6082,48,14,10,8,12,3,1,6082,6068,6058,4590,1216,1141,19,29,3044,3038,261,4660,1113,0
20:11:21,11357.29,Fox,6084,49,14,8,7,14,3,1,6082,6068,6060,4592,1216,1141,20,29,3046,3038,261,4661,1113,0
20:11:21,11357.49,Fox,6084,49,16,8,7,14,3,1,6084,6068,6060,4592,1216,1141,20,29,3046,3038,261,4661,1113,0
20:11:21,11358.67,Fox,6086,51,18,8,7,14,3,1,6086,6068,6060,4592,1216,1141,21,30,3047,3039,261,4661,1113,0
20:11:22,11361.33,Fox,6086,51,16,10,7,14,3,1,6086,6070,6060,4592,1216,1141,21,30,3047,3039,261,4661,1113,0
20:11:23,11363.03,Fox,6086,51,16,8,9,14,3,1,6086,6070,6062,4592,1216,1141,21,30,3047,3039,261,4661,1113,0
20:11:24,11367.06,Fox,6086,50,16,8,9,13,3,1,6086,6070,6062,4592,1216,1141,21,29,3047,3039,261,4662,1113,0
20:11:25,11369.59,Fox,6086,50,16,6,10,14,3,1,6086,6070,6064,4593,1216,1141,21,29,3047,3039,261,4662,1113,0
20:11:26,11372.18,Fox,6086,49,16,6,10,14,3,0,6086,6070,6064,4593,1216,1141,21,28,3047,3039,261,4662,1114,0
20:11:27,11375.98,Fox,6086,49,16,6,8,16,3,0,6086,6070,6064,4595,1216,1141,21,28,3047,3039,261,4662,1114,0
20:11:27,11376.75,Fox,6086,49,16,6,7,17,3,0,6086,6070,6064,4596,1216,1141,21,28,3047,3039,261,4662,1114,0
20:11:27,11377.31,Fox,6086,49,16,6,7,15,5,0,6086,6070,6064,4596,1218,1141,21,28,3047,3039,261,4662,1114,0
20:11:28,11379.32,Fox,6088,50,18,6,7,14,5,0,6088,6070,6064,4596,1218,1141,21,29,3048,3040,261,4663,1114,0
20:11:28,11380.02,Fox,6088,49,18,6,7,13,5,0,6088,6070,6064,4596,1218,1141,21,28,3048,3040,261,4664,1114,0
20:11:29,11380.75,Fox,6088,49,18,6,7,13,3,2,6088,6070,6064,4596,1218,1143,21,28,3048,3040,261,4664,1114,0
20:11:29,11382.88,Fox,6088,49,18,6,7,12,4,2,6088,6070,6064,4596,1219,1143,21,28,3048,3040,261,4664,1114,0
20:11:31,11386.94,Fox,6088,49,18,4,9,12,4,2,6088,6070,6066,4596,1219,1143,21,28,3048,3040,261,4664,1114,0
20:11:31,11387.78,Fox,6088,49,18,4,7,14,4,2,6088,6070,6066,4598,1219,1143,21,28,3048,3040,261,4664,1114,0
20:11:32,11390.91,Fox,6088,47,18,4,7,14,4,0,6088,6070,6066,4598,1219,1143,20,27,3048,3040,261,4664,1116,0
20:11:33,11395.28,Fox,6088,47,18,2,9,13,5,0,6088,6070,6068,4598,1220,1143,20,27,3048,3040,261,4664,1116,0
20:11:35,11399.23,Fox,6090,49,20,2,9,13,5,0,6090,6070,6068,4598,1220,1143,21,28,3049,3041,261,4664,1116,0
20:11:35,11399.82,Fox,6090,49,20,0,11,13,5,0,6090,6070,6070,4598,1220,1143,21,28,3049,3041,261,4664,1116,0
20:11:36,11402.03,Fox,6092,51,16,4,11,13,5,0,6090,6074,6070,4598,1220,1143,23,28,3051,3041,261,4664,1116,0
20:11:36,11402.25,Fox,6092,51,18,4,11,13,5,0,6092,6074,6070,4598,1220,1143,23,28,3051,3041,261,4664,1116,0
20:11:36,11403.02,Fox,6092,51,18,4,11,11,7,0,6092,6074,6070,4598,1222,1143,23,28,3051,3041,261,4664,1116,0
20:11:40,11415.82,Fox,6092,51,18,4,9,13,7,0,6092,6074,6070,4600,1222,1143,23,28,3051,3041,261,4664,1116,0
20:11:41,11417.77,Fox,6092,51,16,6,7,15,7,0,6092,6076,6070,4602,1222,1143,23,28,3051,3041,261,4664,1116,0
20:11:43,11422.37,Fox,6092,51,16,6,7,15,6,1,6092,6076,6070,4602,1222,1144,23,28,3051,3041,261,4664,1116,0
20:11:43,11423.48,Fox,6092,51,16,6,5,17,6,1,6092,6076,6070,4604,1222,1144,23,28,3051,3041,261,4664,1116,0
20:11:44,11427,Fox,6092,51,14,8,5,17,6,1,6092,6078,6070,4604,1222,1144,23,28,3051,3041,261,4664,1116,0
20:11:45,11428.77,Fox,6094,53,16,8,5,17,6,1,6094,6078,6070,4604,1222,1144,24,29,3052,3042,261,4664,1116,0
20:11:45,11429.66,Fox,6094,53,14,10,5,17,6,1,6094,6080,6070,4604,1222,1144,24,29,3052,3042,261,4664,1116,0
20:11:45,11430.28,Fox,6094,53,14,10,3,19,6,1,6094,6080,6070,4606,1222,1144,24,29,3052,3042,261,4664,1116,0
20:11:46,11431.94,Fox,6094,53,12,12,3,19,6,1,6094,6082,6070,4606,1222,1144,24,29,3052,3042,261,4664,1116,0
20:11:49,11439.99,Fox,6094,53,10,14,3,19,6,1,6094,6084,6070,4606,1222,1144,24,29,3052,3042,261,4664,1116,0
20:11:49,11440.54,Fox,6094,53,10,10,7,19,6,1,6094,6084,6074,4606,1222,1144,24,29,3052,3042,261,4664,1116,0
20:11:49,11441.44,Fox,6094,53,8,12,7,17,8,1,6094,6086,6074,4606,1224,1144,24,29,3052,3042,261,4664,1116,0
20:11:49,11442.38,Fox,6096,55,10,12,7,17,8,1,6096,6086,6074,4606,1224,1144,25,30,3053,3043,261,4664,1116,0
20:11:51,11447.35,Fox,6096,54,10,12,5,18,8,1,6096,6086,6074,4608,1224,1144,25,29,3053,3043,261,4665,1116,0
20:11:52,11450.62,Fox,6096,54,10,12,5,16,10,1,6096,6086,6074,4608,1226,1144,25,29,3053,3043,261,4665,1116,0
20:11:53,11453.24,Fox,6098,56,12,12,5,16,10,1,6098,6086,6074,4608,1226,1144,26,30,3054,3044,261,4665,1116,0
20:11:54,11455.62,Fox,6100,57,14,12,4,16,10,1,6100,6086,6074,4608,1226,1144,26,31,3055,3045,262,4665,1116,0
20:11:54,11455.97,Fox,6100,57,14,10,5,17,10,1,6100,6086,6076,4609,1226,1144,26,31,3055,3045,262,4665,1116,0
20:11:55,11457.82,Fox,6100,55,14,10,5,15,10,1,6100,6086,6076,4609,1226,1144,25,30,3055,3045,262,4667,1116,0
20:11:55,11460.35,Fox,6100,55,14,10,3,17,10,1,6100,6086,6076,4611,1226,1144,25,30,3055,3045,262,4667,1116,0
20:11:56,11461.87,Fox,6100,55,12,12,3,17,10,1,6100,6088,6076,4611,1226,1144,25,30,3055,3045,262,4667,1116,0
20:11:57,11465.38,Fox,6100,55,12,10,5,17,10,1,6100,6088,6078,4611,1226,1144,25,30,3055,3045,262,4667,1116,0
20:11:57,11466.29,Fox,6100,54,12,10,5,16,10,1,6100,6088,6078,4611,1226,1144,25,29,3055,3045,262,4668,1116,0
20:11:58,11468.17,Fox,6100,54,12,8,7,16,10,1,6100,6088,6080,4611,1226,1144,25,29,3055,3045,262,4668,1116,0
20:11:58,11469.44,Fox,6100,54,12,8,7,15,11,1,6100,6088,6080,4611,1227,1144,25,29,3055,3045,262,4668,1116,0
20:11:59,11470.62,Fox,6100,54,12,6,9,15,11,1,6100,6088,6082,4611,1227,1144,25,29,3055,3045,262,4668,1116,0
20:11:59,11471.17,Fox,6102,56,14,6,9,15,11,1,6102,6088,6082,4611,1227,1144,26,30,3056,3046,262,4668,1116,0
20:12:00,11473.35,Fox,6104,58,16,6,9,15,11,1,6104,6088,6082,4611,1227,1144,27,31,3057,3047,262,4668,1116,0
20:12:00,11475.47,Fox,6106,60,18,6,9,15,11,1,6106,6088,6082,4611,1227,1144,29,31,3059,3047,262,4668,1116,0
20:12:01,11478.49,Fox,6106,60,18,4,11,15,11,1,6106,6088,6084,4611,1227,1144,29,31,3059,3047,262,4668,1116,0
20:12:02,11479.12,Fox,6108,61,20,4,10,15,11,1,6108,6088,6084,4611,1227,1144,30,31,3061,3047,262,4669,1116,0
20:12:02,11479.63,Fox,6108,61,20,2,12,15,11,1,6108,6088,6086,4611,1227,1144,30,31,3061,3047,262,4669,1116,0
20:12:02,11481.37,Fox,6108,61,20,2,12,13,13,1,6108,6088,6086,4611,1229,1144,30,31,3061,3047,262,4669,1116,0
20:12:03,11481.68,Fox,6108,61,18,4,12,13,13,1,6108,6090,6086,4611,1229,1144,30,31,3061,3047,262,4669,1116,0
20:12:04,11484.76,Fox,6108,61,16,6,12,13,13,1,6108,6092,6086,4611,1229,1144,30,31,3061,3047,262,4669,1116,0
20:12:09,11500.44,Fox,6108,61,16,4,14,13,13,1,6108,6092,6088,4611,1229,1144,30,31,3061,3047,262,4669,1116,0
20:12:09,11501.06,Fox,6108,61,16,4,11,16,13,1,6108,6092,6088,4614,1229,1144,30,31,3061,3047,262,4669,1116,0
20:12:10,11503.35,Fox,6110,62,18,4,11,16,13,0,6110,6092,6088,4614,1229,1144,30,32,3062,3048,262,4669,1117,0
20:12:10,11504.64,Fox,6112,63,20,4,10,16,13,0,6112,6092,6088,4614,1229,1144,29,34,3062,3050,262,4670,1117,0
20:12:12,11509.25,Fox,6112,63,20,4,10,14,15,0,6112,6092,6088,4614,1231,1144,29,34,3062,3050,262,4670,1117,0
20:12:13,11511.39,Fox,6112,62,18,6,10,11,17,0,6112,6094,6088,4614,1233,1144,29,33,3062,3050,262,4671,1117,0
20:12:14,11514.7,Fox,6112,62,18,6,10,11,15,2,6112,6094,6088,4614,1233,1146,29,33,3062,3050,262,4671,1117,0
20:12:14,11515.47,Fox,6114,63,20,6,9,11,15,2,6114,6094,6088,4614,1233,1146,30,33,3064,3050,262,4672,1117,0
20:12:14,11516.61,Fox,6114,63,20,6,7,13,15,2,6114,6094,6088,4616,1233,1146,30,33,3064,3050,262,4672,1117,0
20:12:15,11517.05,Fox,6114,63,20,6,7,11,17,2,6114,6094,6088,4616,1235,1146,30,33,3064,3050,262,4672,1117,0
20:12:15,11518.67,Fox,6116,65,22,6,7,11,17,2,6116,6094,6088,4616,1235,1146,32,33,3066,3050,262,4672,1117,0
20:12:16,11520.52,Fox,6116,65,22,4,9,11,16,3,6116,6094,6090,4616,1235,1147,32,33,3066,3050,262,4672,1117,0
20:12:17,11523.33,Fox,6116,65,22,2,11,11,16,3,6116,6094,6092,4616,1235,1147,32,33,3066,3050,262,4672,1117,0
20:12:17,11523.79,Fox,6116,65,22,2,11,9,18,3,6116,6094,6092,4616,1237,1147,32,33,3066,3050,262,4672,1117,0
20:12:17,11525.02,Fox,6116,65,20,4,11,9,18,3,6116,6096,6092,4616,1237,1147,32,33,3066,3050,262,4672,1117,0
20:12:17,11525.9,Fox,6116,65,20,4,9,11,18,3,6116,6096,6092,4618,1237,1147,32,33,3066,3050,262,4672,1117,0
20:12:18,11527.1,Fox,6116,63,20,4,9,9,18,3,6116,6096,6092,4618,1237,1147,31,32,3066,3050,262,4674,1117,0
20:12:18,11528.62,Fox,6116,63,20,4,8,10,18,3,6116,6096,6092,4619,1237,1147,31,32,3066,3050,262,4674,1117,0
20:12:19,11529.94,Fox,6118,65,22,4,8,10,18,3,6118,6096,6092,4619,1237,1147,33,32,3068,3050,262,4674,1117,0
20:12:19,11530.91,Fox,6118,65,22,4,6,12,18,3,6118,6096,6092,4621,1237,1147,33,32,3068,3050,262,4674,1117,0
20:12:20,11532.81,Fox,6118,65,22,4,6,12,17,4,6118,6096,6092,4621,1237,1148,33,32,3068,3050,262,4674,1117,0
20:12:21,11535.86,Fox,6118,65,20,6,6,12,17,4,6118,6098,6092,4621,1237,1148,33,32,3068,3050,262,4674,1117,0
20:12:21,11536.36,Fox,6118,64,20,6,6,11,17,4,6118,6098,6092,4621,1237,1148,33,31,3068,3050,263,4674,1117,0
20:12:22,11538.16,Fox,6118,64,18,8,6,11,17,4,6118,6100,6092,4621,1237,1148,33,31,3068,3050,263,4674,1117,0
20:12:22,11539.12,Fox,6118,63,18,8,5,11,17,4,6118,6100,6092,4622,1237,1148,33,30,3068,3050,263,4675,1117,0
20:12:22,11539.87,Fox,6120,65,20,8,5,11,17,4,6120,6100,6092,4622,1237,1148,33,32,3068,3052,263,4675,1117,0
20:12:23,11540.62,Fox,6120,65,20,8,3,13,15,6,6120,6100,6092,4624,1237,1150,33,32,3068,3052,263,4675,1117,0
20:12:23,11541.51,Fox,6120,63,20,8,3,11,15,6,6120,6100,6092,4624,1237,1150,31,32,3068,3052,263,4677,1117,0
20:12:25,11547.74,Fox,6122,64,22,8,3,10,15,6,6122,6100,6092,4624,1237,1150,30,34,3068,3054,264,4677,1117,0
20:12:26,11549.98,Fox,6122,64,22,6,5,10,15,6,6122,6100,6094,4624,1237,1150,30,34,3068,3054,264,4677,1117,0
20:12:26,11550.63,Fox,6124,66,24,6,5,10,15,6,6124,6100,6094,4624,1237,1150,31,35,3069,3055,264,4677,1117,0
20:12:27,11553.8,Fox,6124,66,22,8,5,8,17,6,6124,6102,6094,4624,1239,1150,31,35,3069,3055,264,4677,1117,0
20:12:27,11555.19,Fox,6124,65,22,8,5,8,17,5,6124,6102,6094,4624,1239,1150,30,35,3069,3055,264,4677,1118,0
20:12:28,11555.82,Fox,6126,67,24,8,5,8,17,5,6126,6102,6094,4624,1239,1150,30,37,3069,3057,264,4677,1118,0
20:12:28,11556.04,Fox,6126,67,22,10,5,8,17,5,6126,6104,6094,4624,1239,1150,30,37,3069,3057,264,4677,1118,0
20:12:28,11558.09,Fox,6126,67,20,12,5,8,17,5,6126,6106,6094,4624,1239,1150,30,37,3069,3057,264,4677,1118,0
20:12:29,11560.85,Fox,6126,67,20,12,3,10,17,5,6126,6106,6094,4626,1239,1150,30,37,3069,3057,264,4677,1118,0
20:12:30,11561.78,Fox,6126,67,18,14,3,10,17,5,6126,6108,6094,4626,1239,1150,30,37,3069,3057,264,4677,1118,0
20:12:30,11563.41,Fox,6126,67,18,12,5,10,17,5,6126,6108,6096,4626,1239,1150,30,37,3069,3057,264,4677,1118,0
20:12:33,11571.36,Fox,6126,65,18,12,5,8,17,5,6126,6108,6096,4626,1239,1150,29,36,3069,3057,264,4679,1118,0
20:12:34,11574.28,Fox,6126,65,18,10,7,8,17,5,6126,6108,6098,4626,1239,1150,29,36,3069,3057,264,4679,1118,0
20:12:34,11575.45,Fox,6126,64,18,10,7,8,17,4,6126,6108,6098,4626,1239,1150,28,36,3069,3057,264,4679,1119,0
20:12:35,11576.6,Fox,6126,64,18,8,9,8,17,4,6126,6108,6100,4626,1239,1150,28,36,3069,3057,264,4679,1119,0
20:12:36,11579.11,Fox,6126,64,18,8,9,8,15,6,6126,6108,6100,4626,1239,1152,28,36,3069,3057,264,4679,1119,0
20:12:36,11580.85,Fox,6126,62,18,8,7,10,15,4,6126,6108,6100,4628,1239,1152,28,34,3069,3057,264,4679,1121,0
20:12:37,11583.77,Fox,6126,62,18,8,5,12,15,4,6126,6108,6100,4630,1239,1152,28,34,3069,3057,264,4679,1121,0
20:12:38,11584.92,Fox,6128,63,20,8,4,12,15,4,6128,6108,6100,4630,1239,1152,28,35,3070,3058,265,4679,1121,0
20:12:38,11586.04,Fox,6128,63,18,10,4,12,15,4,6128,6110,6100,4630,1239,1152,28,35,3070,3058,265,4679,1121,0
20:12:38,11587.23,Fox,6128,63,16,12,4,12,15,4,6128,6112,6100,4630,1239,1152,28,35,3070,3058,265,4679,1121,0
20:12:39,11588.19,Fox,6128,63,16,12,4,12,13,6,6128,6112,6100,4630,1239,1154,28,35,3070,3058,265,4679,1121,0
20:12:40,11592.21,Fox,6128,63,16,10,6,12,13,6,6128,6112,6102,4630,1239,1154,28,35,3070,3058,265,4679,1121,0
20:12:41,11594.49,Fox,6128,61,16,8,8,10,13,6,6128,6112,6104,4630,1239,1154,26,35,3070,3058,267,4679,1121,0
20:12:41,11594.66,Fox,6128,61,16,8,8,8,15,6,6128,6112,6104,4630,1241,1154,26,35,3070,3058,267,4679,1121,0
20:12:41,11596.64,Fox,6128,61,16,6,10,8,15,6,6128,6112,6106,4630,1241,1154,26,35,3070,3058,267,4679,1121,0
20:12:42,11597.65,Fox,6130,63,18,6,10,8,15,6,6130,6112,6106,4630,1241,1154,27,36,3071,3059,267,4679,1121,0
20:12:42,11598,Fox,6130,63,16,8,10,8,15,6,6130,6114,6106,4630,1241,1154,27,36,3071,3059,267,4679,1121,0
20:12:42,11599.35,Fox,6130,62,16,8,10,8,15,5,6130,6114,6106,4630,1241,1154,27,35,3071,3059,267,4679,1122,0
20:12:43,11600.12,Fox,6130,62,16,6,12,8,15,5,6130,6114,6108,4630,1241,1154,27,35,3071,3059,267,4679,1122,0
20:12:43,11601.35,Fox,6130,61,14,8,12,8,15,4,6130,6116,6108,4630,1241,1154,27,34,3071,3059,267,4679,1123,0
20:12:43,11602.28,Fox,6132,63,16,8,12,8,15,4,6132,6116,6108,4630,1241,1154,27,36,3071,3061,267,4679,1123,0
20:12:45,11607.02,Fox,6132,63,16,8,12,8,14,5,6132,6116,6108,4630,1241,1155,27,36,3071,3061,267,4679,1123,0
20:12:46,11610.3,Fox,6132,63,16,8,11,9,14,5,6132,6116,6108,4631,1241,1155,27,36,3071,3061,267,4679,1123,0
20:12:46,11610.85,Fox,6134,64,18,8,10,9,14,5,6134,6116,6108,4631,1241,1155,27,37,3072,3062,267,4680,1123,0
20:12:47,11612.47,Fox,6134,64,16,10,10,9,14,5,6134,6118,6108,4631,1241,1155,27,37,3072,3062,267,4680,1123,0
20:12:49,11618.88,Fox,6134,64,16,10,10,9,12,7,6134,6118,6108,4631,1241,1157,27,37,3072,3062,267,4680,1123,0
20:12:49,11619.45,Fox,6134,64,16,10,10,8,13,7,6134,6118,6108,4631,1242,1157,27,37,3072,3062,267,4680,1123,0
20:12:49,11619.97,Fox,6136,66,18,10,10,8,13,7,6136,6118,6108,4631,1242,1157,28,38,3073,3063,267,4680,1123,0
20:12:50,11622.7,Fox,6138,68,18,12,10,8,13,7,6138,6120,6108,4631,1242,1157,30,38,3075,3063,267,4680,1123,0
20:12:51,11624.05,Fox,6138,68,18,12,9,9,13,7,6138,6120,6108,4632,1242,1157,30,38,3075,3063,267,4680,1123,0
20:12:51,11624.73,Fox,6140,70,18,10,11,9,13,7,6138,6120,6110,4632,1242,1157,32,38,3077,3063,267,4680,1123,0
20:12:51,11624.91,Fox,6140,70,20,10,11,9,13,7,6140,6120,6110,4632,1242,1157,32,38,3077,3063,267,4680,1123,0
20:12:51,11625.85,Fox,6140,70,20,8,13,9,13,7,6140,6120,6112,4632,1242,1157,32,38,3077,3063,267,4680,1123,0
20:12:52,11627.51,Fox,6142,72,22,8,13,9,13,7,6142,6120,6112,4632,1242,1157,34,38,3079,3063,267,4680,1123,0
20:12:53,11630.24,Fox,6144,74,22,10,13,9,13,7,6144,6122,6112,4632,1242,1157,35,39,3080,3064,267,4680,1123,0
20:12:54,11633.1,Fox,6144,74,20,12,13,9,13,7,6144,6124,6112,4632,1242,1157,35,39,3080,3064,267,4680,1123,0
20:12:54,11633.66,Fox,6144,73,20,12,13,7,15,6,6144,6124,6112,4632,1244,1157,35,38,3080,3064,267,4680,1124,0
20:12:54,11634.55,Fox,6144,72,20,12,13,6,15,6,6144,6124,6112,4632,1244,1157,35,37,3080,3064,267,4681,1124,0
20:12:54,11635.07,Fox,6144,72,20,12,11,8,15,6,6144,6124,6112,4634,1244,1157,35,37,3080,3064,267,4681,1124,0
20:12:55,11636.55,Fox,6144,72,20,10,13,8,15,6,6144,6124,6114,4634,1244,1157,35,37,3080,3064,267,4681,1124,0
20:12:55,11637.33,Fox,6144,72,20,10,11,10,15,6,6144,6124,6114,4636,1244,1157,35,37,3080,3064,267,4681,1124,0
20:12:56,11638.46,Fox,6144,70,18,12,11,10,15,4,6144,6126,6114,4636,1244,1157,34,36,3080,3064,267,4681,1126,0
20:12:56,11639.22,Fox,6146,72,20,12,11,10,15,4,6146,6126,6114,4636,1244,1157,36,36,3082,3064,267,4681,1126,0
20:12:56,11639.81,Fox,6146,72,20,10,13,10,15,4,6146,6126,6116,4636,1244,1157,36,36,3082,3064,267,4681,1126,0
20:12:58,11646.81,Fox,6146,72,20,10,13,10,13,6,6146,6126,6116,4636,1244,1159,36,36,3082,3064,267,4681,1126,0
20:12:59,11648.85,Fox,6146,72,20,10,13,10,11,8,6146,6126,6116,4636,1244,1161,36,36,3082,3064,267,4681,1126,0
20:13:00,11651.06,Fox,6146,72,20,8,15,10,11,8,6146,6126,6118,4636,1244,1161,36,36,3082,3064,267,4681,1126,0
20:13:00,11652.12,Fox,6146,71,20,8,15,10,10,8,6146,6126,6118,4636,1244,1161,35,36,3082,3064,267,4682,1126,0
20:13:00,11652.74,Fox,6146,71,20,8,13,12,10,8,6146,6126,6118,4638,1244,1161,35,36,3082,3064,267,4682,1126,0
20:13:01,11654.43,Fox,6146,71,20,8,13,12,8,10,6146,6126,6118,4638,1244,1163,35,36,3082,3064,267,4682,1126,0
20:13:01,11655.01,Fox,6146,71,20,8,11,14,8,10,6146,6126,6118,4640,1244,1163,35,36,3082,3064,267,4682,1126,0
20:13:01,11655.67,Fox,6148,73,22,8,11,14,8,10,6148,6126,6118,4640,1244,1163,36,37,3083,3065,267,4682,1126,0
20:13:02,11657.04,Fox,6148,73,22,8,9,16,8,10,6148,6126,6118,4642,1244,1163,36,37,3083,3065,267,4682,1126,0
20:13:03,11659.95,Fox,6148,72,22,8,9,16,8,9,6148,6126,6118,4642,1244,1163,36,36,3083,3065,267,4682,1127,0
20:13:03,11660.93,Fox,6150,74,22,6,9,18,8,9,6148,6126,6120,4644,1244,1163,38,36,3085,3065,267,4682,1127,0
20:13:03,11661.14,Fox,6150,74,24,6,9,18,6,11,6150,6126,6120,4644,1244,1165,38,36,3085,3065,267,4682,1127,0
20:13:05,11665.82,Fox,6152,76,26,6,9,18,6,11,6152,6126,6120,4644,1244,1165,40,36,3087,3065,267,4682,1127,0
20:13:05,11667.51,Fox,6152,76,24,8,9,18,6,11,6152,6128,6120,4644,1244,1165,40,36,3087,3065,267,4682,1127,0
20:13:06,11668.78,Fox,6152,76,24,6,11,18,6,11,6152,6128,6122,4644,1244,1165,40,36,3087,3065,267,4682,1127,0
20:13:06,11669.12,Fox,6152,75,24,6,11,18,6,10,6152,6128,6122,4644,1244,1165,40,35,3087,3065,267,4682,1128,0
20:13:07,11671.68,Fox,6152,75,24,4,13,18,6,10,6152,6128,6124,4644,1244,1165,40,35,3087,3065,267,4682,1128,0
20:13:08,11674.28,Fox,6152,75,24,4,13,16,8,10,6152,6128,6124,4644,1246,1165,40,35,3087,3065,267,4682,1128,0
20:13:08,11676.86,Fox,6152,75,24,2,15,16,8,10,6152,6128,6126,4644,1246,1165,40,35,3087,3065,267,4682,1128,0
20:13:09,11677.44,Fox,6152,74,24,2,15,16,8,9,6152,6128,6126,4644,1246,1165,39,35,3087,3065,267,4682,1129,0
20:13:09,11679.07,Fox,6154,76,26,2,15,16,8,9,6154,6128,6126,4644,1246,1165,40,36,3088,3066,267,4682,1129,0
20:13:10,11680.13,Fox,6154,76,24,4,15,16,8,9,6154,6130,6126,4644,1246,1165,40,36,3088,3066,267,4682,1129,0
20:13:10,11682.46,Fox,6156,77,26,4,14,16,8,9,6156,6130,6126,4644,1246,1165,40,37,3089,3067,267,4683,1129,0
20:13:11,11684.92,Fox,6156,76,24,6,12,18,8,8,6156,6132,6126,4646,1246,1165,39,37,3089,3067,267,4683,1130,0
20:13:12,11686.25,Fox,6156,76,24,6,10,20,8,8,6156,6132,6126,4648,1246,1165,39,37,3089,3067,267,4683,1130,0
20:13:13,11689.04,Fox,6158,78,26,6,10,20,8,8,6158,6132,6126,4648,1246,1165,40,38,3090,3068,267,4683,1130,0
20:13:13,11691.36,Fox,6158,78,26,6,10,20,7,9,6158,6132,6126,4648,1246,1166,40,38,3090,3068,267,4683,1130,0
20:13:14,11693.39,Fox,6158,78,24,8,10,20,7,9,6158,6134,6126,4648,1246,1166,40,38,3090,3068,267,4683,1130,0
20:13:15,11696.69,Fox,6158,76,24,8,10,18,7,9,6158,6134,6126,4648,1246,1166,40,36,3090,3068,267,4685,1130,0
20:13:15,11697.28,Fox,6158,75,24,8,9,19,7,8,6158,6134,6126,4649,1246,1166,40,35,3090,3068,267,4685,1131,0
20:13:16,11698.38,Fox,6162,78,26,8,9,18,7,8,6160,6134,6126,4649,1246,1166,43,35,3094,3068,267,4686,1131,0
20:13:16,11698.68,Fox,6162,78,28,8,9,18,7,8,6162,6134,6126,4649,1246,1166,43,35,3094,3068,267,4686,1131,0
20:13:16,11699.88,Fox,6162,77,28,8,9,18,7,7,6162,6134,6126,4649,1246,1166,43,34,3094,3068,267,4686,1132,0
20:13:17,11700.57,Fox,6164,79,30,8,7,20,7,7,6164,6134,6126,4651,1246,1166,43,36,3094,3070,267,4686,1132,0
20:13:17,11701.41,Fox,6166,80,32,8,7,19,7,7,6166,6134,6126,4651,1246,1166,44,36,3096,3070,267,4687,1132,0
20:13:17,11701.8,Fox,6168,82,34,8,7,19,7,7,6168,6134,6126,4651,1246,1166,45,37,3097,3071,267,4687,1132,0
20:13:17,11702.64,Fox,6170,84,34,10,7,19,7,7,6170,6136,6126,4651,1246,1166,46,38,3098,3072,267,4687,1132,0
20:13:18,11703.86,Fox,6170,84,34,10,7,18,8,7,6170,6136,6126,4651,1247,1166,46,38,3098,3072,267,4687,1132,0
20:13:18,11705.37,Fox,6170,84,32,12,7,18,8,7,6170,6138,6126,4651,1247,1166,46,38,3098,3072,267,4687,1132,0
20:13:18,11706,Fox,6170,84,32,10,9,18,8,7,6170,6138,6128,4651,1247,1166,46,38,3098,3072,267,4687,1132,0
20:13:19,11707.5,Fox,6170,84,30,12,9,18,8,7,6170,6140,6128,4651,1247,1166,46,38,3098,3072,267,4687,1132,0
20:13:19,11708.72,Fox,6172,85,32,12,9,17,8,7,6172,6140,6128,4651,1247,1166,46,39,3099,3073,267,4688,1132,0
20:13:20,11710.12,Fox,6172,85,30,14,9,17,8,7,6172,6142,6128,4651,1247,1166,46,39,3099,3073,267,4688,1132,0
20:13:20,11711.57,Fox,6172,85,30,14,7,19,8,7,6172,6142,6128,4653,1247,1166,46,39,3099,3073,267,4688,1132,0
20:13:21,11712.75,Fox,6172,85,28,16,7,19,8,7,6172,6144,6128,4653,1247,1166,46,39,3099,3073,267,4688,1132,0
20:13:23,11718.81,Fox,6172,85,28,14,9,19,8,7,6172,6144,6130,4653,1247,1166,46,39,3099,3073,267,4688,1132,0
20:13:23,11719.96,Fox,6172,84,28,14,9,19,8,6,6172,6144,6130,4653,1247,1166,46,38,3099,3073,267,4688,1133,0
20:13:24,11720.59,Fox,6174,86,30,14,9,19,8,6,6174,6144,6130,4653,1247,1166,46,40,3099,3075,267,4688,1133,0
20:13:24,11721.2,Fox,6176,88,32,14,9,19,8,6,6176,6144,6130,4653,1247,1166,47,41,3100,3076,267,4688,1133,0
20:13:24,11721.63,Fox,6176,86,32,14,7,21,8,4,6176,6144,6130,4655,1247,1166,47,39,3100,3076,267,4688,1135,0
20:13:24,11721.83,Fox,6176,86,30,16,7,21,8,4,6176,6146,6130,4655,1247,1166,47,39,3100,3076,267,4688,1135,0
20:13:24,11723.42,Fox,6176,86,30,14,9,21,8,4,6176,6146,6132,4655,1247,1166,47,39,3100,3076,267,4688,1135,0
20:13:26,11728.43,Fox,6176,86,30,14,9,19,10,4,6176,6146,6132,4655,1249,1166,47,39,3100,3076,267,4688,1135,0
20:13:26,11729.35,Fox,6176,86,30,14,7,21,10,4,6176,6146,6132,4657,1249,1166,47,39,3100,3076,267,4688,1135,0
20:13:27,11730.37,Fox,6176,85,30,14,7,21,9,4,6176,6146,6132,4657,1249,1166,46,39,3100,3076,267,4689,1135,0
20:13:27,11730.84,Fox,6176,85,30,14,7,19,11,4,6176,6146,6132,4657,1251,1166,46,39,3100,3076,267,4689,1135,0
20:13:27,11732.25,Fox,6176,83,30,12,7,19,9,6,6176,6146,6134,4659,1251,1168,46,37,3100,3076,267,4691,1135,0
20:13:29,11737.37,Fox,6176,83,30,12,5,21,9,6,6176,6146,6134,4661,1251,1168,46,37,3100,3076,267,4691,1135,0
20:13:29,11738.21,Fox,6176,83,28,14,5,21,9,6,6176,6148,6134,4661,1251,1168,46,37,3100,3076,267,4691,1135,0
20:13:30,11740.41,Fox,6178,85,30,14,5,21,9,6,6178,6148,6134,4661,1251,1168,47,38,3101,3077,267,4691,1135,0
20:13:30,11741.03,Fox,6178,85,30,12,7,21,9,6,6178,6148,6136,4661,1251,1168,47,38,3101,3077,267,4691,1135,0
20:13:31,11741.89,Fox,6178,84,30,12,7,21,9,5,6178,6148,6136,4661,1251,1168,47,37,3101,3077,267,4691,1136,0
20:13:31,11742.98,Fox,6180,85,32,12,7,20,9,5,6180,6148,6136,4661,1251,1168,48,37,3102,3078,267,4692,1136,0
20:13:31,11743.85,Fox,6180,85,30,12,9,20,9,5,6180,6150,6138,4661,1251,1168,48,37,3102,3078,267,4692,1136,0
20:13:32,11746.31,Fox,6180,85,30,10,11,18,11,5,6180,6150,6140,4661,1253,1168,48,37,3102,3078,267,4692,1136,0
20:13:33,11747.9,Fox,6180,82,30,10,11,16,11,4,6180,6150,6140,4661,1253,1168,47,35,3102,3078,267,4694,1137,0
20:13:33,11748.72,Fox,6180,82,28,10,13,14,13,4,6180,6152,6142,4661,1255,1168,47,35,3102,3078,267,4694,1137,0
20:13:34,11750.66,Fox,6180,82,28,10,13,12,15,4,6180,6152,6142,4661,1257,1168,47,35,3102,3078,267,4694,1137,0
20:13:34,11751.25,Fox,6180,82,28,8,15,12,15,4,6180,6152,6144,4661,1257,1168,47,35,3102,3078,267,4694,1137,0
20:13:35,11753.77,Fox,6182,84,30,8,15,12,15,4,6182,6152,6144,4661,1257,1168,49,35,3104,3078,267,4694,1137,0
20:13:35,11754.21,Fox,6182,84,30,8,15,10,17,4,6182,6152,6144,4661,1259,1168,49,35,3104,3078,267,4694,1137,0
20:13:36,11757.04,Fox,6182,84,30,8,15,10,16,5,6182,6152,6144,4661,1259,1169,49,35,3104,3078,267,4694,1137,0
20:13:37,11760.29,Fox,6182,84,30,6,17,10,16,5,6182,6152,6146,4661,1259,1169,49,35,3104,3078,267,4694,1137,0
20:13:37,11761.69,Fox,6182,84,28,8,17,10,16,5,6182,6154,6146,4661,1259,1169,49,35,3104,3078,267,4694,1137,0
20:13:38,11765.08,Fox,6182,84,26,10,17,10,16,5,6182,6156,6146,4661,1259,1169,49,35,3104,3078,267,4694,1137,0
20:13:39,11766.56,Fox,6182,84,26,10,15,12,16,5,6182,6156,6146,4663,1259,1169,49,35,3104,3078,267,4694,1137,0
20:13:40,11769.4,Fox,6184,86,28,10,15,12,16,5,6184,6156,6146,4663,1259,1169,49,37,3104,3080,267,4694,1137,0
20:13:40,11769.9,Fox,6186,87,30,10,15,11,16,5,6186,6156,6146,4663,1259,1169,49,38,3105,3081,267,4695,1137,0
20:13:41,11771.33,Fox,6186,87,30,10,15,11,14,7,6186,6156,6146,4663,1259,1171,49,38,3105,3081,267,4695,1137,0
20:13:41,11771.83,Fox,6186,87,28,12,15,11,14,7,6186,6158,6146,4663,1259,1171,49,38,3105,3081,267,4695,1137,0
20:13:42,11775.67,Fox,6186,86,28,12,15,11,14,6,6186,6158,6146,4663,1259,1171,49,37,3105,3081,267,4695,1138,0
20:13:42,11777.11,Fox,6186,85,28,10,17,10,14,6,6186,6158,6148,4663,1259,1171,49,36,3105,3081,267,4696,1138,0
20:13:43,11778.35,Fox,6186,85,28,10,17,8,16,6,6186,6158,6148,4663,1261,1171,49,36,3105,3081,267,4696,1138,0
20:13:43,11779.04,Fox,6192,91,30,10,17,8,16,6,6188,6158,6148,4663,1261,1171,51,40,3107,3085,267,4696,1138,0
20:13:43,11779.34,Fox,6192,91,34,10,15,10,16,6,6192,6158,6148,4665,1261,1171,51,40,3107,3085,267,4696,1138,0
20:13:44,11781.27,Fox,6192,91,30,14,15,10,16,6,6192,6162,6148,4665,1261,1171,51,40,3107,3085,267,4696,1138,0
20:13:44,11782.31,Fox,6194,93,32,12,17,10,16,6,6194,6162,6150,4665,1261,1171,52,41,3108,3086,267,4696,1138,0
20:13:45,11783.33,Fox,6194,93,30,14,17,10,16,6,6194,6164,6150,4665,1261,1171,52,41,3108,3086,267,4696,1138,0
20:13:45,11784.04,Fox,6194,93,28,16,15,12,16,6,6194,6166,6150,4667,1261,1171,52,41,3108,3086,267,4696,1138,0
20:13:45,11784.5,Fox,6194,93,26,18,15,12,16,6,6194,6168,6150,4667,1261,1171,52,41,3108,3086,267,4696,1138,0
20:13:45,11785.17,Fox,6194,93,24,20,15,12,16,6,6194,6170,6150,4667,1261,1171,52,41,3108,3086,267,4696,1138,0
20:13:46,11787.07,Fox,6196,94,24,18,16,12,16,6,6194,6170,6152,4667,1261,1171,52,42,3109,3087,267,4697,1138,0
20:13:46,11787.29,Fox,6196,94,26,18,16,12,16,6,6196,6170,6152,4667,1261,1171,52,42,3109,3087,267,4697,1138,0
20:13:47,11790.68,Fox,6196,93,26,18,16,12,16,5,6196,6170,6152,4667,1261,1171,52,41,3109,3087,267,4697,1139,0
20:13:47,11791.45,Fox,6196,93,24,20,16,12,16,5,6196,6172,6152,4667,1261,1171,52,41,3109,3087,267,4697,1139,0
20:13:48,11792.57,Fox,6196,93,24,20,14,14,16,5,6196,6172,6152,4669,1261,1171,52,41,3109,3087,267,4697,1139,0
20:13:48,11794.28,Fox,6196,92,24,20,14,13,16,5,6196,6172,6152,4669,1261,1171,52,40,3109,3087,268,4697,1139,0
20:13:49,11795.71,Fox,6198,94,26,20,14,13,16,5,6198,6172,6152,4669,1261,1171,54,40,3111,3087,268,4697,1139,0
20:13:50,11800.24,Fox,6198,94,26,18,16,13,16,5,6198,6172,6154,4669,1261,1171,54,40,3111,3087,268,4697,1139,0
20:13:51,11801.54,Fox,6198,94,26,18,14,15,16,5,6198,6172,6154,4671,1261,1171,54,40,3111,3087,268,4697,1139,0
20:13:51,11803.39,Fox,6198,92,24,20,14,14,16,4,6198,6174,6154,4671,1261,1171,53,39,3111,3087,268,4698,1140,0
20:13:52,11803.93,Fox,6198,92,22,20,16,14,16,4,6198,6176,6156,4671,1261,1171,53,39,3111,3087,268,4698,1140,0
20:13:52,11804.49,Fox,6198,92,22,20,14,16,16,4,6198,6176,6156,4673,1261,1171,53,39,3111,3087,268,4698,1140,0
20:13:52,11805.02,Fox,6198,92,22,20,14,14,18,4,6198,6176,6156,4673,1263,1171,53,39,3111,3087,268,4698,1140,0
20:13:52,11806.7,Fox,6198,92,22,20,12,16,18,4,6198,6176,6156,4675,1263,1171,53,39,3111,3087,268,4698,1140,0
20:13:53,11807.88,Fox,6198,91,22,20,12,16,18,3,6198,6176,6156,4675,1263,1171,53,38,3111,3087,268,4698,1141,0
20:13:53,11809.37,Fox,6198,91,22,20,10,18,18,3,6198,6176,6156,4677,1263,1171,53,38,3111,3087,268,4698,1141,0
20:13:54,11810.27,Fox,6198,91,22,18,12,18,18,3,6198,6176,6158,4677,1263,1171,53,38,3111,3087,268,4698,1141,0
20:13:54,11812.05,Fox,6198,91,22,18,11,19,17,4,6198,6176,6158,4678,1263,1172,53,38,3111,3087,268,4698,1141,0
20:13:56,11817.1,Fox,6198,89,22,18,11,17,17,4,6198,6176,6158,4678,1263,1172,51,38,3111,3087,268,4700,1141,0
20:13:57,11819.69,Fox,6198,87,22,14,15,15,17,4,6198,6176,6162,4678,1263,1172,49,38,3111,3087,268,4702,1141,0
20:13:57,11820.84,Fox,6198,87,22,14,13,17,17,4,6198,6176,6162,4680,1263,1172,49,38,3111,3087,268,4702,1141,0
20:13:58,11821.71,Fox,6198,87,22,12,15,17,17,4,6198,6176,6164,4680,1263,1172,49,38,3111,3087,268,4702,1141,0
20:13:58,11822.62,Fox,6198,86,22,10,17,16,17,4,6198,6176,6166,4680,1263,1172,49,37,3111,3087,268,4703,1141,0
20:13:58,11823.21,Fox,6198,86,20,10,19,14,19,4,6198,6178,6168,4680,1265,1172,49,37,3111,3087,268,4703,1141,0
20:13:58,11823.77,Fox,6200,87,20,8,21,14,19,3,6198,6178,6170,4680,1265,1172,50,37,3113,3087,268,4703,1142,0
20:13:59,11824.07,Fox,6200,87,22,8,21,14,19,3,6200,6178,6170,4680,1265,1172,50,37,3113,3087,268,4703,1142,0
20:13:59,11825.83,Fox,6200,87,20,10,21,13,20,3,6200,6180,6170,4680,1266,1172,50,37,3113,3087,268,4703,1142,0
20:14:01,11829.4,Fox,6202,89,22,10,21,13,20,3,6202,6180,6170,4680,1266,1172,52,37,3115,3087,268,4703,1142,0
20:14:01,11830,Fox,6202,89,22,8,23,13,20,3,6202,6180,6172,4680,1266,1172,52,37,3115,3087,268,4703,1142,0
20:14:01,11831.48,Fox,6202,88,22,8,23,12,20,3,6202,6180,6172,4680,1266,1172,51,37,3115,3087,268,4704,1142,0
20:14:02,11832.38,Fox,6202,86,22,8,23,12,20,1,6202,6180,6172,4680,1266,1172,50,36,3115,3087,268,4704,1144,0
20:14:04,11836.58,Fox,6202,86,20,10,23,12,20,1,6202,6182,6172,4680,1266,1172,50,36,3115,3087,268,4704,1144,0
20:14:04,11837.48,Fox,6202,86,20,10,21,14,20,1,6202,6182,6172,4682,1266,1172,50,36,3115,3087,268,4704,1144,0
20:14:05,11839.58,Fox,6204,87,22,10,20,14,20,1,6204,6182,6172,4682,1266,1172,49,38,3115,3089,268,4705,1144,0
20:14:06,11841.68,Fox,6206,89,24,10,20,14,19,2,6206,6182,6172,4682,1266,1173,50,39,3116,3090,268,4705,1144,0
20:14:06,11841.98,Fox,6206,89,24,8,22,14,19,2,6206,6182,6174,4682,1266,1173,50,39,3116,3090,268,4705,1144,0
20:14:07,11842.88,Fox,6206,89,24,6,22,16,19,2,6206,6182,6176,4684,1266,1173,50,39,3116,3090,268,4705,1144,0
20:14:08,11847.55,Fox,6206,89,24,6,20,18,19,2,6206,6182,6176,4686,1266,1173,50,39,3116,3090,268,4705,1144,0
20:14:09,11848.73,Fox,6210,93,26,6,20,18,19,2,6208,6182,6176,4686,1266,1173,50,43,3116,3094,268,4705,1144,0
20:14:09,11849.03,Fox,6210,93,28,6,20,18,19,2,6210,6182,6176,4686,1266,1173,50,43,3116,3094,268,4705,1144,0
20:14:10,11852,Fox,6210,93,26,8,20,18,19,2,6210,6184,6176,4686,1266,1173,50,43,3116,3094,268,4705,1144,0
20:14:10,11852.6,Fox,6210,92,24,10,20,18,19,1,6210,6186,6176,4686,1266,1173,50,42,3116,3094,268,4705,1145,0
20:14:10,11853.2,Fox,6210,90,24,10,20,16,19,1,6210,6186,6176,4686,1266,1173,48,42,3116,3094,268,4707,1145,0
20:14:11,11855.3,Fox,6214,94,28,10,20,16,19,1,6214,6186,6176,4686,1266,1173,50,44,3118,3096,268,4707,1145,0
20:14:12,11856.2,Fox,6216,96,30,10,20,16,19,1,6216,6186,6176,4686,1266,1173,51,45,3119,3097,268,4707,1145,0
20:14:12,11857.98,Fox,6216,94,30,10,20,14,19,1,6216,6186,6176,4686,1266,1173,49,45,3119,3097,268,4709,1145,0
20:14:13,11860.68,Fox,6218,96,32,10,19,15,19,1,6218,6186,6176,4687,1266,1173,50,46,3120,3098,268,4709,1145,0
20:14:14,11861.88,Fox,6218,96,26,14,21,15,19,1,6218,6192,6178,4687,1266,1173,50,46,3120,3098,268,4709,1145,0
20:14:14,11862.78,Fox,6220,98,28,14,21,15,19,1,6220,6192,6178,4687,1266,1173,50,48,3120,3100,268,4709,1145,0
20:14:14,11863.97,Fox,6222,99,30,14,20,15,19,1,6222,6192,6178,4687,1266,1173,51,48,3122,3100,268,4710,1145,0
20:14:14,11864.28,Fox,6222,99,30,12,20,17,19,1,6222,6192,6180,4689,1266,1173,51,48,3122,3100,268,4710,1145,0
20:14:15,11864.88,Fox,6222,99,28,14,20,17,19,1,6222,6194,6180,4689,1266,1173,51,48,3122,3100,268,4710,1145,0
20:14:15,11866.38,Fox,6224,101,30,14,20,17,17,3,6224,6194,6180,4689,1266,1175,52,49,3123,3101,268,4710,1145,0
20:14:16,11867.88,Fox,6224,100,30,14,20,16,17,3,6224,6194,6180,4689,1266,1175,52,48,3123,3101,268,4711,1145,0
20:14:16,11868.47,Fox,6224,100,30,14,20,16,15,5,6224,6194,6180,4689,1266,1177,52,48,3123,3101,268,4711,1145,0
20:14:17,11869.97,Fox,6224,100,28,16,20,16,15,5,6224,6196,6180,4689,1266,1177,52,48,3123,3101,268,4711,1145,0
20:14:17,11871.17,Fox,6224,99,28,16,18,17,15,5,6224,6196,6180,4691,1266,1177,52,47,3123,3101,268,4712,1145,0
20:14:18,11872.97,Fox,6224,99,28,16,18,15,17,5,6224,6196,6180,4691,1268,1177,52,47,3123,3101,268,4712,1145,0
20:14:18,11874.47,Fox,6224,98,28,16,18,14,17,5,6224,6196,6180,4691,1268,1177,51,47,3123,3101,268,4713,1145,0
20:14:19,11875.08,Fox,6224,98,28,14,20,14,17,5,6224,6196,6182,4691,1268,1177,51,47,3123,3101,268,4713,1145,0
20:14:19,11876.88,Fox,6226,100,30,14,20,14,17,5,6226,6196,6182,4691,1268,1177,53,47,3125,3101,268,4713,1145,0
20:14:20,11877.47,Fox,6226,100,30,14,20,13,18,5,6226,6196,6182,4691,1269,1177,53,47,3125,3101,268,4713,1145,0
20:14:20,11878.38,Fox,6226,100,28,16,20,13,18,5,6226,6198,6182,4691,1269,1177,53,47,3125,3101,268,4713,1145,0
20:14:21,11879.58,Fox,6228,102,30,16,20,13,18,5,6228,6198,6182,4691,1269,1177,55,47,3127,3101,268,4713,1145,0
20:14:21,11880.47,Fox,6228,102,30,16,16,17,18,5,6228,6198,6182,4695,1269,1177,55,47,3127,3101,268,4713,1145,0
20:14:21,11881.38,Fox,6230,102,32,16,16,15,18,5,6230,6198,6182,4695,1269,1177,56,46,3129,3101,269,4714,1145,0
20:14:22,11882.28,Fox,6230,102,32,16,14,17,18,5,6230,6198,6182,4697,1269,1177,56,46,3129,3101,269,4714,1145,0
20:14:22,11883.47,Fox,6230,102,32,16,11,20,18,5,6230,6198,6182,4700,1269,1177,56,46,3129,3101,269,4714,1145,0
20:14:22,11883.78,Fox,6230,102,32,16,11,20,16,7,6230,6198,6182,4700,1269,1179,56,46,3129,3101,269,4714,1145,0
20:14:22,11884.38,Fox,6230,102,32,16,9,22,16,7,6230,6198,6182,4702,1269,1179,56,46,3129,3101,269,4714,1145,0
20:14:23,11886.17,Fox,6230,102,32,16,9,21,15,9,6230,6198,6182,4702,1270,1181,56,46,3129,3101,269,4714,1145,0
20:14:24,11888.28,Fox,6230,102,32,16,9,21,13,11,6230,6198,6182,4702,1270,1183,56,46,3129,3101,269,4714,1145,0
20:14:25,11890.67,Fox,6230,100,32,14,9,21,13,11,6230,6198,6184,4704,1270,1183,54,46,3129,3101,269,4716,1145,0
20:14:25,11890.97,Fox,6230,100,32,12,11,21,13,11,6230,6198,6186,4704,1270,1183,54,46,3129,3101,269,4716,1145,0
20:14:26,11891.88,Fox,6230,100,32,12,11,21,11,13,6230,6198,6186,4704,1270,1185,54,46,3129,3101,269,4716,1145,0
20:14:26,11892.78,Fox,6230,98,32,12,11,19,11,13,6230,6198,6186,4704,1270,1185,54,44,3129,3101,269,4718,1145,0
20:14:26,11893.67,Fox,6230,96,32,12,11,17,11,13,6230,6198,6186,4704,1270,1185,52,44,3129,3101,271,4718,1145,0
20:14:27,11895.17,Fox,6230,96,32,12,11,15,13,13,6230,6198,6186,4704,1272,1185,52,44,3129,3101,271,4718,1145,0
20:14:27,11896.67,Fox,6230,95,32,12,11,15,13,12,6230,6198,6186,4704,1272,1185,51,44,3129,3101,271,4718,1146,0
20:14:28,11897.88,Fox,6232,97,34,12,11,13,15,12,6232,6198,6186,4704,1274,1185,53,44,3131,3101,271,4718,1146,0
20:14:28,11899.08,Fox,6232,96,34,12,11,13,15,11,6232,6198,6186,4704,1274,1185,53,43,3131,3101,271,4718,1147,0
20:14:29,11900.58,Fox,6232,96,34,6,17,13,15,11,6232,6198,6192,4704,1274,1185,53,43,3131,3101,271,4718,1147,0
20:14:30,11902.38,Fox,6232,96,34,6,15,15,15,11,6232,6198,6192,4706,1274,1185,53,43,3131,3101,271,4718,1147,0
20:14:30,11902.97,Fox,6232,96,34,6,13,17,15,11,6232,6198,6192,4708,1274,1185,53,43,3131,3101,271,4718,1147,0
20:14:30,11903.58,Fox,6232,96,34,4,15,17,15,11,6232,6198,6194,4708,1274,1185,53,43,3131,3101,271,4718,1147,0
20:14:31,11905.67,Fox,6234,98,36,4,15,17,15,11,6234,6198,6194,4708,1274,1185,53,45,3131,3103,271,4718,1147,0
20:14:31,11906.58,Fox,6234,98,34,6,15,17,15,11,6234,6200,6194,4708,1274,1185,53,45,3131,3103,271,4718,1147,0
20:14:32,11908.38,Fox,6234,98,34,4,17,17,15,11,6234,6200,6196,4708,1274,1185,53,45,3131,3103,271,4718,1147,0
20:14:34,11911.97,Fox,6234,98,32,6,17,17,15,11,6234,6202,6196,4708,1274,1185,53,45,3131,3103,271,4718,1147,0
20:14:35,11914.38,Fox,6234,97,32,6,17,16,16,10,6234,6202,6196,4708,1275,1185,52,45,3131,3103,271,4718,1148,0
20:14:36,11916.47,Fox,6236,99,34,6,17,16,14,12,6236,6202,6196,4708,1275,1187,53,46,3132,3104,271,4718,1148,0
20:14:36,11916.78,Fox,6236,98,34,4,19,16,14,11,6236,6202,6198,4708,1275,1187,52,46,3132,3104,271,4718,1149,0
20:14:38,11922.47,Fox,6238,100,34,6,17,18,14,11,6238,6204,6198,4710,1275,1187,54,46,3134,3104,271,4718,1149,0
20:14:39,11924.58,Fox,6238,100,32,8,15,20,14,11,6238,6206,6198,4712,1275,1187,54,46,3134,3104,271,4718,1149,0
20:14:40,11927.88,Fox,6240,102,34,8,15,20,14,11,6240,6206,6198,4712,1275,1187,54,48,3134,3106,271,4718,1149,0
20:14:41,11928.47,Fox,6242,104,36,8,15,20,14,11,6242,6206,6198,4712,1275,1187,55,49,3135,3107,271,4718,1149,0
20:14:41,11929.08,Fox,6242,103,36,8,15,20,14,10,6242,6206,6198,4712,1275,1187,54,49,3135,3107,271,4718,1150,0
20:14:42,11930.88,Fox,6242,103,36,8,15,19,15,10,6242,6206,6198,4712,1276,1187,54,49,3135,3107,271,4718,1150,0
20:14:42,11931.78,Fox,6242,103,32,12,15,19,15,10,6242,6210,6198,4712,1276,1187,54,49,3135,3107,271,4718,1150,0
20:14:42,11932.67,Fox,6242,102,32,12,15,18,15,10,6242,6210,6198,4712,1276,1187,54,48,3135,3107,271,4719,1150,0
20:14:44,11935.38,Fox,6242,102,32,12,13,20,15,10,6242,6210,6198,4714,1276,1187,54,48,3135,3107,271,4719,1150,0
20:14:45,11938.08,Fox,6242,102,28,16,13,20,15,10,6242,6214,6198,4714,1276,1187,54,48,3135,3107,271,4719,1150,0
20:14:45,11938.97,Fox,6242,102,26,18,13,20,15,10,6242,6216,6198,4714,1276,1187,54,48,3135,3107,271,4719,1150,0
20:14:47,11942.58,Fox,6242,102,26,18,13,20,13,12,6242,6216,6198,4714,1276,1189,54,48,3135,3107,271,4719,1150,0
20:14:47,11943.47,Fox,6242,102,24,20,13,20,13,12,6242,6218,6198,4714,1276,1189,54,48,3135,3107,271,4719,1150,0
20:14:48,11944.97,Fox,6246,104,26,20,11,20,13,12,6244,6218,6198,4714,1276,1189,55,49,3138,3108,271,4721,1150,0
20:14:48,11945.58,Fox,6248,105,28,20,12,20,13,12,6248,6220,6200,4714,1276,1189,56,49,3140,3108,271,4722,1150,0
20:14:49,11946.78,Fox,6248,104,26,22,12,20,13,11,6248,6222,6200,4714,1276,1189,56,48,3140,3108,271,4722,1151,0
20:14:49,11948.58,Fox,6250,106,28,22,12,20,13,11,6250,6222,6200,4714,1276,1189,56,50,3140,3110,271,4722,1151,0
20:14:50,11949.17,Fox,6252,108,26,24,12,20,13,11,6250,6224,6200,4714,1276,1189,58,50,3142,3110,271,4722,1151,0
20:14:50,11949.47,Fox,6252,108,28,24,12,20,13,11,6252,6224,6200,4714,1276,1189,58,50,3142,3110,271,4722,1151,0
20:14:51,11950.97,Fox,6252,108,28,22,12,22,13,11,6252,6224,6202,4716,1276,1189,58,50,3142,3110,271,4722,1151,0
20:14:51,11951.58,Fox,6252,108,28,22,10,24,13,11,6252,6224,6202,4718,1276,1189,58,50,3142,3110,271,4722,1151,0
20:14:51,11952.78,Fox,6252,107,28,22,10,24,13,10,6252,6224,6202,4718,1276,1189,57,50,3142,3110,271,4722,1152,0
20:14:54,11956.97,Fox,6256,111,32,22,10,24,13,10,6256,6224,6202,4718,1276,1189,57,54,3142,3114,271,4722,1152,0
20:14:54,11957.58,Fox,6258,112,34,22,10,23,14,9,6258,6224,6202,4718,1277,1189,59,53,3144,3114,271,4722,1153,0
20:14:54,11958.47,Fox,6260,114,36,22,10,23,14,9,6260,6224,6202,4718,1277,1189,61,53,3146,3114,271,4722,1153,0
20:14:55,11959.38,Fox,6260,114,34,24,10,23,14,9,6260,6226,6202,4718,1277,1189,61,53,3146,3114,271,4722,1153,0
20:14:55,11960.28,Fox,6260,113,34,24,10,23,12,10,6260,6226,6202,4718,1277,1191,60,53,3146,3114,271,4722,1154,0
20:14:55,11960.88,Fox,6260,113,34,22,8,27,12,10,6260,6226,6204,4722,1277,1191,60,53,3146,3114,271,4722,1154,0
20:14:56,11962.08,Fox,6260,111,32,24,8,25,12,10,6260,6228,6204,4722,1277,1191,59,52,3146,3114,271,4724,1154,0
20:14:56,11963.28,Fox,6260,110,32,22,10,25,11,10,6260,6228,6206,4722,1277,1192,58,52,3146,3114,271,4724,1155,0
20:14:57,11963.88,Fox,6260,110,30,24,9,26,11,10,6260,6230,6206,4723,1277,1192,58,52,3146,3114,271,4724,1155,0
20:14:57,11965.38,Fox,6260,109,30,24,9,26,11,9,6260,6230,6206,4723,1277,1192,58,51,3146,3114,271,4724,1156,0
20:14:59,11968.97,Fox,6262,111,32,24,7,28,11,9,6262,6230,6206,4725,1277,1192,59,52,3147,3115,271,4724,1156,0
20:15:00,11970.17,Fox,6262,111,32,20,11,28,11,9,6262,6230,6210,4725,1277,1192,59,52,3147,3115,271,4724,1156,0
20:15:00,11971.38,Fox,6262,108,32,20,11,25,11,9,6262,6230,6210,4725,1277,1192,59,49,3147,3115,272,4726,1156,0
20:15:01,11973.47,Fox,6264,110,34,20,11,25,11,9,6264,6230,6210,4725,1277,1192,60,50,3148,3116,272,4726,1156,0
20:15:01,11974.08,Fox,6264,109,34,20,11,23,13,8,6264,6230,6210,4725,1279,1192,60,49,3148,3116,272,4726,1157,0
20:15:02,11974.38,Fox,6264,108,34,20,11,22,13,8,6264,6230,6210,4725,1279,1192,60,48,3148,3116,272,4727,1157,0
20:15:02,11975.58,Fox,6266,110,36,20,11,22,13,8,6266,6230,6210,4725,1279,1192,60,50,3148,3118,272,4727,1157,0
20:15:03,11976.47,Fox,6266,110,36,16,15,22,13,8,6266,6230,6214,4725,1279,1192,60,50,3148,3118,272,4727,1157,0
20:15:03,11977.38,Fox,6266,110,36,14,15,23,14,8,6266,6230,6216,4727,1280,1192,60,50,3148,3118,272,4727,1157,0
20:15:03,11977.67,Fox,6266,110,36,14,15,21,16,8,6266,6230,6216,4727,1282,1192,60,50,3148,3118,272,4727,1157,0
20:15:04,11979.47,Fox,6266,108,36,14,15,19,16,8,6266,6230,6216,4727,1282,1192,59,49,3148,3118,272,4729,1157,0
20:15:05,11980.38,Fox,6266,107,34,16,15,19,16,7,6266,6232,6216,4727,1282,1192,58,49,3148,3118,272,4729,1158,0
20:15:05,11981.88,Fox,6266,107,34,14,17,19,16,7,6266,6232,6218,4727,1282,1192,58,49,3148,3118,272,4729,1158,0
20:15:06,11983.97,Fox,6266,107,34,12,19,17,18,7,6266,6232,6220,4727,1284,1192,58,49,3148,3118,272,4729,1158,0
20:15:07,11985.17,Fox,6266,107,34,10,21,17,18,7,6266,6232,6222,4727,1284,1192,58,49,3148,3118,272,4729,1158,0
20:15:08,11987.88,Fox,6266,104,34,8,23,15,18,6,6266,6232,6224,4727,1284,1192,55,49,3148,3118,272,4731,1159,0
20:15:08,11988.17,Fox,6266,104,32,10,23,15,18,6,6266,6234,6224,4727,1284,1192,55,49,3148,3118,272,4731,1159,0
20:15:11,11993.88,Fox,6268,105,32,10,23,15,18,5,6266,6234,6224,4727,1284,1192,55,50,3149,3119,272,4731,1160,0
20:15:12,11994.17,Fox,6268,105,34,10,23,15,18,5,6268,6234,6224,4727,1284,1192,55,50,3149,3119,272,4731,1160,0
20:15:12,11995.97,Fox,6268,105,34,10,23,13,20,5,6268,6234,6224,4727,1286,1192,55,50,3149,3119,272,4731,1160,0
20:15:13,11996.58,Fox,6268,105,34,10,23,11,22,5,6268,6234,6224,4727,1288,1192,55,50,3149,3119,272,4731,1160,0
20:15:14,11998.08,Fox,6268,105,34,8,25,11,22,5,6268,6234,6226,4727,1288,1192,55,50,3149,3119,272,4731,1160,0
20:15:14,11998.97,Fox,6268,104,32,10,25,11,22,4,6268,6236,6226,4727,1288,1192,55,49,3149,3119,272,4731,1161,0
20:15:15,12000.78,Fox,6268,104,32,8,27,11,22,4,6268,6236,6228,4727,1288,1192,55,49,3149,3119,272,4731,1161,0
20:15:16,12002.58,Fox,6268,104,32,6,29,11,22,4,6268,6236,6230,4727,1288,1192,55,49,3149,3119,272,4731,1161,0
20:15:17,12004.08,Fox,6268,103,32,6,29,11,22,3,6268,6236,6230,4727,1288,1192,54,49,3149,3119,272,4731,1162,0
20:15:17,12004.97,Fox,6268,103,30,8,29,11,22,3,6268,6238,6230,4727,1288,1192,54,49,3149,3119,272,4731,1162,0
20:15:18,12005.58,Fox,6268,103,30,8,27,13,22,3,6268,6238,6230,4729,1288,1192,54,49,3149,3119,272,4731,1162,0
20:15:21,12010.38,Fox,6268,103,28,10,27,13,20,5,6268,6240,6230,4729,1288,1194,54,49,3149,3119,272,4731,1162,0
20:15:21,12011.28,Fox,6268,102,26,12,25,15,20,4,6268,6242,6230,4731,1288,1194,54,48,3149,3119,272,4731,1163,0
20:15:22,12012.17,Fox,6270,104,28,12,25,15,20,4,6270,6242,6230,4731,1288,1194,55,49,3150,3120,272,4731,1163,0
20:15:23,12013.97,Fox,6272,105,30,12,24,15,20,4,6272,6242,6230,4731,1288,1194,54,51,3150,3122,272,4732,1163,0
20:15:23,12014.28,Fox,6272,104,30,12,24,15,20,3,6272,6242,6230,4731,1288,1194,53,51,3150,3122,272,4732,1164,0
20:15:23,12015.17,Fox,6272,104,30,12,24,15,19,4,6272,6242,6230,4731,1288,1195,53,51,3150,3122,272,4732,1164,0
20:15:24,12015.78,Fox,6272,104,30,12,24,14,20,4,6272,6242,6230,4731,1289,1195,53,51,3150,3122,272,4732,1164,0
20:15:25,12018.17,Fox,6272,104,30,12,24,12,22,4,6272,6242,6230,4731,1291,1195,53,51,3150,3122,272,4732,1164,0
20:15:26,12019.08,Fox,6272,104,30,10,26,12,22,4,6272,6242,6232,4731,1291,1195,53,51,3150,3122,272,4732,1164,0
20:15:26,12019.97,Fox,6274,106,32,10,26,12,22,4,6274,6242,6232,4731,1291,1195,55,51,3152,3122,272,4732,1164,0
20:15:27,12021.47,Fox,6274,105,32,10,24,13,22,4,6274,6242,6232,4733,1291,1195,54,51,3152,3122,273,4732,1164,0
20:15:28,12023.58,Fox,6274,105,32,10,23,14,21,5,6274,6242,6232,4734,1291,1196,54,51,3152,3122,273,4732,1164,0
20:15:28,12024.17,Fox,6276,107,34,10,23,14,21,5,6276,6242,6232,4734,1291,1196,54,53,3152,3124,273,4732,1164,0
20:15:29,12024.78,Fox,6278,108,36,10,22,14,21,5,6278,6242,6232,4734,1291,1196,53,55,3152,3126,274,4732,1164,0
20:15:30,12026.88,Fox,6278,108,36,8,24,14,21,5,6278,6242,6234,4734,1291,1196,53,55,3152,3126,274,4732,1164,0
20:15:30,12027.78,Fox,6278,108,32,12,24,14,21,5,6278,6246,6234,4734,1291,1196,53,55,3152,3126,274,4732,1164,0
20:15:31,12028.08,Fox,6278,108,30,14,24,14,21,5,6278,6248,6234,4734,1291,1196,53,55,3152,3126,274,4732,1164,0
20:15:31,12029.28,Fox,6280,109,32,14,23,12,23,5,6280,6248,6234,4734,1293,1196,53,56,3153,3127,274,4733,1164,0
20:15:32,12030.17,Fox,6282,111,34,14,23,12,23,5,6282,6248,6234,4734,1293,1196,54,57,3154,3128,274,4733,1164,0
20:15:32,12030.78,Fox,6282,111,34,14,19,16,23,5,6282,6248,6234,4738,1293,1196,54,57,3154,3128,274,4733,1164,0
20:15:32,12031.08,Fox,6282,111,32,16,19,16,23,5,6282,6250,6234,4738,1293,1196,54,57,3154,3128,274,4733,1164,0
20:15:33,12031.97,Fox,6282,109,30,18,19,14,23,5,6282,6252,6234,4738,1293,1196,54,55,3154,3128,274,4735,1164,0
20:15:33,12032.88,Fox,6282,109,30,18,19,14,21,7,6282,6252,6234,4738,1293,1198,54,55,3154,3128,274,4735,1164,0
20:15:34,12034.08,Fox,6284,110,30,18,19,13,21,7,6282,6252,6234,4738,1293,1198,56,54,3156,3128,274,4736,1164,0
20:15:34,12034.38,Fox,6284,110,32,18,19,13,21,7,6284,6252,6234,4738,1293,1198,56,54,3156,3128,274,4736,1164,0
20:15:35,12035.28,Fox,6284,110,32,18,19,13,19,9,6284,6252,6234,4738,1293,1200,56,54,3156,3128,274,4736,1164,0
20:15:36,12037.08,Fox,6286,112,34,18,15,17,19,9,6286,6252,6234,4742,1293,1200,58,54,3158,3128,274,4736,1164,0
20:15:36,12037.97,Fox,6286,112,34,16,15,19,19,9,6286,6252,6236,4744,1293,1200,58,54,3158,3128,274,4736,1164,0
20:15:37,12039.47,Fox,6286,112,30,20,15,19,19,9,6286,6256,6236,4744,1293,1200,58,54,3158,3128,274,4736,1164,0
20:15:37,12040.08,Fox,6286,112,28,22,15,19,19,9,6286,6258,6236,4744,1293,1200,58,54,3158,3128,274,4736,1164,0
20:15:38,12040.97,Fox,6286,110,26,24,15,17,19,9,6286,6260,6236,4744,1293,1200,58,52,3158,3128,274,4738,1164,0
20:15:39,12042.47,Fox,6286,110,26,24,14,18,19,9,6286,6260,6236,4745,1293,1200,58,52,3158,3128,274,4738,1164,0
20:15:39,12043.67,Fox,6286,110,26,22,16,18,19,9,6286,6260,6238,4745,1293,1200,58,52,3158,3128,274,4738,1164,0
20:15:40,12044.58,Fox,6286,110,26,22,14,18,21,9,6286,6260,6238,4747,1295,1200,58,52,3158,3128,274,4738,1164,0
20:15:40,12045.47,Fox,6286,110,26,22,12,20,21,9,6286,6260,6238,4749,1295,1200,58,52,3158,3128,274,4738,1164,0
20:15:42,12048.17,Fox,6286,108,26,22,11,19,21,9,6286,6260,6238,4750,1295,1200,57,51,3158,3128,274,4740,1164,0
20:15:42,12049.08,Fox,6286,108,26,20,13,19,21,9,6286,6260,6240,4750,1295,1200,57,51,3158,3128,274,4740,1164,0
20:15:43,12049.67,Fox,6286,108,26,18,15,19,21,9,6286,6260,6242,4750,1295,1200,57,51,3158,3128,274,4740,1164,0
20:15:44,12051.17,Fox,6288,109,28,18,15,19,21,8,6288,6260,6242,4750,1295,1200,59,50,3160,3128,274,4740,1165,0
20:15:44,12051.47,Fox,6288,109,26,20,15,19,21,8,6288,6262,6242,4750,1295,1200,59,50,3160,3128,274,4740,1165,0
20:15:44,12052.08,Fox,6288,109,26,20,15,19,20,9,6288,6262,6242,4750,1295,1201,59,50,3160,3128,274,4740,1165,0
20:15:45,12052.67,Fox,6288,108,26,20,15,18,20,9,6288,6262,6242,4750,1295,1201,59,49,3160,3128,274,4741,1165,0
20:15:46,12054.78,Fox,6288,106,26,20,15,15,21,9,6288,6262,6242,4750,1296,1201,59,47,3160,3128,274,4743,1165,0
20:15:47,12055.97,Fox,6288,104,24,22,15,13,21,9,6288,6264,6242,4750,1296,1201,57,47,3160,3128,274,4745,1165,0
20:15:48,12058.38,Fox,6288,103,22,24,13,14,21,9,6288,6266,6242,4752,1296,1201,57,46,3160,3128,275,4745,1165,0
20:15:50,12060.78,Fox,6290,105,24,24,13,14,21,9,6290,6266,6242,4752,1296,1201,59,46,3162,3128,275,4745,1165,0
20:15:50,12061.08,Fox,6290,105,24,24,11,16,21,9,6290,6266,6242,4754,1296,1201,59,46,3162,3128,275,4745,1165,0
20:15:50,12062.28,Fox,6290,104,24,24,11,16,21,8,6290,6266,6242,4754,1296,1201,59,45,3162,3128,275,4745,1166,0
20:15:51,12063.17,Fox,6292,106,26,24,9,18,21,8,6292,6266,6242,4756,1296,1201,61,45,3164,3128,275,4745,1166,0
20:15:53,12065.88,Fox,6294,107,28,24,9,17,21,8,6294,6266,6242,4756,1296,1201,62,45,3166,3128,275,4746,1166,0
20:15:53,12066.47,Fox,6294,107,28,20,13,17,21,8,6294,6266,6246,4756,1296,1201,62,45,3166,3128,275,4746,1166,0
20:15:53,12066.78,Fox,6294,107,28,18,15,17,21,8,6294,6266,6248,4756,1296,1201,62,45,3166,3128,275,4746,1166,0
20:15:54,12068.28,Fox,6294,107,28,18,15,17,20,9,6294,6266,6248,4756,1296,1202,62,45,3166,3128,275,4746,1166,0
20:15:54,12068.88,Fox,6294,106,28,18,15,16,20,9,6294,6266,6248,4756,1296,1202,61,45,3166,3128,275,4747,1166,0
20:15:55,12069.78,Fox,6294,106,28,16,17,16,20,9,6294,6266,6250,4756,1296,1202,61,45,3166,3128,275,4747,1166,0
20:15:56,12070.67,Fox,6294,106,28,14,19,16,20,9,6294,6266,6252,4756,1296,1202,61,45,3166,3128,275,4747,1166,0
20:15:56,12071.58,Fox,6294,105,28,14,19,15,20,9,6294,6266,6252,4756,1296,1202,60,45,3166,3128,275,4748,1166,0
20:15:57,12073.38,Fox,6294,104,28,14,19,14,20,9,6294,6266,6252,4756,1296,1202,59,45,3166,3128,275,4749,1166,0
20:15:59,12076.67,Fox,6294,103,26,16,19,14,20,8,6294,6268,6252,4756,1296,1202,59,44,3166,3128,275,4749,1167,0
20:16:00,12078.17,Fox,6294,103,26,12,23,14,20,8,6294,6268,6256,4756,1296,1202,59,44,3166,3128,275,4749,1167,0
20:16:00,12078.78,Fox,6294,103,26,10,25,14,20,8,6294,6268,6258,4756,1296,1202,59,44,3166,3128,275,4749,1167,0
20:16:01,12079.67,Fox,6294,103,26,8,25,16,20,8,6294,6268,6260,4758,1296,1202,59,44,3166,3128,275,4749,1167,0
20:16:02,12081.78,Fox,6294,102,26,8,25,16,20,7,6294,6268,6260,4758,1296,1202,58,44,3166,3128,275,4749,1168,0
20:16:03,12083.58,Fox,6296,104,28,8,25,16,20,7,6296,6268,6260,4758,1296,1202,58,46,3166,3130,275,4749,1168,0
20:16:06,12087.17,Fox,6296,104,28,8,23,18,20,7,6296,6268,6260,4760,1296,1202,58,46,3166,3130,275,4749,1168,0
20:16:07,12089.28,Fox,6298,106,30,8,23,18,20,7,6298,6268,6260,4760,1296,1202,59,47,3167,3131,275,4749,1168,0
20:16:08,12090.17,Fox,6298,105,30,6,25,17,20,7,6298,6268,6262,4760,1296,1202,58,47,3167,3131,275,4750,1168,0
20:16:10,12094.08,Fox,6298,104,30,6,25,17,20,6,6298,6268,6262,4760,1296,1202,58,46,3167,3131,275,4750,1169,0
20:16:10,12094.67,Fox,6298,104,28,6,27,17,20,6,6298,6270,6264,4760,1296,1202,58,46,3167,3131,275,4750,1169,0
20:16:11,12095.28,Fox,6298,104,28,6,27,17,19,7,6298,6270,6264,4760,1296,1203,58,46,3167,3131,275,4750,1169,0
20:16:12,12096.78,Fox,6298,103,26,6,29,17,19,6,6298,6272,6266,4760,1296,1203,57,46,3167,3131,275,4750,1170,0
20:16:12,12097.97,Fox,6298,102,26,6,27,18,19,6,6298,6272,6266,4762,1296,1203,57,45,3167,3131,276,4750,1170,0
20:16:13,12099.47,Fox,6300,104,28,6,27,16,21,6,6300,6272,6266,4762,1298,1203,59,45,3169,3131,276,4750,1170,0
20:16:14,12100.97,Fox,6304,108,32,6,27,16,21,6,6304,6272,6266,4762,1298,1203,60,48,3170,3134,276,4750,1170,0
20:16:15,12102.47,Fox,6304,108,30,8,27,16,21,6,6304,6274,6266,4762,1298,1203,60,48,3170,3134,276,4750,1170,0
20:16:15,12103.08,Fox,6304,107,30,8,27,16,21,5,6304,6274,6266,4762,1298,1203,59,48,3170,3134,276,4750,1171,0
20:16:16,12103.97,Fox,6304,107,30,8,25,18,21,5,6304,6274,6266,4764,1298,1203,59,48,3170,3134,276,4750,1171,0
20:16:16,12104.58,Fox,6304,107,30,8,25,17,22,5,6304,6274,6266,4764,1299,1203,59,48,3170,3134,276,4750,1171,0
20:16:18,12106.67,Fox,6304,107,28,10,25,17,22,5,6304,6276,6266,4764,1299,1203,59,48,3170,3134,276,4750,1171,0
20:16:18,12107.28,Fox,6304,107,26,12,25,17,22,5,6304,6278,6266,4764,1299,1203,59,48,3170,3134,276,4750,1171,0
20:16:19,12109.38,Fox,6304,107,26,12,23,19,22,5,6304,6278,6266,4766,1299,1203,59,48,3170,3134,276,4750,1171,0
20:16:19,12109.97,Fox,6304,107,26,12,21,21,22,5,6304,6278,6266,4768,1299,1203,59,48,3170,3134,276,4750,1171,0
20:16:21,12111.78,Fox,6304,107,24,14,21,21,20,7,6304,6280,6266,4768,1299,1205,59,48,3170,3134,276,4750,1171,0
20:16:21,12112.67,Fox,6304,107,22,16,21,21,20,7,6304,6282,6266,4768,1299,1205,59,48,3170,3134,276,4750,1171,0
20:16:22,12113.88,Fox,6306,109,24,16,21,21,20,7,6306,6282,6266,4768,1299,1205,61,48,3172,3134,276,4750,1171,0
20:16:22,12114.47,Fox,6306,106,24,16,21,19,19,7,6306,6282,6266,4768,1299,1206,58,48,3172,3134,276,4752,1172,0
20:16:23,12115.38,Fox,6306,106,24,14,23,19,17,9,6306,6282,6268,4768,1299,1208,58,48,3172,3134,276,4752,1172,0
20:16:24,12116.88,Fox,6306,105,22,16,23,19,17,8,6306,6284,6268,4768,1299,1208,57,48,3172,3134,276,4752,1173,0
20:16:24,12117.78,Fox,6308,106,24,16,22,19,17,8,6308,6284,6268,4768,1299,1208,58,48,3174,3134,277,4752,1173,0
20:16:25,12119.88,Fox,6308,105,22,18,22,18,17,8,6308,6286,6268,4768,1299,1208,58,47,3174,3134,277,4753,1173,0
20:16:26,12120.47,Fox,6312,109,26,18,22,18,17,8,6312,6286,6268,4768,1299,1208,58,51,3174,3138,277,4753,1173,0
20:16:26,12121.38,Fox,6312,109,26,18,22,18,15,10,6312,6286,6268,4768,1299,1210,58,51,3174,3138,277,4753,1173,0
20:16:28,12123.47,Fox,6314,110,28,18,21,18,15,10,6314,6286,6268,4768,1299,1210,57,53,3174,3140,278,4753,1173,0
20:16:28,12124.38,Fox,6316,111,28,18,20,16,17,10,6314,6286,6268,4768,1301,1210,58,53,3176,3140,279,4753,1173,0
20:16:28,12124.67,Fox,6316,111,30,18,20,16,17,10,6316,6286,6268,4768,1301,1210,58,53,3176,3140,279,4753,1173,0
20:16:30,12126.78,Fox,6318,113,30,18,17,19,17,10,6316,6286,6268,4771,1301,1210,58,55,3176,3142,279,4753,1173,0
20:16:30,12127.38,Fox,6320,115,32,18,15,21,17,10,6318,6286,6268,4773,1301,1210,58,57,3176,3144,279,4753,1173,0
20:16:30,12127.67,Fox,6320,115,34,18,15,21,17,10,6320,6286,6268,4773,1301,1210,58,57,3176,3144,279,4753,1173,0
20:16:32,12130.38,Fox,6322,116,36,18,13,18,21,10,6322,6286,6268,4775,1305,1210,57,59,3176,3146,279,4754,1173,0
20:16:32,12130.97,Fox,6322,116,36,18,11,20,21,10,6322,6286,6268,4777,1305,1210,57,59,3176,3146,279,4754,1173,0
20:16:33,12132.17,Fox,6324,117,38,18,11,19,21,10,6324,6286,6268,4777,1305,1210,57,60,3177,3147,279,4755,1173,0
20:16:34,12133.67,Fox,6326,119,36,18,13,19,19,12,6324,6288,6270,4777,1305,1212,58,61,3178,3148,279,4755,1173,0
20:16:34,12133.97,Fox,6326,119,38,18,13,19,17,14,6326,6288,6270,4777,1305,1214,58,61,3178,3148,279,4755,1173,0
20:16:35,12135.17,Fox,6326,119,38,16,15,19,17,14,6326,6288,6272,4777,1305,1214,58,61,3178,3148,279,4755,1173,0
20:16:36,12137.58,Fox,6326,116,38,16,15,16,17,14,6326,6288,6272,4777,1305,1214,56,60,3178,3148,280,4757,1173,0
20:16:37,12138.47,Fox,6326,116,38,16,11,20,17,14,6326,6288,6272,4781,1305,1214,56,60,3178,3148,280,4757,1173,0
20:16:37,12139.08,Fox,6326,116,38,16,10,21,17,14,6326,6288,6272,4782,1305,1214,56,60,3178,3148,280,4757,1173,0
20:16:38,12139.97,Fox,6326,116,38,16,9,22,17,14,6326,6288,6272,4783,1305,1214,56,60,3178,3148,280,4757,1173,0
20:16:39,12141.17,Fox,6328,118,40,14,11,22,17,14,6328,6288,6274,4783,1305,1214,58,60,3180,3148,280,4757,1173,0
20:16:40,12143.28,Fox,6328,118,38,16,11,22,17,14,6328,6290,6274,4783,1305,1214,58,60,3180,3148,280,4757,1173,0
20:16:41,12144.47,Fox,6330,119,40,16,10,22,17,14,6330,6290,6274,4783,1305,1214,58,61,3181,3149,280,4758,1173,0
20:16:41,12145.08,Fox,6332,121,42,16,10,22,17,14,6332,6290,6274,4783,1305,1214,58,63,3181,3151,280,4758,1173,0
20:16:42,12145.67,Fox,6332,121,40,16,12,22,17,14,6332,6292,6276,4783,1305,1214,58,63,3181,3151,280,4758,1173,0
20:16:42,12146.28,Fox,6334,122,42,14,14,22,17,13,6334,6292,6278,4783,1305,1214,60,62,3183,3151,280,4758,1174,0
20:16:43,12148.38,Fox,6336,124,42,16,14,22,17,13,6336,6294,6278,4783,1305,1214,60,64,3183,3153,280,4758,1174,0
20:16:44,12149.58,Fox,6336,123,42,16,14,21,17,13,6336,6294,6278,4783,1305,1214,59,64,3183,3153,280,4759,1174,0
20:16:45,12150.47,Fox,6336,123,42,14,14,23,17,13,6336,6294,6280,4785,1305,1214,59,64,3183,3153,280,4759,1174,0
20:16:45,12151.38,Fox,6336,123,42,12,16,23,17,13,6336,6294,6282,4785,1305,1214,59,64,3183,3153,280,4759,1174,0
20:16:46,12152.28,Fox,6336,120,42,12,16,23,16,11,6336,6294,6282,4785,1305,1214,57,63,3183,3153,280,4760,1176,0
20:16:46,12153.17,Fox,6336,120,42,12,16,23,15,12,6336,6294,6282,4785,1305,1215,57,63,3183,3153,280,4760,1176,0
20:16:47,12154.97,Fox,6336,120,42,12,15,23,16,12,6336,6294,6282,4786,1306,1215,57,63,3183,3153,280,4760,1176,0
20:16:48,12155.58,Fox,6336,120,42,10,17,23,14,14,6336,6294,6284,4786,1306,1217,57,63,3183,3153,280,4760,1176,0
20:16:48,12156.47,Fox,6336,120,42,10,17,22,15,14,6336,6294,6284,4786,1307,1217,57,63,3183,3153,280,4760,1176,0
20:16:49,12157.08,Fox,6336,120,42,10,15,24,15,14,6336,6294,6284,4788,1307,1217,57,63,3183,3153,280,4760,1176,0
20:16:50,12158.28,Fox,6336,120,42,8,17,24,15,14,6336,6294,6286,4788,1307,1217,57,63,3183,3153,280,4760,1176,0
20:16:51,12160.08,Fox,6336,119,42,8,17,24,15,13,6336,6294,6286,4788,1307,1217,56,63,3183,3153,280,4760,1177,0
20:16:52,12161.88,Fox,6340,122,44,8,16,24,15,13,6338,6294,6286,4788,1307,1217,58,64,3186,3154,280,4761,1177,0
20:16:52,12162.17,Fox,6340,121,46,8,16,24,15,12,6340,6294,6286,4788,1307,1217,58,63,3186,3154,280,4761,1178,0
20:16:53,12163.38,Fox,6340,120,46,8,16,24,15,11,6340,6294,6286,4788,1307,1217,57,63,3186,3154,280,4761,1179,0
20:16:54,12165.47,Fox,6340,119,46,8,16,23,15,11,6340,6294,6286,4788,1307,1217,57,62,3186,3154,280,4762,1179,0
20:16:55,12166.38,Fox,6340,119,44,10,16,23,13,13,6340,6296,6286,4788,1307,1219,57,62,3186,3154,280,4762,1179,0
20:16:56,12167.58,Fox,6340,118,44,10,16,22,13,13,6340,6296,6286,4788,1307,1219,57,61,3186,3154,280,4763,1179,0
20:16:58,12171.78,Fox,6340,118,42,12,16,22,13,13,6340,6298,6286,4788,1307,1219,57,61,3186,3154,280,4763,1179,0
20:16:59,12172.38,Fox,6340,118,42,10,18,22,13,13,6340,6298,6288,4788,1307,1219,57,61,3186,3154,280,4763,1179,0
20:16:59,12173.28,Fox,6342,120,44,10,18,21,14,13,6342,6298,6288,4788,1308,1219,59,61,3188,3154,280,4763,1179,0
20:17:01,12175.67,Fox,6342,119,44,10,17,22,14,12,6342,6298,6288,4789,1308,1219,59,60,3188,3154,280,4763,1180,0
20:17:01,12176.88,Fox,6342,118,44,10,17,22,14,11,6342,6298,6288,4789,1308,1219,59,59,3188,3154,280,4763,1181,0
20:17:04,12180.47,Fox,6344,120,46,10,17,22,14,11,6344,6298,6288,4789,1308,1219,60,60,3189,3155,280,4763,1181,0
20:17:04,12180.78,Fox,6344,120,46,10,17,21,15,11,6344,6298,6288,4789,1309,1219,60,60,3189,3155,280,4763,1181,0
20:17:05,12181.67,Fox,6346,122,48,10,17,21,15,11,6346,6298,6288,4789,1309,1219,61,61,3190,3156,280,4763,1181,0
20:17:05,12181.97,Fox,6346,122,46,10,19,21,13,13,6346,6300,6290,4789,1309,1221,61,61,3190,3156,280,4763,1181,0
20:17:06,12183.47,Fox,6346,122,42,14,19,21,13,13,6346,6304,6290,4789,1309,1221,61,61,3190,3156,280,4763,1181,0
20:17:06,12184.38,Fox,6346,122,42,12,21,21,13,13,6346,6304,6292,4789,1309,1221,61,61,3190,3156,280,4763,1181,0
20:17:07,12186.17,Fox,6346,121,42,12,21,20,13,13,6346,6304,6292,4789,1309,1221,61,60,3190,3156,280,4764,1181,0
20:17:08,12187.08,Fox,6348,122,42,10,23,20,13,12,6346,6304,6294,4789,1309,1221,61,61,3191,3157,280,4764,1182,0
20:17:08,12187.38,Fox,6348,122,44,10,23,20,13,12,6348,6304,6294,4789,1309,1221,61,61,3191,3157,280,4764,1182,0
20:17:09,12188.58,Fox,6350,123,46,10,22,20,13,12,6350,6304,6294,4789,1309,1221,61,62,3192,3158,280,4765,1182,0
20:17:11,12191.88,Fox,6352,125,46,10,22,18,14,13,6350,6304,6294,4789,1311,1222,63,62,3194,3158,280,4765,1182,0
20:17:11,12192.17,Fox,6352,125,48,10,22,18,14,13,6352,6304,6294,4789,1311,1222,63,62,3194,3158,280,4765,1182,0
20:17:12,12193.67,Fox,6352,125,48,10,21,19,14,13,6352,6304,6294,4790,1311,1222,63,62,3194,3158,280,4765,1182,0
20:17:13,12195.78,Fox,6354,127,48,10,19,21,14,13,6352,6304,6294,4792,1311,1222,65,62,3196,3158,280,4765,1182,0
20:17:13,12196.38,Fox,6354,127,48,12,19,21,14,13,6354,6306,6294,4792,1311,1222,65,62,3196,3158,280,4765,1182,0
20:17:14,12197.28,Fox,6356,127,50,12,19,21,14,11,6356,6306,6294,4792,1311,1222,64,63,3196,3160,280,4765,1184,0
20:17:16,12200.58,Fox,6358,129,48,14,19,21,14,11,6356,6308,6294,4792,1311,1222,65,64,3197,3161,280,4765,1184,0
20:17:16,12200.88,Fox,6358,129,50,14,19,21,14,11,6358,6308,6294,4792,1311,1222,65,64,3197,3161,280,4765,1184,0
20:17:16,12201.47,Fox,6358,129,50,14,17,23,14,11,6358,6308,6294,4794,1311,1222,65,64,3197,3161,280,4765,1184,0
20:17:17,12202.38,Fox,6358,128,50,14,17,22,14,11,6358,6308,6294,4794,1311,1222,65,63,3197,3161,280,4766,1184,0
20:17:17,12202.97,Fox,6358,128,46,18,17,21,15,11,6358,6312,6294,4794,1312,1222,65,63,3197,3161,280,4766,1184,0
20:17:18,12203.58,Fox,6358,128,46,18,17,19,17,11,6358,6312,6294,4794,1314,1222,65,63,3197,3161,280,4766,1184,0
20:17:18,12204.17,Fox,6358,127,46,18,17,18,17,11,6358,6312,6294,4794,1314,1222,65,62,3197,3161,280,4767,1184,0
20:17:19,12204.78,Fox,6358,126,46,16,19,18,17,10,6358,6312,6296,4794,1314,1222,65,61,3197,3161,280,4767,1185,0
20:17:19,12205.97,Fox,6358,124,44,18,17,18,17,10,6358,6314,6296,4796,1314,1222,65,59,3197,3161,281,4768,1185,0
20:17:19,12206.28,Fox,6358,124,44,18,15,20,17,10,6358,6314,6296,4798,1314,1222,65,59,3197,3161,281,4768,1185,0
20:17:20,12207.17,Fox,6358,124,42,20,15,20,17,10,6358,6316,6296,4798,1314,1222,65,59,3197,3161,281,4768,1185,0
20:17:21,12209.58,Fox,6358,124,40,22,15,20,17,10,6358,6318,6296,4798,1314,1222,65,59,3197,3161,281,4768,1185,0
20:17:22,12210.47,Fox,6358,124,38,22,17,20,17,10,6358,6320,6298,4798,1314,1222,65,59,3197,3161,281,4768,1185,0
20:17:22,12210.78,Fox,6358,124,38,22,15,22,17,10,6358,6320,6298,4800,1314,1222,65,59,3197,3161,281,4768,1185,0
20:17:22,12211.67,Fox,6358,124,38,22,13,24,17,10,6358,6320,6298,4802,1314,1222,65,59,3197,3161,281,4768,1185,0
20:17:23,12212.88,Fox,6358,124,36,24,13,24,17,10,6358,6322,6298,4802,1314,1222,65,59,3197,3161,281,4768,1185,0
20:17:23,12213.47,Fox,6358,123,36,24,13,24,17,9,6358,6322,6298,4802,1314,1222,64,59,3197,3161,281,4768,1186,0
20:17:24,12214.67,Fox,6358,123,34,26,13,24,17,9,6358,6324,6298,4802,1314,1222,64,59,3197,3161,281,4768,1186,0
20:17:25,12215.88,Fox,6358,122,34,26,11,26,17,8,6358,6324,6298,4804,1314,1222,64,58,3197,3161,281,4768,1187,0
20:17:25,12216.47,Fox,6358,120,32,28,11,24,17,8,6358,6326,6298,4804,1314,1222,64,56,3197,3161,282,4769,1187,0
20:17:25,12216.78,Fox,6358,119,32,28,11,24,17,7,6358,6326,6298,4804,1314,1222,64,55,3197,3161,282,4769,1188,0
20:17:26,12217.38,Fox,6358,118,32,28,11,24,17,6,6358,6326,6298,4804,1314,1222,63,55,3197,3161,282,4769,1189,0
20:17:26,12218.58,Fox,6358,118,32,28,9,26,17,6,6358,6326,6298,4806,1314,1222,63,55,3197,3161,282,4769,1189,0
20:17:28,12220.67,Fox,6360,120,34,26,11,26,17,6,6360,6326,6300,4806,1314,1222,63,57,3197,3163,282,4769,1189,0
20:17:28,12221.28,Fox,6360,119,34,26,11,25,17,6,6360,6326,6300,4806,1314,1222,63,56,3197,3163,282,4770,1189,0
20:17:29,12222.17,Fox,6360,118,34,22,15,24,17,6,6360,6326,6304,4806,1314,1222,62,56,3197,3163,282,4771,1189,0
20:17:29,12223.67,Fox,6360,118,32,24,15,22,19,6,6360,6328,6304,4806,1316,1222,62,56,3197,3163,282,4771,1189,0
20:17:30,12224.58,Fox,6360,118,32,24,15,20,21,6,6360,6328,6304,4806,1318,1222,62,56,3197,3163,282,4771,1189,0
20:17:30,12225.17,Fox,6360,117,32,24,15,20,21,5,6360,6328,6304,4806,1318,1222,62,55,3197,3163,282,4771,1190,0
20:17:31,12226.67,Fox,6362,116,34,24,15,17,21,5,6362,6328,6304,4806,1318,1222,61,55,3199,3163,282,4774,1190,0
20:17:31,12226.97,Fox,6362,116,32,26,15,17,21,5,6362,6330,6304,4806,1318,1222,61,55,3199,3163,282,4774,1190,0
20:17:32,12227.58,Fox,6362,116,30,28,15,17,21,5,6362,6332,6304,4806,1318,1222,61,55,3199,3163,282,4774,1190,0
20:17:32,12228.78,Fox,6364,118,30,30,15,17,21,5,6364,6334,6304,4806,1318,1222,62,56,3200,3164,282,4774,1190,0
20:17:34,12230.88,Fox,6364,118,28,32,15,17,21,5,6364,6336,6304,4806,1318,1222,62,56,3200,3164,282,4774,1190,0
20:17:34,12232.08,Fox,6364,118,28,32,15,14,24,5,6364,6336,6304,4806,1321,1222,62,56,3200,3164,282,4774,1190,0
20:17:35,12232.97,Fox,6364,117,28,32,13,16,24,4,6364,6336,6304,4808,1321,1222,62,55,3200,3164,282,4774,1191,0
20:17:35,12233.58,Fox,6364,117,28,32,13,15,25,4,6364,6336,6304,4808,1322,1222,62,55,3200,3164,282,4774,1191,0
20:17:36,12235.08,Fox,6364,117,28,30,15,15,25,4,6364,6336,6306,4808,1322,1222,62,55,3200,3164,282,4774,1191,0
20:17:37,12236.28,Fox,6366,118,30,30,15,15,25,3,6366,6336,6306,4808,1322,1222,63,55,3202,3164,282,4774,1192,0
20:17:37,12236.58,Fox,6366,118,30,30,15,15,23,5,6366,6336,6306,4808,1322,1224,63,55,3202,3164,282,4774,1192,0
20:17:38,12238.97,Fox,6366,118,30,28,17,15,23,5,6366,6336,6308,4808,1322,1224,63,55,3202,3164,282,4774,1192,0
20:17:39,12240.47,Fox,6368,120,32,28,17,15,23,5,6368,6336,6308,4808,1322,1224,64,56,3203,3165,282,4774,1192,0
20:17:40,12241.97,Fox,6368,120,32,24,21,15,22,6,6368,6336,6312,4808,1322,1225,64,56,3203,3165,282,4774,1192,0
20:17:40,12242.28,Fox,6368,120,32,24,19,17,22,6,6368,6336,6312,4810,1322,1225,64,56,3203,3165,282,4774,1192,0
20:17:40,12243.17,Fox,6368,118,32,24,19,15,22,6,6368,6336,6312,4810,1322,1225,62,56,3203,3165,284,4774,1192,0
20:17:41,12244.38,Fox,6368,118,30,26,19,13,24,6,6368,6338,6312,4810,1324,1225,62,56,3203,3165,284,4774,1192,0
20:17:41,12244.67,Fox,6368,118,28,26,19,15,24,6,6368,6340,6314,4812,1324,1225,62,56,3203,3165,284,4774,1192,0
20:17:42,12245.88,Fox,6368,118,28,24,21,15,24,6,6368,6340,6316,4812,1324,1225,62,56,3203,3165,284,4774,1192,0
20:17:43,12247.38,Fox,6368,117,28,24,19,17,24,5,6368,6340,6316,4814,1324,1225,61,56,3203,3165,284,4774,1193,0
20:17:43,12248.28,Fox,6368,117,28,22,21,17,24,5,6368,6340,6318,4814,1324,1225,61,56,3203,3165,284,4774,1193,0
20:17:43,12248.88,Fox,6368,117,28,20,23,17,24,5,6368,6340,6320,4814,1324,1225,61,56,3203,3165,284,4774,1193,0
20:17:44,12250.67,Fox,6368,117,28,20,23,16,25,5,6368,6340,6320,4814,1325,1225,61,56,3203,3165,284,4774,1193,0
20:17:45,12251.58,Fox,6368,117,28,18,25,16,25,5,6368,6340,6322,4814,1325,1225,61,56,3203,3165,284,4774,1193,0
20:17:45,12252.78,Fox,6368,115,28,18,25,14,25,5,6368,6340,6322,4814,1325,1225,59,56,3203,3165,285,4775,1193,0
20:17:46,12253.38,Fox,6368,114,28,16,27,14,25,4,6368,6340,6324,4814,1325,1225,59,55,3203,3165,285,4775,1194,0
20:17:47,12255.47,Fox,6370,116,30,14,29,14,25,4,6370,6340,6326,4814,1325,1225,60,56,3204,3166,285,4775,1194,0
20:17:47,12255.78,Fox,6370,116,28,16,29,14,25,4,6370,6342,6326,4814,1325,1225,60,56,3204,3166,285,4775,1194,0
20:17:49,12258.17,Fox,6372,116,28,16,28,13,25,4,6370,6342,6326,4814,1325,1225,59,57,3205,3167,286,4776,1194,0
20:17:49,12258.47,Fox,6372,116,30,16,28,13,25,4,6372,6342,6326,4814,1325,1225,59,57,3205,3167,286,4776,1194,0
20:17:49,12259.67,Fox,6374,117,32,16,27,13,25,4,6374,6342,6326,4814,1325,1225,59,58,3206,3168,287,4776,1194,0
20:17:50,12261.17,Fox,6376,119,34,16,27,13,25,4,6376,6342,6326,4814,1325,1225,61,58,3208,3168,287,4776,1194,0
20:17:50,12261.78,Fox,6376,119,34,16,27,13,24,5,6376,6342,6326,4814,1325,1226,61,58,3208,3168,287,4776,1194,0
20:17:51,12262.38,Fox,6376,119,34,14,29,13,24,5,6376,6342,6328,4814,1325,1226,61,58,3208,3168,287,4776,1194,0
20:17:51,12262.97,Fox,6376,119,32,16,29,13,24,5,6376,6344,6328,4814,1325,1226,61,58,3208,3168,287,4776,1194,0
20:17:52,12264.17,Fox,6376,119,30,18,29,13,24,5,6376,6346,6328,4814,1325,1226,61,58,3208,3168,287,4776,1194,0
20:17:52,12265.08,Fox,6376,119,30,18,27,15,24,5,6376,6346,6328,4816,1325,1226,61,58,3208,3168,287,4776,1194,0
20:17:52,12265.67,Fox,6376,119,30,16,29,15,24,5,6376,6346,6330,4816,1325,1226,61,58,3208,3168,287,4776,1194,0
20:17:53,12266.28,Fox,6376,119,30,14,31,15,24,5,6376,6346,6332,4816,1325,1226,61,58,3208,3168,287,4776,1194,0
20:17:53,12267.47,Fox,6376,119,30,12,33,15,24,5,6376,6346,6334,4816,1325,1226,61,58,3208,3168,287,4776,1194,0
20:17:54,12268.08,Fox,6376,119,30,12,33,15,20,9,6376,6346,6334,4816,1325,1230,61,58,3208,3168,287,4776,1194,0
20:17:55,12269.88,Fox,6376,119,28,12,35,15,20,9,6376,6348,6336,4816,1325,1230,61,58,3208,3168,287,4776,1194,0
20:17:55,12271.08,Fox,6376,119,26,14,33,17,20,9,6376,6350,6336,4818,1325,1230,61,58,3208,3168,287,4776,1194,0
20:17:57,12274.67,Fox,6376,119,24,16,33,17,20,9,6376,6352,6336,4818,1325,1230,61,58,3208,3168,287,4776,1194,0
20:17:59,12278.58,Fox,6376,119,22,18,33,17,20,9,6376,6354,6336,4818,1325,1230,61,58,3208,3168,287,4776,1194,0
20:18:00,12279.78,Fox,6376,119,20,20,33,17,20,9,6376,6356,6336,4818,1325,1230,61,58,3208,3168,287,4776,1194,0
20:18:01,12281.28,Fox,6376,117,20,20,32,16,20,9,6376,6356,6336,4819,1325,1230,60,57,3208,3168,287,4778,1194,0
20:18:01,12282.47,Fox,6376,116,20,20,29,19,20,8,6376,6356,6336,4822,1325,1230,60,56,3208,3168,287,4778,1195,0
20:18:02,12283.38,Fox,6376,116,18,18,33,19,20,8,6376,6358,6340,4822,1325,1230,60,56,3208,3168,287,4778,1195,0
20:18:02,12283.67,Fox,6376,115,18,18,33,19,20,7,6376,6358,6340,4822,1325,1230,60,55,3208,3168,287,4778,1196,0
20:18:04,12287.58,Fox,6378,117,20,18,33,19,20,7,6378,6358,6340,4822,1325,1230,61,56,3209,3169,287,4778,1196,0
20:18:04,12288.17,Fox,6380,118,22,18,33,18,20,7,6380,6358,6340,4822,1325,1230,60,58,3209,3171,288,4778,1196,0
20:18:04,12288.47,Fox,6380,117,22,18,33,18,20,6,6380,6358,6340,4822,1325,1230,60,57,3209,3171,288,4778,1197,0
20:18:06,12290.88,Fox,6382,118,24,18,32,18,20,6,6382,6358,6340,4822,1325,1230,61,57,3211,3171,288,4779,1197,0
20:18:06,12292.38,Fox,6384,120,24,18,32,18,19,7,6382,6358,6340,4822,1325,1231,62,58,3212,3172,288,4779,1197,0
20:18:07,12292.97,Fox,6384,119,26,18,32,17,19,7,6384,6358,6340,4822,1325,1231,62,57,3212,3172,289,4779,1197,0
20:18:07,12293.88,Fox,6384,119,26,18,32,17,18,8,6384,6358,6340,4822,1325,1232,62,57,3212,3172,289,4779,1197,0
20:18:07,12294.47,Fox,6384,119,26,16,34,17,18,8,6384,6358,6342,4822,1325,1232,62,57,3212,3172,289,4779,1197,0
20:18:08,12295.38,Fox,6384,119,26,16,32,17,20,8,6384,6358,6342,4824,1327,1232,62,57,3212,3172,289,4779,1197,0
20:18:09,12297.78,Fox,6384,117,26,16,32,17,20,6,6384,6358,6342,4824,1327,1232,60,57,3212,3172,289,4779,1199,0
20:18:10,12299.28,Fox,6384,117,26,16,30,19,20,6,6384,6358,6342,4826,1327,1232,60,57,3212,3172,289,4779,1199,0
20:18:10,12299.88,Fox,6384,117,26,16,30,17,22,6,6384,6358,6342,4826,1329,1232,60,57,3212,3172,289,4779,1199,0
20:18:11,12301.08,Fox,6388,120,28,16,29,17,22,6,6386,6358,6342,4826,1329,1232,63,57,3216,3172,289,4780,1199,0
20:18:11,12301.67,Fox,6388,120,30,14,31,17,22,6,6388,6358,6344,4826,1329,1232,63,57,3216,3172,289,4780,1199,0
20:18:11,12301.97,Fox,6388,120,30,14,27,21,22,6,6388,6358,6344,4830,1329,1232,63,57,3216,3172,289,4780,1199,0
20:18:12,12303.17,Fox,6388,120,28,14,29,21,22,6,6388,6360,6346,4830,1329,1232,63,57,3216,3172,289,4780,1199,0
20:18:12,12304.38,Fox,6388,120,28,14,29,20,23,6,6388,6360,6346,4830,1330,1232,63,57,3216,3172,289,4780,1199,0
20:18:13,12305.28,Fox,6388,120,28,14,27,21,24,6,6388,6360,6346,4832,1331,1232,63,57,3216,3172,289,4780,1199,0
20:18:13,12306.17,Fox,6388,118,28,14,25,21,24,6,6388,6360,6346,4834,1331,1232,61,57,3216,3172,291,4780,1199,0
20:18:14,12308.88,Fox,6388,117,28,12,25,23,24,5,6388,6360,6348,4836,1331,1232,61,56,3216,3172,291,4780,1200,0
20:18:15,12309.17,Fox,6388,117,26,14,23,25,24,5,6388,6362,6348,4838,1331,1232,61,56,3216,3172,291,4780,1200,0
20:18:15,12309.78,Fox,6388,115,26,12,25,23,24,5,6388,6362,6350,4838,1331,1232,59,56,3216,3172,291,4782,1200,0
20:18:15,12310.38,Fox,6388,115,26,12,25,23,23,6,6388,6362,6350,4838,1331,1233,59,56,3216,3172,291,4782,1200,0
20:18:16,12311.28,Fox,6388,115,24,14,25,23,23,6,6388,6364,6350,4838,1331,1233,59,56,3216,3172,291,4782,1200,0
20:18:16,12312.17,Fox,6388,115,24,14,23,24,24,6,6388,6364,6350,4840,1332,1233,59,56,3216,3172,291,4782,1200,0
20:18:16,12312.47,Fox,6388,114,24,14,23,23,24,6,6388,6364,6350,4840,1332,1233,59,55,3216,3172,291,4783,1200,0
20:18:17,12313.67,Fox,6388,114,24,12,24,24,24,6,6388,6364,6352,4841,1332,1233,59,55,3216,3172,291,4783,1200,0
20:18:18,12315.47,Fox,6388,113,24,12,22,25,24,6,6388,6364,6352,4843,1332,1233,59,54,3216,3172,291,4784,1200,0
20:18:18,12316.38,Fox,6390,114,26,12,22,24,24,6,6390,6364,6352,4843,1332,1233,60,54,3218,3172,291,4785,1200,0
20:18:18,12317.28,Fox,6390,114,26,10,24,24,24,6,6390,6364,6354,4843,1332,1233,60,54,3218,3172,291,4785,1200,0
20:18:19,12318.47,Fox,6390,114,26,8,26,24,23,7,6390,6364,6356,4843,1332,1234,60,54,3218,3172,291,4785,1200,0
20:18:19,12319.08,Fox,6390,112,24,10,26,23,23,6,6390,6366,6356,4843,1332,1234,59,53,3218,3172,292,4785,1201,0
20:18:20,12319.67,Fox,6390,110,24,10,26,21,23,6,6390,6366,6356,4843,1332,1234,59,51,3218,3172,292,4787,1201,0
20:18:21,12322.38,Fox,6390,108,24,8,28,19,23,6,6390,6366,6358,4843,1332,1234,59,49,3218,3172,292,4789,1201,0
20:18:21,12322.97,Fox,6390,108,22,10,26,21,23,6,6390,6368,6358,4845,1332,1234,59,49,3218,3172,292,4789,1201,0
20:18:22,12324.17,Fox,6390,107,22,10,26,20,23,6,6390,6368,6358,4845,1332,1234,59,48,3218,3172,292,4790,1201,0
20:18:23,12325.97,Fox,6390,107,22,10,25,21,23,6,6390,6368,6358,4846,1332,1234,59,48,3218,3172,292,4790,1201,0
20:18:23,12326.58,Fox,6390,107,22,10,23,23,23,6,6390,6368,6358,4848,1332,1234,59,48,3218,3172,292,4790,1201,0
20:18:23,12327.78,Fox,6390,107,22,10,21,25,23,6,6390,6368,6358,4850,1332,1234,59,48,3218,3172,292,4790,1201,0
20:18:24,12329.28,Fox,6392,108,24,10,21,24,21,8,6392,6368,6358,4850,1332,1236,59,49,3218,3174,292,4791,1201,0
20:18:24,12329.88,Fox,6394,110,26,10,19,26,21,8,6394,6368,6358,4852,1332,1236,59,51,3218,3176,292,4791,1201,0
20:18:26,12333.17,Fox,6394,109,26,10,19,25,21,8,6394,6368,6358,4852,1332,1236,58,51,3218,3176,293,4791,1201,0
20:18:26,12334.38,Fox,6396,111,28,10,19,25,21,8,6396,6368,6358,4852,1332,1236,59,52,3219,3177,293,4791,1201,0
20:18:27,12334.67,Fox,6396,110,28,10,19,25,21,7,6396,6368,6358,4852,1332,1236,58,52,3219,3177,293,4791,1202,0
20:18:27,12336.47,Fox,6396,109,28,10,19,24,21,7,6396,6368,6358,4852,1332,1236,58,51,3219,3177,293,4792,1202,0
20:18:28,12338.28,Fox,6398,111,28,12,19,22,23,7,6398,6370,6358,4852,1334,1236,60,51,3221,3177,293,4792,1202,0
20:18:28,12338.58,Fox,6398,110,28,12,19,22,23,6,6398,6370,6358,4852,1334,1236,60,50,3221,3177,293,4792,1203,0
20:18:29,12340.67,Fox,6400,111,30,12,19,21,22,7,6400,6370,6358,4852,1334,1237,61,50,3222,3178,293,4793,1203,0
20:18:30,12340.97,Fox,6400,111,28,14,19,20,21,9,6400,6372,6358,4852,1335,1239,61,50,3222,3178,293,4793,1203,0
20:18:30,12342.17,Fox,6400,111,26,14,21,20,21,9,6400,6374,6360,4852,1335,1239,61,50,3222,3178,293,4793,1203,0
20:18:31,12343.67,Fox,6400,111,24,16,17,24,21,9,6400,6376,6360,4856,1335,1239,61,50,3222,3178,293,4793,1203,0
20:18:31,12343.97,Fox,6400,110,24,16,17,24,21,8,6400,6376,6360,4856,1335,1239,60,50,3222,3178,293,4793,1204,0
20:18:33,12347.88,Fox,6400,110,24,14,19,24,21,8,6400,6376,6362,4856,1335,1239,60,50,3222,3178,293,4793,1204,0
20:18:34,12349.97,Fox,6400,109,24,12,21,24,21,7,6400,6376,6364,4856,1335,1239,59,50,3222,3178,293,4793,1205,0
20:18:34,12351.17,Fox,6400,108,24,12,21,24,21,6,6400,6376,6364,4856,1335,1239,58,50,3222,3178,293,4793,1206,0
20:18:35,12352.38,Fox,6400,106,24,12,21,22,21,6,6400,6376,6364,4856,1335,1239,58,48,3222,3178,293,4795,1206,0
20:18:35,12353.28,Fox,6400,105,24,12,21,22,21,5,6400,6376,6364,4856,1335,1239,57,48,3222,3178,293,4795,1207,0
20:18:36,12354.78,Fox,6402,107,26,12,19,24,21,5,6402,6376,6364,4858,1335,1239,59,48,3224,3178,293,4795,1207,0
20:18:36,12355.38,Fox,6404,109,28,12,19,24,21,5,6404,6376,6364,4858,1335,1239,61,48,3226,3178,293,4795,1207,0
20:18:37,12357.47,Fox,6404,109,28,10,21,24,21,5,6404,6376,6366,4858,1335,1239,61,48,3226,3178,293,4795,1207,0
20:18:38,12358.67,Fox,6406,111,30,10,21,22,23,5,6406,6376,6366,4858,1337,1239,62,49,3227,3179,293,4795,1207,0
20:18:39,12360.78,Fox,6408,113,32,10,21,22,23,5,6408,6376,6366,4858,1337,1239,64,49,3229,3179,293,4795,1207,0
20:18:39,12361.38,Fox,6408,112,32,10,21,22,21,6,6408,6376,6366,4858,1337,1241,63,49,3229,3179,293,4795,1208,0
20:18:39,12361.97,Fox,6408,112,32,8,21,24,19,8,6408,6376,6368,4860,1337,1243,63,49,3229,3179,293,4795,1208,0
20:18:40,12363.17,Fox,6408,112,32,8,19,26,19,8,6408,6376,6368,4862,1337,1243,63,49,3229,3179,293,4795,1208,0
20:18:41,12365.28,Fox,6408,110,32,8,19,24,19,8,6408,6376,6368,4862,1337,1243,61,49,3229,3179,293,4797,1208,0
20:18:41,12366.78,Fox,6410,112,34,8,19,24,19,8,6410,6376,6368,4862,1337,1243,61,51,3229,3181,293,4797,1208,0
20:18:42,12368.88,Fox,6410,112,34,8,17,26,19,8,6410,6376,6368,4864,1337,1243,61,51,3229,3181,293,4797,1208,0
20:18:43,12369.78,Fox,6410,111,34,8,17,26,16,10,6410,6376,6368,4864,1337,1246,61,50,3229,3181,293,4797,1209,0
20:18:43,12370.08,Fox,6410,111,32,10,15,28,16,10,6410,6378,6368,4866,1337,1246,61,50,3229,3181,293,4797,1209,0
20:18:43,12370.97,Fox,6410,111,30,12,15,28,15,11,6410,6380,6368,4866,1337,1247,61,50,3229,3181,293,4797,1209,0
20:18:44,12373.67,Fox,6410,109,28,14,13,28,15,11,6410,6382,6368,4868,1337,1247,60,49,3229,3181,293,4799,1209,0
20:18:45,12375.17,Fox,6410,109,26,16,13,28,15,11,6410,6384,6368,4868,1337,1247,60,49,3229,3181,293,4799,1209,0
20:18:45,12376.08,Fox,6410,109,26,16,13,26,17,11,6410,6384,6368,4868,1339,1247,60,49,3229,3181,293,4799,1209,0
20:18:45,12376.67,Fox,6410,109,26,14,15,26,17,11,6410,6384,6370,4868,1339,1247,60,49,3229,3181,293,4799,1209,0
20:18:46,12377.58,Fox,6410,109,26,14,13,28,17,11,6410,6384,6370,4870,1339,1247,60,49,3229,3181,293,4799,1209,0
20:18:46,12378.78,Fox,6410,109,26,14,11,30,17,11,6410,6384,6370,4872,1339,1247,60,49,3229,3181,293,4799,1209,0
20:18:47,12379.67,Fox,6410,109,26,12,13,30,17,11,6410,6384,6372,4872,1339,1247,60,49,3229,3181,293,4799,1209,0
20:18:47,12380.88,Fox,6410,108,26,10,15,29,17,11,6410,6384,6374,4872,1339,1247,59,49,3229,3181,293,4800,1209,0
20:18:47,12381.47,Fox,6410,106,26,10,15,29,15,11,6410,6384,6374,4872,1339,1249,58,48,3229,3181,293,4800,1211,0
20:18:47,12381.78,Fox,6410,105,26,10,15,29,15,10,6410,6384,6374,4872,1339,1249,58,47,3229,3181,293,4800,1212,0
20:18:48,12382.38,Fox,6410,105,26,8,15,31,15,10,6410,6384,6376,4874,1339,1249,58,47,3229,3181,293,4800,1212,0
20:18:48,12383.88,Fox,6410,105,22,12,15,31,15,10,6410,6388,6376,4874,1339,1249,58,47,3229,3181,293,4800,1212,0
20:18:48,12384.17,Fox,6410,104,22,12,15,30,15,10,6410,6388,6376,4874,1339,1249,57,47,3229,3181,293,4801,1212,0
20:18:49,12385.97,Fox,6412,106,24,12,15,30,15,10,6412,6388,6376,4874,1339,1249,57,49,3229,3183,293,4801,1212,0
20:18:50,12386.88,Fox,6414,107,26,12,14,30,15,10,6414,6388,6376,4874,1339,1249,57,50,3230,3184,293,4802,1212,0
20:18:50,12388.08,Fox,6414,105,26,12,14,28,14,11,6414,6388,6376,4874,1339,1250,55,50,3230,3184,293,4804,1212,0
20:18:51,12388.97,Fox,6418,108,28,12,13,28,14,11,6416,6388,6376,4874,1339,1250,55,53,3231,3187,293,4805,1212,0
20:18:51,12389.28,Fox,6418,106,30,12,13,26,14,11,6418,6388,6376,4874,1339,1250,55,51,3231,3187,293,4807,1212,0
20:18:53,12394.67,Fox,6420,108,32,12,13,26,14,11,6420,6388,6376,4874,1339,1250,55,53,3231,3189,293,4807,1212,0
20:18:53,12395.58,Fox,6420,108,32,12,13,25,15,11,6420,6388,6376,4874,1340,1250,55,53,3231,3189,293,4807,1212,0
20:18:54,12396.78,Fox,6422,110,34,12,13,25,15,11,6422,6388,6376,4874,1340,1250,56,54,3232,3190,293,4807,1212,0
20:18:55,12399.17,Fox,6426,113,34,14,12,25,15,11,6424,6390,6376,4874,1340,1250,57,56,3234,3192,293,4808,1212,0
20:18:55,12399.78,Fox,6426,113,36,14,12,24,16,11,6426,6390,6376,4874,1341,1250,57,56,3234,3192,293,4808,1212,0
20:18:56,12402.17,Fox,6426,113,36,14,10,25,17,11,6426,6390,6376,4876,1342,1250,57,56,3234,3192,293,4808,1212,0
20:18:58,12408.17,Fox,6426,113,36,14,9,26,17,11,6426,6390,6376,4877,1342,1250,57,56,3234,3192,293,4808,1212,0
20:18:58,12409.08,Fox,6428,115,38,12,11,24,19,11,6428,6390,6378,4877,1344,1250,57,58,3234,3194,293,4808,1212,0
20:18:58,12409.38,Fox,6428,115,38,10,13,24,19,11,6428,6390,6380,4877,1344,1250,57,58,3234,3194,293,4808,1212,0
20:18:59,12410.57,Fox,6428,115,38,10,12,25,19,11,6428,6390,6380,4878,1344,1250,57,58,3234,3194,293,4808,1212,0
20:18:59,12411.77,Fox,6430,116,40,10,11,25,19,11,6430,6390,6380,4878,1344,1250,56,60,3234,3196,293,4809,1212,0
20:18:59,12412.07,Fox,6430,115,38,10,13,25,19,10,6430,6392,6382,4878,1344,1250,56,59,3234,3196,293,4809,1213,0
20:19:00,12412.97,Fox,6430,113,36,12,13,25,19,8,6430,6394,6382,4878,1344,1250,54,59,3234,3196,293,4809,1215,0
20:19:00,12413.57,Fox,6432,115,38,12,13,25,19,8,6432,6394,6382,4878,1344,1250,56,59,3236,3196,293,4809,1215,0
20:19:00,12413.87,Fox,6432,115,38,10,15,25,19,8,6432,6394,6384,4878,1344,1250,56,59,3236,3196,293,4809,1215,0
20:19:01,12416.27,Fox,6432,115,38,10,15,24,20,8,6432,6394,6384,4878,1345,1250,56,59,3236,3196,293,4809,1215,0
20:19:01,12417.17,Fox,6432,115,36,12,15,24,20,8,6432,6396,6384,4878,1345,1250,56,59,3236,3196,293,4809,1215,0
20:19:02,12418.07,Fox,6432,115,36,12,14,25,20,8,6432,6396,6384,4879,1345,1250,56,59,3236,3196,293,4809,1215,0
20:19:02,12420.47,Fox,6432,113,36,12,14,23,22,6,6432,6396,6384,4879,1347,1250,56,57,3236,3196,293,4809,1217,0
20:19:03,12421.07,Fox,6432,112,34,14,14,23,22,5,6432,6398,6384,4879,1347,1250,55,57,3236,3196,293,4809,1218,0
20:19:03,12421.67,Fox,6434,114,34,14,14,21,24,5,6432,6398,6384,4879,1349,1250,56,58,3237,3197,293,4809,1218,0
20:19:03,12422.27,Fox,6434,113,36,12,14,23,24,4,6434,6398,6386,4881,1349,1250,55,58,3237,3197,293,4809,1219,0
20:19:03,12422.57,Fox,6434,113,36,10,16,23,24,4,6434,6398,6388,4881,1349,1250,55,58,3237,3197,293,4809,1219,0
20:19:04,12423.47,Fox,6434,113,34,12,16,22,25,4,6434,6400,6388,4881,1350,1250,55,58,3237,3197,293,4809,1219,0
20:19:05,12426.17,Fox,6436,114,36,12,15,22,25,4,6436,6400,6388,4881,1350,1250,55,59,3238,3198,294,4809,1219,0
20:19:05,12426.77,Fox,6438,116,38,12,15,22,25,4,6438,6400,6388,4881,1350,1250,56,60,3239,3199,294,4809,1219,0
20:19:06,12429.46,Fox,6440,118,40,12,15,22,25,4,6440,6400,6388,4881,1350,1250,58,60,3241,3199,294,4809,1219,0
20:19:07,12430.96,Fox,6442,119,42,12,15,22,25,3,6442,6400,6388,4881,1350,1250,60,59,3243,3199,294,4809,1220,0
20:19:07,12432.76,Fox,6442,117,42,12,15,20,23,5,6442,6400,6388,4881,1350,1252,59,58,3243,3199,295,4810,1220,0
20:19:08,12434.26,Fox,6444,119,44,12,15,20,23,5,6444,6400,6388,4881,1350,1252,60,59,3244,3200,295,4810,1220,0
20:19:08,12435.76,Fox,6446,121,46,12,15,20,23,5,6446,6400,6388,4881,1350,1252,62,59,3246,3200,295,4810,1220,0
20:19:09,12437.26,Fox,6446,121,46,12,14,17,27,5,6446,6400,6388,4882,1354,1252,62,59,3246,3200,295,4810,1220,0
20:19:09,12437.56,Fox,6446,121,44,12,16,17,25,7,6446,6402,6390,4882,1354,1254,62,59,3246,3200,295,4810,1220,0
20:19:09,12438.14,Fox,6446,121,42,14,16,17,25,7,6446,6404,6390,4882,1354,1254,62,59,3246,3200,295,4810,1220,0
20:19:10,12440.2,Fox,6446,121,42,14,15,18,25,7,6446,6404,6390,4883,1354,1254,62,59,3246,3200,295,4810,1220,0
20:19:10,12441.39,Fox,6446,121,40,16,13,20,25,7,6446,6406,6390,4885,1354,1254,62,59,3246,3200,295,4810,1220,0
20:19:10,12441.99,Fox,6446,121,40,16,13,20,24,8,6446,6406,6390,4885,1354,1255,62,59,3246,3200,295,4810,1220,0
20:19:11,12442.89,Fox,6446,119,40,16,11,22,23,7,6446,6406,6390,4887,1354,1256,61,58,3246,3200,295,4810,1222,0
20:19:11,12443.49,Fox,6446,119,38,18,11,22,23,7,6446,6408,6390,4887,1354,1256,61,58,3246,3200,295,4810,1222,0
20:19:12,12446.19,Fox,6450,121,42,18,10,21,23,7,6450,6408,6390,4887,1354,1256,62,59,3249,3201,295,4812,1222,0
20:19:12,12447.39,Fox,6452,122,44,18,10,20,23,7,6452,6408,6390,4887,1354,1256,64,58,3251,3201,295,4813,1222,0
20:19:13,12449.79,Fox,6452,122,42,20,10,20,22,8,6452,6410,6390,4887,1354,1257,64,58,3251,3201,295,4813,1222,0
20:19:13,12450.38,Fox,6452,121,42,18,12,19,22,8,6452,6410,6392,4887,1354,1257,64,57,3251,3201,296,4813,1222,0
20:19:14,12451.29,Fox,6452,120,42,16,14,19,21,8,6452,6410,6394,4887,1354,1257,64,56,3251,3201,296,4814,1222,0
20:19:14,12451.58,Fox,6452,119,42,16,14,18,21,8,6452,6410,6394,4887,1354,1257,64,55,3251,3201,297,4814,1222,0
20:19:15,12455.76,Fox,6452,119,42,14,16,16,23,8,6452,6410,6396,4887,1356,1257,64,55,3251,3201,297,4814,1222,0
20:19:17,12459.34,Fox,6452,119,42,12,18,16,23,8,6452,6410,6398,4887,1356,1257,64,55,3251,3201,297,4814,1222,0
20:19:17,12461.44,Fox,6454,121,44,12,18,16,23,8,6454,6410,6398,4887,1356,1257,65,56,3252,3202,297,4814,1222,0
20:19:17,12461.74,Fox,6454,121,44,10,20,16,23,8,6454,6410,6400,4887,1356,1257,65,56,3252,3202,297,4814,1222,0
20:19:18,12462.64,Fox,6454,121,44,10,20,14,25,8,6454,6410,6400,4887,1358,1257,65,56,3252,3202,297,4814,1222,0
20:19:18,12463.54,Fox,6458,124,46,10,19,14,25,8,6456,6410,6400,4887,1358,1257,66,58,3254,3204,298,4814,1222,0
20:19:18,12463.84,Fox,6458,124,48,10,19,13,26,8,6458,6410,6400,4887,1359,1257,66,58,3254,3204,298,4814,1222,0
20:19:19,12467.12,Fox,6460,125,50,10,18,13,26,8,6460,6410,6400,4887,1359,1257,67,58,3256,3204,298,4815,1222,0
20:19:19,12467.42,Fox,6460,125,50,10,18,12,27,8,6460,6410,6400,4887,1360,1257,67,58,3256,3204,298,4815,1222,0
20:19:20,12468.62,Fox,6460,125,48,12,18,12,27,8,6460,6412,6400,4887,1360,1257,67,58,3256,3204,298,4815,1222,0
20:19:20,12469.52,Fox,6460,125,46,14,17,13,27,8,6460,6414,6400,4888,1360,1257,67,58,3256,3204,298,4815,1222,0
20:19:20,12469.82,Fox,6460,125,46,14,15,15,27,8,6460,6414,6400,4890,1360,1257,67,58,3256,3204,298,4815,1222,0
20:19:21,12470.72,Fox,6462,127,48,14,15,15,27,8,6462,6414,6400,4890,1360,1257,68,59,3257,3205,298,4815,1222,0
20:19:21,12471.91,Fox,6462,127,44,18,15,15,27,8,6462,6418,6400,4890,1360,1257,68,59,3257,3205,298,4815,1222,0
20:19:21,12472.51,Fox,6462,127,44,18,13,17,27,8,6462,6418,6400,4892,1360,1257,68,59,3257,3205,298,4815,1222,0
20:19:22,12474.31,Fox,6462,127,44,18,12,18,27,8,6462,6418,6400,4893,1360,1257,68,59,3257,3205,298,4815,1222,0
20:19:23,12476.09,Fox,6462,127,44,16,14,16,27,10,6462,6418,6402,4893,1362,1259,68,59,3257,3205,298,4815,1222,0
20:19:23,12476.39,Fox,6462,127,44,14,16,16,27,10,6462,6418,6404,4893,1362,1259,68,59,3257,3205,298,4815,1222,0
20:19:23,12477.29,Fox,6462,127,42,16,16,16,27,10,6462,6420,6404,4893,1362,1259,68,59,3257,3205,298,4815,1222,0
20:19:23,12478.45,Fox,6462,127,42,16,16,16,26,11,6462,6420,6404,4893,1362,1260,68,59,3257,3205,298,4815,1222,0
20:19:24,12479.62,Fox,6462,126,40,18,16,15,26,11,6462,6422,6404,4893,1362,1260,68,58,3257,3205,298,4816,1222,0
20:19:24,12480.2,Fox,6462,125,40,16,18,14,26,11,6462,6422,6406,4893,1362,1260,68,57,3257,3205,298,4817,1222,0
20:19:25,12481.95,Fox,6462,125,38,16,20,14,26,11,6462,6424,6408,4893,1362,1260,68,57,3257,3205,298,4817,1222,0
20:19:25,12482.55,Fox,6464,127,36,18,20,14,26,11,6462,6426,6408,4893,1362,1260,69,58,3258,3206,298,4817,1222,0
20:19:25,12483.13,Fox,6464,124,38,18,17,15,26,10,6464,6426,6408,4896,1362,1260,67,57,3258,3206,298,4819,1223,0
20:19:26,12484.63,Fox,6464,123,38,18,17,14,26,10,6464,6426,6408,4896,1362,1260,67,56,3258,3206,299,4819,1223,0
20:19:27,12487.92,Fox,6464,123,38,16,19,14,26,10,6464,6426,6410,4896,1362,1260,67,56,3258,3206,299,4819,1223,0
20:19:27,12489.42,Fox,6466,125,40,16,19,14,26,10,6466,6426,6410,4896,1362,1260,67,58,3258,3208,299,4819,1223,0
20:19:27,12489.71,Fox,6466,124,40,16,19,14,26,9,6466,6426,6410,4896,1362,1260,67,57,3258,3208,299,4819,1224,0
20:19:28,12491.8,Fox,6468,125,40,18,18,14,26,9,6468,6428,6410,4896,1362,1260,67,58,3259,3209,300,4819,1224,0
20:19:28,12492.97,Fox,6468,124,40,18,18,13,26,9,6468,6428,6410,4896,1362,1260,66,58,3259,3209,300,4820,1224,0
20:19:29,12493.54,Fox,6468,123,40,18,18,13,26,8,6468,6428,6410,4896,1362,1260,66,57,3259,3209,300,4820,1225,0
20:19:29,12494.44,Fox,6468,123,38,20,18,13,26,8,6468,6430,6410,4896,1362,1260,66,57,3259,3209,300,4820,1225,0
20:19:30,12496.23,Fox,6468,123,36,22,18,11,26,10,6468,6432,6410,4896,1364,1262,66,57,3259,3209,300,4820,1225,0
20:19:30,12498.25,Fox,6468,122,36,22,16,13,26,9,6468,6432,6410,4898,1364,1262,66,56,3259,3209,300,4820,1226,0
20:19:31,12501.73,Fox,6468,122,36,22,16,12,27,9,6468,6432,6410,4898,1365,1262,66,56,3259,3209,300,4820,1226,0
20:19:32,12502.59,Fox,6470,124,38,22,16,12,27,9,6470,6432,6410,4898,1365,1262,67,57,3260,3210,300,4820,1226,0
20:19:32,12504,Fox,6470,124,38,22,16,11,28,9,6470,6432,6410,4898,1366,1262,67,57,3260,3210,300,4820,1226,0
20:19:32,12504.5,Fox,6470,124,36,24,16,11,28,9,6470,6434,6410,4898,1366,1262,67,57,3260,3210,300,4820,1226,0
20:19:33,12505.58,Fox,6472,126,38,24,16,11,28,9,6472,6434,6410,4898,1366,1262,68,58,3261,3211,300,4820,1226,0
20:19:33,12507.08,Fox,6472,126,38,22,18,11,28,9,6472,6434,6412,4898,1366,1262,68,58,3261,3211,300,4820,1226,0
20:19:34,12508.32,Fox,6472,125,38,20,20,11,28,8,6472,6434,6414,4898,1366,1262,68,57,3261,3211,300,4820,1227,0
20:19:34,12508.86,Fox,6472,125,36,22,20,11,28,8,6472,6436,6414,4898,1366,1262,68,57,3261,3211,300,4820,1227,0
20:19:34,12509.39,Fox,6472,125,34,24,20,11,28,8,6472,6438,6414,4898,1366,1262,68,57,3261,3211,300,4820,1227,0
20:19:34,12510.42,Fox,6472,125,34,20,24,11,28,8,6472,6438,6418,4898,1366,1262,68,57,3261,3211,300,4820,1227,0
20:19:34,12510.91,Fox,6472,125,34,20,22,13,28,8,6472,6438,6418,4900,1366,1262,68,57,3261,3211,300,4820,1227,0
20:19:35,12511.36,Fox,6472,125,34,20,20,14,29,8,6472,6438,6418,4902,1367,1262,68,57,3261,3211,300,4820,1227,0
20:19:35,12512.33,Fox,6472,124,32,22,20,13,29,8,6472,6440,6418,4902,1367,1262,67,57,3261,3211,300,4821,1227,0
20:19:36,12513.85,Fox,6472,123,30,24,20,13,27,9,6472,6442,6418,4902,1367,1264,66,57,3261,3211,300,4821,1228,0
20:19:36,12515.92,Fox,6472,123,30,22,21,14,27,9,6472,6442,6420,4903,1367,1264,66,57,3261,3211,300,4821,1228,0
20:19:36,12516.14,Fox,6472,122,30,22,21,14,27,8,6472,6442,6420,4903,1367,1264,65,57,3261,3211,300,4821,1229,0
20:19:37,12516.88,Fox,6472,122,28,24,21,14,27,8,6472,6444,6420,4903,1367,1264,65,57,3261,3211,300,4821,1229,0
20:19:37,12517.84,Fox,6474,124,30,22,23,14,27,8,6474,6444,6422,4903,1367,1264,65,59,3261,3213,300,4821,1229,0
20:19:37,12518.33,Fox,6474,124,28,24,23,14,27,8,6474,6446,6422,4903,1367,1264,65,59,3261,3213,300,4821,1229,0
20:19:38,12519.86,Fox,6474,124,28,24,21,16,27,8,6474,6446,6422,4905,1367,1264,65,59,3261,3213,300,4821,1229,0
20:19:38,12520.64,Fox,6474,124,28,20,25,16,27,8,6474,6446,6426,4905,1367,1264,65,59,3261,3213,300,4821,1229,0
20:19:38,12521.68,Fox,6476,123,28,20,24,14,27,8,6474,6446,6426,4905,1367,1264,65,58,3262,3214,300,4824,1229,0
20:19:38,12522.22,Fox,6476,122,30,20,22,15,27,8,6476,6446,6426,4907,1367,1264,65,57,3262,3214,300,4825,1229,0
20:19:40,12526.58,Fox,6476,120,30,20,22,14,27,7,6476,6446,6426,4907,1367,1264,65,55,3262,3214,301,4825,1230,0
20:19:41,12528.91,Fox,6478,121,26,24,22,14,27,6,6476,6450,6426,4907,1367,1264,66,55,3264,3214,301,4825,1231,0
20:19:41,12529.13,Fox,6478,121,28,24,22,14,27,6,6478,6450,6426,4907,1367,1264,66,55,3264,3214,301,4825,1231,0
20:19:41,12530.07,Fox,6478,121,26,24,24,14,27,6,6478,6452,6428,4907,1367,1264,66,55,3264,3214,301,4825,1231,0
20:19:41,12530.28,Fox,6478,119,26,24,24,12,27,6,6478,6452,6428,4907,1367,1264,64,55,3264,3214,301,4827,1231,0
20:19:42,12532.99,Fox,6478,118,26,22,26,11,26,7,6478,6452,6430,4907,1367,1265,64,54,3264,3214,301,4828,1231,0
20:19:43,12534.65,Fox,6478,118,26,20,28,11,26,7,6478,6452,6432,4907,1367,1265,64,54,3264,3214,301,4828,1231,0
20:19:43,12536.4,Fox,6478,118,26,20,27,11,27,7,6478,6452,6432,4908,1368,1265,64,54,3264,3214,301,4828,1231,0
20:19:43,12536.88,Fox,6480,119,28,20,25,13,27,6,6480,6452,6432,4910,1368,1265,66,53,3266,3214,301,4828,1232,0
20:19:43,12537.12,Fox,6480,119,28,20,25,13,26,7,6480,6452,6432,4910,1368,1266,66,53,3266,3214,301,4828,1232,0
20:19:44,12538.53,Fox,6484,123,30,20,25,13,26,7,6482,6452,6432,4910,1368,1266,67,56,3267,3217,301,4828,1232,0
20:19:44,12538.77,Fox,6484,123,32,20,25,13,26,7,6484,6452,6432,4910,1368,1266,67,56,3267,3217,301,4828,1232,0
20:19:44,12539.47,Fox,6486,125,34,20,25,13,26,7,6486,6452,6432,4910,1368,1266,69,56,3269,3217,301,4828,1232,0
20:19:44,12539.7,Fox,6486,125,34,20,25,13,25,8,6486,6452,6432,4910,1368,1267,69,56,3269,3217,301,4828,1232,0
20:19:44,12540.18,Fox,6486,125,34,20,23,15,25,8,6486,6452,6432,4912,1368,1267,69,56,3269,3217,301,4828,1232,0
20:19:45,12542.4,Fox,6486,125,34,20,21,17,25,8,6486,6452,6432,4914,1368,1267,69,56,3269,3217,301,4828,1232,0
20:19:45,12543.27,Fox,6486,124,34,18,23,17,25,7,6486,6452,6434,4914,1368,1267,68,56,3269,3217,301,4828,1233,0
20:19:46,12543.98,Fox,6486,124,32,20,23,17,25,7,6486,6454,6434,4914,1368,1267,68,56,3269,3217,301,4828,1233,0
20:19:46,12546.35,Fox,6486,122,28,24,23,16,25,6,6486,6458,6434,4914,1368,1267,66,56,3269,3217,301,4829,1234,0
20:19:47,12546.84,Fox,6486,121,28,24,23,15,23,8,6486,6458,6434,4914,1368,1269,65,56,3269,3217,301,4830,1234,0
20:19:47,12547.31,Fox,6486,121,28,22,25,15,23,8,6486,6458,6436,4914,1368,1269,65,56,3269,3217,301,4830,1234,0
20:19:47,12547.75,Fox,6486,121,28,20,27,15,23,8,6486,6458,6438,4914,1368,1269,65,56,3269,3217,301,4830,1234,0
20:19:47,12548.36,Fox,6486,121,28,20,25,17,23,8,6486,6458,6438,4916,1368,1269,65,56,3269,3217,301,4830,1234,0
20:19:48,12549.63,Fox,6486,121,26,22,25,17,23,8,6486,6460,6438,4916,1368,1269,65,56,3269,3217,301,4830,1234,0
20:19:48,12550.52,Fox,6486,121,26,20,27,17,23,8,6486,6460,6440,4916,1368,1269,65,56,3269,3217,301,4830,1234,0
20:19:48,12551.92,Fox,6486,121,26,18,29,17,23,8,6486,6460,6442,4916,1368,1269,65,56,3269,3217,301,4830,1234,0
20:19:49,12552.78,Fox,6486,119,26,18,29,15,23,8,6486,6460,6442,4916,1368,1269,63,56,3269,3217,301,4832,1234,0
20:19:49,12553.54,Fox,6488,121,24,20,29,15,23,8,6486,6462,6442,4916,1368,1269,65,56,3271,3217,301,4832,1234,0
20:19:49,12553.84,Fox,6488,121,26,20,29,15,22,9,6488,6462,6442,4916,1368,1270,65,56,3271,3217,301,4832,1234,0
20:19:49,12555.24,Fox,6488,121,26,18,31,15,22,9,6488,6462,6444,4916,1368,1270,65,56,3271,3217,301,4832,1234,0
20:19:50,12556.88,Fox,6494,125,28,16,31,15,22,9,6490,6462,6446,4916,1368,1270,65,60,3273,3221,301,4834,1234,0
20:19:50,12557.41,Fox,6496,126,32,16,30,15,22,9,6494,6462,6446,4916,1368,1270,65,61,3274,3222,302,4834,1234,0
20:19:50,12557.67,Fox,6496,126,34,16,30,15,20,11,6496,6462,6446,4916,1368,1272,65,61,3274,3222,302,4834,1234,0
20:19:51,12558.87,Fox,6496,126,34,16,30,15,18,13,6496,6462,6446,4916,1368,1274,65,61,3274,3222,302,4834,1234,0
20:19:52,12561.34,Fox,6496,125,34,16,30,15,18,12,6496,6462,6446,4916,1368,1274,64,61,3274,3222,302,4834,1235,0
20:19:52,12563.1,Fox,6496,125,34,16,30,14,19,12,6496,6462,6446,4916,1369,1274,64,61,3274,3222,302,4834,1235,0
20:19:53,12565.32,Fox,6496,125,32,18,30,14,19,12,6496,6464,6446,4916,1369,1274,64,61,3274,3222,302,4834,1235,0
20:19:54,12567.56,Fox,6496,125,32,14,32,16,19,12,6496,6464,6450,4918,1369,1274,64,61,3274,3222,302,4834,1235,0
20:19:54,12568.45,Fox,6496,125,32,12,32,18,19,12,6496,6464,6452,4920,1369,1274,64,61,3274,3222,302,4834,1235,0
20:19:55,12570.7,Fox,6496,125,32,12,28,22,19,12,6496,6464,6452,4924,1369,1274,64,61,3274,3222,302,4834,1235,0
20:19:55,12572,Fox,6498,127,32,14,28,22,19,12,6498,6466,6452,4924,1369,1274,65,62,3275,3223,302,4834,1235,0
20:19:56,12574.34,Fox,6498,126,30,16,28,22,17,13,6498,6468,6452,4924,1369,1276,65,61,3275,3223,302,4834,1236,0
20:19:56,12574.81,Fox,6498,126,30,16,28,22,15,15,6498,6468,6452,4924,1369,1278,65,61,3275,3223,302,4834,1236,0
20:19:57,12576.26,Fox,6500,128,32,16,26,24,15,15,6500,6468,6452,4926,1369,1278,67,61,3277,3223,302,4834,1236,0
20:19:57,12576.51,Fox,6500,128,32,16,26,23,16,15,6500,6468,6452,4926,1370,1278,67,61,3277,3223,302,4834,1236,0
20:19:57,12578.1,Fox,6502,128,34,16,25,23,16,14,6502,6468,6452,4926,1370,1278,68,60,3279,3223,302,4835,1237,0
20:19:57,12578.33,Fox,6502,128,34,16,24,24,16,14,6502,6468,6452,4927,1370,1278,68,60,3279,3223,302,4835,1237,0
20:19:57,12578.81,Fox,6502,127,34,16,24,23,16,14,6502,6468,6452,4927,1370,1278,68,59,3279,3223,302,4836,1237,0
20:19:58,12580.71,Fox,6504,129,36,16,23,24,16,14,6504,6468,6452,4928,1370,1278,69,60,3280,3224,302,4836,1237,0
20:19:58,12580.95,Fox,6504,129,36,16,22,25,16,14,6504,6468,6452,4929,1370,1278,69,60,3280,3224,302,4836,1237,0
20:19:59,12582.45,Fox,6506,131,38,14,24,25,16,14,6506,6468,6454,4929,1370,1278,71,60,3282,3224,302,4836,1237,0
20:19:59,12583.1,Fox,6508,132,40,14,23,25,16,14,6508,6468,6454,4929,1370,1278,72,60,3284,3224,302,4837,1237,0
20:19:59,12584.23,Fox,6508,131,40,14,23,25,16,13,6508,6468,6454,4929,1370,1278,71,60,3284,3224,302,4837,1238,0
20:20:00,12584.91,Fox,6510,133,40,10,27,25,16,13,6508,6468,6458,4929,1370,1278,71,62,3284,3226,302,4837,1238,0
20:20:00,12585.15,Fox,6510,133,40,12,27,25,16,13,6510,6470,6458,4929,1370,1278,71,62,3284,3226,302,4837,1238,0
20:20:00,12585.9,Fox,6514,137,44,12,27,25,16,13,6514,6470,6458,4929,1370,1278,74,63,3287,3227,302,4837,1238,0
20:20:00,12586.9,Fox,6516,138,46,12,26,25,16,13,6516,6470,6458,4929,1370,1278,73,65,3287,3229,302,4838,1238,0
20:20:00,12587.14,Fox,6516,137,46,12,26,25,16,12,6516,6470,6458,4929,1370,1278,73,64,3287,3229,302,4838,1239,0
20:20:01,12588.09,Fox,6516,136,44,12,28,25,16,11,6516,6472,6460,4929,1370,1278,72,64,3287,3229,302,4838,1240,0
20:20:01,12588.77,Fox,6516,135,44,12,28,24,16,11,6516,6472,6460,4929,1370,1278,72,63,3287,3229,303,4838,1240,0
20:20:01,12590.59,Fox,6516,135,44,12,26,26,16,11,6516,6472,6460,4931,1370,1278,72,63,3287,3229,303,4838,1240,0
20:20:02,12591.69,Fox,6516,134,44,10,28,23,18,11,6516,6472,6462,4931,1372,1278,72,62,3287,3229,304,4838,1240,0
20:20:02,12592.88,Fox,6518,135,46,10,27,23,18,11,6518,6472,6462,4931,1372,1278,71,64,3287,3231,304,4839,1240,0
20:20:02,12593.34,Fox,6520,137,46,10,25,25,16,13,6518,6472,6462,4933,1372,1280,72,65,3288,3232,304,4839,1240,0
20:20:02,12593.61,Fox,6520,136,48,10,25,25,16,12,6520,6472,6462,4933,1372,1280,72,64,3288,3232,304,4839,1241,0
20:20:03,12595.01,Fox,6520,136,48,10,23,27,16,12,6520,6472,6462,4935,1372,1280,72,64,3288,3232,304,4839,1241,0
20:20:04,12597.16,Fox,6522,138,50,10,23,27,16,12,6522,6472,6462,4935,1372,1280,72,66,3288,3234,304,4839,1241,0
20:20:04,12599.8,Fox,6522,138,50,10,23,27,14,14,6522,6472,6462,4935,1372,1282,72,66,3288,3234,304,4839,1241,0
20:20:05,12600.41,Fox,6522,138,48,12,23,27,14,14,6522,6474,6462,4935,1372,1282,72,66,3288,3234,304,4839,1241,0
20:20:05,12601.11,Fox,6522,137,48,12,23,26,13,15,6522,6474,6462,4935,1372,1283,72,65,3288,3234,305,4839,1241,0
20:20:06,12603.72,Fox,6522,135,48,12,22,25,13,15,6522,6474,6462,4936,1372,1283,72,63,3288,3234,305,4841,1241,0
20:20:06,12603.95,Fox,6522,135,48,10,24,25,13,15,6522,6474,6464,4936,1372,1283,72,63,3288,3234,305,4841,1241,0
20:20:06,12604.62,Fox,6522,135,46,12,24,25,12,16,6522,6476,6464,4936,1372,1284,72,63,3288,3234,305,4841,1241,0
20:20:06,12604.83,Fox,6522,135,46,12,24,24,13,16,6522,6476,6464,4936,1373,1284,72,63,3288,3234,305,4841,1241,0
20:20:07,12606.7,Fox,6526,138,50,12,23,24,13,16,6526,6476,6464,4936,1373,1284,74,64,3291,3235,305,4842,1241,0
20:20:07,12607.61,Fox,6526,138,50,12,22,25,13,16,6526,6476,6464,4937,1373,1284,74,64,3291,3235,305,4842,1241,0
20:20:07,12608.25,Fox,6526,137,50,12,21,26,13,15,6526,6476,6464,4938,1373,1284,74,63,3291,3235,305,4842,1242,0
20:20:08,12609.32,Fox,6528,139,52,12,21,26,13,15,6528,6476,6464,4938,1373,1284,75,64,3292,3236,305,4842,1242,0
20:20:08,12610.64,Fox,6528,138,52,10,23,26,13,14,6528,6476,6466,4938,1373,1284,75,63,3292,3236,305,4842,1243,0
20:20:08,12611.06,Fox,6528,138,52,10,21,28,13,14,6528,6476,6466,4940,1373,1284,75,63,3292,3236,305,4842,1243,0
20:20:09,12611.93,Fox,6530,140,50,12,21,28,13,14,6528,6478,6466,4940,1373,1284,76,64,3293,3237,305,4842,1243,0
20:20:09,12612.14,Fox,6530,140,52,12,21,28,13,14,6530,6478,6466,4940,1373,1284,76,64,3293,3237,305,4842,1243,0
20:20:09,12612.85,Fox,6530,140,52,10,21,30,13,14,6530,6478,6468,4942,1373,1284,76,64,3293,3237,305,4842,1243,0
20:20:09,12613.3,Fox,6530,140,52,10,21,30,11,16,6530,6478,6468,4942,1373,1286,76,64,3293,3237,305,4842,1243,0
20:20:09,12613.92,Fox,6530,139,52,10,21,29,11,16,6530,6478,6468,4942,1373,1286,76,63,3293,3237,305,4843,1243,0
20:20:10,12615.71,Fox,6530,139,52,10,20,29,12,16,6530,6478,6468,4943,1374,1286,76,63,3293,3237,305,4843,1243,0
20:20:10,12617.25,Fox,6530,139,52,10,18,31,12,16,6530,6478,6468,4945,1374,1286,76,63,3293,3237,305,4843,1243,0
20:20:11,12618.18,Fox,6530,138,52,10,18,30,12,16,6530,6478,6468,4945,1374,1286,76,62,3293,3237,305,4844,1243,0
20:20:11,12619.4,Fox,6530,138,50,12,18,30,12,16,6530,6480,6468,4945,1374,1286,76,62,3293,3237,305,4844,1243,0
20:20:12,12621.28,Fox,6530,138,46,16,18,30,12,16,6530,6484,6468,4945,1374,1286,76,62,3293,3237,305,4844,1243,0
20:20:12,12622.12,Fox,6534,142,48,18,18,30,12,16,6534,6486,6468,4945,1374,1286,78,64,3295,3239,305,4844,1243,0
20:20:13,12623.89,Fox,6536,143,48,16,19,30,12,16,6534,6486,6470,4945,1374,1286,78,65,3296,3240,305,4845,1243,0
20:20:13,12624.13,Fox,6536,143,50,16,19,30,12,16,6536,6486,6470,4945,1374,1286,78,65,3296,3240,305,4845,1243,0
20:20:13,12625.01,Fox,6538,144,50,16,19,30,12,15,6536,6486,6470,4945,1374,1286,78,66,3297,3241,305,4845,1244,0
20:20:13,12625.26,Fox,6538,143,52,16,19,30,12,14,6538,6486,6470,4945,1374,1286,77,66,3297,3241,305,4845,1245,0
20:20:13,12625.99,Fox,6540,145,54,16,19,30,12,14,6540,6486,6470,4945,1374,1286,77,68,3297,3243,305,4845,1245,0
20:20:14,12626.68,Fox,6540,145,54,14,21,30,12,14,6540,6486,6472,4945,1374,1286,77,68,3297,3243,305,4845,1245,0
20:20:14,12627.88,Fox,6540,143,54,14,18,31,12,14,6540,6486,6472,4948,1374,1286,75,68,3297,3243,305,4847,1245,0
20:20:14,12629.04,Fox,6540,143,54,14,16,33,12,14,6540,6486,6472,4950,1374,1286,75,68,3297,3243,305,4847,1245,0
20:20:15,12629.74,Fox,6540,142,54,14,16,33,12,13,6540,6486,6472,4950,1374,1286,74,68,3297,3243,305,4847,1246,0
20:20:15,12630.42,Fox,6540,142,54,14,16,31,14,13,6540,6486,6472,4950,1376,1286,74,68,3297,3243,305,4847,1246,0
20:20:16,12633.23,Fox,6540,142,54,14,16,31,12,15,6540,6486,6472,4950,1376,1288,74,68,3297,3243,305,4847,1246,0
20:20:16,12633.69,Fox,6540,142,54,14,16,29,14,15,6540,6486,6472,4950,1378,1288,74,68,3297,3243,305,4847,1246,0
20:20:16,12634.84,Fox,6540,141,54,14,16,29,14,14,6540,6486,6472,4950,1378,1288,73,68,3297,3243,305,4847,1247,0
20:20:17,12636.46,Fox,6540,141,52,16,16,29,14,14,6540,6488,6472,4950,1378,1288,73,68,3297,3243,305,4847,1247,0
20:20:17,12637.11,Fox,6542,143,54,16,16,29,14,14,6542,6488,6472,4950,1378,1288,74,69,3298,3244,305,4847,1247,0
20:20:17,12638.22,Fox,6542,142,54,16,16,28,14,14,6542,6488,6472,4950,1378,1288,73,69,3298,3244,305,4848,1247,0
20:20:18,12638.95,Fox,6544,144,56,14,18,28,14,14,6544,6488,6474,4950,1378,1288,74,70,3299,3245,305,4848,1247,0
20:20:18,12639.43,Fox,6544,144,54,16,18,28,13,15,6544,6490,6474,4950,1378,1289,74,70,3299,3245,305,4848,1247,0
20:20:18,12639.91,Fox,6544,143,50,20,18,28,13,14,6544,6494,6474,4950,1378,1289,73,70,3299,3245,305,4848,1248,0
20:20:18,12640.15,Fox,6544,143,48,22,18,28,13,14,6544,6496,6474,4950,1378,1289,73,70,3299,3245,305,4848,1248,0
20:20:18,12641.13,Fox,6546,145,50,22,18,28,13,14,6546,6496,6474,4950,1378,1289,74,71,3300,3246,305,4848,1248,0
20:20:18,12641.37,Fox,6546,145,50,22,18,28,12,15,6546,6496,6474,4950,1378,1290,74,71,3300,3246,305,4848,1248,0
20:20:19,12641.81,Fox,6546,145,50,22,18,26,14,15,6546,6496,6474,4950,1380,1290,74,71,3300,3246,305,4848,1248,0
20:20:19,12643.11,Fox,6546,145,50,20,18,28,14,15,6546,6496,6476,4952,1380,1290,74,71,3300,3246,305,4848,1248,0
20:20:19,12643.57,Fox,6546,143,50,20,18,28,14,13,6546,6496,6476,4952,1380,1290,73,70,3300,3246,305,4848,1250,0
20:20:20,12645.13,Fox,6546,142,50,20,16,30,14,12,6546,6496,6476,4954,1380,1290,73,69,3300,3246,305,4848,1251,0
20:20:20,12645.36,Fox,6546,141,50,20,15,31,14,11,6546,6496,6476,4955,1380,1290,72,69,3300,3246,305,4848,1252,0
20:20:21,12647.59,Fox,6546,140,50,20,15,31,14,10,6546,6496,6476,4955,1380,1290,71,69,3300,3246,305,4848,1253,0
20:20:21,12649.03,Fox,6548,142,50,20,13,33,13,11,6546,6496,6476,4957,1380,1291,72,70,3301,3247,305,4848,1253,0
20:20:21,12649.29,Fox,6548,142,52,20,13,33,13,11,6548,6496,6476,4957,1380,1291,72,70,3301,3247,305,4848,1253,0
20:20:22,12650.32,Fox,6548,142,52,18,15,33,13,11,6548,6496,6478,4957,1380,1291,72,70,3301,3247,305,4848,1253,0
20:20:22,12652.23,Fox,6548,142,52,18,13,35,13,11,6548,6496,6478,4959,1380,1291,72,70,3301,3247,305,4848,1253,0
20:20:23,12653.55,Fox,6548,140,52,18,13,33,13,11,6548,6496,6478,4959,1380,1291,71,69,3301,3247,305,4850,1253,0
20:20:23,12654.43,Fox,6550,142,54,18,13,33,13,11,6550,6496,6478,4959,1380,1291,73,69,3303,3247,305,4850,1253,0
20:20:23,12654.9,Fox,6550,141,52,20,13,33,13,10,6550,6498,6478,4959,1380,1291,73,68,3303,3247,305,4850,1254,0
20:20:23,12655.85,Fox,6550,140,52,20,13,32,13,10,6550,6498,6478,4959,1380,1291,73,67,3303,3247,305,4851,1254,0
20:20:24,12657.21,Fox,6552,141,54,20,13,31,13,10,6552,6498,6478,4959,1380,1291,72,69,3303,3249,305,4852,1254,0
20:20:24,12657.88,Fox,6552,141,54,18,15,31,13,10,6552,6498,6480,4959,1380,1291,72,69,3303,3249,305,4852,1254,0
20:20:24,12658.79,Fox,6552,141,52,20,15,31,13,10,6552,6500,6480,4959,1380,1291,72,69,3303,3249,305,4852,1254,0
20:20:25,12659.19,Fox,6552,140,52,20,15,30,13,10,6552,6500,6480,4959,1380,1291,72,68,3303,3249,305,4853,1254,0
20:20:25,12659.81,Fox,6552,140,52,16,19,30,13,10,6552,6500,6484,4959,1380,1291,72,68,3303,3249,305,4853,1254,0
20:20:25,12660.63,Fox,6552,140,50,16,21,30,13,10,6552,6502,6486,4959,1380,1291,72,68,3303,3249,305,4853,1254,0
20:20:25,12661.06,Fox,6552,140,50,16,21,28,15,10,6552,6502,6486,4959,1382,1291,72,68,3303,3249,305,4853,1254,0
20:20:25,12661.97,Fox,6552,139,50,16,21,27,16,9,6552,6502,6486,4959,1383,1291,72,67,3303,3249,305,4853,1255,0
20:20:26,12663.31,Fox,6554,141,50,18,21,27,16,9,6554,6504,6486,4959,1383,1291,74,67,3305,3249,305,4853,1255,0
20:20:26,12663.96,Fox,6554,141,50,18,21,25,18,9,6554,6504,6486,4959,1385,1291,74,67,3305,3249,305,4853,1255,0
20:20:26,12664.61,Fox,6556,143,52,18,19,25,20,9,6556,6504,6486,4961,1387,1291,74,69,3305,3251,305,4853,1255,0
20:20:27,12665.06,Fox,6556,143,50,20,19,25,20,9,6556,6506,6486,4961,1387,1291,74,69,3305,3251,305,4853,1255,0
20:20:27,12665.74,Fox,6558,144,50,22,19,24,20,9,6558,6508,6486,4961,1387,1291,74,70,3306,3252,305,4854,1255,0
20:20:27,12666.45,Fox,6560,145,52,22,19,23,20,9,6560,6508,6486,4961,1387,1291,74,71,3307,3253,305,4855,1255,0
20:20:27,12667.82,Fox,6560,145,50,24,19,23,20,9,6560,6510,6486,4961,1387,1291,74,71,3307,3253,305,4855,1255,0
20:20:28,12668.42,Fox,6560,145,46,28,19,23,20,9,6560,6514,6486,4961,1387,1291,74,71,3307,3253,305,4855,1255,0
20:20:28,12669.69,Fox,6560,144,44,30,19,21,22,8,6560,6516,6486,4961,1389,1291,73,71,3307,3253,305,4855,1256,0
20:20:28,12670.98,Fox,6560,143,44,30,17,23,22,7,6560,6516,6486,4963,1389,1291,72,71,3307,3253,305,4855,1257,0
20:20:29,12673.11,Fox,6562,144,46,30,16,23,22,7,6562,6516,6486,4963,1389,1291,72,72,3308,3254,305,4856,1257,0
20:20:29,12673.33,Fox,6562,144,46,30,14,25,22,7,6562,6516,6486,4965,1389,1291,72,72,3308,3254,305,4856,1257,0
20:20:29,12674.02,Fox,6562,143,46,30,14,25,21,7,6562,6516,6486,4965,1389,1292,71,72,3308,3254,305,4856,1258,0
20:20:30,12674.22,Fox,6562,143,46,30,14,24,22,7,6562,6516,6486,4965,1390,1292,71,72,3308,3254,305,4856,1258,0
20:20:30,12675.11,Fox,6564,145,48,28,16,24,22,7,6564,6516,6488,4965,1390,1292,72,73,3309,3255,305,4856,1258,0
20:20:30,12675.56,Fox,6564,145,46,30,16,24,22,7,6564,6518,6488,4965,1390,1292,72,73,3309,3255,305,4856,1258,0
20:20:30,12676.2,Fox,6564,145,44,32,16,24,22,7,6564,6520,6488,4965,1390,1292,72,73,3309,3255,305,4856,1258,0
20:20:31,12677.77,Fox,6566,147,46,32,16,24,22,7,6566,6520,6488,4965,1390,1292,73,74,3310,3256,305,4856,1258,0
20:20:31,12678.3,Fox,6566,147,46,26,22,24,22,7,6566,6520,6494,4965,1390,1292,73,74,3310,3256,305,4856,1258,0
20:20:31,12678.79,Fox,6566,147,46,24,24,24,22,7,6566,6520,6496,4965,1390,1292,73,74,3310,3256,305,4856,1258,0
20:20:31,12679.69,Fox,6566,147,44,26,24,24,22,7,6566,6522,6496,4965,1390,1292,73,74,3310,3256,305,4856,1258,0
20:20:32,12680.33,Fox,6568,149,46,26,24,24,22,7,6568,6522,6496,4965,1390,1292,74,75,3311,3257,305,4856,1258,0
20:20:32,12681.54,Fox,6568,147,46,26,24,22,22,7,6568,6522,6496,4965,1390,1292,74,73,3311,3257,306,4857,1258,0
20:20:33,12683.38,Fox,6570,149,48,26,24,22,22,7,6570,6522,6496,4965,1390,1292,74,75,3311,3259,306,4857,1258,0
20:20:33,12684.12,Fox,6570,148,48,26,23,21,23,7,6570,6522,6496,4966,1391,1292,74,74,3311,3259,306,4858,1258,0
20:20:34,12687.17,Fox,6572,150,50,26,21,23,23,7,6572,6522,6496,4968,1391,1292,76,74,3313,3259,306,4858,1258,0
20:20:44,12688.71,Fox,6572,150,50,26,21,21,25,7,6572,6522,6496,4968,1393,1292,76,74,3313,3259,306,4858,1258,0
20:20:44,12689.27,Fox,6572,150,46,30,21,21,25,7,6572,6526,6496,4968,1393,1292,76,74,3313,3259,306,4858,1258,0
20:20:46,12692.21,Fox,6574,151,46,32,20,21,25,7,6574,6528,6496,4968,1393,1292,77,74,3315,3259,306,4859,1258,0
20:20:46,12693.31,Fox,6574,151,46,30,22,21,25,7,6574,6528,6498,4968,1393,1292,77,74,3315,3259,306,4859,1258,0
20:20:47,12694.76,Fox,6574,150,44,32,22,20,25,7,6574,6530,6498,4968,1393,1292,77,73,3315,3259,306,4860,1258,0
20:20:48,12697.7,Fox,6574,149,44,30,24,19,25,7,6574,6530,6500,4968,1393,1292,77,72,3315,3259,306,4861,1258,0
20:20:48,12698.7,Fox,6576,150,46,30,24,19,24,7,6576,6530,6500,4968,1393,1292,77,73,3316,3260,306,4862,1258,0
20:20:48,12699.4,Fox,6576,150,46,28,24,21,24,7,6576,6530,6502,4970,1393,1292,77,73,3316,3260,306,4862,1258,0
20:20:49,12700.66,Fox,6576,150,46,28,24,21,23,8,6576,6530,6502,4970,1393,1293,77,73,3316,3260,306,4862,1258,0
20:20:49,12701.73,Fox,6576,150,46,26,26,20,24,8,6576,6530,6504,4970,1394,1293,77,73,3316,3260,306,4862,1258,0
20:20:50,12703.74,Fox,6576,150,46,24,27,21,24,8,6576,6530,6506,4971,1394,1293,77,73,3316,3260,306,4862,1258,0
20:20:50,12704.26,Fox,6576,150,46,22,29,21,24,8,6576,6530,6508,4971,1394,1293,77,73,3316,3260,306,4862,1258,0
20:20:50,12704.68,Fox,6576,150,42,26,29,21,24,8,6576,6534,6508,4971,1394,1293,77,73,3316,3260,306,4862,1258,0
20:20:51,12706.26,Fox,6576,150,42,24,31,19,26,8,6576,6534,6510,4971,1396,1293,77,73,3316,3260,306,4862,1258,0
20:20:51,12706.96,Fox,6576,150,40,22,35,19,26,8,6576,6536,6514,4971,1396,1293,77,73,3316,3260,306,4862,1258,0
20:20:51,12707.89,Fox,6576,150,38,22,37,19,26,8,6576,6538,6516,4971,1396,1293,77,73,3316,3260,306,4862,1258,0
20:20:51,12708.61,Fox,6576,150,36,24,37,19,26,8,6576,6540,6516,4971,1396,1293,77,73,3316,3260,306,4862,1258,0
20:20:52,12709.28,Fox,6576,150,36,24,37,18,27,8,6576,6540,6516,4971,1397,1293,77,73,3316,3260,306,4862,1258,0
20:20:52,12710.74,Fox,6576,150,36,24,35,20,27,8,6576,6540,6516,4973,1397,1293,77,73,3316,3260,306,4862,1258,0
20:20:53,12714.13,Fox,6578,150,36,22,36,19,26,9,6576,6540,6518,4973,1397,1294,78,72,3318,3260,306,4864,1258,0
20:20:54,12714.68,Fox,6578,149,38,20,38,19,26,8,6578,6540,6520,4973,1397,1294,78,71,3318,3260,306,4864,1259,0
20:20:54,12715.36,Fox,6584,154,44,20,37,19,26,8,6584,6540,6520,4973,1397,1294,82,72,3323,3261,306,4865,1259,0
20:20:55,12718.32,Fox,6586,156,46,18,39,19,26,8,6586,6540,6522,4973,1397,1294,83,73,3324,3262,306,4865,1259,0
20:20:55,12718.54,Fox,6586,155,46,18,38,20,25,8,6586,6540,6522,4974,1397,1294,83,72,3324,3262,306,4866,1259,0
20:20:55,12719.86,Fox,6590,158,48,20,38,20,25,7,6590,6542,6522,4974,1397,1294,85,73,3327,3263,306,4866,1260,0
20:20:56,12720.33,Fox,6590,158,48,20,34,24,25,7,6590,6542,6522,4978,1397,1294,85,73,3327,3263,306,4866,1260,0
20:20:56,12721.16,Fox,6590,158,48,20,32,25,26,7,6590,6542,6522,4980,1398,1294,85,73,3327,3263,306,4866,1260,0
20:20:56,12721.6,Fox,6590,158,46,22,32,25,26,7,6590,6544,6522,4980,1398,1294,85,73,3327,3263,306,4866,1260,0
20:20:56,12722.26,Fox,6594,161,50,22,31,25,26,7,6594,6544,6522,4980,1398,1294,86,75,3329,3265,307,4866,1260,0
20:20:56,12722.5,Fox,6594,161,50,22,31,23,28,7,6594,6544,6522,4980,1400,1294,86,75,3329,3265,307,4866,1260,0
20:20:57,12723.67,Fox,6594,161,48,24,31,23,28,7,6594,6546,6522,4980,1400,1294,86,75,3329,3265,307,4866,1260,0
20:20:57,12724.85,Fox,6596,163,50,24,31,23,28,7,6596,6546,6522,4980,1400,1294,87,76,3330,3266,307,4866,1260,0
20:20:57,12725.57,Fox,6598,165,52,24,31,23,28,7,6598,6546,6522,4980,1400,1294,89,76,3332,3266,307,4866,1260,0
20:20:58,12727.8,Fox,6598,165,52,20,35,23,28,7,6598,6546,6526,4980,1400,1294,89,76,3332,3266,307,4866,1260,0
20:20:58,12728.97,Fox,6598,164,52,20,35,22,26,9,6598,6546,6526,4980,1400,1296,88,76,3332,3266,307,4867,1260,0
20:20:59,12730.39,Fox,6598,164,52,18,37,22,26,9,6598,6546,6528,4980,1400,1296,88,76,3332,3266,307,4867,1260,0
20:20:59,12731.1,Fox,6600,163,54,18,36,20,26,9,6600,6546,6528,4980,1400,1296,88,75,3333,3267,307,4870,1260,0
20:20:59,12731.82,Fox,6600,162,52,20,36,20,26,8,6600,6548,6528,4980,1400,1296,88,74,3333,3267,307,4870,1261,0
20:21:00,12732.88,Fox,6600,161,52,20,36,20,26,7,6600,6548,6528,4980,1400,1296,88,73,3333,3267,307,4870,1262,0
20:21:00,12733.34,Fox,6600,161,52,18,38,20,26,7,6600,6548,6530,4980,1400,1296,88,73,3333,3267,307,4870,1262,0
20:21:00,12734.87,Fox,6602,161,52,18,37,20,26,6,6600,6548,6530,4980,1400,1296,87,74,3333,3269,307,4871,1263,0
20:21:00,12735.1,Fox,6602,161,54,18,37,20,26,6,6602,6548,6530,4980,1400,1296,87,74,3333,3269,307,4871,1263,0
20:21:01,12736.23,Fox,6602,160,54,18,37,20,26,5,6602,6548,6530,4980,1400,1296,86,74,3333,3269,307,4872,1263,0
20:21:01,12737.37,Fox,6604,161,52,20,36,20,26,5,6602,6550,6530,4980,1400,1296,86,75,3334,3270,307,4873,1263,0
20:21:01,12737.63,Fox,6604,161,54,20,36,20,26,5,6604,6550,6530,4980,1400,1296,86,75,3334,3270,307,4873,1263,0
20:21:02,12738.65,Fox,6604,161,54,20,31,23,28,5,6604,6550,6530,4985,1402,1296,86,75,3334,3270,307,4873,1263,0
20:21:02,12739.33,Fox,6604,160,54,20,30,24,27,5,6604,6550,6530,4986,1402,1296,85,75,3334,3270,307,4874,1263,0
20:21:02,12739.74,Fox,6604,160,52,22,30,24,27,5,6604,6552,6530,4986,1402,1296,85,75,3334,3270,307,4874,1263,0
20:21:02,12741.08,Fox,6606,161,54,22,29,24,27,5,6606,6552,6530,4986,1402,1296,86,75,3336,3270,307,4875,1263,0
20:21:03,12742.5,Fox,6606,161,54,22,29,23,27,6,6606,6552,6530,4986,1403,1297,86,75,3336,3270,307,4875,1263,0
20:21:03,12743.19,Fox,6606,161,54,18,33,23,27,6,6606,6552,6534,4986,1403,1297,86,75,3336,3270,307,4875,1263,0
20:21:04,12744.33,Fox,6610,164,58,18,33,23,27,5,6610,6552,6534,4986,1403,1297,87,77,3338,3272,307,4875,1264,0
20:21:04,12744.76,Fox,6610,163,58,18,33,23,27,4,6610,6552,6534,4986,1403,1297,87,76,3338,3272,307,4875,1265,0
20:21:04,12745.25,Fox,6610,163,58,16,35,23,27,4,6610,6552,6536,4986,1403,1297,87,76,3338,3272,307,4875,1265,0
20:21:04,12745.96,Fox,6610,163,56,18,35,21,29,4,6610,6554,6536,4986,1405,1297,87,76,3338,3272,307,4875,1265,0
20:21:04,12746.44,Fox,6610,163,56,16,37,21,29,4,6610,6554,6538,4986,1405,1297,87,76,3338,3272,307,4875,1265,0
20:21:05,12747.3,Fox,6612,164,56,16,38,21,29,4,6612,6556,6540,4986,1405,1297,86,78,3338,3274,307,4876,1265,0
20:21:05,12748.46,Fox,6612,164,54,18,38,21,29,4,6612,6558,6540,4986,1405,1297,86,78,3338,3274,307,4876,1265,0
20:21:05,12749.16,Fox,6612,162,52,20,38,19,29,4,6612,6560,6540,4986,1405,1297,85,77,3338,3274,307,4878,1265,0
20:21:06,12751.37,Fox,6612,161,52,20,38,19,29,3,6612,6560,6540,4986,1405,1297,85,76,3338,3274,307,4878,1266,0
20:21:07,12753.64,Fox,6612,161,52,20,36,21,29,3,6612,6560,6540,4988,1405,1297,85,76,3338,3274,307,4878,1266,0
20:21:07,12754.38,Fox,6614,162,54,20,35,21,29,3,6614,6560,6540,4988,1405,1297,85,77,3339,3275,308,4878,1266,0
20:21:07,12755.84,Fox,6614,162,52,22,35,21,29,3,6614,6562,6540,4988,1405,1297,85,77,3339,3275,308,4878,1266,0
20:21:08,12757.2,Fox,6616,164,54,22,35,21,29,3,6616,6562,6540,4988,1405,1297,86,78,3340,3276,308,4878,1266,0
20:21:08,12757.96,Fox,6618,166,52,24,33,21,31,3,6616,6564,6540,4990,1407,1297,87,79,3341,3277,308,4878,1266,0
20:21:08,12758.24,Fox,6618,166,54,22,35,21,31,3,6618,6564,6542,4990,1407,1297,87,79,3341,3277,308,4878,1266,0
20:21:08,12759,Fox,6622,170,58,22,35,21,31,3,6622,6564,6542,4990,1407,1297,89,81,3343,3279,308,4878,1266,0
20:21:09,12760.27,Fox,6622,170,56,22,37,21,31,3,6622,6566,6544,4990,1407,1297,89,81,3343,3279,308,4878,1266,0
20:21:10,12762.21,Fox,6622,170,56,20,38,22,31,3,6622,6566,6546,4991,1407,1297,89,81,3343,3279,308,4878,1266,0
20:21:10,12762.86,Fox,6622,170,54,22,38,22,31,3,6622,6568,6546,4991,1407,1297,89,81,3343,3279,308,4878,1266,0
20:21:10,12764.23,Fox,6624,171,56,22,35,24,31,3,6624,6568,6546,4993,1407,1297,88,83,3343,3281,308,4879,1266,0
20:21:10,12764.7,Fox,6624,171,56,22,33,26,31,3,6624,6568,6546,4995,1407,1297,88,83,3343,3281,308,4879,1266,0
20:21:11,12766.26,Fox,6626,172,56,24,32,26,31,3,6626,6570,6546,4995,1407,1297,88,84,3344,3282,309,4879,1266,0
20:21:11,12766.74,Fox,6626,172,56,24,30,27,32,3,6626,6570,6546,4997,1408,1297,88,84,3344,3282,309,4879,1266,0
20:21:11,12767.36,Fox,6626,172,56,24,27,30,32,3,6626,6570,6546,5000,1408,1297,88,84,3344,3282,309,4879,1266,0
20:21:11,12767.82,Fox,6626,172,56,24,27,30,30,5,6626,6570,6546,5000,1408,1299,88,84,3344,3282,309,4879,1266,0
20:21:12,12768.49,Fox,6628,173,58,24,24,32,30,5,6628,6570,6546,5002,1408,1299,89,84,3346,3282,309,4880,1266,0
20:21:12,12769.78,Fox,6630,174,58,26,23,32,30,5,6630,6572,6546,5002,1408,1299,88,86,3346,3284,310,4880,1266,0
20:21:12,12770.67,Fox,6632,176,60,24,25,32,30,5,6632,6572,6548,5002,1408,1299,89,87,3347,3285,310,4880,1266,0
20:21:13,12771.33,Fox,6634,178,60,24,25,32,28,7,6632,6572,6548,5002,1408,1301,89,89,3347,3287,310,4880,1266,0
20:21:13,12771.59,Fox,6634,178,62,24,25,32,28,7,6634,6572,6548,5002,1408,1301,89,89,3347,3287,310,4880,1266,0
20:21:13,12773.02,Fox,6636,179,62,24,25,31,28,7,6634,6572,6548,5002,1408,1301,90,89,3348,3288,311,4880,1266,0
20:21:13,12773.28,Fox,6636,179,64,24,25,31,28,7,6636,6572,6548,5002,1408,1301,90,89,3348,3288,311,4880,1266,0
20:21:14,12774.7,Fox,6636,179,62,26,23,33,28,7,6636,6574,6548,5004,1408,1301,90,89,3348,3288,311,4880,1266,0
20:21:14,12775.18,Fox,6636,178,62,26,22,33,28,7,6636,6574,6548,5005,1408,1301,89,89,3348,3288,311,4881,1266,0
20:21:14,12775.68,Fox,6636,178,62,24,24,33,28,7,6636,6574,6550,5005,1408,1301,89,89,3348,3288,311,4881,1266,0
20:21:15,12777.21,Fox,6636,176,62,24,24,31,28,7,6636,6574,6550,5005,1408,1301,89,87,3348,3288,311,4883,1266,0
20:21:15,12777.9,Fox,6636,172,62,24,24,28,28,6,6636,6574,6550,5005,1408,1301,86,86,3348,3288,311,4886,1267,0
20:21:15,12778.32,Fox,6636,172,62,22,26,28,28,6,6636,6574,6552,5005,1408,1301,86,86,3348,3288,311,4886,1267,0
20:21:15,12779.01,Fox,6636,170,62,22,24,28,28,6,6636,6574,6552,5007,1408,1301,86,84,3348,3288,311,4888,1267,0
20:21:15,12779.42,Fox,6636,169,62,22,24,28,26,7,6636,6574,6552,5007,1408,1303,85,84,3348,3288,311,4888,1268,0
20:21:16,12780.5,Fox,6636,169,62,22,24,27,27,7,6636,6574,6552,5007,1409,1303,85,84,3348,3288,311,4888,1268,0
20:21:16,12781.17,Fox,6636,169,60,24,24,27,27,7,6636,6576,6552,5007,1409,1303,85,84,3348,3288,311,4888,1268,0
20:21:16,12781.9,Fox,6638,171,62,24,24,27,27,7,6638,6576,6552,5007,1409,1303,87,84,3350,3288,311,4888,1268,0
20:21:17,12782.85,Fox,6640,173,64,24,24,27,27,7,6640,6576,6552,5007,1409,1303,88,85,3351,3289,311,4888,1268,0
20:21:17,12783.08,Fox,6640,172,64,24,24,27,27,6,6640,6576,6552,5007,1409,1303,88,84,3351,3289,311,4888,1269,0
20:21:17,12784.31,Fox,6642,174,66,22,26,27,27,6,6642,6576,6554,5007,1409,1303,90,84,3353,3289,311,4888,1269,0
20:21:17,12784.77,Fox,6644,175,68,22,25,27,27,6,6644,6576,6554,5007,1409,1303,90,85,3354,3290,311,4889,1269,0
20:21:17,12785.27,Fox,6646,176,70,22,24,27,27,6,6646,6576,6554,5007,1409,1303,91,85,3356,3290,311,4890,1269,0
20:21:18,12785.79,Fox,6646,176,70,20,26,27,27,6,6646,6576,6556,5007,1409,1303,91,85,3356,3290,311,4890,1269,0
20:21:18,12786.82,Fox,6650,179,72,18,27,27,27,6,6648,6576,6558,5007,1409,1303,92,87,3358,3292,311,4891,1269,0
20:21:18,12787.08,Fox,6650,179,74,18,27,27,27,6,6650,6576,6558,5007,1409,1303,92,87,3358,3292,311,4891,1269,0
20:21:18,12787.58,Fox,6650,179,74,16,29,27,27,6,6650,6576,6560,5007,1409,1303,92,87,3358,3292,311,4891,1269,0
20:21:18,12788.3,Fox,6650,178,74,16,26,30,27,5,6650,6576,6560,5010,1409,1303,91,87,3358,3292,311,4891,1270,0
20:21:19,12789.06,Fox,6652,180,76,16,26,30,27,5,6652,6576,6560,5010,1409,1303,93,87,3360,3292,311,4891,1270,0
20:21:19,12789.31,Fox,6652,178,76,16,26,28,27,5,6652,6576,6560,5010,1409,1303,93,85,3360,3292,311,4893,1270,0
20:21:19,12790.97,Fox,6652,178,76,16,25,29,27,5,6652,6576,6560,5011,1409,1303,93,85,3360,3292,311,4893,1270,0
20:21:20,12792.87,Fox,6652,178,76,16,25,27,29,5,6652,6576,6560,5011,1411,1303,93,85,3360,3292,311,4893,1270,0
20:21:20,12793.78,Fox,6652,178,76,16,24,28,29,5,6652,6576,6560,5012,1411,1303,93,85,3360,3292,311,4893,1270,0
20:21:20,12794.2,Fox,6652,178,76,14,26,28,29,5,6652,6576,6562,5012,1411,1303,93,85,3360,3292,311,4893,1270,0
20:21:21,12795.57,Fox,6656,182,80,14,26,28,29,5,6656,6576,6562,5012,1411,1303,96,86,3363,3293,311,4893,1270,0
20:21:21,12796.54,Fox,6658,183,80,12,27,28,29,5,6656,6576,6564,5012,1411,1303,97,86,3365,3293,311,4894,1270,0
20:21:21,12797.07,Fox,6662,186,80,14,27,27,29,5,6658,6578,6564,5012,1411,1303,98,88,3367,3295,311,4895,1270,0
20:21:21,12797.34,Fox,6662,186,84,14,27,27,29,5,6662,6578,6564,5012,1411,1303,98,88,3367,3295,311,4895,1270,0
20:21:22,12798.36,Fox,6666,189,82,20,26,27,29,5,6666,6584,6564,5012,1411,1303,100,89,3370,3296,311,4896,1270,0
20:21:22,12798.87,Fox,6666,189,82,18,28,27,27,7,6666,6584,6566,5012,1411,1305,100,89,3370,3296,311,4896,1270,0
20:21:22,12799.38,Fox,6666,189,82,18,28,27,26,8,6666,6584,6566,5012,1411,1306,100,89,3370,3296,311,4896,1270,0
20:21:23,12801.35,Fox,6666,188,80,20,28,26,26,8,6666,6586,6566,5012,1411,1306,100,88,3370,3296,312,4896,1270,0
20:21:23,12801.8,Fox,6668,190,80,18,30,26,22,12,6666,6586,6568,5012,1411,1310,102,88,3372,3296,312,4896,1270,0
20:21:23,12802.08,Fox,6668,190,82,18,30,26,22,12,6668,6586,6568,5012,1411,1310,102,88,3372,3296,312,4896,1270,0
20:21:23,12802.61,Fox,6668,190,78,22,30,26,22,12,6668,6590,6568,5012,1411,1310,102,88,3372,3296,312,4896,1270,0
20:21:24,12803.86,Fox,6668,190,78,22,28,28,22,12,6668,6590,6568,5014,1411,1310,102,88,3372,3296,312,4896,1270,0
20:21:24,12804.57,Fox,6668,189,78,20,30,25,24,12,6668,6590,6570,5014,1413,1310,102,87,3372,3296,313,4896,1270,0
20:21:24,12804.82,Fox,6668,189,74,24,30,25,24,12,6668,6594,6570,5014,1413,1310,102,87,3372,3296,313,4896,1270,0
20:21:24,12805.88,Fox,6668,189,74,24,28,27,24,12,6668,6594,6570,5016,1413,1310,102,87,3372,3296,313,4896,1270,0
20:21:25,12806.82,Fox,6668,189,74,24,27,28,24,12,6668,6594,6570,5017,1413,1310,102,87,3372,3296,313,4896,1270,0
20:21:25,12807.49,Fox,6668,189,72,26,25,30,22,14,6668,6596,6570,5019,1413,1312,102,87,3372,3296,313,4896,1270,0
20:21:25,12808.46,Fox,6670,190,70,26,26,30,22,14,6668,6598,6572,5019,1413,1312,102,88,3373,3297,313,4897,1270,0
20:21:25,12808.7,Fox,6670,190,72,26,26,30,22,14,6670,6598,6572,5019,1413,1312,102,88,3373,3297,313,4897,1270,0
20:21:26,12809.75,Fox,6672,192,74,26,26,30,22,14,6672,6598,6572,5019,1413,1312,103,89,3374,3298,313,4897,1270,0
20:21:26,12811.68,Fox,6672,192,74,26,26,30,21,15,6672,6598,6572,5019,1413,1313,103,89,3374,3298,313,4897,1270,0
20:21:27,12813.57,Fox,6672,192,74,24,28,28,23,15,6672,6598,6574,5019,1415,1313,103,89,3374,3298,313,4897,1270,0
20:21:27,12813.82,Fox,6672,192,72,26,28,28,23,15,6672,6600,6574,5019,1415,1313,103,89,3374,3298,313,4897,1270,0
20:21:27,12814.56,Fox,6672,190,72,26,28,24,25,15,6672,6600,6574,5019,1417,1313,103,87,3374,3298,313,4899,1270,0
20:21:28,12816.11,Fox,6672,188,72,26,28,22,25,15,6672,6600,6574,5019,1417,1313,102,86,3374,3298,313,4901,1270,0
20:21:28,12817.28,Fox,6672,187,72,26,28,21,25,15,6672,6600,6574,5019,1417,1313,102,85,3374,3298,313,4902,1270,0
20:21:28,12817.99,Fox,6672,185,70,28,28,19,25,15,6672,6602,6574,5019,1417,1313,102,83,3374,3298,313,4904,1270,0
20:21:29,12818.67,Fox,6672,185,70,28,27,20,25,15,6672,6602,6574,5020,1417,1313,102,83,3374,3298,313,4904,1270,0
20:21:29,12820.14,Fox,6672,185,68,28,29,20,25,15,6672,6604,6576,5020,1417,1313,102,83,3374,3298,313,4904,1270,0
20:21:29,12820.64,Fox,6672,185,68,28,28,21,25,15,6672,6604,6576,5021,1417,1313,102,83,3374,3298,313,4904,1270,0
20:21:30,12821.62,Fox,6672,184,68,28,28,21,24,15,6672,6604,6576,5021,1417,1314,101,83,3374,3298,313,4904,1271,0
20:21:30,12822.07,Fox,6672,183,68,28,28,21,24,14,6672,6604,6576,5021,1417,1314,101,82,3374,3298,313,4904,1272,0
20:21:30,12822.78,Fox,6672,183,68,28,26,23,24,14,6672,6604,6576,5023,1417,1314,101,82,3374,3298,313,4904,1272,0
20:21:30,12823.65,Fox,6672,183,66,30,26,23,24,14,6672,6606,6576,5023,1417,1314,101,82,3374,3298,313,4904,1272,0
20:21:31,12826.01,Fox,6674,184,68,30,25,23,24,14,6674,6606,6576,5023,1417,1314,101,83,3375,3299,313,4905,1272,0
20:21:31,12826.55,Fox,6676,186,70,30,25,23,22,16,6676,6606,6576,5023,1417,1316,102,84,3376,3300,313,4905,1272,0
20:21:31,12827.05,Fox,6676,186,66,34,25,23,22,16,6676,6610,6576,5023,1417,1316,102,84,3376,3300,313,4905,1272,0
20:21:32,12829.27,Fox,6676,184,66,34,25,22,22,15,6676,6610,6576,5023,1417,1316,102,82,3376,3300,313,4906,1273,0
20:21:32,12830.04,Fox,6676,184,64,36,25,22,22,15,6676,6612,6576,5023,1417,1316,102,82,3376,3300,313,4906,1273,0
20:21:33,12830.78,Fox,6676,184,64,36,24,23,22,15,6676,6612,6576,5024,1417,1316,102,82,3376,3300,313,4906,1273,0
20:21:33,12831.97,Fox,6676,183,64,36,24,21,24,14,6676,6612,6576,5024,1419,1316,102,81,3376,3300,313,4906,1274,0
20:21:33,12832.23,Fox,6676,183,64,36,24,20,25,14,6676,6612,6576,5024,1420,1316,102,81,3376,3300,313,4906,1274,0
20:21:33,12832.72,Fox,6676,183,64,36,24,19,26,14,6676,6612,6576,5024,1421,1316,102,81,3376,3300,313,4906,1274,0
20:21:34,12834.78,Fox,6678,185,66,36,24,19,26,14,6678,6612,6576,5024,1421,1316,103,82,3377,3301,313,4906,1274,0
20:21:34,12835.74,Fox,6680,187,68,34,26,19,26,14,6680,6612,6578,5024,1421,1316,104,83,3378,3302,313,4906,1274,0
20:21:34,12836.01,Fox,6680,187,68,34,24,21,26,14,6680,6612,6578,5026,1421,1316,104,83,3378,3302,313,4906,1274,0
20:21:35,12836.51,Fox,6680,187,68,28,30,21,26,14,6680,6612,6584,5026,1421,1316,104,83,3378,3302,313,4906,1274,0
20:21:35,12837.27,Fox,6682,189,68,30,30,21,26,14,6682,6614,6584,5026,1421,1316,104,85,3378,3304,313,4906,1274,0
20:21:35,12837.79,Fox,6684,190,70,30,30,20,26,14,6684,6614,6584,5026,1421,1316,105,85,3380,3304,313,4907,1274,0
20:21:35,12838.81,Fox,6684,190,70,30,28,22,26,14,6684,6614,6584,5028,1421,1316,105,85,3380,3304,313,4907,1274,0
20:21:36,12839.8,Fox,6684,189,68,30,30,22,26,13,6684,6616,6586,5028,1421,1316,104,85,3380,3304,313,4907,1275,0
20:21:36,12840.73,Fox,6686,191,68,32,30,22,26,13,6686,6618,6586,5028,1421,1316,106,85,3382,3304,313,4907,1275,0
20:21:36,12840.98,Fox,6686,191,68,28,34,22,26,13,6686,6618,6590,5028,1421,1316,106,85,3382,3304,313,4907,1275,0
20:21:36,12841.71,Fox,6686,190,64,32,34,21,26,13,6686,6622,6590,5028,1421,1316,106,84,3382,3304,313,4908,1275,0
20:21:36,12842.2,Fox,6688,192,66,32,34,21,26,13,6688,6622,6590,5028,1421,1316,107,85,3383,3305,313,4908,1275,0
20:21:37,12843.72,Fox,6690,194,66,28,38,21,24,15,6688,6622,6594,5028,1421,1318,107,87,3383,3307,313,4908,1275,0
20:21:37,12843.97,Fox,6690,194,68,28,38,21,24,15,6690,6622,6594,5028,1421,1318,107,87,3383,3307,313,4908,1275,0
20:21:37,12844.99,Fox,6690,194,68,28,36,23,24,15,6690,6622,6594,5030,1421,1318,107,87,3383,3307,313,4908,1275,0
20:21:38,12846.16,Fox,6690,194,68,26,36,25,24,15,6690,6622,6596,5032,1421,1318,107,87,3383,3307,313,4908,1275,0
20:21:38,12846.89,Fox,6692,195,68,26,38,24,23,16,6692,6624,6598,5032,1421,1319,107,88,3384,3308,313,4909,1275,0
20:21:38,12847.42,Fox,6692,195,68,26,36,24,25,16,6692,6624,6598,5034,1423,1319,107,88,3384,3308,313,4909,1275,0
20:21:38,12847.69,Fox,6692,194,68,26,36,24,25,15,6692,6624,6598,5034,1423,1319,107,87,3384,3308,313,4909,1276,0
20:21:38,12848.15,Fox,6692,194,68,26,35,25,25,15,6692,6624,6598,5035,1423,1319,107,87,3384,3308,313,4909,1276,0
20:21:39,12849.13,Fox,6694,195,66,28,34,25,25,15,6692,6626,6598,5035,1423,1319,107,88,3385,3309,313,4910,1276,0
20:21:39,12849.43,Fox,6694,193,68,28,34,23,25,15,6694,6626,6598,5035,1423,1319,107,86,3385,3309,313,4912,1276,0
20:21:39,12850.21,Fox,6696,194,70,28,34,23,25,14,6696,6626,6598,5035,1423,1319,109,85,3387,3309,313,4912,1277,0
20:21:40,12851.44,Fox,6698,195,70,30,33,21,27,14,6698,6628,6598,5035,1425,1319,109,86,3388,3310,313,4913,1277,0
20:21:40,12852.46,Fox,6698,195,68,30,35,21,27,14,6698,6630,6600,5035,1425,1319,109,86,3388,3310,313,4913,1277,0
20:21:40,12853.21,Fox,6698,195,66,32,35,21,27,14,6698,6632,6600,5035,1425,1319,109,86,3388,3310,313,4913,1277,0
20:21:41,12854.2,Fox,6698,195,64,34,35,21,27,14,6698,6634,6600,5035,1425,1319,109,86,3388,3310,313,4913,1277,0
20:21:41,12854.68,Fox,6698,195,64,34,33,23,27,14,6698,6634,6600,5037,1425,1319,109,86,3388,3310,313,4913,1277,0
20:21:41,12855.79,Fox,6698,195,62,36,33,23,27,14,6698,6636,6600,5037,1425,1319,109,86,3388,3310,313,4913,1277,0
20:21:41,12856.22,Fox,6698,195,62,34,35,23,27,14,6698,6636,6602,5037,1425,1319,109,86,3388,3310,313,4913,1277,0
20:21:41,12856.64,Fox,6698,194,62,34,33,25,27,13,6698,6636,6602,5039,1425,1319,108,86,3388,3310,313,4913,1278,0
20:21:42,12857.54,Fox,6698,194,62,34,33,23,29,13,6698,6636,6602,5039,1427,1319,108,86,3388,3310,313,4913,1278,0
20:21:42,12858.46,Fox,6698,193,62,34,33,21,30,13,6698,6636,6602,5039,1428,1319,108,85,3388,3310,313,4914,1278,0
20:21:42,12858.67,Fox,6698,193,62,32,35,21,29,14,6698,6636,6604,5039,1428,1320,108,85,3388,3310,313,4914,1278,0
20:21:42,12859.62,Fox,6700,195,62,32,33,23,29,14,6698,6636,6604,5041,1428,1320,109,86,3389,3311,313,4914,1278,0
20:21:43,12860.14,Fox,6702,196,66,32,33,23,28,14,6702,6636,6604,5041,1428,1321,110,86,3390,3312,313,4914,1279,0
20:21:43,12860.62,Fox,6702,195,66,32,33,23,28,13,6702,6636,6604,5041,1428,1321,109,86,3390,3312,313,4914,1280,0
20:21:43,12862.26,Fox,6702,195,66,30,33,25,28,13,6702,6636,6606,5043,1428,1321,109,86,3390,3312,313,4914,1280,0
20:21:43,12862.49,Fox,6702,194,66,30,33,25,28,12,6702,6636,6606,5043,1428,1321,109,85,3390,3312,313,4914,1281,0
20:21:44,12863.68,Fox,6704,196,68,30,33,25,28,12,6704,6636,6606,5043,1428,1321,109,87,3390,3314,313,4914,1281,0
20:21:44,12864.41,Fox,6704,196,66,32,33,25,28,12,6704,6638,6606,5043,1428,1321,109,87,3390,3314,313,4914,1281,0
20:21:44,12865.1,Fox,6704,194,66,32,31,25,28,12,6704,6638,6606,5045,1428,1321,108,86,3390,3314,314,4915,1281,0
20:21:44,12865.58,Fox,6704,194,64,30,35,25,28,12,6704,6640,6610,5045,1428,1321,108,86,3390,3314,314,4915,1281,0
20:21:45,12867.01,Fox,6704,193,62,32,35,25,28,11,6704,6642,6610,5045,1428,1321,107,86,3390,3314,314,4915,1282,0
20:21:45,12867.78,Fox,6704,192,58,36,35,25,28,10,6704,6646,6610,5045,1428,1321,107,85,3390,3314,314,4915,1283,0
20:21:45,12868.31,Fox,6706,194,60,36,35,23,30,10,6706,6646,6610,5045,1430,1321,109,85,3392,3314,314,4915,1283,0
20:21:45,12868.82,Fox,6706,194,60,34,36,23,31,10,6706,6646,6612,5046,1431,1321,109,85,3392,3314,314,4915,1283,0
20:21:46,12869.56,Fox,6708,196,60,36,36,23,31,10,6708,6648,6612,5046,1431,1321,111,85,3394,3314,314,4915,1283,0
20:21:46,12869.81,Fox,6708,196,58,38,36,23,31,10,6708,6650,6612,5046,1431,1321,111,85,3394,3314,314,4915,1283,0
20:21:46,12871.77,Fox,6708,196,56,40,36,23,31,10,6708,6652,6612,5046,1431,1321,111,85,3394,3314,314,4915,1283,0
20:21:47,12872.5,Fox,6710,196,58,40,36,21,31,10,6710,6652,6612,5046,1431,1321,112,84,3396,3314,316,4915,1283,0
20:21:47,12873.04,Fox,6712,198,60,40,36,21,31,10,6712,6652,6612,5046,1431,1321,113,85,3397,3315,316,4915,1283,0
20:21:47,12873.79,Fox,6712,198,60,40,35,22,31,10,6712,6652,6612,5047,1431,1321,113,85,3397,3315,316,4915,1283,0
20:21:48,12875.7,Fox,6714,197,60,38,36,20,31,10,6712,6652,6614,5047,1431,1321,113,84,3398,3316,316,4918,1283,0
20:21:48,12876.24,Fox,6718,200,62,38,35,20,29,12,6714,6652,6614,5047,1431,1323,116,84,3402,3316,317,4918,1283,0
20:21:48,12876.53,Fox,6718,200,66,38,35,20,29,12,6718,6652,6614,5047,1431,1323,116,84,3402,3316,317,4918,1283,0
20:21:49,12878.36,Fox,6720,201,64,40,37,19,29,12,6720,6656,6616,5047,1431,1323,115,86,3402,3318,317,4919,1283,0
20:21:49,12879.7,Fox,6720,201,62,40,39,19,28,13,6720,6658,6618,5047,1431,1324,115,86,3402,3318,317,4919,1283,0
20:21:49,12880.25,Fox,6726,204,60,40,38,21,28,13,6722,6662,6622,5049,1431,1324,115,89,3405,3321,317,4922,1283,0
20:21:49,12880.55,Fox,6726,204,64,40,38,21,28,13,6726,6662,6622,5049,1431,1324,115,89,3405,3321,317,4922,1283,0
20:21:50,12881.07,Fox,6726,204,60,44,38,21,28,13,6726,6666,6622,5049,1431,1324,115,89,3405,3321,317,4922,1283,0
20:21:50,12881.82,Fox,6726,204,60,44,38,19,30,13,6726,6666,6622,5049,1433,1324,115,89,3405,3321,317,4922,1283,0
20:21:50,12882.57,Fox,6728,205,62,44,38,18,30,13,6728,6666,6622,5049,1433,1324,116,89,3407,3321,317,4923,1283,0
20:21:50,12882.86,Fox,6728,204,62,44,38,18,30,12,6728,6666,6622,5049,1433,1324,115,89,3407,3321,317,4923,1284,0
20:21:50,12883.43,Fox,6728,204,62,44,38,18,28,14,6728,6666,6622,5049,1433,1326,115,89,3407,3321,317,4923,1284,0
20:21:51,12884.73,Fox,6728,204,60,46,38,18,28,14,6728,6668,6622,5049,1433,1326,115,89,3407,3321,317,4923,1284,0
20:21:51,12885.25,Fox,6728,204,60,44,40,18,28,14,6728,6668,6624,5049,1433,1326,115,89,3407,3321,317,4923,1284,0
20:21:52,12887.61,Fox,6730,205,62,42,41,18,28,14,6730,6668,6626,5049,1433,1326,116,89,3409,3321,317,4924,1284,0
20:21:53,12889.8,Fox,6732,207,64,40,43,18,28,14,6732,6668,6628,5049,1433,1326,117,90,3410,3322,317,4924,1284,0
20:21:53,12890.39,Fox,6734,208,66,40,42,18,28,14,6734,6668,6628,5049,1433,1326,118,90,3412,3322,317,4925,1284,0
20:21:53,12890.97,Fox,6734,206,66,38,44,16,28,14,6734,6668,6630,5049,1433,1326,117,89,3412,3322,318,4926,1284,0
20:21:53,12891.52,Fox,6736,207,66,40,43,16,28,14,6736,6670,6630,5049,1433,1326,118,89,3414,3322,318,4927,1284,0
20:21:53,12891.8,Fox,6736,207,66,38,45,16,28,14,6736,6670,6632,5049,1433,1326,118,89,3414,3322,318,4927,1284,0
20:21:54,12892.66,Fox,6736,205,64,38,47,16,28,12,6736,6672,6634,5049,1433,1326,118,87,3414,3322,318,4927,1286,0
20:21:54,12893.5,Fox,6740,208,66,38,46,16,28,12,6738,6672,6634,5049,1433,1326,120,88,3417,3323,318,4928,1286,0
20:21:54,12893.78,Fox,6740,208,68,38,46,16,28,12,6740,6672,6634,5049,1433,1326,120,88,3417,3323,318,4928,1286,0
20:21:54,12894.35,Fox,6740,208,68,36,48,16,28,12,6740,6672,6636,5049,1433,1326,120,88,3417,3323,318,4928,1286,0
20:21:54,12895.41,Fox,6740,208,68,36,48,16,26,14,6740,6672,6636,5049,1433,1328,120,88,3417,3323,318,4928,1286,0
20:21:55,12895.96,Fox,6740,208,68,36,46,18,26,14,6740,6672,6636,5051,1433,1328,120,88,3417,3323,318,4928,1286,0
20:21:55,12896.48,Fox,6740,207,68,36,46,18,26,13,6740,6672,6636,5051,1433,1328,120,87,3417,3323,318,4928,1287,0
20:21:55,12897.05,Fox,6740,207,68,36,44,20,26,13,6740,6672,6636,5053,1433,1328,120,87,3417,3323,318,4928,1287,0
20:21:55,12897.91,Fox,6742,208,70,36,43,20,26,13,6742,6672,6636,5053,1433,1328,120,88,3418,3324,318,4929,1287,0
20:21:56,12900.09,Fox,6742,208,70,36,41,22,26,13,6742,6672,6636,5055,1433,1328,120,88,3418,3324,318,4929,1287,0
20:21:56,12900.94,Fox,6744,210,72,36,41,22,26,13,6744,6672,6636,5055,1433,1328,121,89,3419,3325,318,4929,1287,0
20:21:57,12901.77,Fox,6746,212,74,36,40,23,26,13,6746,6672,6636,5056,1433,1328,123,89,3421,3325,318,4929,1287,0
20:21:57,12903.15,Fox,6746,212,74,34,42,23,26,13,6746,6672,6638,5056,1433,1328,123,89,3421,3325,318,4929,1287,0
20:21:57,12903.96,Fox,6746,212,74,32,40,27,26,13,6746,6672,6640,5060,1433,1328,123,89,3421,3325,318,4929,1287,0
20:21:58,12904.5,Fox,6746,212,74,32,40,27,25,14,6746,6672,6640,5060,1433,1329,123,89,3421,3325,318,4929,1287,0
20:21:58,12905.57,Fox,6748,213,76,30,41,27,25,14,6748,6672,6642,5060,1433,1329,124,89,3423,3325,318,4930,1287,0
20:21:58,12906.09,Fox,6750,214,76,28,43,26,25,14,6748,6672,6644,5060,1433,1329,124,90,3424,3326,319,4930,1287,0
20:21:58,12906.67,Fox,6750,214,78,26,44,27,25,14,6750,6672,6646,5061,1433,1329,124,90,3424,3326,319,4930,1287,0
20:21:59,12907.52,Fox,6750,213,78,26,42,28,25,14,6750,6672,6646,5063,1433,1329,124,89,3424,3326,319,4931,1287,0
20:21:59,12908.36,Fox,6750,213,78,22,46,28,25,14,6750,6672,6650,5063,1433,1329,124,89,3424,3326,319,4931,1287,0
20:21:59,12908.65,Fox,6750,213,76,24,46,28,25,14,6750,6674,6650,5063,1433,1329,124,89,3424,3326,319,4931,1287,0
20:21:59,12909.2,Fox,6750,212,74,26,46,28,25,13,6750,6676,6650,5063,1433,1329,123,89,3424,3326,319,4931,1288,0
20:22:00,12910.38,Fox,6752,212,76,24,48,26,25,13,6752,6676,6652,5063,1433,1329,123,89,3425,3327,319,4933,1288,0
20:22:00,12910.68,Fox,6752,211,76,24,48,26,25,12,6752,6676,6652,5063,1433,1329,122,89,3425,3327,319,4933,1289,0
20:22:00,12911.57,Fox,6754,213,78,24,48,26,25,12,6754,6676,6652,5063,1433,1329,124,89,3427,3327,319,4933,1289,0
20:22:00,12912.13,Fox,6756,214,78,24,48,25,25,12,6754,6676,6652,5063,1433,1329,125,89,3428,3328,320,4933,1289,0
20:22:00,12912.7,Fox,6756,214,80,24,47,26,25,12,6756,6676,6652,5064,1433,1329,125,89,3428,3328,320,4933,1289,0
20:22:01,12913.27,Fox,6758,215,80,24,47,26,25,11,6756,6676,6652,5064,1433,1329,127,88,3430,3328,320,4933,1290,0
20:22:01,12913.85,Fox,6758,213,82,24,47,26,25,9,6758,6676,6652,5064,1433,1329,126,87,3430,3328,320,4933,1292,0
20:22:01,12914.14,Fox,6758,213,82,24,47,25,26,9,6758,6676,6652,5064,1434,1329,126,87,3430,3328,320,4933,1292,0
20:22:02,12916.62,Fox,6760,215,82,20,51,23,28,9,6758,6676,6656,5064,1436,1329,126,89,3430,3330,320,4933,1292,0
20:22:02,12917.21,Fox,6762,215,84,20,48,24,28,9,6760,6676,6656,5066,1436,1329,125,90,3430,3332,320,4935,1292,0
20:22:02,12917.8,Fox,6762,214,84,22,48,23,28,9,6762,6678,6656,5066,1436,1329,124,90,3430,3332,320,4936,1292,0
20:22:02,12918.39,Fox,6762,214,82,18,54,23,27,10,6762,6680,6662,5066,1436,1330,124,90,3430,3332,320,4936,1292,0
20:22:02,12918.98,Fox,6764,215,84,18,53,23,27,10,6764,6680,6662,5066,1436,1330,124,91,3431,3333,321,4936,1292,0
20:22:03,12919.58,Fox,6764,214,84,14,56,24,27,9,6764,6680,6666,5067,1436,1330,123,91,3431,3333,321,4937,1292,0
20:22:03,12919.87,Fox,6764,213,82,16,56,24,27,8,6764,6682,6666,5067,1436,1330,123,90,3431,3333,321,4937,1293,0
20:22:03,12920.45,Fox,6764,213,80,18,56,24,27,8,6764,6684,6666,5067,1436,1330,123,90,3431,3333,321,4937,1293,0
20:22:03,12921.62,Fox,6766,215,82,18,56,24,27,8,6766,6684,6666,5067,1436,1330,124,91,3432,3334,321,4937,1293,0
20:22:04,12923.03,Fox,6770,219,84,18,55,25,27,8,6768,6684,6666,5068,1436,1330,126,93,3434,3336,321,4937,1293,0
20:22:04,12923.33,Fox,6770,218,84,18,57,24,27,8,6770,6686,6668,5068,1436,1330,126,92,3434,3336,321,4938,1293,0
20:22:04,12924.76,Fox,6774,220,86,20,56,23,27,8,6774,6688,6668,5068,1436,1330,126,94,3436,3338,322,4939,1293,0
20:22:05,12925.94,Fox,6774,220,86,20,52,27,27,8,6774,6688,6668,5072,1436,1330,126,94,3436,3338,322,4939,1293,0
20:22:05,12926.73,Fox,6774,220,84,22,52,27,27,8,6774,6690,6668,5072,1436,1330,126,94,3436,3338,322,4939,1293,0
20:22:05,12927.25,Fox,6774,218,84,22,52,25,27,8,6774,6690,6668,5072,1436,1330,126,92,3436,3338,322,4941,1293,0
20:22:06,12929.27,Fox,6776,220,86,22,50,27,27,8,6776,6690,6668,5074,1436,1330,126,94,3436,3340,322,4941,1293,0
20:22:06,12929.87,Fox,6776,219,84,22,52,26,27,8,6776,6692,6670,5074,1436,1330,126,93,3436,3340,323,4941,1293,0
20:22:06,12930.76,Fox,6776,219,84,20,54,26,25,10,6776,6692,6672,5074,1436,1332,126,93,3436,3340,323,4941,1293,0
20:22:07,12931.65,Fox,6778,221,86,20,54,26,25,10,6778,6692,6672,5074,1436,1332,126,95,3436,3342,323,4941,1293,0
20:22:07,12931.94,Fox,6778,221,84,22,54,26,25,10,6778,6694,6672,5074,1436,1332,126,95,3436,3342,323,4941,1293,0
20:22:07,12932.75,Fox,6778,221,82,24,54,26,25,10,6778,6696,6672,5074,1436,1332,126,95,3436,3342,323,4941,1293,0
20:22:07,12933.6,Fox,6780,223,84,24,54,26,25,10,6780,6696,6672,5074,1436,1332,126,97,3436,3344,323,4941,1293,0
20:22:07,12934.14,Fox,6780,223,82,26,54,26,25,10,6780,6698,6672,5074,1436,1332,126,97,3436,3344,323,4941,1293,0
20:22:08,12936.15,Fox,6780,223,82,26,52,28,25,10,6780,6698,6672,5076,1436,1332,126,97,3436,3344,323,4941,1293,0
20:22:09,12938.45,Fox,6780,223,82,26,52,26,27,10,6780,6698,6672,5076,1438,1332,126,97,3436,3344,323,4941,1293,0
20:22:09,12939.34,Fox,6782,224,84,26,49,28,27,10,6782,6698,6672,5078,1438,1332,127,97,3438,3344,323,4942,1293,0
20:22:10,12939.94,Fox,6782,224,84,26,48,27,29,10,6782,6698,6672,5079,1440,1332,127,97,3438,3344,323,4942,1293,0
20:22:10,12940.84,Fox,6782,224,84,26,46,27,31,10,6782,6698,6672,5081,1442,1332,127,97,3438,3344,323,4942,1293,0
20:22:10,12941.69,Fox,6782,224,84,26,46,27,29,12,6782,6698,6672,5081,1442,1334,127,97,3438,3344,323,4942,1293,0
20:22:11,12942.84,Fox,6782,224,80,30,46,27,29,12,6782,6702,6672,5081,1442,1334,127,97,3438,3344,323,4942,1293,0
20:22:11,12945.19,Fox,6782,223,80,30,46,27,29,11,6782,6702,6672,5081,1442,1334,126,97,3438,3344,323,4942,1294,0
20:22:12,12945.79,Fox,6782,223,80,30,44,29,29,11,6782,6702,6672,5083,1442,1334,126,97,3438,3344,323,4942,1294,0
20:22:12,12946.39,Fox,6782,222,78,32,44,28,29,11,6782,6704,6672,5083,1442,1334,126,96,3438,3344,323,4943,1294,0
20:22:12,12947.27,Fox,6784,223,80,30,45,28,29,11,6784,6704,6674,5083,1442,1334,126,97,3439,3345,323,4944,1294,0
20:22:12,12947.87,Fox,6786,223,82,28,44,30,29,10,6786,6704,6676,5085,1442,1334,127,96,3441,3345,323,4945,1295,0
20:22:13,12948.47,Fox,6788,224,82,28,44,30,29,9,6786,6704,6676,5085,1442,1334,128,96,3443,3345,323,4945,1296,0
20:22:13,12949.07,Fox,6790,226,86,28,44,30,29,9,6790,6704,6676,5085,1442,1334,128,98,3443,3347,323,4945,1296,0
20:22:13,12950.57,Fox,6790,223,86,28,42,29,31,7,6790,6704,6676,5087,1444,1334,127,96,3443,3347,323,4946,1298,0
20:22:13,12951.16,Fox,6790,222,84,30,42,28,29,9,6790,6706,6676,5087,1444,1336,127,95,3443,3347,323,4947,1298,0
20:22:14,12951.46,Fox,6790,222,84,30,40,30,29,9,6790,6706,6676,5089,1444,1336,127,95,3443,3347,323,4947,1298,0
20:22:14,12952.34,Fox,6792,223,84,32,37,32,27,11,6792,6708,6676,5091,1444,1338,127,96,3444,3348,323,4948,1298,0
20:22:14,12953.21,Fox,6794,224,86,32,35,31,29,11,6794,6708,6676,5093,1446,1338,127,97,3445,3349,323,4949,1298,0
20:22:15,12955.14,Fox,6798,227,88,34,33,32,29,11,6798,6710,6676,5095,1446,1338,128,99,3447,3351,323,4950,1298,0
20:22:15,12955.73,Fox,6798,226,86,36,33,32,29,10,6798,6712,6676,5095,1446,1338,127,99,3447,3351,323,4950,1299,0
20:22:15,12956.32,Fox,6800,225,88,34,34,30,29,10,6800,6712,6678,5095,1446,1338,128,97,3449,3351,323,4953,1299,0
20:22:15,12956.91,Fox,6804,229,90,32,36,30,29,10,6802,6712,6680,5095,1446,1338,129,100,3450,3354,323,4953,1299,0
20:22:16,12957.51,Fox,6808,232,96,32,36,29,29,10,6808,6712,6680,5095,1446,1338,130,102,3452,3356,323,4954,1299,0
20:22:16,12958.66,Fox,6810,234,94,32,38,29,29,10,6808,6714,6682,5095,1446,1338,132,102,3454,3356,323,4954,1299,0
20:22:16,12959.26,Fox,6812,235,94,34,39,29,29,10,6812,6718,6684,5095,1446,1338,132,103,3455,3357,323,4955,1299,0
20:22:17,12961.02,Fox,6812,235,92,36,39,29,29,10,6812,6720,6684,5095,1446,1338,132,103,3455,3357,323,4955,1299,0
20:22:17,12962.22,Fox,6814,234,94,34,40,27,29,10,6814,6720,6686,5095,1446,1338,132,102,3456,3358,323,4958,1299,0
20:22:17,12963.1,Fox,6814,233,88,40,40,26,29,10,6814,6726,6686,5095,1446,1338,132,101,3456,3358,323,4959,1299,0
20:22:18,12963.7,Fox,6814,231,88,38,40,26,29,10,6814,6726,6688,5097,1446,1338,132,99,3456,3358,323,4961,1299,0
20:22:18,12964.6,Fox,6816,233,90,38,39,27,29,10,6816,6726,6688,5098,1446,1338,132,101,3456,3360,323,4961,1299,0
20:22:18,12965.2,Fox,6816,233,88,38,41,27,29,10,6816,6728,6690,5098,1446,1338,132,101,3456,3360,323,4961,1299,0
20:22:19,12966.36,Fox,6816,233,88,38,38,30,29,10,6816,6728,6690,5101,1446,1338,132,101,3456,3360,323,4961,1299,0
20:22:19,12966.64,Fox,6816,232,88,38,38,30,29,9,6816,6728,6690,5101,1446,1338,132,100,3456,3360,323,4961,1300,0
20:22:19,12968.03,Fox,6818,233,90,36,40,30,29,8,6818,6728,6692,5101,1446,1338,133,100,3458,3360,323,4961,1301,0
20:22:19,12968.89,Fox,6820,234,90,36,35,34,29,8,6818,6728,6692,5105,1446,1338,134,100,3460,3360,323,4962,1301,0
20:22:20,12969.46,Fox,6820,234,92,36,35,34,27,10,6820,6728,6692,5105,1446,1340,134,100,3460,3360,323,4962,1301,0
20:22:20,12969.74,Fox,6820,234,92,36,35,34,26,11,6820,6728,6692,5105,1446,1341,134,100,3460,3360,323,4962,1301,0
20:22:20,12970.59,Fox,6822,236,92,36,37,34,25,12,6822,6730,6694,5105,1446,1342,135,101,3461,3361,323,4962,1301,0
20:22:20,12970.87,Fox,6822,236,92,36,35,36,25,12,6822,6730,6694,5107,1446,1342,135,101,3461,3361,323,4962,1301,0
20:22:20,12971.45,Fox,6822,235,92,34,37,36,25,11,6822,6730,6696,5107,1446,1342,135,100,3461,3361,323,4962,1302,0
20:22:21,12972.6,Fox,6826,239,94,34,39,36,25,11,6826,6732,6698,5107,1446,1342,137,102,3463,3363,323,4962,1302,0
20:22:21,12973.17,Fox,6826,239,92,36,39,36,25,11,6826,6734,6698,5107,1446,1342,137,102,3463,3363,323,4962,1302,0
20:22:21,12974.25,Fox,6826,237,90,38,39,34,25,11,6826,6736,6698,5107,1446,1342,135,102,3463,3363,323,4964,1302,0
20:22:22,12976.48,Fox,6826,236,86,42,39,33,25,11,6826,6740,6698,5107,1446,1342,134,102,3463,3363,323,4965,1302,0
20:22:22,12977.04,Fox,6828,236,88,42,39,32,25,10,6828,6740,6698,5107,1446,1342,134,102,3464,3364,323,4966,1303,0
20:22:23,12977.64,Fox,6830,237,90,42,37,33,25,10,6830,6740,6698,5109,1446,1342,134,103,3465,3365,323,4967,1303,0
20:22:23,12978.44,Fox,6830,237,90,42,35,35,25,10,6830,6740,6698,5111,1446,1342,134,103,3465,3365,323,4967,1303,0
20:22:23,12979.26,Fox,6834,238,92,42,31,36,25,10,6832,6740,6698,5115,1446,1342,136,102,3468,3366,323,4970,1303,0
20:22:23,12979.85,Fox,6834,237,94,42,31,36,25,9,6834,6740,6698,5115,1446,1342,135,102,3468,3366,323,4971,1303,0
20:22:23,12980.44,Fox,6834,237,92,44,28,39,25,9,6834,6742,6698,5118,1446,1342,135,102,3468,3366,323,4971,1303,0
20:22:24,12981.31,Fox,6834,236,92,40,32,38,25,9,6834,6742,6702,5118,1446,1342,134,102,3468,3366,323,4972,1303,0
20:22:24,12982.15,Fox,6834,235,92,40,32,38,25,8,6834,6742,6702,5118,1446,1342,133,102,3468,3366,323,4972,1304,0
20:22:25,12983.87,Fox,6834,235,90,42,30,40,25,8,6834,6744,6702,5120,1446,1342,133,102,3468,3366,323,4972,1304,0
20:22:25,12984.72,Fox,6834,235,88,44,30,40,23,10,6834,6746,6702,5120,1446,1344,133,102,3468,3366,323,4972,1304,0
20:22:25,12985,Fox,6834,235,88,42,32,40,23,10,6834,6746,6704,5120,1446,1344,133,102,3468,3366,323,4972,1304,0
20:22:26,12987.67,Fox,6834,234,88,42,32,39,23,10,6834,6746,6704,5120,1446,1344,133,101,3468,3366,323,4973,1304,0
20:22:26,12988.18,Fox,6834,234,86,44,32,39,23,10,6834,6748,6704,5120,1446,1344,133,101,3468,3366,323,4973,1304,0
20:22:26,12989.31,Fox,6836,234,84,46,32,37,21,12,6834,6750,6704,5120,1446,1346,133,101,3469,3367,323,4975,1304,0
20:22:27,12989.59,Fox,6836,234,86,44,34,35,23,12,6836,6750,6706,5120,1448,1346,133,101,3469,3367,323,4975,1304,0
20:22:27,12990.71,Fox,6836,231,86,42,34,33,24,12,6836,6750,6708,5122,1449,1346,131,100,3469,3367,323,4978,1304,0
20:22:27,12991.29,Fox,6836,230,86,42,33,34,24,11,6836,6750,6708,5123,1449,1346,131,99,3469,3367,323,4978,1305,0
20:22:28,12993.06,Fox,6836,230,84,44,33,34,24,11,6836,6752,6708,5123,1449,1346,131,99,3469,3367,323,4978,1305,0
20:22:28,12993.95,Fox,6838,232,84,42,35,34,24,11,6836,6752,6710,5123,1449,1346,131,101,3469,3369,323,4978,1305,0
20:22:28,12994.24,Fox,6838,232,84,42,37,34,24,11,6838,6754,6712,5123,1449,1346,131,101,3469,3369,323,4978,1305,0
20:22:28,12995.13,Fox,6838,232,82,44,37,34,22,13,6838,6756,6712,5123,1449,1348,131,101,3469,3369,323,4978,1305,0
20:22:28,12995.66,Fox,6838,232,82,44,37,34,21,14,6838,6756,6712,5123,1449,1349,131,101,3469,3369,323,4978,1305,0
20:22:29,12996.49,Fox,6840,234,80,46,37,34,21,14,6838,6758,6712,5123,1449,1349,133,101,3471,3369,323,4978,1305,0
20:22:29,12997.06,Fox,6840,234,82,44,39,34,21,14,6840,6758,6714,5123,1449,1349,133,101,3471,3369,323,4978,1305,0
20:22:29,12997.6,Fox,6840,234,82,40,43,31,24,14,6840,6758,6718,5123,1452,1349,133,101,3471,3369,323,4978,1305,0
20:22:30,12998.92,Fox,6844,237,84,40,42,31,24,14,6842,6758,6718,5123,1452,1349,133,104,3472,3372,323,4979,1305,0
20:22:30,12999.52,Fox,6846,239,86,40,44,31,24,14,6846,6760,6720,5123,1452,1349,133,106,3472,3374,323,4979,1305,0
20:22:30,13000.1,Fox,6846,238,84,42,44,31,24,13,6846,6762,6720,5123,1452,1349,133,105,3472,3374,323,4979,1306,0
20:22:30,13000.7,Fox,6846,236,84,42,44,29,25,12,6846,6762,6720,5123,1453,1349,133,103,3472,3374,323,4980,1307,0
20:22:31,13001.59,Fox,6846,236,82,38,50,29,25,12,6846,6764,6726,5123,1453,1349,133,103,3472,3374,323,4980,1307,0
20:22:31,13002.19,Fox,6846,234,82,38,50,29,25,10,6846,6764,6726,5123,1453,1349,131,103,3472,3374,323,4980,1309,0
20:22:31,13003.62,Fox,6846,234,82,36,52,29,25,10,6846,6764,6728,5123,1453,1349,131,103,3472,3374,323,4980,1309,0
20:22:31,13004.17,Fox,6846,234,80,38,52,29,25,10,6846,6766,6728,5123,1453,1349,131,103,3472,3374,323,4980,1309,0
20:22:32,13005.83,Fox,6846,234,76,42,52,29,23,12,6846,6770,6728,5123,1453,1351,131,103,3472,3374,323,4980,1309,0
20:22:32,13006.39,Fox,6846,234,76,42,52,29,22,13,6846,6770,6728,5123,1453,1352,131,103,3472,3374,323,4980,1309,0
20:22:32,13007.42,Fox,6848,235,74,46,51,29,22,13,6848,6774,6728,5123,1453,1352,131,104,3473,3375,323,4981,1309,0
20:22:33,13007.71,Fox,6848,235,74,46,49,31,22,13,6848,6774,6728,5125,1453,1352,131,104,3473,3375,323,4981,1309,0
20:22:33,13008.24,Fox,6848,235,74,46,47,33,22,13,6848,6774,6728,5127,1453,1352,131,104,3473,3375,323,4981,1309,0
20:22:33,13008.76,Fox,6848,235,74,44,49,33,22,13,6848,6774,6730,5127,1453,1352,131,104,3473,3375,323,4981,1309,0
20:22:33,13009.83,Fox,6848,234,74,44,49,33,22,12,6848,6774,6730,5127,1453,1352,131,103,3473,3375,323,4981,1310,0
20:22:34,13010.91,Fox,6848,234,74,42,51,33,22,12,6848,6774,6732,5127,1453,1352,131,103,3473,3375,323,4981,1310,0
20:22:34,13011.74,Fox,6850,235,74,40,52,33,22,12,6848,6774,6734,5127,1453,1352,131,104,3474,3376,323,4982,1310,0
20:22:34,13012.04,Fox,6850,235,74,42,52,33,22,12,6850,6776,6734,5127,1453,1352,131,104,3474,3376,323,4982,1310,0
20:22:34,13012.6,Fox,6850,235,74,40,54,33,22,12,6850,6776,6736,5127,1453,1352,131,104,3474,3376,323,4982,1310,0
20:22:35,13014.17,Fox,6850,235,72,42,54,33,22,12,6850,6778,6736,5127,1453,1352,131,104,3474,3376,323,4982,1310,0
20:22:35,13015.04,Fox,6850,235,72,38,58,33,22,12,6850,6778,6740,5127,1453,1352,131,104,3474,3376,323,4982,1310,0
20:22:35,13015.89,Fox,6854,238,74,38,57,33,22,12,6852,6778,6740,5127,1453,1352,133,105,3477,3377,323,4983,1310,0
20:22:36,13016.46,Fox,6854,238,74,40,55,35,22,12,6854,6780,6740,5129,1453,1352,133,105,3477,3377,323,4983,1310,0
20:22:36,13017.64,Fox,6856,240,74,40,53,37,22,12,6854,6780,6740,5131,1453,1352,135,105,3479,3377,323,4983,1310,0
20:22:36,13017.94,Fox,6856,240,76,40,53,37,22,12,6856,6780,6740,5131,1453,1352,135,105,3479,3377,323,4983,1310,0
20:22:36,13018.84,Fox,6856,238,76,40,51,37,22,12,6856,6780,6740,5133,1453,1352,134,104,3479,3377,323,4985,1310,0
20:22:37,13019.44,Fox,6856,238,76,38,51,35,24,14,6856,6780,6742,5135,1457,1354,134,104,3479,3377,323,4985,1310,0
20:22:38,13022.4,Fox,6856,238,74,38,51,35,26,14,6856,6782,6744,5137,1459,1354,134,104,3479,3377,323,4985,1310,0
20:22:38,13022.97,Fox,6856,238,74,36,53,35,26,14,6856,6782,6746,5137,1459,1354,134,104,3479,3377,323,4985,1310,0
20:22:38,13024.14,Fox,6858,240,76,36,52,36,26,14,6858,6782,6746,5138,1459,1354,136,104,3481,3377,323,4985,1310,0
20:22:39,13025.9,Fox,6858,239,76,36,50,38,26,13,6858,6782,6746,5140,1459,1354,136,103,3481,3377,323,4985,1311,0
20:22:39,13027.08,Fox,6860,241,76,34,52,38,26,13,6858,6782,6748,5140,1459,1354,137,104,3482,3378,323,4985,1311,0
20:22:40,13027.67,Fox,6860,241,78,32,54,38,26,13,6860,6782,6750,5140,1459,1354,137,104,3482,3378,323,4985,1311,0
20:22:40,13028.25,Fox,6862,242,78,32,54,37,26,13,6860,6782,6750,5140,1459,1354,137,105,3482,3380,323,4986,1311,0
20:22:40,13028.54,Fox,6862,242,80,32,53,38,26,13,6862,6782,6750,5141,1459,1354,137,105,3482,3380,323,4986,1311,0
20:22:40,13029.45,Fox,6862,241,80,32,53,36,27,13,6862,6782,6750,5141,1460,1354,137,104,3482,3380,323,4987,1311,0
20:22:40,13030.04,Fox,6862,241,78,34,53,36,27,13,6862,6784,6750,5141,1460,1354,137,104,3482,3380,323,4987,1311,0
20:22:41,13030.95,Fox,6862,241,76,36,52,37,27,13,6862,6786,6750,5142,1460,1354,137,104,3482,3380,323,4987,1311,0
20:22:41,13031.85,Fox,6864,243,74,38,52,39,27,13,6864,6790,6752,5144,1460,1354,138,105,3483,3381,323,4987,1311,0
20:22:41,13032.75,Fox,6864,241,74,36,54,35,29,13,6864,6790,6754,5144,1462,1354,136,105,3483,3381,323,4989,1311,0
20:22:42,13033.35,Fox,6870,246,78,36,53,35,29,13,6868,6790,6754,5145,1462,1354,138,108,3486,3384,323,4990,1311,0
20:22:42,13033.65,Fox,6870,246,80,34,55,35,29,13,6870,6790,6756,5145,1462,1354,138,108,3486,3384,323,4990,1311,0
20:22:42,13034.25,Fox,6870,245,80,34,55,33,30,13,6870,6790,6756,5145,1463,1354,138,107,3486,3384,323,4991,1311,0
20:22:42,13034.84,Fox,6870,245,78,34,57,33,30,13,6870,6792,6758,5145,1463,1354,138,107,3486,3384,323,4991,1311,0
20:22:42,13036.01,Fox,6870,243,76,36,57,31,30,13,6870,6794,6758,5145,1463,1354,138,105,3486,3384,323,4993,1311,0
20:22:43,13037.5,Fox,6872,244,78,36,56,31,30,13,6872,6794,6758,5145,1463,1354,139,105,3488,3384,323,4994,1311,0
20:22:43,13038.09,Fox,6872,244,74,38,58,31,30,13,6872,6798,6760,5145,1463,1354,139,105,3488,3384,323,4994,1311,0
20:22:44,13038.99,Fox,6874,245,74,38,60,30,30,13,6874,6800,6762,5145,1463,1354,141,104,3490,3384,323,4995,1311,0
20:22:44,13039.89,Fox,6874,243,70,42,60,30,30,11,6874,6804,6762,5145,1463,1354,139,104,3490,3384,323,4995,1313,0
20:22:44,13040.49,Fox,6876,245,66,44,62,30,30,11,6874,6808,6764,5145,1463,1354,139,106,3490,3386,323,4995,1313,0
20:22:44,13040.79,Fox,6876,245,68,44,62,30,30,11,6876,6808,6764,5145,1463,1354,139,106,3490,3386,323,4995,1313,0
20:22:44,13041.68,Fox,6876,244,66,46,58,31,32,11,6876,6810,6764,5149,1465,1354,139,105,3490,3386,323,4996,1313,0
20:22:45,13042.27,Fox,6878,244,66,48,58,29,32,11,6878,6812,6764,5149,1465,1354,138,106,3491,3387,323,4998,1313,0
20:22:45,13042.86,Fox,6878,243,66,46,60,29,32,10,6878,6812,6766,5149,1465,1354,137,106,3491,3387,323,4998,1314,0
20:22:45,13043.46,Fox,6878,242,66,46,60,28,32,10,6878,6812,6766,5149,1465,1354,137,105,3491,3387,323,4999,1314,0
20:22:45,13044.35,Fox,6878,242,66,42,64,28,32,10,6878,6812,6770,5149,1465,1354,137,105,3491,3387,323,4999,1314,0
20:22:45,13044.92,Fox,6878,241,64,44,64,27,32,10,6878,6814,6770,5149,1465,1354,137,104,3491,3387,323,5000,1314,0
20:22:46,13045.82,Fox,6882,244,66,40,66,29,32,9,6880,6814,6774,5151,1465,1354,140,104,3494,3388,323,5000,1315,0
20:22:46,13046.12,Fox,6882,242,68,40,66,29,32,7,6882,6814,6774,5151,1465,1354,139,103,3494,3388,323,5000,1317,0
20:22:46,13047.55,Fox,6888,247,66,42,65,29,32,7,6882,6816,6774,5151,1465,1354,144,103,3500,3388,323,5001,1317,0
20:22:47,13047.85,Fox,6888,247,72,42,65,29,32,7,6888,6816,6774,5151,1465,1354,144,103,3500,3388,323,5001,1317,0
20:22:47,13048.44,Fox,6888,247,72,42,65,28,33,7,6888,6816,6774,5151,1466,1354,144,103,3500,3388,323,5001,1317,0
20:22:47,13049.33,Fox,6890,248,74,42,64,28,33,7,6890,6816,6774,5151,1466,1354,143,105,3500,3390,323,5002,1317,0
20:22:47,13050.23,Fox,6892,250,76,42,62,30,33,7,6892,6816,6774,5153,1466,1354,143,107,3500,3392,323,5002,1317,0
20:22:47,13050.83,Fox,6892,250,74,42,64,30,33,7,6892,6818,6776,5153,1466,1354,143,107,3500,3392,323,5002,1317,0
20:22:48,13051.12,Fox,6892,250,74,42,62,32,33,7,6892,6818,6776,5155,1466,1354,143,107,3500,3392,323,5002,1317,0
20:22:48,13051.72,Fox,6892,250,72,44,62,32,32,8,6892,6820,6776,5155,1466,1355,143,107,3500,3392,323,5002,1317,0
20:22:48,13052.88,Fox,6894,251,74,42,63,32,32,8,6894,6820,6778,5155,1466,1355,143,108,3501,3393,323,5003,1317,0
20:22:48,13053.18,Fox,6894,251,72,44,63,32,32,8,6894,6822,6778,5155,1466,1355,143,108,3501,3393,323,5003,1317,0
20:22:49,13054.08,Fox,6896,252,74,44,60,34,30,10,6896,6822,6778,5157,1466,1357,143,109,3502,3394,323,5004,1317,0
20:22:49,13054.68,Fox,6896,252,74,42,60,36,30,10,6896,6822,6780,5159,1466,1357,143,109,3502,3394,323,5004,1317,0
20:22:49,13055.27,Fox,6896,252,70,46,60,36,30,10,6896,6826,6780,5159,1466,1357,143,109,3502,3394,323,5004,1317,0
20:22:49,13056.16,Fox,6898,251,70,46,59,34,30,10,6896,6826,6780,5159,1466,1357,144,107,3504,3394,323,5007,1317,0
20:22:49,13056.46,Fox,6898,251,72,46,59,34,30,10,6898,6826,6780,5159,1466,1357,144,107,3504,3394,323,5007,1317,0
20:22:50,13057.34,Fox,6904,256,76,46,58,34,30,10,6902,6826,6780,5159,1466,1357,146,110,3507,3397,323,5008,1317,0
20:22:50,13057.94,Fox,6906,258,78,46,56,35,31,10,6904,6826,6780,5161,1467,1357,146,112,3507,3399,323,5008,1317,0
20:22:50,13058.24,Fox,6906,258,80,46,53,38,31,10,6906,6826,6780,5164,1467,1357,146,112,3507,3399,323,5008,1317,0
20:22:50,13059.68,Fox,6906,258,78,48,53,37,32,10,6906,6828,6780,5164,1468,1357,146,112,3507,3399,323,5008,1317,0
20:22:51,13060.21,Fox,6906,258,76,50,51,39,32,10,6906,6830,6780,5166,1468,1357,146,112,3507,3399,323,5008,1317,0
20:22:51,13060.78,Fox,6908,258,76,48,53,37,32,10,6906,6830,6782,5166,1468,1357,145,113,3508,3400,323,5010,1317,0
20:22:51,13061.08,Fox,6908,258,78,48,53,37,32,10,6908,6830,6782,5166,1468,1357,145,113,3508,3400,323,5010,1317,0
20:22:51,13061.95,Fox,6908,256,76,50,52,36,32,10,6908,6832,6782,5167,1468,1357,143,113,3508,3400,325,5010,1317,0
20:22:51,13062.23,Fox,6908,256,74,52,48,39,33,10,6908,6834,6782,5171,1469,1357,143,113,3508,3400,325,5010,1317,0
20:22:52,13064.3,Fox,6910,258,76,52,47,40,33,10,6910,6834,6782,5172,1469,1357,143,115,3508,3402,325,5010,1317,0
20:22:53,13065.47,Fox,6912,260,78,52,47,40,33,10,6912,6834,6782,5172,1469,1357,144,116,3509,3403,325,5010,1317,0
20:22:54,13068.3,Fox,6912,259,78,50,49,39,33,10,6912,6834,6784,5172,1469,1357,144,115,3509,3403,325,5011,1317,0
20:22:54,13068.89,Fox,6912,258,78,48,51,38,33,10,6912,6834,6786,5172,1469,1357,143,115,3509,3403,325,5012,1317,0
20:22:54,13069.18,Fox,6912,258,78,48,50,39,33,10,6912,6834,6786,5173,1469,1357,143,115,3509,3403,325,5012,1317,0
20:22:54,13070.01,Fox,6912,257,78,46,52,39,33,9,6912,6834,6788,5173,1469,1357,143,114,3509,3403,325,5012,1318,0
20:22:54,13070.57,Fox,6914,256,80,44,53,37,33,9,6914,6834,6790,5173,1469,1357,143,113,3510,3404,325,5015,1318,0
20:22:54,13070.86,Fox,6914,256,80,44,53,36,34,9,6914,6834,6790,5173,1470,1357,143,113,3510,3404,325,5015,1318,0
20:22:55,13071.73,Fox,6914,255,80,44,51,38,34,8,6914,6834,6790,5175,1470,1357,143,112,3510,3404,325,5015,1319,0
20:22:55,13072.32,Fox,6914,254,78,46,50,37,35,8,6914,6836,6790,5176,1471,1357,143,111,3510,3404,325,5016,1319,0
20:22:55,13072.9,Fox,6916,256,78,46,50,35,37,8,6914,6836,6790,5176,1473,1357,145,111,3512,3404,325,5016,1319,0
20:22:55,13073.5,Fox,6920,260,82,44,50,37,37,8,6918,6836,6792,5178,1473,1357,149,111,3516,3404,325,5016,1319,0
20:22:56,13074.1,Fox,6922,261,86,44,50,37,37,7,6922,6836,6792,5178,1473,1357,150,111,3517,3405,325,5016,1320,0
20:22:56,13074.4,Fox,6922,261,86,42,52,37,37,7,6922,6836,6794,5178,1473,1357,150,111,3517,3405,325,5016,1320,0
20:22:56,13075.54,Fox,6922,261,86,42,49,40,37,7,6922,6836,6794,5181,1473,1357,150,111,3517,3405,325,5016,1320,0
20:22:56,13076.13,Fox,6924,263,88,42,49,40,35,9,6924,6836,6794,5181,1473,1359,151,112,3518,3406,325,5016,1320,0
20:22:56,13076.72,Fox,6926,265,88,38,53,40,35,9,6924,6836,6798,5181,1473,1359,152,113,3519,3407,325,5016,1320,0
20:22:57,13077.27,Fox,6926,265,88,40,53,38,35,11,6926,6838,6798,5181,1475,1361,152,113,3519,3407,325,5016,1320,0
20:22:57,13077.86,Fox,6928,267,88,38,55,38,35,11,6926,6838,6800,5181,1475,1361,154,113,3521,3407,325,5016,1320,0
20:22:57,13078.46,Fox,6932,269,94,34,58,37,33,13,6932,6838,6804,5181,1475,1363,153,116,3522,3410,325,5018,1320,0
20:22:57,13079.06,Fox,6934,270,96,30,61,37,33,13,6934,6838,6808,5181,1475,1363,154,116,3524,3410,326,5018,1320,0
20:22:57,13079.66,Fox,6934,269,94,32,60,37,33,13,6934,6840,6808,5182,1475,1363,153,116,3524,3410,326,5019,1320,0
20:22:58,13080.25,Fox,6934,269,94,28,64,37,33,13,6934,6840,6812,5182,1475,1363,153,116,3524,3410,326,5019,1320,0
20:22:58,13080.85,Fox,6936,270,96,28,63,37,33,13,6936,6840,6812,5182,1475,1363,153,117,3525,3411,326,5020,1320,0
20:22:58,13082.04,Fox,6936,270,90,34,63,37,33,13,6936,6846,6812,5182,1475,1363,153,117,3525,3411,326,5020,1320,0
20:22:58,13082.63,Fox,6940,272,90,34,61,37,33,13,6936,6846,6812,5184,1475,1363,152,120,3526,3414,326,5022,1320,0
20:22:59,13083.22,Fox,6940,272,94,32,63,37,33,13,6940,6846,6814,5184,1475,1363,152,120,3526,3414,326,5022,1320,0
20:22:59,13083.82,Fox,6940,271,94,32,61,37,34,13,6940,6846,6814,5186,1476,1363,151,120,3526,3414,326,5023,1320,0
20:22:59,13084.41,Fox,6946,275,100,32,60,36,34,13,6946,6846,6814,5186,1476,1363,152,123,3529,3417,326,5025,1320,0
20:22:59,13085,Fox,6946,275,100,32,60,35,35,13,6946,6846,6814,5186,1477,1363,152,123,3529,3417,326,5025,1320,0
20:22:59,13085.81,Fox,6948,277,102,30,62,35,35,13,6948,6846,6816,5186,1477,1363,152,125,3529,3419,326,5025,1320,0
20:23:00,13086.4,Fox,6952,278,104,30,61,35,35,11,6950,6846,6816,5186,1477,1363,150,128,3530,3422,326,5026,1322,0
20:23:00,13086.99,Fox,6952,277,106,30,61,35,35,10,6952,6846,6816,5186,1477,1363,150,127,3530,3422,326,5026,1323,0
20:23:00,13088.14,Fox,6952,277,106,30,59,37,33,12,6952,6846,6816,5188,1477,1365,150,127,3530,3422,326,5026,1323,0
20:23:00,13088.7,Fox,6954,279,108,30,59,37,33,12,6954,6846,6816,5188,1477,1365,150,129,3530,3424,326,5026,1323,0
20:23:01,13089.25,Fox,6954,279,108,28,61,37,33,12,6954,6846,6818,5188,1477,1365,150,129,3530,3424,326,5026,1323,0
20:23:01,13090.11,Fox,6956,279,106,30,61,36,33,11,6954,6848,6818,5188,1477,1365,150,129,3531,3425,326,5027,1324,0
20:23:01,13090.41,Fox,6956,279,108,28,63,36,31,13,6956,6848,6820,5188,1477,1367,150,129,3531,3425,326,5027,1324,0
20:23:02,13092.13,Fox,6956,278,108,26,64,37,31,12,6956,6848,6822,5189,1477,1367,150,128,3531,3425,326,5027,1325,0
20:23:02,13093.62,Fox,6956,278,108,22,66,39,31,12,6956,6848,6826,5191,1477,1367,150,128,3531,3425,326,5027,1325,0
20:23:02,13094.47,Fox,6958,279,108,22,64,41,31,11,6956,6848,6826,5193,1477,1367,150,129,3532,3426,326,5027,1326,0
20:23:03,13095.07,Fox,6958,279,108,24,62,43,31,11,6958,6850,6826,5195,1477,1367,150,129,3532,3426,326,5027,1326,0
20:23:03,13096.23,Fox,6960,281,110,24,62,43,31,11,6960,6850,6826,5195,1477,1367,151,130,3533,3427,326,5027,1326,0
20:23:03,13096.51,Fox,6960,279,110,24,62,43,31,9,6960,6850,6826,5195,1477,1367,149,130,3533,3427,326,5027,1328,0
20:23:04,13098.58,Fox,6960,278,108,24,62,44,31,9,6960,6852,6828,5197,1477,1367,148,130,3533,3427,326,5028,1328,0
20:23:04,13099.18,Fox,6962,279,108,24,62,46,31,8,6962,6854,6830,5199,1477,1367,149,130,3535,3427,326,5028,1329,0
20:23:04,13100.62,Fox,6962,278,106,22,65,47,31,7,6962,6856,6834,5200,1477,1367,148,130,3535,3427,326,5028,1330,0
20:23:05,13101.22,Fox,6962,278,106,22,65,45,33,7,6962,6856,6834,5200,1479,1367,148,130,3535,3427,326,5028,1330,0
20:23:05,13103.3,Fox,6962,278,106,22,63,47,33,7,6962,6856,6834,5202,1479,1367,148,130,3535,3427,326,5028,1330,0
20:23:06,13105.06,Fox,6962,278,106,22,60,50,33,7,6962,6856,6834,5205,1479,1367,148,130,3535,3427,326,5028,1330,0
20:23:06,13106.17,Fox,6964,280,108,22,60,50,33,7,6964,6856,6834,5205,1479,1367,149,131,3536,3428,326,5028,1330,0
20:23:07,13106.77,Fox,6966,281,108,24,56,53,33,7,6966,6858,6834,5208,1479,1367,149,132,3537,3429,326,5029,1330,0
20:23:07,13107.67,Fox,6966,280,108,24,56,53,33,6,6966,6858,6834,5208,1479,1367,149,131,3537,3429,326,5029,1331,0
20:23:07,13108.57,Fox,6968,281,110,24,55,53,33,6,6968,6858,6834,5208,1479,1367,148,133,3537,3431,326,5030,1331,0
20:23:08,13109.17,Fox,6972,283,114,24,55,51,33,6,6972,6858,6834,5208,1479,1367,151,132,3540,3432,326,5032,1331,0
20:23:08,13109.77,Fox,6974,284,116,24,55,50,33,6,6974,6858,6834,5208,1479,1367,151,133,3540,3434,327,5032,1331,0
20:23:08,13110.37,Fox,6976,286,114,26,55,48,35,6,6974,6860,6834,5208,1481,1367,153,133,3542,3434,327,5032,1331,0
20:23:08,13110.97,Fox,6976,286,116,24,55,49,36,6,6976,6860,6836,5210,1482,1367,153,133,3542,3434,327,5032,1331,0
20:23:08,13111.27,Fox,6976,285,114,26,55,48,36,6,6976,6862,6836,5210,1482,1367,152,133,3542,3434,327,5033,1331,0
20:23:09,13112.77,Fox,6978,286,116,26,54,47,37,6,6978,6862,6836,5210,1483,1367,153,133,3544,3434,327,5034,1331,0
20:23:09,13113.37,Fox,6978,286,116,26,52,47,39,6,6978,6862,6836,5212,1485,1367,153,133,3544,3434,327,5034,1331,0
20:23:09,13113.67,Fox,6978,285,116,26,52,46,39,6,6978,6862,6836,5212,1485,1367,152,133,3544,3434,327,5035,1331,0
20:23:10,13114.87,Fox,6980,287,116,28,52,46,39,6,6980,6864,6836,5212,1485,1367,152,135,3544,3436,327,5035,1331,0
20:23:10,13115.47,Fox,6980,286,116,26,52,47,39,6,6980,6864,6838,5214,1485,1367,152,134,3544,3436,327,5036,1331,0
20:23:10,13116.04,Fox,6982,287,114,30,51,47,39,6,6982,6868,6838,5214,1485,1367,153,134,3546,3436,327,5037,1331,0
20:23:10,13116.64,Fox,6984,289,112,32,51,47,39,6,6982,6870,6838,5214,1485,1367,154,135,3547,3437,327,5037,1331,0
20:23:10,13117.24,Fox,6988,289,114,32,50,44,39,6,6984,6870,6838,5214,1485,1367,155,134,3550,3438,327,5041,1331,0
20:23:11,13117.84,Fox,6988,288,118,30,52,44,39,5,6988,6870,6840,5214,1485,1367,155,133,3550,3438,327,5041,1332,0
20:23:11,13119.61,Fox,6990,289,118,30,52,44,39,4,6988,6870,6840,5214,1485,1367,157,132,3552,3438,327,5041,1333,0
20:23:11,13120.21,Fox,6992,290,118,30,53,44,39,4,6990,6872,6842,5214,1485,1367,157,133,3553,3439,327,5042,1333,0
20:23:12,13120.81,Fox,6992,290,120,26,57,44,39,4,6992,6872,6846,5214,1485,1367,157,133,3553,3439,327,5042,1333,0
20:23:12,13121.41,Fox,6994,290,122,26,55,44,39,4,6994,6872,6846,5216,1485,1367,157,133,3553,3441,327,5044,1333,0
20:23:12,13121.71,Fox,6994,290,120,28,55,44,39,4,6994,6874,6846,5216,1485,1367,157,133,3553,3441,327,5044,1333,0
20:23:12,13122.91,Fox,6996,291,122,28,54,44,39,4,6996,6874,6846,5216,1485,1367,158,133,3555,3441,327,5045,1333,0
20:23:13,13123.81,Fox,6998,290,122,30,53,42,39,4,6998,6876,6846,5216,1485,1367,158,132,3556,3442,329,5046,1333,0
20:23:13,13125.01,Fox,7000,292,122,32,53,42,39,4,7000,6878,6846,5216,1485,1367,160,132,3558,3442,329,5046,1333,0
20:23:14,13127.41,Fox,7002,294,124,32,53,42,37,6,7002,6878,6846,5216,1485,1369,160,134,3558,3444,329,5046,1333,0
20:23:14,13128.01,Fox,7002,294,124,32,53,42,36,7,7002,6878,6846,5216,1485,1370,160,134,3558,3444,329,5046,1333,0
20:23:14,13128.91,Fox,7002,294,120,34,53,44,36,7,7002,6882,6848,5218,1485,1370,160,134,3558,3444,329,5046,1333,0
20:23:15,13130.11,Fox,7004,296,122,34,53,44,36,7,7004,6882,6848,5218,1485,1370,162,134,3560,3444,329,5046,1333,0
20:23:15,13130.71,Fox,7006,297,116,40,48,48,36,7,7004,6888,6848,5222,1485,1370,162,135,3561,3445,329,5047,1333,0
20:23:15,13131.01,Fox,7006,297,118,40,48,48,36,7,7006,6888,6848,5222,1485,1370,162,135,3561,3445,329,5047,1333,0
20:23:16,13131.91,Fox,7006,297,116,42,48,48,36,7,7006,6890,6848,5222,1485,1370,162,135,3561,3445,329,5047,1333,0
20:23:16,13133.08,Fox,7006,297,114,42,50,48,36,7,7006,6892,6850,5222,1485,1370,162,135,3561,3445,329,5047,1333,0
20:23:16,13133.67,Fox,7010,301,118,42,50,48,36,7,7010,6892,6850,5222,1485,1370,164,137,3563,3447,329,5047,1333,0
20:23:16,13134.27,Fox,7012,303,120,42,48,50,36,7,7012,6892,6850,5224,1485,1370,165,138,3564,3448,329,5047,1333,0
20:23:17,13135.17,Fox,7014,304,120,42,46,47,37,10,7012,6892,6850,5225,1489,1373,164,140,3564,3450,329,5048,1333,0
20:23:17,13135.47,Fox,7014,304,120,44,46,47,37,10,7014,6894,6850,5225,1489,1373,164,140,3564,3450,329,5048,1333,0
20:23:17,13136.38,Fox,7016,306,122,44,46,47,37,10,7016,6894,6850,5225,1489,1373,165,141,3565,3451,329,5048,1333,0
20:23:17,13136.97,Fox,7016,306,120,44,45,50,37,10,7016,6896,6852,5228,1489,1373,165,141,3565,3451,329,5048,1333,0
20:23:17,13137.27,Fox,7016,305,120,42,47,50,37,9,7016,6896,6854,5228,1489,1373,164,141,3565,3451,329,5048,1334,0
20:23:18,13138.47,Fox,7016,305,120,42,45,52,36,10,7016,6896,6854,5230,1489,1374,164,141,3565,3451,329,5048,1334,0
20:23:18,13139.08,Fox,7016,305,118,42,42,57,36,10,7016,6898,6856,5235,1489,1374,164,141,3565,3451,329,5048,1334,0
20:23:18,13139.67,Fox,7018,304,120,42,42,55,35,10,7018,6898,6856,5235,1489,1374,164,140,3567,3451,329,5051,1334,0
20:23:19,13140.27,Fox,7018,304,114,48,42,55,35,10,7018,6904,6856,5235,1489,1374,164,140,3567,3451,329,5051,1334,0
20:23:19,13140.85,Fox,7018,304,112,50,39,58,35,10,7018,6906,6856,5238,1489,1374,164,140,3567,3451,329,5051,1334,0
20:23:19,13141.14,Fox,7018,302,112,50,39,56,35,10,7018,6906,6856,5238,1489,1374,164,138,3567,3451,329,5053,1334,0
20:23:20,13143.23,Fox,7020,303,114,50,38,56,35,10,7020,6906,6856,5238,1489,1374,165,138,3569,3451,329,5054,1334,0
20:23:20,13143.83,Fox,7020,303,112,52,36,58,35,10,7020,6908,6856,5240,1489,1374,165,138,3569,3451,329,5054,1334,0
20:23:20,13145.33,Fox,7020,302,112,50,38,57,35,10,7020,6908,6858,5240,1489,1374,165,137,3569,3451,329,5055,1334,0
20:23:21,13146.23,Fox,7020,302,112,50,36,59,35,10,7020,6908,6858,5242,1489,1374,165,137,3569,3451,329,5055,1334,0
20:23:21,13147.13,Fox,7020,301,110,52,36,58,35,10,7020,6910,6858,5242,1489,1374,165,136,3569,3451,329,5056,1334,0
20:23:21,13147.73,Fox,7022,303,112,52,36,56,37,10,7022,6910,6858,5242,1491,1374,165,138,3569,3453,329,5056,1334,0
20:23:22,13148.33,Fox,7024,305,112,54,36,54,39,10,7024,6912,6858,5242,1493,1374,166,139,3570,3454,329,5056,1334,0
20:23:22,13148.93,Fox,7026,305,114,52,38,52,39,10,7026,6912,6860,5242,1493,1374,166,139,3570,3456,329,5058,1334,0
20:23:22,13149.83,Fox,7026,302,114,50,38,51,39,10,7026,6912,6862,5244,1493,1374,165,137,3570,3456,329,5061,1334,0
20:23:22,13150.43,Fox,7028,304,116,50,38,51,39,10,7028,6912,6862,5244,1493,1374,167,137,3572,3456,329,5061,1334,0
20:23:23,13151.03,Fox,7028,303,116,50,37,50,40,10,7028,6912,6862,5245,1494,1374,166,137,3572,3456,329,5062,1334,0
20:23:23,13151.63,Fox,7028,301,116,50,37,46,42,10,7028,6912,6862,5245,1496,1374,165,136,3572,3456,329,5064,1334,0
20:23:23,13152.53,Fox,7030,302,116,50,35,47,42,10,7028,6912,6862,5246,1496,1374,164,138,3572,3458,329,5065,1334,0
20:23:23,13153.13,Fox,7030,302,116,50,37,47,42,10,7030,6914,6864,5246,1496,1374,164,138,3572,3458,329,5065,1334,0
20:23:24,13154.03,Fox,7032,303,118,50,36,47,42,10,7032,6914,6864,5246,1496,1374,164,139,3573,3459,329,5066,1334,0
20:23:24,13154.63,Fox,7032,303,118,46,37,50,42,10,7032,6914,6868,5249,1496,1374,164,139,3573,3459,329,5066,1334,0
20:23:24,13155.23,Fox,7034,305,120,44,39,50,42,10,7034,6914,6870,5249,1496,1374,165,140,3574,3460,329,5066,1334,0
20:23:24,13155.83,Fox,7036,306,120,46,39,45,46,10,7036,6916,6870,5249,1500,1374,165,141,3575,3461,329,5067,1334,0
20:23:24,13156.43,Fox,7036,306,116,50,39,45,46,10,7036,6920,6870,5249,1500,1374,165,141,3575,3461,329,5067,1334,0
20:23:25,13157.03,Fox,7036,306,114,52,39,45,42,14,7036,6922,6870,5249,1500,1378,165,141,3575,3461,329,5067,1334,0
20:23:25,13157.93,Fox,7038,307,116,52,38,44,43,14,7038,6922,6870,5249,1501,1378,165,142,3576,3462,329,5068,1334,0
20:23:25,13158.83,Fox,7040,308,114,52,37,46,43,14,7038,6924,6872,5251,1501,1378,165,143,3577,3463,329,5069,1334,0
20:23:25,13159.43,Fox,7040,307,116,52,36,47,43,13,7040,6924,6872,5252,1501,1378,164,143,3577,3463,329,5069,1335,0
20:23:26,13160.03,Fox,7044,309,116,52,38,45,41,15,7042,6926,6874,5252,1501,1380,166,143,3581,3463,329,5071,1335,0
20:23:26,13160.33,Fox,7044,309,118,52,38,45,41,15,7044,6926,6874,5252,1501,1380,166,143,3581,3463,329,5071,1335,0
20:23:26,13161.23,Fox,7044,309,112,58,36,47,41,15,7044,6932,6874,5254,1501,1380,166,143,3581,3463,329,5071,1335,0
20:23:26,13162.13,Fox,7046,311,112,58,38,47,41,15,7046,6934,6876,5254,1501,1380,167,144,3582,3464,329,5071,1335,0
20:23:27,13162.73,Fox,7048,312,114,58,38,46,41,15,7048,6934,6876,5254,1501,1380,168,144,3583,3465,329,5072,1335,0
20:23:27,13163.63,Fox,7048,312,112,58,40,46,41,15,7048,6936,6878,5254,1501,1380,168,144,3583,3465,329,5072,1335,0
20:23:27,13164.5,Fox,7048,310,112,58,40,44,41,15,7048,6936,6878,5254,1501,1380,167,143,3583,3465,330,5073,1335,0
20:23:28,13165.4,Fox,7048,308,112,58,40,42,43,13,7048,6936,6878,5254,1503,1380,166,142,3583,3465,330,5073,1337,0
20:23:28,13165.7,Fox,7048,308,108,62,40,42,43,13,7048,6940,6878,5254,1503,1380,166,142,3583,3465,330,5073,1337,0
20:23:28,13167.15,Fox,7048,308,102,64,44,42,42,14,7048,6946,6882,5254,1503,1381,166,142,3583,3465,330,5073,1337,0
20:23:29,13168.31,Fox,7048,308,100,66,44,42,42,14,7048,6948,6882,5254,1503,1381,166,142,3583,3465,330,5073,1337,0
20:23:29,13169.17,Fox,7048,306,98,62,50,39,43,14,7048,6950,6888,5254,1504,1381,165,141,3583,3465,330,5075,1337,0
20:23:29,13169.77,Fox,7050,306,96,64,49,38,41,16,7048,6952,6888,5254,1504,1383,164,142,3583,3467,330,5077,1337,0
20:23:29,13170.36,Fox,7050,306,98,62,51,38,41,16,7050,6952,6890,5254,1504,1383,164,142,3583,3467,330,5077,1337,0
20:23:30,13171.21,Fox,7050,305,96,62,51,39,41,16,7050,6954,6892,5256,1504,1383,163,142,3583,3467,330,5078,1337,0
20:23:30,13172.07,Fox,7052,306,96,62,51,39,40,16,7050,6954,6892,5256,1504,1384,164,142,3584,3468,330,5078,1338,0
20:23:30,13172.37,Fox,7052,306,98,62,51,39,40,16,7052,6954,6892,5256,1504,1384,164,142,3584,3468,330,5078,1338,0
20:23:30,13173.27,Fox,7054,308,96,64,51,39,40,16,7052,6956,6892,5256,1504,1384,164,144,3584,3470,330,5078,1338,0
20:23:30,13173.82,Fox,7054,307,98,64,51,39,39,16,7054,6956,6892,5256,1504,1384,163,144,3584,3470,330,5079,1338,0
20:23:31,13174.12,Fox,7054,307,98,62,53,39,39,16,7054,6956,6894,5256,1504,1384,163,144,3584,3470,330,5079,1338,0
20:23:31,13175,Fox,7060,311,100,62,51,39,39,16,7056,6956,6894,5256,1504,1384,164,147,3587,3473,330,5081,1338,0
20:23:31,13175.6,Fox,7062,312,104,60,52,39,39,16,7060,6956,6896,5256,1504,1384,164,148,3588,3474,330,5082,1338,0
20:23:31,13176.2,Fox,7062,312,106,60,50,39,41,16,7062,6956,6896,5258,1506,1384,164,148,3588,3474,330,5082,1338,0
20:23:31,13176.8,Fox,7062,312,106,60,50,38,42,16,7062,6956,6896,5258,1507,1384,164,148,3588,3474,330,5082,1338,0
20:23:32,13177.69,Fox,7062,312,104,60,52,38,42,16,7062,6958,6898,5258,1507,1384,164,148,3588,3474,330,5082,1338,0
20:23:32,13178.29,Fox,7064,312,106,60,49,40,42,15,7064,6958,6898,5260,1507,1384,163,149,3589,3475,330,5083,1339,0
20:23:32,13178.86,Fox,7064,312,104,56,55,40,40,17,7064,6960,6904,5260,1507,1386,163,149,3589,3475,330,5083,1339,0
20:23:32,13179.46,Fox,7064,312,104,54,57,40,40,17,7064,6960,6906,5260,1507,1386,163,149,3589,3475,330,5083,1339,0
20:23:33,13180.95,Fox,7064,312,104,54,54,43,40,17,7064,6960,6906,5263,1507,1386,163,149,3589,3475,330,5083,1339,0
20:23:33,13181.54,Fox,7064,312,104,54,52,44,41,17,7064,6960,6906,5265,1508,1386,163,149,3589,3475,330,5083,1339,0
20:23:33,13182.14,Fox,7064,312,102,54,54,44,41,17,7064,6962,6908,5265,1508,1386,163,149,3589,3475,330,5083,1339,0
20:23:34,13182.75,Fox,7066,314,104,54,54,44,41,17,7066,6962,6908,5265,1508,1386,164,150,3590,3476,330,5083,1339,0
20:23:34,13185.06,Fox,7068,316,106,54,54,44,41,17,7068,6962,6908,5265,1508,1386,165,151,3591,3477,330,5083,1339,0
20:23:35,13185.66,Fox,7070,316,106,52,55,43,42,16,7068,6962,6910,5265,1509,1386,164,152,3591,3479,330,5084,1340,0
20:23:35,13186.26,Fox,7070,314,108,52,55,41,41,17,7070,6962,6910,5265,1509,1387,164,150,3591,3479,330,5086,1340,0
20:23:35,13186.86,Fox,7072,316,110,50,57,39,43,17,7072,6962,6912,5265,1511,1387,164,152,3591,3481,330,5086,1340,0
20:23:35,13187.46,Fox,7076,319,112,50,56,37,45,17,7074,6962,6912,5265,1513,1387,165,154,3593,3483,330,5087,1340,0
20:23:35,13187.76,Fox,7076,319,114,50,56,37,45,17,7076,6962,6912,5265,1513,1387,165,154,3593,3483,330,5087,1340,0
20:23:36,13188.96,Fox,7076,319,112,52,55,36,47,17,7076,6964,6912,5266,1515,1387,165,154,3593,3483,330,5087,1340,0
20:23:36,13189.56,Fox,7076,318,110,54,55,36,47,16,7076,6966,6912,5266,1515,1387,165,153,3593,3483,330,5087,1341,0
20:23:37,13191.62,Fox,7076,314,108,54,57,33,46,16,7076,6968,6914,5266,1515,1387,164,150,3593,3483,330,5091,1341,0
20:23:37,13191.92,Fox,7076,314,104,58,57,33,46,16,7076,6972,6914,5266,1515,1387,164,150,3593,3483,330,5091,1341,0
20:23:37,13192.81,Fox,7078,316,104,60,57,32,47,16,7078,6974,6914,5266,1516,1387,165,151,3594,3484,330,5091,1341,0
20:23:37,13193.4,Fox,7080,318,104,62,57,32,47,16,7080,6976,6914,5266,1516,1387,165,153,3594,3486,330,5091,1341,0
20:23:37,13194,Fox,7080,318,104,62,56,32,48,16,7080,6976,6914,5267,1517,1387,165,153,3594,3486,330,5091,1341,0
20:23:38,13194.57,Fox,7080,318,104,58,60,32,48,16,7080,6976,6918,5267,1517,1387,165,153,3594,3486,330,5091,1341,0
20:23:38,13195.15,Fox,7082,320,104,54,64,32,48,16,7080,6976,6922,5267,1517,1387,166,154,3595,3487,330,5091,1341,0
20:23:38,13195.75,Fox,7084,322,106,56,64,32,47,17,7084,6978,6922,5267,1517,1388,167,155,3596,3488,330,5091,1341,0
20:23:38,13196.92,Fox,7084,322,106,56,64,31,47,18,7084,6978,6922,5267,1518,1389,167,155,3596,3488,330,5091,1341,0
20:23:39,13197.48,Fox,7084,322,104,56,65,32,47,18,7084,6980,6924,5268,1518,1389,167,155,3596,3488,330,5091,1341,0
20:23:39,13198.34,Fox,7086,324,104,54,67,30,49,18,7084,6980,6926,5268,1520,1389,168,156,3597,3489,330,5091,1341,0
20:23:39,13198.94,Fox,7088,326,104,56,67,30,49,18,7086,6982,6926,5268,1520,1389,168,158,3597,3491,330,5091,1341,0
20:23:39,13199.54,Fox,7090,326,106,52,71,31,49,17,7090,6984,6932,5270,1520,1389,168,158,3598,3492,330,5092,1342,0
20:23:40,13200.13,Fox,7090,326,102,54,73,31,48,18,7090,6988,6934,5270,1520,1390,168,158,3598,3492,330,5092,1342,0
20:23:40,13201.02,Fox,7092,328,104,54,73,31,48,18,7092,6988,6934,5270,1520,1390,169,159,3599,3493,330,5092,1342,0
20:23:40,13201.89,Fox,7092,328,104,52,75,31,48,18,7092,6988,6936,5270,1520,1390,169,159,3599,3493,330,5092,1342,0
20:23:40,13202.71,Fox,7092,327,102,54,75,31,47,18,7092,6990,6936,5270,1520,1390,168,159,3599,3493,330,5093,1342,0
20:23:41,13203.56,Fox,7094,329,100,56,75,31,47,18,7092,6992,6936,5270,1520,1390,169,160,3600,3494,330,5093,1342,0
20:23:41,13204.16,Fox,7094,328,100,54,79,30,47,18,7094,6994,6940,5270,1520,1390,169,159,3600,3494,330,5094,1342,0
20:23:41,13205.63,Fox,7094,328,98,50,85,30,47,18,7094,6996,6946,5270,1520,1390,169,159,3600,3494,330,5094,1342,0
20:23:42,13206.45,Fox,7094,328,96,52,85,30,47,18,7094,6998,6946,5270,1520,1390,169,159,3600,3494,330,5094,1342,0
20:23:42,13207.04,Fox,7094,328,96,50,87,30,47,18,7094,6998,6948,5270,1520,1390,169,159,3600,3494,330,5094,1342,0
20:23:42,13207.89,Fox,7094,327,94,48,91,29,47,18,7094,7000,6952,5270,1520,1390,169,158,3600,3494,330,5095,1342,0
20:23:42,13208.16,Fox,7094,327,94,48,91,29,46,19,7094,7000,6952,5270,1520,1391,169,158,3600,3494,330,5095,1342,0
20:23:43,13209.01,Fox,7094,327,94,48,89,29,48,19,7094,7000,6952,5272,1522,1391,169,158,3600,3494,330,5095,1342,0
20:23:43,13209.57,Fox,7096,328,96,48,89,29,47,19,7096,7000,6952,5272,1522,1392,168,160,3600,3496,330,5096,1342,0
20:23:43,13210.17,Fox,7098,329,94,48,88,31,45,21,7096,7002,6954,5274,1522,1394,168,161,3601,3497,331,5096,1342,0
20:23:43,13210.77,Fox,7098,328,96,48,88,31,45,20,7098,7002,6954,5274,1522,1394,168,160,3601,3497,331,5096,1343,0
20:23:43,13211.66,Fox,7098,328,96,46,90,31,45,20,7098,7002,6956,5274,1522,1394,168,160,3601,3497,331,5096,1343,0
20:23:44,13212.78,Fox,7098,328,94,48,90,31,45,20,7098,7004,6956,5274,1522,1394,168,160,3601,3497,331,5096,1343,0
20:23:44,13213.66,Fox,7098,327,92,50,88,32,45,20,7098,7006,6956,5276,1522,1394,167,160,3601,3497,331,5097,1343,0
20:23:45,13214.85,Fox,7100,329,94,50,84,34,45,22,7100,7006,6956,5280,1524,1396,169,160,3603,3497,331,5097,1343,0
20:23:45,13215.45,Fox,7104,332,94,50,81,36,45,22,7100,7006,6956,5282,1524,1396,170,162,3605,3499,331,5098,1343,0
20:23:45,13216.05,Fox,7104,332,98,48,83,36,45,22,7104,7006,6958,5282,1524,1396,170,162,3605,3499,331,5098,1343,0
20:23:45,13216.35,Fox,7104,332,94,52,83,36,45,22,7104,7010,6958,5282,1524,1396,170,162,3605,3499,331,5098,1343,0
20:23:45,13217.24,Fox,7106,334,94,54,83,36,45,22,7106,7012,6958,5282,1524,1396,170,164,3605,3501,331,5098,1343,0
20:23:46,13217.84,Fox,7108,336,96,52,85,36,45,22,7108,7012,6960,5282,1524,1396,170,166,3605,3503,331,5098,1343,0
20:23:46,13218.44,Fox,7110,338,94,54,85,36,45,22,7108,7014,6960,5282,1524,1396,170,168,3605,3505,331,5098,1343,0
20:23:46,13219.04,Fox,7112,340,94,56,83,38,45,22,7110,7016,6960,5284,1524,1396,172,168,3607,3505,331,5098,1343,0
20:23:46,13219.34,Fox,7112,340,96,56,83,38,45,22,7112,7016,6960,5284,1524,1396,172,168,3607,3505,331,5098,1343,0
20:23:47,13220.5,Fox,7112,339,96,54,83,39,45,22,7112,7016,6962,5286,1524,1396,172,167,3607,3505,331,5099,1343,0
20:23:47,13221.39,Fox,7112,339,96,54,83,39,44,23,7112,7016,6962,5286,1524,1397,172,167,3607,3505,331,5099,1343,0
20:23:47,13222.29,Fox,7114,340,96,56,80,41,43,24,7114,7018,6962,5288,1524,1398,171,169,3607,3507,331,5100,1343,0
20:23:47,13223.17,Fox,7116,341,98,56,79,41,43,24,7116,7018,6962,5288,1524,1398,171,170,3608,3508,331,5101,1343,0
20:23:48,13224.04,Fox,7116,339,98,56,77,39,45,24,7116,7018,6962,5290,1526,1398,170,169,3608,3508,331,5103,1343,0
20:23:48,13224.94,Fox,7118,341,100,56,77,39,45,24,7118,7018,6962,5290,1526,1398,170,171,3608,3510,331,5103,1343,0
20:23:48,13225.84,Fox,7118,338,98,58,77,36,45,24,7118,7020,6962,5290,1526,1398,170,168,3608,3510,332,5105,1343,0
20:23:49,13226.44,Fox,7118,337,98,58,77,36,45,23,7118,7020,6962,5290,1526,1398,169,168,3608,3510,332,5105,1344,0
20:23:49,13227.28,Fox,7120,338,100,56,79,36,44,23,7120,7020,6964,5290,1526,1398,170,168,3610,3510,332,5106,1344,0
20:23:49,13227.88,Fox,7122,339,100,54,77,38,46,22,7120,7020,6966,5294,1528,1398,169,170,3610,3512,332,5106,1345,0
20:23:49,13228.48,Fox,7124,341,104,54,77,38,46,22,7124,7020,6966,5294,1528,1398,169,172,3610,3514,332,5106,1345,0
20:23:49,13229.08,Fox,7128,343,106,54,77,38,45,21,7126,7020,6966,5294,1528,1398,169,174,3612,3516,332,5107,1346,0
20:23:50,13229.68,Fox,7128,341,108,52,73,42,45,21,7128,7020,6968,5300,1528,1398,167,174,3612,3516,332,5109,1346,0
20:23:50,13230.28,Fox,7128,341,106,50,77,40,47,21,7128,7022,6972,5300,1530,1398,167,174,3612,3516,332,5109,1346,0
20:23:50,13230.86,Fox,7128,340,104,50,77,42,47,20,7128,7024,6974,5302,1530,1398,167,173,3612,3516,332,5109,1347,0
20:23:50,13231.74,Fox,7130,342,104,50,77,44,47,20,7130,7026,6976,5304,1530,1398,169,173,3614,3516,332,5109,1347,0
20:23:51,13232.34,Fox,7130,341,104,50,77,42,49,19,7130,7026,6976,5304,1532,1398,169,172,3614,3516,332,5109,1348,0
20:23:51,13232.94,Fox,7130,341,102,52,77,42,49,19,7130,7028,6976,5304,1532,1398,169,172,3614,3516,332,5109,1348,0
20:23:51,13233.84,Fox,7130,341,102,50,79,42,49,19,7130,7028,6978,5304,1532,1398,169,172,3614,3516,332,5109,1348,0
20:23:51,13234.44,Fox,7130,341,102,50,78,43,49,19,7130,7028,6978,5305,1532,1398,169,172,3614,3516,332,5109,1348,0
20:23:52,13235.87,Fox,7132,342,100,50,79,43,49,19,7130,7030,6980,5306,1532,1398,169,173,3615,3517,332,5110,1348,0
20:23:52,13236.17,Fox,7132,342,102,50,79,43,49,19,7132,7030,6980,5306,1532,1398,169,173,3615,3517,332,5110,1348,0
20:23:52,13237.06,Fox,7132,341,100,50,81,43,48,19,7132,7032,6982,5306,1532,1398,168,173,3615,3517,332,5111,1348,0
20:23:53,13237.67,Fox,7138,347,102,50,81,41,50,19,7134,7032,6982,5306,1534,1398,171,176,3618,3520,332,5111,1348,0
20:23:53,13238.26,Fox,7138,342,104,50,82,38,50,18,7138,7034,6984,5307,1534,1398,168,174,3618,3520,332,5115,1349,0
20:23:53,13238.87,Fox,7142,344,104,48,80,42,48,20,7140,7036,6988,5311,1534,1400,168,176,3620,3522,332,5117,1349,0
20:23:53,13239.46,Fox,7144,346,106,48,78,44,48,20,7142,7036,6988,5313,1534,1400,170,176,3622,3522,332,5117,1349,0
20:23:53,13240.06,Fox,7146,344,110,48,76,41,50,19,7146,7036,6988,5315,1536,1400,167,177,3622,3524,332,5120,1350,0
20:23:54,13240.96,Fox,7146,343,108,48,78,41,50,18,7146,7038,6990,5315,1536,1400,166,177,3622,3524,332,5120,1351,0
20:23:54,13241.56,Fox,7146,341,108,46,80,39,50,18,7146,7038,6992,5315,1536,1400,166,175,3622,3524,332,5122,1351,0
20:23:54,13242.15,Fox,7146,338,106,48,80,37,49,18,7146,7040,6992,5315,1536,1400,165,173,3622,3524,332,5125,1351,0
20:23:54,13242.74,Fox,7146,338,104,48,80,39,49,18,7146,7042,6994,5317,1536,1400,165,173,3622,3524,332,5125,1351,0
20:23:55,13243.34,Fox,7148,340,104,50,80,39,49,18,7148,7044,6994,5317,1536,1400,165,175,3622,3526,332,5125,1351,0
20:23:55,13244.23,Fox,7150,342,106,48,82,39,49,18,7150,7044,6996,5317,1536,1400,166,176,3623,3527,332,5125,1351,0
20:23:55,13244.82,Fox,7152,343,106,48,83,39,49,18,7152,7046,6998,5317,1536,1400,167,176,3625,3527,332,5126,1351,0
20:23:55,13245.42,Fox,7154,343,106,50,82,39,49,17,7154,7048,6998,5317,1536,1400,166,177,3626,3528,332,5127,1352,0
20:23:56,13246.02,Fox,7156,343,108,48,81,40,49,17,7156,7048,7000,5319,1536,1400,165,178,3626,3530,332,5129,1352,0
20:23:56,13247.5,Fox,7156,342,108,48,80,41,47,18,7156,7048,7000,5320,1536,1402,164,178,3626,3530,332,5129,1353,0
20:23:56,13247.78,Fox,7156,342,108,48,80,40,48,18,7156,7048,7000,5320,1537,1402,164,178,3626,3530,332,5129,1353,0
20:23:56,13248.68,Fox,7158,342,110,46,81,39,48,18,7158,7048,7002,5320,1537,1402,164,178,3628,3530,332,5131,1353,0
20:23:57,13249.28,Fox,7162,344,114,46,81,37,48,18,7162,7048,7002,5320,1537,1402,166,178,3631,3531,332,5133,1353,0
20:23:57,13249.88,Fox,7162,341,114,46,81,35,47,18,7162,7048,7002,5320,1537,1403,164,177,3631,3531,332,5135,1354,0
20:23:57,13250.48,Fox,7162,340,114,46,81,34,46,19,7162,7048,7002,5320,1537,1404,164,176,3631,3531,333,5135,1354,0
20:23:57,13250.78,Fox,7162,339,114,46,81,34,46,18,7162,7048,7002,5320,1537,1404,164,175,3631,3531,333,5135,1355,0
20:23:58,13251.68,Fox,7164,340,114,44,82,34,46,18,7162,7048,7004,5320,1537,1404,165,175,3633,3531,333,5136,1355,0
20:23:58,13252.28,Fox,7164,340,116,42,82,36,46,18,7164,7048,7006,5322,1537,1404,165,175,3633,3531,333,5136,1355,0
20:23:58,13252.58,Fox,7164,340,114,44,82,36,46,18,7164,7050,7006,5322,1537,1404,165,175,3633,3531,333,5136,1355,0
20:23:58,13253.45,Fox,7164,337,114,44,82,34,46,17,7164,7050,7006,5322,1537,1404,163,174,3633,3531,335,5137,1355,0
20:23:58,13254.35,Fox,7164,337,114,44,82,33,47,17,7164,7050,7006,5322,1538,1404,163,174,3633,3531,335,5137,1355,0
20:23:59,13255.25,Fox,7166,339,112,42,82,37,47,17,7164,7052,7010,5326,1538,1404,164,175,3634,3532,335,5137,1355,0
20:23:59,13255.85,Fox,7170,342,114,40,80,40,47,17,7166,7052,7012,5329,1538,1404,165,177,3636,3534,335,5138,1355,0
20:23:59,13256.15,Fox,7170,342,116,42,80,40,47,17,7170,7054,7012,5329,1538,1404,165,177,3636,3534,335,5138,1355,0
20:23:59,13256.75,Fox,7170,342,116,40,82,40,47,17,7170,7054,7014,5329,1538,1404,165,177,3636,3534,335,5138,1355,0
20:24:00,13257.95,Fox,7170,341,110,44,82,41,47,17,7170,7060,7016,5331,1538,1404,165,176,3636,3534,335,5139,1355,0
20:24:00,13258.55,Fox,7170,339,108,46,80,43,47,15,7170,7062,7016,5333,1538,1404,164,175,3636,3534,335,5139,1357,0
20:24:00,13259.99,Fox,7170,338,108,46,74,49,47,14,7170,7062,7016,5339,1538,1404,163,175,3636,3534,335,5139,1358,0
20:24:01,13261.15,Fox,7172,339,108,46,76,48,47,14,7172,7064,7018,5339,1538,1404,162,177,3636,3536,335,5140,1358,0
20:24:01,13262.35,Fox,7176,343,110,46,76,48,47,14,7174,7064,7018,5339,1538,1404,165,178,3639,3537,335,5140,1358,0
20:24:01,13262.65,Fox,7176,342,112,46,75,49,47,13,7176,7064,7018,5340,1538,1404,165,177,3639,3537,335,5140,1359,0
20:24:02,13264.67,Fox,7176,342,112,44,73,51,49,13,7176,7064,7020,5344,1540,1404,165,177,3639,3537,335,5140,1359,0
20:24:02,13265.57,Fox,7178,341,112,46,73,48,49,13,7178,7066,7020,5344,1540,1404,163,178,3640,3538,335,5143,1359,0
20:24:02,13266.17,Fox,7178,339,112,46,69,51,49,12,7178,7066,7020,5348,1540,1404,163,176,3640,3538,335,5144,1360,0
20:24:03,13267.36,Fox,7180,341,114,46,67,53,49,12,7180,7066,7020,5350,1540,1404,164,177,3641,3539,335,5144,1360,0
20:24:03,13267.96,Fox,7182,343,114,48,65,55,49,12,7182,7068,7020,5352,1540,1404,164,179,3641,3541,335,5144,1360,0
20:24:03,13268.55,Fox,7182,343,112,50,64,56,49,12,7182,7070,7020,5353,1540,1404,164,179,3641,3541,335,5144,1360,0
20:24:04,13269.14,Fox,7186,344,112,48,65,56,49,10,7182,7070,7022,5353,1540,1404,165,179,3644,3542,335,5145,1362,0
20:24:04,13269.74,Fox,7188,346,114,48,67,56,49,10,7186,7072,7024,5353,1540,1404,165,181,3644,3544,335,5145,1362,0
20:24:04,13270.34,Fox,7194,351,114,50,67,58,49,9,7190,7076,7026,5355,1540,1404,169,182,3649,3545,335,5145,1363,0
20:24:04,13270.64,Fox,7194,348,118,50,67,55,49,9,7194,7076,7026,5355,1540,1404,169,179,3649,3545,335,5148,1363,0
20:24:04,13271.84,Fox,7200,354,124,48,69,53,51,9,7200,7076,7028,5355,1542,1404,171,183,3651,3549,335,5148,1363,0
20:24:05,13272.44,Fox,7204,357,126,48,67,54,49,11,7202,7076,7028,5356,1542,1406,172,185,3653,3551,335,5149,1363,0
20:24:05,13273.04,Fox,7208,359,130,48,66,53,47,13,7206,7076,7028,5356,1542,1408,173,186,3655,3553,335,5151,1363,0
20:24:05,13273.64,Fox,7210,360,134,48,65,53,47,13,7210,7076,7028,5356,1542,1408,173,187,3656,3554,335,5152,1363,0
20:24:05,13274.24,Fox,7212,362,134,46,67,51,49,13,7210,7076,7030,5356,1544,1408,174,188,3657,3555,335,5152,1363,0
20:24:06,13274.84,Fox,7214,364,136,46,67,51,49,13,7212,7076,7030,5356,1544,1408,175,189,3658,3556,335,5152,1363,0
20:24:06,13275.44,Fox,7214,362,136,46,69,49,49,13,7214,7078,7032,5356,1544,1408,175,187,3658,3556,335,5154,1363,0
20:24:06,13276.04,Fox,7216,364,136,48,69,49,49,13,7216,7080,7032,5356,1544,1408,176,188,3659,3557,335,5154,1363,0
20:24:06,13276.64,Fox,7218,361,138,46,68,47,49,13,7218,7080,7034,5358,1544,1408,174,187,3659,3559,335,5159,1363,0
20:24:06,13276.93,Fox,7218,361,138,44,70,47,49,13,7218,7080,7036,5358,1544,1408,174,187,3659,3559,335,5159,1363,0
20:24:07,13278.1,Fox,7218,360,136,46,68,48,49,13,7218,7082,7036,5360,1544,1408,174,186,3659,3559,336,5159,1363,0
20:24:07,13278.39,Fox,7218,359,134,48,68,47,49,13,7218,7084,7036,5360,1544,1408,174,185,3659,3559,336,5160,1363,0
20:24:07,13279.27,Fox,7220,360,134,46,69,47,49,13,7218,7084,7038,5360,1544,1408,174,186,3660,3560,336,5161,1363,0
20:24:07,13279.57,Fox,7220,360,136,46,69,47,49,13,7220,7084,7038,5360,1544,1408,174,186,3660,3560,336,5161,1363,0
20:24:08,13280.41,Fox,7222,360,136,44,71,47,49,11,7220,7084,7040,5360,1544,1408,172,188,3660,3562,336,5161,1365,0
20:24:08,13280.69,Fox,7222,358,138,44,69,47,49,11,7222,7084,7040,5362,1544,1408,172,186,3660,3562,336,5163,1365,0
20:24:08,13281.59,Fox,7222,358,136,42,73,47,49,11,7222,7086,7044,5362,1544,1408,172,186,3660,3562,336,5163,1365,0
20:24:08,13282.16,Fox,7222,358,132,46,73,47,49,11,7222,7090,7044,5362,1544,1408,172,186,3660,3562,336,5163,1365,0
20:24:08,13282.44,Fox,7222,357,132,46,73,46,49,11,7222,7090,7044,5362,1544,1408,172,185,3660,3562,336,5164,1365,0
20:24:09,13283.61,Fox,7222,356,130,46,75,45,49,11,7222,7092,7046,5362,1544,1408,171,185,3660,3562,336,5165,1365,0
20:24:09,13284.2,Fox,7224,357,130,44,76,45,49,11,7222,7092,7048,5362,1544,1408,171,186,3661,3563,336,5166,1365,0
20:24:09,13284.8,Fox,7226,359,132,44,76,45,49,11,7224,7092,7048,5362,1544,1408,172,187,3662,3564,336,5166,1365,0
20:24:09,13285.1,Fox,7226,359,134,44,76,45,47,13,7226,7092,7048,5362,1544,1410,172,187,3662,3564,336,5166,1365,0
20:24:09,13285.69,Fox,7226,359,134,44,76,45,45,15,7226,7092,7048,5362,1544,1412,172,187,3662,3564,336,5166,1365,0
20:24:10,13286.58,Fox,7226,359,132,46,76,45,45,15,7226,7094,7048,5362,1544,1412,172,187,3662,3564,336,5166,1365,0
20:24:10,13287.71,Fox,7226,359,132,46,74,47,45,15,7226,7094,7048,5364,1544,1412,172,187,3662,3564,336,5166,1365,0
20:24:10,13288.3,Fox,7226,359,132,46,72,49,45,15,7226,7094,7048,5366,1544,1412,172,187,3662,3564,336,5166,1365,0
20:24:10,13289.15,Fox,7226,359,132,46,72,49,43,17,7226,7094,7048,5366,1544,1414,172,187,3662,3564,336,5166,1365,0
20:24:11,13289.94,Fox,7228,361,134,46,72,49,43,17,7228,7094,7048,5366,1544,1414,172,189,3662,3566,336,5166,1365,0
20:24:11,13290.54,Fox,7230,362,136,46,69,51,43,17,7230,7094,7048,5368,1544,1414,173,189,3664,3566,336,5167,1365,0
20:24:11,13291.13,Fox,7230,362,136,44,67,55,43,17,7230,7094,7050,5372,1544,1414,173,189,3664,3566,336,5167,1365,0
20:24:11,13291.73,Fox,7232,364,138,44,65,57,43,17,7232,7094,7050,5374,1544,1414,173,191,3664,3568,336,5167,1365,0
20:24:12,13292.33,Fox,7234,366,138,46,65,57,43,17,7234,7096,7050,5374,1544,1414,175,191,3666,3568,336,5167,1365,0
20:24:12,13293.23,Fox,7238,369,138,48,64,55,43,19,7236,7098,7050,5374,1546,1416,176,193,3668,3570,336,5168,1365,0
20:24:12,13293.83,Fox,7240,370,140,46,65,55,43,19,7238,7098,7052,5374,1546,1416,175,195,3668,3572,336,5169,1365,0
20:24:12,13294.43,Fox,7242,372,144,46,64,56,43,19,7242,7098,7052,5375,1546,1416,176,196,3669,3573,336,5169,1365,0
20:24:12,13294.73,Fox,7242,372,144,44,66,56,43,19,7242,7098,7054,5375,1546,1416,176,196,3669,3573,336,5169,1365,0
20:24:13,13295.63,Fox,7244,374,146,44,66,56,43,19,7244,7098,7054,5375,1546,1416,177,197,3670,3574,336,5169,1365,0
20:24:13,13296.23,Fox,7244,373,146,42,68,56,43,18,7244,7098,7056,5375,1546,1416,176,197,3670,3574,336,5169,1366,0
20:24:13,13296.53,Fox,7244,373,146,38,70,58,43,18,7244,7098,7060,5377,1546,1416,176,197,3670,3574,336,5169,1366,0
20:24:13,13297.42,Fox,7246,375,146,38,72,58,43,18,7246,7100,7062,5377,1546,1416,176,199,3670,3576,336,5169,1366,0
20:24:14,13298.01,Fox,7246,374,146,38,70,60,43,17,7246,7100,7062,5379,1546,1416,176,198,3670,3576,336,5169,1367,0
20:24:14,13298.61,Fox,7246,374,142,42,69,61,43,17,7246,7104,7062,5380,1546,1416,176,198,3670,3576,336,5169,1367,0
20:24:14,13299.18,Fox,7246,372,142,42,67,61,43,17,7246,7104,7062,5382,1546,1416,175,197,3670,3576,336,5171,1367,0
20:24:14,13299.75,Fox,7246,371,140,42,69,61,43,16,7246,7106,7064,5382,1546,1416,174,197,3670,3576,336,5171,1368,0
20:24:14,13300.35,Fox,7248,372,138,44,69,61,43,15,7246,7108,7064,5382,1546,1416,175,197,3672,3576,336,5171,1369,0
20:24:15,13300.66,Fox,7248,370,140,44,69,59,43,15,7248,7108,7064,5382,1546,1416,175,195,3672,3576,336,5173,1369,0
20:24:15,13301.55,Fox,7248,368,138,46,67,59,43,15,7248,7110,7064,5384,1546,1416,174,194,3672,3576,338,5173,1369,0
20:24:15,13302.15,Fox,7248,367,136,48,66,59,43,15,7248,7112,7064,5385,1546,1416,174,193,3672,3576,338,5174,1369,0
20:24:15,13302.75,Fox,7252,370,138,48,65,57,43,17,7250,7112,7064,5385,1548,1418,174,196,3673,3579,338,5175,1369,0
20:24:15,13303.04,Fox,7252,370,140,48,63,59,43,17,7252,7112,7064,5387,1548,1418,174,196,3673,3579,338,5175,1369,0
20:24:16,13303.92,Fox,7252,370,140,46,65,58,44,17,7252,7112,7066,5387,1549,1418,174,196,3673,3579,338,5175,1369,0
20:24:16,13304.49,Fox,7256,373,142,46,62,60,44,17,7254,7112,7066,5389,1549,1418,175,198,3675,3581,338,5176,1369,0
20:24:16,13305.09,Fox,7256,372,142,48,62,59,44,17,7256,7114,7066,5389,1549,1418,174,198,3675,3581,338,5177,1369,0
20:24:16,13305.69,Fox,7258,374,140,50,61,60,44,17,7256,7116,7066,5390,1549,1418,176,198,3677,3581,338,5177,1369,0
20:24:16,13306.29,Fox,7258,374,142,48,63,60,44,17,7258,7116,7068,5390,1549,1418,176,198,3677,3581,338,5177,1369,0
20:24:17,13306.89,Fox,7258,373,142,48,61,61,43,18,7258,7116,7068,5392,1549,1419,176,197,3677,3581,338,5178,1369,0
20:24:17,13307.49,Fox,7260,374,142,48,63,61,42,18,7260,7118,7070,5392,1549,1419,175,199,3677,3583,338,5179,1369,0
20:24:17,13308.09,Fox,7262,374,144,46,65,59,42,18,7262,7118,7072,5392,1549,1419,173,201,3677,3585,338,5181,1369,0
20:24:17,13308.69,Fox,7262,374,144,44,67,56,45,18,7262,7118,7074,5392,1552,1419,173,201,3677,3585,338,5181,1369,0
20:24:18,13309.29,Fox,7264,374,144,42,66,57,45,18,7262,7118,7076,5394,1552,1419,174,200,3679,3585,339,5182,1369,0
20:24:18,13309.88,Fox,7264,372,144,44,66,55,45,18,7264,7120,7076,5394,1552,1419,173,199,3679,3585,339,5184,1369,0
20:24:18,13311.07,Fox,7264,372,140,48,66,55,45,18,7264,7124,7076,5394,1552,1419,173,199,3679,3585,339,5184,1369,0
20:24:18,13311.91,Fox,7264,372,136,52,64,57,45,18,7264,7128,7076,5396,1552,1419,173,199,3679,3585,339,5184,1369,0
20:24:19,13312.75,Fox,7266,373,136,52,62,58,45,18,7264,7128,7076,5398,1552,1419,175,198,3681,3585,339,5185,1369,0
20:24:19,13313.34,Fox,7266,371,138,52,62,58,45,16,7266,7128,7076,5398,1552,1419,174,197,3681,3585,339,5185,1371,0
20:24:19,13313.93,Fox,7268,373,138,50,64,58,43,18,7266,7128,7078,5398,1552,1421,175,198,3682,3586,339,5185,1371,0
20:24:19,13314.53,Fox,7270,374,140,50,65,56,44,19,7270,7130,7080,5398,1554,1422,176,198,3684,3586,339,5186,1371,0
20:24:19,13314.83,Fox,7270,373,140,50,65,55,44,19,7270,7130,7080,5398,1554,1422,175,198,3684,3586,339,5187,1371,0
20:24:20,13315.72,Fox,7276,377,144,50,62,57,44,18,7274,7130,7080,5401,1554,1422,179,198,3689,3587,339,5188,1372,0
20:24:20,13316.32,Fox,7280,380,148,50,60,56,46,18,7278,7130,7080,5402,1556,1422,179,201,3690,3590,339,5189,1372,0
20:24:20,13316.92,Fox,7280,379,150,46,64,55,46,18,7280,7130,7084,5402,1556,1422,178,201,3690,3590,339,5190,1372,0
20:24:20,13317.52,Fox,7280,379,150,46,62,56,47,18,7280,7130,7084,5404,1557,1422,178,201,3690,3590,339,5190,1372,0
20:24:21,13318.11,Fox,7280,379,150,46,60,58,47,18,7280,7130,7084,5406,1557,1422,178,201,3690,3590,339,5190,1372,0
20:24:21,13319,Fox,7280,379,148,48,60,58,46,19,7280,7132,7084,5406,1557,1423,178,201,3690,3590,339,5190,1372,0
20:24:21,13319.84,Fox,7280,378,148,46,62,57,46,19,7280,7132,7086,5406,1557,1423,178,200,3690,3590,339,5191,1372,0
20:24:21,13320.43,Fox,7284,380,148,46,62,57,46,19,7282,7134,7088,5406,1557,1423,178,202,3692,3592,339,5193,1372,0
20:24:22,13320.73,Fox,7284,380,146,48,64,57,46,19,7284,7138,7090,5406,1557,1423,178,202,3692,3592,339,5193,1372,0
20:24:22,13321.63,Fox,7284,380,144,50,62,59,46,19,7284,7140,7090,5408,1557,1423,178,202,3692,3592,339,5193,1372,0
20:24:22,13322.22,Fox,7284,378,142,50,64,57,46,19,7284,7142,7092,5408,1557,1423,176,202,3692,3592,339,5195,1372,0
20:24:22,13322.81,Fox,7284,378,138,54,64,57,46,19,7284,7146,7092,5408,1557,1423,176,202,3692,3592,339,5195,1372,0
20:24:22,13323.1,Fox,7284,378,138,54,64,55,47,20,7284,7146,7092,5408,1559,1424,176,202,3692,3592,339,5195,1372,0
20:24:23,13323.93,Fox,7288,380,140,54,64,55,47,18,7286,7146,7092,5408,1559,1424,177,203,3695,3593,339,5195,1374,0
20:24:23,13324.23,Fox,7288,380,142,54,64,55,45,20,7288,7146,7092,5408,1559,1426,177,203,3695,3593,339,5195,1374,0
20:24:23,13325.4,Fox,7288,379,142,52,66,55,43,21,7288,7146,7094,5408,1559,1427,177,202,3695,3593,339,5196,1374,0
20:24:23,13325.97,Fox,7288,378,140,54,66,54,43,21,7288,7148,7094,5408,1559,1427,177,201,3695,3593,339,5197,1374,0
20:24:23,13326.25,Fox,7288,377,140,54,66,53,43,21,7288,7148,7094,5408,1559,1427,177,200,3695,3593,339,5198,1374,0
20:24:24,13326.83,Fox,7288,377,138,56,66,53,43,21,7288,7150,7094,5408,1559,1427,177,200,3695,3593,339,5198,1374,0
20:24:24,13327.42,Fox,7288,377,136,58,66,53,43,21,7288,7152,7094,5408,1559,1427,177,200,3695,3593,339,5198,1374,0
20:24:24,13328.01,Fox,7288,377,134,60,66,52,44,21,7288,7154,7094,5408,1560,1427,177,200,3695,3593,339,5198,1374,0
20:24:24,13328.55,Fox,7288,377,132,62,66,52,44,21,7288,7156,7094,5408,1560,1427,177,200,3695,3593,339,5198,1374,0
20:24:25,13329.72,Fox,7288,376,132,62,64,54,43,21,7288,7156,7094,5410,1560,1427,177,199,3695,3593,339,5199,1374,0
20:24:25,13330.27,Fox,7292,379,136,62,61,56,42,22,7292,7156,7094,5412,1560,1428,179,200,3698,3594,340,5199,1374,0
20:24:25,13330.86,Fox,7292,379,136,60,61,58,42,22,7292,7156,7096,5414,1560,1428,179,200,3698,3594,340,5199,1374,0
20:24:25,13331.74,Fox,7292,377,134,60,63,56,41,23,7292,7158,7098,5414,1560,1429,177,200,3698,3594,340,5201,1374,0
20:24:25,13332.34,Fox,7292,377,130,64,63,54,43,23,7292,7162,7098,5414,1562,1429,177,200,3698,3594,340,5201,1374,0
20:24:26,13333.74,Fox,7292,376,130,64,63,53,44,22,7292,7162,7098,5414,1563,1429,177,199,3698,3594,340,5201,1375,0
20:24:26,13334.64,Fox,7292,376,128,66,61,55,44,22,7292,7164,7098,5416,1563,1429,177,199,3698,3594,340,5201,1375,0
20:24:26,13335.24,Fox,7298,379,132,66,59,55,44,21,7296,7164,7098,5416,1563,1429,178,201,3701,3597,340,5203,1376,0
20:24:27,13335.84,Fox,7300,381,134,66,58,56,42,23,7298,7164,7098,5417,1563,1431,179,202,3702,3598,340,5203,1376,0
20:24:27,13336.14,Fox,7300,381,136,64,60,56,42,23,7300,7164,7100,5417,1563,1431,179,202,3702,3598,340,5203,1376,0
20:24:28,13337.04,Fox,7300,381,136,60,62,58,42,23,7300,7164,7104,5419,1563,1431,179,202,3702,3598,340,5203,1376,0
20:24:28,13337.62,Fox,7302,382,136,60,60,59,42,23,7300,7164,7104,5420,1563,1431,179,203,3703,3599,340,5204,1376,0
20:24:28,13338.22,Fox,7302,382,136,62,60,59,42,23,7302,7166,7104,5420,1563,1431,179,203,3703,3599,340,5204,1376,0
20:24:28,13338.81,Fox,7302,382,132,64,62,59,42,23,7302,7170,7106,5420,1563,1431,179,203,3703,3599,340,5204,1376,0
20:24:28,13339.41,Fox,7304,384,132,62,64,57,44,23,7302,7170,7108,5420,1565,1431,180,204,3704,3600,340,5204,1376,0
20:24:29,13340.01,Fox,7304,382,134,60,64,57,44,23,7304,7170,7110,5422,1565,1431,180,202,3704,3600,340,5206,1376,0
20:24:29,13340.9,Fox,7308,384,138,58,64,57,44,23,7308,7170,7112,5424,1565,1431,183,201,3707,3601,340,5208,1376,0
20:24:29,13342.1,Fox,7308,384,138,58,60,61,44,23,7308,7170,7112,5428,1565,1431,183,201,3707,3601,340,5208,1376,0
20:24:30,13343.43,Fox,7310,386,140,56,62,61,44,23,7310,7170,7114,5428,1565,1431,183,203,3707,3603,340,5208,1376,0
20:24:30,13343.73,Fox,7310,385,138,58,61,62,43,23,7310,7172,7114,5429,1565,1431,183,202,3707,3603,340,5209,1376,0
20:24:30,13344.32,Fox,7310,385,138,56,62,63,43,23,7310,7172,7116,5430,1565,1431,183,202,3707,3603,340,5209,1376,0
20:24:30,13345.22,Fox,7314,386,136,60,61,61,43,23,7312,7176,7116,5430,1565,1431,185,201,3710,3604,340,5212,1376,0
20:24:31,13345.82,Fox,7316,388,140,60,61,59,45,23,7316,7176,7116,5430,1567,1431,186,202,3711,3605,340,5212,1376,0
20:24:31,13346.42,Fox,7320,390,142,58,62,58,43,25,7318,7176,7118,5430,1567,1433,187,203,3713,3607,340,5214,1376,0
20:24:31,13347.02,Fox,7322,391,144,58,62,57,43,25,7320,7176,7118,5430,1567,1433,186,205,3713,3609,340,5215,1376,0
20:24:31,13347.62,Fox,7326,392,148,58,61,55,43,25,7324,7176,7118,5430,1567,1433,186,206,3715,3611,343,5215,1376,0
20:24:32,13348.22,Fox,7328,392,148,60,61,53,43,25,7326,7178,7118,5430,1567,1433,187,205,3717,3611,343,5217,1376,0
20:24:32,13348.82,Fox,7330,392,152,58,63,50,45,24,7330,7178,7120,5430,1569,1433,185,207,3717,3613,343,5218,1377,0
20:24:32,13349.42,Fox,7332,394,154,56,65,50,45,24,7332,7178,7122,5430,1569,1433,186,208,3718,3614,343,5218,1377,0
20:24:32,13350.02,Fox,7334,393,154,56,67,49,45,22,7334,7180,7124,5430,1569,1433,185,208,3718,3616,343,5219,1379,0
20:24:33,13350.62,Fox,7336,395,154,54,71,49,45,22,7336,7182,7128,5430,1569,1433,187,208,3720,3616,343,5219,1379,0
20:24:33,13351.22,Fox,7336,394,154,54,71,46,47,22,7336,7182,7128,5430,1571,1433,187,207,3720,3616,343,5220,1379,0
20:24:33,13352.12,Fox,7338,394,150,58,69,44,47,24,7336,7186,7128,5432,1573,1435,187,207,3722,3616,343,5222,1379,0
20:24:33,13352.72,Fox,7340,395,152,60,69,43,47,24,7340,7188,7128,5432,1573,1435,186,209,3722,3618,343,5223,1379,0
20:24:33,13353.32,Fox,7340,395,146,64,71,41,49,24,7340,7194,7130,5432,1575,1435,186,209,3722,3618,343,5223,1379,0
20:24:34,13353.92,Fox,7342,396,148,64,68,42,50,24,7342,7194,7130,5434,1576,1435,186,210,3723,3619,343,5224,1379,0
20:24:34,13354.51,Fox,7342,395,142,70,68,41,50,24,7342,7200,7130,5434,1576,1435,186,209,3723,3619,343,5225,1379,0
20:24:34,13355.11,Fox,7342,394,140,72,66,42,50,24,7342,7202,7130,5436,1576,1435,186,208,3723,3619,343,5226,1379,0
20:24:34,13355.71,Fox,7346,398,136,76,66,42,50,24,7342,7206,7130,5436,1576,1435,186,212,3723,3623,343,5226,1379,0
20:24:35,13356.31,Fox,7346,398,136,80,66,42,50,24,7346,7210,7130,5436,1576,1435,186,212,3723,3623,343,5226,1379,0
20:24:35,13356.91,Fox,7346,397,136,80,61,47,50,23,7346,7210,7130,5441,1576,1435,185,212,3723,3623,343,5226,1380,0
20:24:35,13357.51,Fox,7346,397,134,80,62,48,50,23,7346,7212,7132,5442,1576,1435,185,212,3723,3623,343,5226,1380,0
20:24:35,13358.11,Fox,7346,397,132,82,62,46,52,23,7346,7214,7132,5442,1578,1435,185,212,3723,3623,343,5226,1380,0
20:24:36,13358.71,Fox,7350,401,134,82,64,46,52,23,7350,7216,7134,5442,1578,1435,188,213,3726,3624,343,5226,1380,0
20:24:36,13359.31,Fox,7350,401,132,80,68,46,52,23,7350,7218,7138,5442,1578,1435,188,213,3726,3624,343,5226,1380,0
20:24:36,13359.91,Fox,7352,403,134,78,69,47,52,23,7352,7218,7140,5443,1578,1435,188,215,3726,3626,343,5226,1380,0
20:24:36,13360.51,Fox,7354,405,136,76,71,47,52,23,7354,7218,7142,5443,1578,1435,189,216,3727,3627,343,5226,1380,0
20:24:36,13361.11,Fox,7360,409,138,72,74,46,53,22,7356,7218,7146,5443,1579,1435,190,219,3729,3631,343,5227,1381,0
20:24:37,13361.71,Fox,7360,408,142,72,74,44,53,23,7360,7218,7146,5443,1581,1437,189,219,3729,3631,343,5227,1382,0
20:24:37,13362.31,Fox,7362,408,140,74,74,42,53,23,7360,7220,7146,5443,1581,1437,191,217,3731,3631,343,5229,1382,0
20:24:37,13362.61,Fox,7362,408,142,74,74,42,53,23,7362,7220,7146,5443,1581,1437,191,217,3731,3631,343,5229,1382,0
20:24:37,13363.51,Fox,7362,408,140,76,74,42,53,23,7362,7222,7146,5443,1581,1437,191,217,3731,3631,343,5229,1382,0
20:24:38,13364.41,Fox,7362,405,140,74,75,41,53,22,7362,7222,7148,5444,1581,1437,190,215,3731,3631,343,5231,1383,0
20:24:38,13365.31,Fox,7362,405,140,72,77,41,51,24,7362,7222,7150,5444,1581,1439,190,215,3731,3631,343,5231,1383,0
20:24:38,13366.21,Fox,7364,406,142,70,78,41,51,24,7364,7222,7152,5444,1581,1439,191,215,3733,3631,343,5232,1383,0
20:24:38,13366.81,Fox,7366,407,142,68,78,43,51,23,7364,7222,7154,5446,1581,1439,191,216,3734,3632,343,5232,1384,0
20:24:39,13367.41,Fox,7366,404,142,68,80,40,51,23,7366,7224,7156,5446,1581,1439,190,214,3734,3632,343,5235,1384,0
20:24:39,13368.01,Fox,7366,403,140,70,78,41,49,25,7366,7226,7156,5448,1581,1441,190,213,3734,3632,343,5236,1384,0
20:24:39,13368.61,Fox,7366,403,140,70,76,43,49,25,7366,7226,7156,5450,1581,1441,190,213,3734,3632,343,5236,1384,0
20:24:39,13369.47,Fox,7366,403,140,70,74,45,49,25,7366,7226,7156,5452,1581,1441,190,213,3734,3632,343,5236,1384,0
20:24:40,13370.03,Fox,7368,405,140,68,76,43,49,27,7366,7226,7158,5452,1583,1443,191,214,3735,3633,343,5236,1384,0
20:24:40,13370.32,Fox,7368,404,142,64,80,42,49,27,7368,7226,7162,5452,1583,1443,191,213,3735,3633,343,5237,1384,0
20:24:40,13371.51,Fox,7372,408,146,64,80,40,51,27,7372,7226,7162,5452,1585,1443,191,217,3735,3637,343,5237,1384,0
20:24:41,13372.71,Fox,7374,408,144,66,79,40,51,26,7372,7228,7162,5452,1585,1443,189,219,3735,3639,343,5238,1385,0
20:24:41,13373.31,Fox,7374,408,144,66,81,40,51,26,7374,7230,7164,5452,1585,1443,189,219,3735,3639,343,5238,1385,0
20:24:41,13373.91,Fox,7376,410,146,66,81,40,51,26,7376,7230,7164,5452,1585,1443,189,221,3735,3641,343,5238,1385,0
20:24:41,13374.51,Fox,7378,411,146,68,78,40,53,26,7378,7232,7164,5454,1587,1443,188,223,3735,3643,343,5239,1385,0
20:24:41,13375.11,Fox,7380,411,146,70,76,40,51,28,7380,7234,7164,5456,1587,1445,187,224,3735,3645,343,5241,1385,0
20:24:42,13376.31,Fox,7382,412,144,74,75,40,51,28,7382,7238,7164,5456,1587,1445,186,226,3735,3647,343,5242,1385,0
20:24:42,13376.91,Fox,7384,414,144,74,77,40,51,28,7384,7240,7166,5456,1587,1445,187,227,3736,3648,343,5242,1385,0
20:24:42,13377.51,Fox,7384,414,142,72,78,43,49,30,7384,7242,7170,5459,1587,1447,187,227,3736,3648,343,5242,1385,0
20:24:43,13378.4,Fox,7384,412,140,74,78,41,49,30,7384,7244,7170,5459,1587,1447,187,225,3736,3648,343,5244,1385,0
20:24:43,13379.9,Fox,7388,413,140,74,77,39,49,30,7384,7244,7170,5459,1587,1447,189,224,3739,3649,344,5246,1385,0
20:24:43,13380.2,Fox,7388,413,142,76,75,41,49,30,7388,7246,7170,5461,1587,1447,189,224,3739,3649,344,5246,1385,0
20:24:44,13381.08,Fox,7388,413,142,76,72,44,49,30,7388,7246,7170,5464,1587,1447,189,224,3739,3649,344,5246,1385,0
20:24:44,13381.37,Fox,7388,413,142,76,72,42,51,30,7388,7246,7170,5464,1589,1447,189,224,3739,3649,344,5246,1385,0
20:24:44,13382.55,Fox,7388,413,142,74,72,44,51,30,7388,7246,7172,5466,1589,1447,189,224,3739,3649,344,5246,1385,0
20:24:45,13383.74,Fox,7390,415,142,72,76,44,51,30,7390,7248,7176,5466,1589,1447,191,224,3741,3649,344,5246,1385,0
20:24:45,13384.64,Fox,7394,417,144,72,75,42,53,29,7392,7248,7176,5466,1591,1447,191,226,3742,3652,344,5247,1386,0
20:24:45,13385.24,Fox,7394,415,146,72,75,40,53,29,7394,7248,7176,5466,1592,1448,190,225,3742,3652,344,5248,1387,0
20:24:45,13385.84,Fox,7396,415,142,76,74,39,53,29,7394,7252,7176,5467,1592,1448,190,225,3742,3654,344,5250,1387,0
20:24:46,13386.44,Fox,7398,416,144,76,73,39,53,29,7396,7252,7176,5467,1592,1448,191,225,3744,3654,344,5251,1387,0
20:24:46,13387.04,Fox,7398,416,144,76,75,39,53,29,7398,7254,7178,5467,1592,1448,191,225,3744,3654,344,5251,1387,0
20:24:46,13387.64,Fox,7400,416,144,78,74,38,53,29,7400,7256,7178,5467,1592,1448,190,226,3744,3656,345,5252,1387,0
20:24:46,13387.94,Fox,7400,414,144,78,74,36,53,29,7400,7256,7178,5467,1592,1448,189,225,3744,3656,345,5254,1387,0
20:24:46,13388.54,Fox,7400,414,142,78,76,36,53,29,7400,7258,7180,5467,1592,1448,189,225,3744,3656,345,5254,1387,0
20:24:47,13389.14,Fox,7400,414,142,76,78,36,53,29,7400,7258,7182,5467,1592,1448,189,225,3744,3656,345,5254,1387,0
20:24:47,13390.02,Fox,7402,416,142,78,78,35,54,29,7402,7260,7182,5467,1593,1448,190,226,3745,3657,345,5254,1387,0
20:24:47,13390.62,Fox,7402,415,140,76,82,35,54,28,7402,7262,7186,5467,1593,1448,189,226,3745,3657,345,5254,1388,0
20:24:47,13391.52,Fox,7402,412,140,72,84,34,54,28,7402,7262,7190,5469,1593,1448,189,223,3745,3657,345,5257,1388,0
20:24:48,13392.12,Fox,7408,418,142,70,86,36,54,28,7406,7264,7194,5471,1593,1448,193,225,3749,3659,345,5257,1388,0
20:24:48,13392.72,Fox,7408,417,144,70,86,36,54,27,7408,7264,7194,5471,1593,1448,192,225,3749,3659,345,5257,1389,0
20:24:48,13393.32,Fox,7410,419,144,64,92,36,54,27,7408,7264,7200,5471,1593,1448,193,226,3750,3660,345,5257,1389,0
20:24:48,13393.92,Fox,7410,419,146,60,96,36,54,27,7410,7264,7204,5471,1593,1448,193,226,3750,3660,345,5257,1389,0
20:24:49,13394.52,Fox,7410,419,146,56,100,36,54,27,7410,7264,7208,5471,1593,1448,193,226,3750,3660,345,5257,1389,0
20:24:49,13395.08,Fox,7410,417,146,54,102,33,56,26,7410,7264,7210,5471,1595,1448,192,225,3750,3660,345,5258,1390,0
20:24:49,13395.68,Fox,7410,416,144,54,104,33,56,25,7410,7266,7212,5471,1595,1448,191,225,3750,3660,345,5258,1391,0
20:24:49,13396.28,Fox,7410,414,144,52,106,32,56,24,7410,7266,7214,5471,1595,1448,190,224,3750,3660,345,5259,1392,0
20:24:49,13396.88,Fox,7410,412,142,54,105,31,57,23,7410,7268,7214,5472,1597,1448,189,223,3750,3660,345,5260,1393,0
20:24:50,13397.48,Fox,7410,411,140,54,105,33,57,22,7410,7270,7216,5474,1597,1448,189,222,3750,3660,345,5260,1394,0
20:24:50,13398.08,Fox,7414,412,142,52,105,32,58,21,7412,7270,7218,5474,1598,1448,187,225,3750,3664,345,5262,1395,0
20:24:50,13398.68,Fox,7414,412,138,58,105,32,58,21,7414,7276,7218,5474,1598,1448,187,225,3750,3664,345,5262,1395,0
20:24:50,13399.28,Fox,7414,412,134,62,103,34,58,21,7414,7280,7218,5476,1598,1448,187,225,3750,3664,345,5262,1395,0
20:24:51,13399.88,Fox,7416,413,136,62,100,36,58,21,7416,7280,7218,5478,1598,1448,188,225,3752,3664,345,5263,1395,0
20:24:51,13400.48,Fox,7418,413,138,62,98,37,59,19,7418,7280,7218,5480,1599,1448,188,225,3753,3665,345,5263,1397,0
20:24:51,13401.08,Fox,7424,417,138,60,98,37,59,19,7418,7280,7220,5480,1599,1448,187,230,3754,3670,345,5265,1397,0
20:24:51,13401.68,Fox,7424,415,144,60,98,35,59,19,7424,7280,7220,5480,1599,1448,187,228,3754,3670,345,5267,1397,0
20:24:51,13402.28,Fox,7424,415,144,58,100,35,57,21,7424,7280,7222,5480,1599,1450,187,228,3754,3670,345,5267,1397,0
20:24:52,13402.88,Fox,7426,415,144,58,100,33,58,20,7424,7280,7222,5480,1600,1450,188,227,3756,3670,345,5268,1398,0
20:24:52,13403.48,Fox,7426,415,142,62,100,33,58,20,7426,7284,7222,5480,1600,1450,188,227,3756,3670,345,5268,1398,0
20:24:52,13404.08,Fox,7426,415,142,62,98,35,58,20,7426,7284,7222,5482,1600,1450,188,227,3756,3670,345,5268,1398,0
20:24:52,13404.96,Fox,7426,415,142,62,97,36,58,20,7426,7284,7222,5483,1600,1450,188,227,3756,3670,345,5268,1398,0
20:24:53,13405.52,Fox,7426,415,142,60,99,36,58,20,7426,7284,7224,5483,1600,1450,188,227,3756,3670,345,5268,1398,0
20:24:53,13406.36,Fox,7426,415,142,58,101,34,60,20,7426,7284,7226,5483,1602,1450,188,227,3756,3670,345,5268,1398,0
20:24:53,13406.96,Fox,7426,414,138,62,99,36,60,19,7426,7288,7226,5485,1602,1450,188,226,3756,3670,345,5268,1399,0
20:24:53,13407.86,Fox,7426,412,138,62,99,34,60,19,7426,7288,7226,5485,1602,1450,188,224,3756,3670,345,5270,1399,0
20:24:54,13409.06,Fox,7426,412,138,62,98,33,62,19,7426,7288,7226,5486,1604,1450,188,224,3756,3670,345,5270,1399,0
20:24:54,13409.63,Fox,7430,412,138,62,96,31,60,21,7426,7288,7226,5486,1604,1452,190,222,3760,3670,345,5274,1399,0
20:24:54,13410.23,Fox,7432,411,144,62,91,33,60,21,7432,7288,7226,5490,1604,1452,190,221,3761,3671,345,5277,1399,0
20:24:54,13410.83,Fox,7432,409,144,62,90,30,62,21,7432,7288,7226,5491,1606,1452,190,219,3761,3671,345,5279,1399,0
20:24:55,13411.43,Fox,7436,412,146,60,89,30,64,21,7434,7288,7228,5493,1608,1452,191,221,3763,3673,345,5280,1399,0
20:24:55,13412.04,Fox,7438,413,150,58,91,30,62,22,7438,7288,7230,5493,1608,1453,192,221,3764,3674,345,5281,1399,0
20:24:55,13413.23,Fox,7442,415,150,60,91,30,62,22,7442,7292,7232,5493,1608,1453,191,224,3765,3677,345,5283,1399,0
20:24:55,13413.54,Fox,7442,415,150,58,91,32,62,22,7442,7292,7234,5495,1608,1453,191,224,3765,3677,345,5283,1399,0
20:24:56,13414.73,Fox,7444,414,152,54,95,30,62,21,7444,7292,7238,5495,1608,1453,192,222,3766,3678,345,5285,1400,0
20:24:56,13415.33,Fox,7446,415,154,52,97,29,62,21,7446,7292,7240,5495,1608,1453,194,221,3768,3678,345,5286,1400,0
20:24:56,13415.93,Fox,7448,417,156,50,99,29,62,21,7448,7292,7242,5495,1608,1453,196,221,3770,3678,345,5286,1400,0
20:24:57,13416.83,Fox,7450,418,158,48,100,29,62,21,7450,7292,7244,5495,1608,1453,196,222,3771,3679,345,5287,1400,0
20:24:57,13418.01,Fox,7450,416,154,52,99,30,61,20,7450,7296,7244,5496,1608,1453,196,220,3771,3679,345,5288,1401,0
20:24:57,13418.61,Fox,7452,416,152,52,100,30,61,19,7450,7298,7246,5496,1608,1453,196,220,3772,3680,345,5289,1402,0
20:24:57,13419.21,Fox,7454,417,152,54,97,32,61,19,7452,7300,7246,5498,1608,1453,196,221,3773,3681,345,5290,1402,0
20:24:58,13419.51,Fox,7454,417,154,54,94,35,61,19,7454,7300,7246,5501,1608,1453,196,221,3773,3681,345,5290,1402,0
20:24:58,13420.41,Fox,7458,417,156,54,93,32,61,19,7456,7300,7246,5501,1608,1453,198,219,3776,3682,345,5294,1402,0
20:24:58,13421.01,Fox,7462,419,158,56,90,33,61,19,7460,7302,7246,5503,1608,1453,199,220,3778,3684,345,5296,1402,0
20:24:58,13421.61,Fox,7462,419,160,56,87,36,61,19,7462,7302,7246,5506,1608,1453,199,220,3778,3684,345,5296,1402,0
20:24:58,13422.21,Fox,7462,419,158,56,89,36,61,19,7462,7304,7248,5506,1608,1453,199,220,3778,3684,345,5296,1402,0
20:24:59,13422.81,Fox,7464,420,158,56,89,36,61,18,7462,7304,7248,5506,1608,1453,199,221,3778,3686,345,5296,1403,0
20:24:59,13423.41,Fox,7464,420,156,60,89,34,63,18,7464,7308,7248,5506,1610,1453,199,221,3778,3686,345,5296,1403,0
20:24:59,13424.01,Fox,7464,418,156,58,91,33,63,17,7464,7308,7250,5506,1610,1453,198,220,3778,3686,345,5297,1404,0
20:24:59,13424.31,Fox,7464,418,156,56,93,33,63,17,7464,7308,7252,5506,1610,1453,198,220,3778,3686,345,5297,1404,0
20:24:59,13424.91,Fox,7464,418,156,56,91,35,63,17,7464,7308,7252,5508,1610,1453,198,220,3778,3686,345,5297,1404,0
20:25:00,13425.8,Fox,7464,417,156,52,94,36,63,16,7464,7308,7256,5509,1610,1453,197,220,3778,3686,345,5297,1405,0
20:25:00,13426.4,Fox,7468,420,156,54,91,38,63,16,7466,7310,7256,5511,1610,1453,197,223,3779,3689,345,5298,1405,0
20:25:00,13427,Fox,7468,420,158,52,92,39,63,16,7468,7310,7258,5512,1610,1453,197,223,3779,3689,345,5298,1405,0
20:25:01,13427.9,Fox,7470,420,156,54,89,41,63,15,7468,7312,7258,5514,1610,1453,197,223,3780,3690,345,5299,1406,0
20:25:01,13428.5,Fox,7472,420,156,56,91,40,63,14,7472,7316,7260,5514,1610,1453,196,224,3780,3692,345,5300,1407,0
20:25:01,13429.4,Fox,7474,421,154,58,92,40,63,14,7474,7320,7262,5514,1610,1453,197,224,3782,3692,345,5301,1407,0
20:25:01,13430,Fox,7476,416,154,60,91,35,63,13,7476,7322,7262,5514,1610,1453,194,222,3783,3693,345,5307,1408,0
20:25:02,13430.6,Fox,7476,416,150,62,92,36,62,14,7476,7326,7264,5515,1610,1454,194,222,3783,3693,345,5307,1408,0
20:25:02,13431.18,Fox,7476,414,148,64,91,35,62,14,7476,7328,7264,5516,1610,1454,194,220,3783,3693,345,5309,1408,0
20:25:02,13431.47,Fox,7476,414,146,66,91,35,62,14,7476,7330,7264,5516,1610,1454,194,220,3783,3693,345,5309,1408,0
20:25:02,13432.07,Fox,7476,413,144,68,91,34,62,14,7476,7332,7264,5516,1610,1454,194,219,3783,3693,345,5310,1408,0
20:25:03,13432.97,Fox,7480,415,142,70,89,34,62,14,7476,7334,7264,5516,1610,1454,193,222,3784,3696,345,5312,1408,0
20:25:03,13433.57,Fox,7480,415,144,72,88,35,62,14,7480,7336,7264,5517,1610,1454,193,222,3784,3696,345,5312,1408,0
20:25:03,13434.46,Fox,7482,416,146,70,90,35,62,13,7482,7336,7266,5517,1610,1454,193,223,3785,3697,345,5312,1409,0
20:25:03,13435.35,Fox,7482,414,142,72,92,33,62,13,7482,7340,7268,5517,1610,1454,193,221,3785,3697,345,5314,1409,0
20:25:03,13435.65,Fox,7482,414,142,70,94,33,62,13,7482,7340,7270,5517,1610,1454,193,221,3785,3697,345,5314,1409,0
20:25:04,13436.54,Fox,7484,414,140,72,93,32,62,13,7482,7342,7270,5517,1610,1454,193,221,3786,3698,345,5316,1409,0
20:25:04,13437.14,Fox,7486,414,144,66,98,31,62,13,7486,7342,7276,5518,1610,1454,191,223,3786,3700,345,5318,1409,0
20:25:04,13437.75,Fox,7486,413,144,62,99,33,62,13,7486,7342,7280,5521,1610,1454,191,222,3786,3700,345,5319,1409,0
20:25:04,13438.34,Fox,7488,413,144,62,99,31,62,13,7486,7342,7280,5521,1610,1454,193,220,3788,3700,345,5321,1409,0
20:25:05,13438.64,Fox,7488,413,142,66,99,31,62,13,7488,7346,7280,5521,1610,1454,193,220,3788,3700,345,5321,1409,0
20:25:05,13440.14,Fox,7492,414,144,66,98,30,60,14,7490,7346,7280,5521,1610,1456,193,221,3791,3701,345,5323,1410,0
20:25:05,13440.75,Fox,7494,414,146,66,98,29,60,13,7492,7346,7280,5521,1610,1456,192,222,3791,3703,345,5324,1411,0
20:25:06,13441.34,Fox,7498,417,146,70,98,28,59,14,7496,7350,7280,5521,1610,1457,195,222,3794,3704,345,5325,1411,0
20:25:06,13441.94,Fox,7498,417,148,66,102,28,59,14,7498,7350,7284,5521,1610,1457,195,222,3794,3704,345,5325,1411,0
20:25:06,13442.84,Fox,7500,419,148,68,100,30,59,14,7500,7352,7284,5523,1610,1457,195,224,3794,3706,345,5325,1411,0
20:25:06,13443.13,Fox,7500,419,146,70,100,30,59,14,7500,7354,7284,5523,1610,1457,195,224,3794,3706,345,5325,1411,0
20:25:06,13444.03,Fox,7500,419,140,76,99,31,59,14,7500,7360,7284,5524,1610,1457,195,224,3794,3706,345,5325,1411,0
20:25:07,13444.63,Fox,7502,420,140,76,96,33,59,14,7500,7360,7284,5526,1610,1457,195,225,3795,3707,345,5326,1411,0
20:25:07,13445.23,Fox,7504,421,142,76,97,33,59,14,7504,7362,7286,5526,1610,1457,195,226,3796,3708,345,5327,1411,0
20:25:07,13445.53,Fox,7504,421,142,74,99,33,59,14,7504,7362,7288,5526,1610,1457,195,226,3796,3708,345,5327,1411,0
20:25:07,13446.43,Fox,7506,422,144,74,99,33,56,16,7506,7362,7288,5526,1610,1460,196,226,3797,3709,345,5327,1412,0
20:25:08,13447.33,Fox,7510,425,148,74,97,34,56,16,7510,7362,7288,5528,1610,1460,198,227,3799,3711,345,5328,1412,0
20:25:08,13447.63,Fox,7510,424,148,74,97,33,56,16,7510,7362,7288,5528,1610,1460,198,226,3799,3711,345,5329,1412,0
20:25:08,13448.53,Fox,7512,422,150,74,97,32,55,14,7512,7362,7288,5528,1610,1460,199,223,3800,3712,345,5331,1414,0
20:25:08,13449.13,Fox,7512,422,148,76,96,31,57,14,7512,7364,7288,5529,1612,1460,199,223,3800,3712,345,5331,1414,0
20:25:09,13449.73,Fox,7512,422,146,78,94,33,57,14,7512,7366,7288,5531,1612,1460,199,223,3800,3712,345,5331,1414,0
20:25:09,13450.63,Fox,7514,424,148,78,94,32,58,14,7514,7366,7288,5531,1613,1460,201,223,3802,3712,345,5331,1414,0
20:25:09,13451.52,Fox,7516,426,150,74,94,36,56,16,7516,7366,7292,5535,1613,1462,202,224,3803,3713,345,5331,1414,0
20:25:09,13452.12,Fox,7516,426,150,74,91,39,56,16,7516,7366,7292,5538,1613,1462,202,224,3803,3713,345,5331,1414,0
20:25:10,13452.72,Fox,7520,429,152,74,89,41,56,15,7518,7366,7292,5540,1613,1462,204,225,3806,3714,345,5331,1415,0
20:25:10,13453.32,Fox,7520,427,152,76,89,39,55,16,7520,7368,7292,5540,1613,1463,204,223,3806,3714,345,5333,1415,0
20:25:10,13453.62,Fox,7520,427,152,76,84,44,55,16,7520,7368,7292,5545,1613,1463,204,223,3806,3714,345,5333,1415,0
20:25:10,13454.52,Fox,7520,426,148,80,80,47,55,16,7520,7372,7292,5549,1613,1463,204,222,3806,3714,345,5334,1415,0
20:25:10,13455.12,Fox,7520,426,148,80,78,49,54,17,7520,7372,7292,5551,1613,1464,204,222,3806,3714,345,5334,1415,0
20:25:11,13455.72,Fox,7524,429,148,82,75,51,54,17,7522,7374,7292,5553,1613,1464,206,223,3809,3715,345,5335,1415,0
20:25:11,13456.32,Fox,7528,432,154,78,78,52,54,16,7528,7374,7296,5554,1613,1464,206,226,3809,3719,345,5335,1416,0
20:25:11,13456.92,Fox,7528,432,152,78,78,54,54,16,7528,7376,7298,5556,1613,1464,206,226,3809,3719,345,5335,1416,0
20:25:11,13457.22,Fox,7528,432,150,78,80,54,54,16,7528,7378,7300,5556,1613,1464,206,226,3809,3719,345,5335,1416,0
20:25:12,13458.12,Fox,7530,433,148,80,78,55,54,16,7528,7380,7300,5557,1613,1464,206,227,3810,3720,345,5336,1416,0
20:25:12,13458.42,Fox,7530,433,150,80,76,57,54,16,7530,7380,7300,5559,1613,1464,206,227,3810,3720,345,5336,1416,0
20:25:12,13459.32,Fox,7530,432,148,80,78,56,54,16,7530,7382,7302,5559,1613,1464,206,226,3810,3720,345,5337,1416,0
20:25:12,13459.92,Fox,7532,431,146,82,77,54,54,16,7530,7384,7302,5559,1613,1464,207,224,3812,3720,346,5339,1416,0
20:25:13,13460.52,Fox,7532,431,148,82,77,53,53,18,7532,7384,7302,5559,1614,1466,207,224,3812,3720,346,5339,1416,0
20:25:13,13461.12,Fox,7532,431,148,80,77,55,53,18,7532,7384,7304,5561,1614,1466,207,224,3812,3720,346,5339,1416,0
20:25:13,13461.72,Fox,7534,432,148,80,77,55,53,17,7532,7384,7304,5561,1614,1466,207,225,3812,3722,346,5339,1417,0
20:25:13,13462.32,Fox,7538,433,152,76,79,52,55,17,7536,7384,7308,5563,1616,1466,206,227,3812,3726,346,5342,1417,0
20:25:14,13462.92,Fox,7538,431,150,80,79,51,55,16,7538,7388,7308,5563,1616,1466,205,226,3812,3726,346,5343,1418,0
20:25:14,13463.82,Fox,7540,431,152,80,78,50,55,16,7540,7388,7308,5563,1616,1466,206,225,3814,3726,346,5345,1418,0
20:25:14,13464.42,Fox,7544,434,154,80,77,50,55,16,7542,7388,7308,5563,1616,1466,207,227,3816,3728,346,5346,1418,0
20:25:14,13465.02,Fox,7544,433,156,78,79,49,55,16,7544,7388,7310,5563,1616,1466,207,226,3816,3728,346,5347,1418,0
20:25:15,13465.92,Fox,7546,433,158,78,79,47,54,17,7546,7388,7310,5563,1616,1467,206,227,3816,3730,346,5349,1418,0
20:25:15,13466.52,Fox,7546,432,156,78,79,49,54,16,7546,7390,7312,5565,1616,1467,205,227,3816,3730,346,5349,1419,0
20:25:15,13467.12,Fox,7550,434,158,74,81,49,54,16,7548,7390,7316,5567,1616,1467,205,229,3817,3733,346,5351,1419,0
20:25:16,13467.72,Fox,7556,440,160,76,83,49,54,16,7554,7394,7318,5567,1616,1467,208,232,3820,3736,346,5351,1419,0
20:25:16,13468.02,Fox,7556,439,162,74,85,48,54,16,7556,7394,7320,5567,1616,1467,208,231,3820,3736,346,5352,1419,0
20:25:16,13468.92,Fox,7556,437,160,72,89,46,54,16,7556,7396,7324,5567,1616,1467,208,229,3820,3736,346,5354,1419,0
20:25:16,13469.52,Fox,7556,437,158,72,91,46,54,16,7556,7398,7326,5567,1616,1467,208,229,3820,3736,346,5354,1419,0
20:25:17,13470.12,Fox,7556,437,158,68,95,46,52,18,7556,7398,7330,5567,1616,1469,208,229,3820,3736,346,5354,1419,0
20:25:17,13470.72,Fox,7556,437,156,68,97,46,52,18,7556,7400,7332,5567,1616,1469,208,229,3820,3736,346,5354,1419,0
20:25:17,13471.32,Fox,7556,437,156,66,99,46,51,19,7556,7400,7334,5567,1616,1470,208,229,3820,3736,346,5354,1419,0
20:25:17,13471.92,Fox,7556,436,156,64,99,47,51,19,7556,7400,7336,5569,1616,1470,208,228,3820,3736,346,5355,1419,0
20:25:18,13472.52,Fox,7556,435,154,66,97,49,50,19,7556,7402,7336,5571,1616,1470,207,228,3820,3736,346,5356,1419,0
20:25:18,13473.72,Fox,7556,434,154,64,97,49,52,18,7556,7402,7338,5573,1618,1470,207,227,3820,3736,346,5356,1420,0
20:25:18,13474.02,Fox,7556,434,154,62,98,50,52,18,7556,7402,7340,5574,1618,1470,207,227,3820,3736,346,5356,1420,0
20:25:19,13475.22,Fox,7556,434,148,66,97,53,52,18,7556,7408,7342,5577,1618,1470,207,227,3820,3736,346,5356,1420,0
20:25:19,13476.12,Fox,7558,435,150,66,92,55,54,18,7558,7408,7342,5581,1620,1470,207,228,3821,3737,346,5357,1420,0
20:25:19,13476.72,Fox,7560,433,150,68,92,53,54,16,7560,7410,7342,5581,1620,1470,206,227,3822,3738,346,5359,1422,0
20:25:20,13477.32,Fox,7560,431,150,64,94,53,52,18,7560,7410,7346,5583,1620,1472,205,226,3822,3738,346,5361,1422,0
20:25:20,13477.92,Fox,7562,432,152,64,94,52,52,18,7562,7410,7346,5583,1620,1472,206,226,3824,3738,347,5361,1422,0
20:25:21,13479.42,Fox,7564,434,152,64,92,54,52,18,7562,7410,7346,5585,1620,1472,208,226,3826,3738,347,5361,1422,0
20:25:21,13479.72,Fox,7564,434,154,60,96,54,52,18,7564,7410,7350,5585,1620,1472,208,226,3826,3738,347,5361,1422,0
20:25:21,13480.92,Fox,7564,433,150,62,98,54,52,17,7564,7414,7352,5585,1620,1472,207,226,3826,3738,347,5361,1423,0
20:25:21,13481.52,Fox,7564,433,150,60,100,54,52,17,7564,7414,7354,5585,1620,1472,207,226,3826,3738,347,5361,1423,0
20:25:22,13482.42,Fox,7564,431,148,56,105,53,52,17,7564,7416,7360,5586,1620,1472,207,224,3826,3738,349,5361,1423,0
20:25:22,13483.02,Fox,7566,430,146,58,104,51,52,17,7564,7418,7360,5586,1620,1472,205,225,3827,3739,349,5364,1423,0
20:25:22,13483.62,Fox,7566,428,148,56,106,51,50,17,7566,7418,7362,5586,1620,1474,204,224,3827,3739,349,5364,1425,0
20:25:23,13484.22,Fox,7570,432,142,62,106,51,50,17,7566,7424,7362,5586,1620,1474,205,227,3828,3742,349,5364,1425,0
20:25:23,13484.82,Fox,7572,433,146,62,103,53,50,17,7570,7424,7362,5589,1620,1474,206,227,3830,3742,349,5365,1425,0
20:25:23,13485.42,Fox,7576,435,150,62,102,52,50,17,7574,7424,7362,5589,1620,1474,207,228,3833,3743,349,5367,1425,0
20:25:23,13486.02,Fox,7576,433,150,64,101,49,52,17,7576,7426,7362,5590,1622,1474,207,226,3833,3743,349,5369,1425,0
20:25:24,13486.62,Fox,7578,435,150,64,99,51,50,19,7576,7426,7362,5592,1622,1476,209,226,3835,3743,349,5369,1425,0
20:25:24,13487.22,Fox,7578,434,152,62,101,51,50,18,7578,7426,7364,5592,1622,1476,208,226,3835,3743,349,5369,1426,0
20:25:24,13487.82,Fox,7580,435,154,62,99,53,49,18,7580,7426,7364,5594,1622,1476,207,228,3835,3745,349,5370,1426,0
20:25:24,13488.12,Fox,7580,435,154,60,101,53,49,18,7580,7426,7366,5594,1622,1476,207,228,3835,3745,349,5370,1426,0
20:25:25,13489.02,Fox,7580,435,154,60,99,55,47,20,7580,7426,7366,5596,1622,1478,207,228,3835,3745,349,5370,1426,0
20:25:25,13489.62,Fox,7580,433,154,60,97,55,45,22,7580,7426,7366,5598,1622,1480,207,226,3835,3745,349,5372,1426,0
20:25:26,13491.12,Fox,7580,433,154,60,95,57,42,25,7580,7426,7366,5600,1622,1483,207,226,3835,3745,349,5372,1426,0
20:25:26,13491.72,Fox,7582,434,154,58,96,57,42,25,7580,7426,7368,5600,1622,1483,207,227,3836,3746,349,5373,1426,0
20:25:26,13492.32,Fox,7582,433,156,58,96,57,42,24,7582,7426,7368,5600,1622,1483,206,227,3836,3746,349,5373,1427,0
20:25:27,13492.92,Fox,7584,434,152,60,100,56,42,24,7584,7432,7372,5600,1622,1483,206,228,3837,3747,350,5373,1427,0
20:25:27,13493.82,Fox,7586,436,154,60,100,56,42,24,7586,7432,7372,5600,1622,1483,207,229,3838,3748,350,5373,1427,0
20:25:27,13494.42,Fox,7592,441,154,62,101,56,42,24,7590,7436,7374,5600,1622,1483,210,231,3842,3750,350,5374,1427,0
20:25:27,13495.02,Fox,7594,439,156,62,100,55,42,24,7594,7438,7376,5602,1622,1483,209,230,3842,3752,350,5378,1427,0
20:25:28,13495.92,Fox,7596,441,154,64,100,57,40,26,7596,7442,7378,5604,1622,1485,211,230,3844,3752,350,5378,1427,0
20:25:28,13496.52,Fox,7598,441,156,62,101,56,40,26,7598,7442,7380,5605,1622,1485,211,230,3845,3753,350,5380,1427,0
20:25:28,13497.12,Fox,7600,442,158,62,101,55,40,26,7600,7442,7380,5605,1622,1485,211,231,3845,3755,350,5381,1427,0
20:25:28,13497.72,Fox,7600,442,156,62,97,61,40,26,7600,7444,7382,5611,1622,1485,211,231,3845,3755,350,5381,1427,0
20:25:29,13498.32,Fox,7600,440,154,62,96,62,40,26,7600,7446,7384,5614,1622,1485,209,231,3845,3755,350,5383,1427,0
20:25:29,13498.92,Fox,7600,440,152,64,96,62,38,28,7600,7448,7384,5614,1622,1487,209,231,3845,3755,350,5383,1427,0
20:25:29,13499.52,Fox,7602,441,152,66,95,62,37,29,7602,7450,7384,5614,1622,1488,208,233,3845,3757,350,5384,1427,0
20:25:29,13500.12,Fox,7602,439,152,66,95,58,39,29,7602,7450,7384,5614,1624,1488,208,231,3845,3757,350,5386,1427,0
20:25:30,13501.02,Fox,7602,437,152,66,95,58,39,27,7602,7450,7384,5614,1624,1488,207,230,3845,3757,350,5386,1429,0
20:25:30,13501.62,Fox,7602,436,150,64,99,58,39,26,7602,7452,7388,5614,1624,1488,206,230,3845,3757,350,5386,1430,0
20:25:30,13502.22,Fox,7606,437,148,66,96,59,39,25,7602,7454,7388,5616,1624,1488,206,231,3848,3758,350,5388,1431,0
20:25:30,13502.82,Fox,7608,438,152,66,93,60,40,25,7606,7454,7388,5618,1625,1488,207,231,3850,3758,350,5389,1431,0
20:25:31,13503.42,Fox,7612,441,150,70,93,58,41,25,7608,7458,7388,5618,1626,1488,210,231,3854,3758,350,5390,1431,0
20:25:31,13504.02,Fox,7614,442,150,74,92,58,41,25,7612,7462,7388,5618,1626,1488,210,232,3855,3759,350,5391,1431,0
20:25:31,13504.62,Fox,7616,444,152,74,92,56,43,25,7614,7462,7388,5618,1628,1488,210,234,3855,3761,350,5391,1431,0
20:25:31,13505.22,Fox,7618,444,154,72,93,55,43,25,7616,7462,7390,5618,1628,1488,209,235,3856,3762,350,5393,1431,0
20:25:32,13505.82,Fox,7620,444,154,72,92,57,43,24,7618,7464,7392,5620,1628,1488,208,236,3856,3764,350,5394,1432,0
20:25:32,13506.42,Fox,7620,442,156,70,94,55,43,24,7620,7464,7394,5620,1628,1488,207,235,3856,3764,350,5396,1432,0
20:25:32,13507.32,Fox,7622,443,158,68,96,53,42,26,7622,7464,7396,5620,1629,1490,208,235,3858,3764,350,5397,1432,0
20:25:33,13507.92,Fox,7622,439,158,66,98,50,42,25,7622,7464,7398,5620,1629,1490,205,234,3858,3764,351,5399,1433,0
20:25:33,13508.52,Fox,7624,438,158,66,97,48,42,25,7622,7464,7398,5620,1629,1490,204,234,3859,3765,351,5402,1433,0
20:25:33,13509.12,Fox,7626,438,158,66,99,46,40,27,7624,7466,7400,5620,1629,1492,204,234,3859,3767,351,5404,1433,0
20:25:33,13509.42,Fox,7626,438,158,68,99,46,40,27,7626,7468,7400,5620,1629,1492,204,234,3859,3767,351,5404,1433,0
20:25:34,13511.22,Fox,7630,441,156,70,100,46,40,27,7628,7472,7402,5620,1629,1492,204,237,3860,3770,351,5405,1433,0
20:25:34,13511.82,Fox,7632,441,160,70,97,49,37,28,7632,7472,7402,5623,1629,1494,205,236,3861,3771,351,5406,1434,0
20:25:34,13512.42,Fox,7632,440,158,72,97,48,37,28,7632,7474,7402,5623,1629,1494,205,235,3861,3771,351,5407,1434,0
20:25:35,13512.72,Fox,7632,439,156,74,97,47,37,28,7632,7476,7402,5623,1629,1494,205,234,3861,3771,351,5408,1434,0
20:25:35,13513.62,Fox,7632,438,156,68,103,47,37,27,7632,7476,7408,5623,1629,1494,205,233,3861,3771,351,5408,1435,0
20:25:35,13515.12,Fox,7632,438,156,66,105,46,38,27,7632,7476,7410,5623,1630,1494,205,233,3861,3771,351,5408,1435,0
20:25:36,13516.02,Fox,7632,438,152,70,105,46,38,27,7632,7480,7410,5623,1630,1494,205,233,3861,3771,351,5408,1435,0
20:25:36,13517.22,Fox,7634,440,150,72,101,50,38,27,7632,7482,7410,5627,1630,1494,207,233,3863,3771,351,5408,1435,0
20:25:37,13517.82,Fox,7636,440,152,72,98,52,38,26,7634,7482,7410,5629,1630,1494,208,232,3865,3771,351,5409,1436,0
20:25:37,13518.12,Fox,7636,440,154,72,98,52,38,26,7636,7482,7410,5629,1630,1494,208,232,3865,3771,351,5409,1436,0
20:25:38,13519.02,Fox,7640,442,156,72,97,52,36,27,7638,7482,7410,5629,1630,1496,211,231,3869,3771,351,5410,1437,0
20:25:39,13519.62,Fox,7646,446,162,70,98,53,36,27,7646,7484,7414,5631,1630,1496,210,236,3870,3776,351,5412,1437,0
20:25:39,13520.22,Fox,7650,449,164,72,97,53,36,27,7650,7486,7414,5631,1630,1496,211,238,3872,3778,351,5413,1437,0
20:25:40,13520.82,Fox,7656,455,168,72,97,53,36,27,7654,7486,7414,5631,1630,1496,214,241,3875,3781,351,5413,1437,0
20:25:40,13521.42,Fox,7658,456,168,72,96,55,36,27,7656,7488,7416,5633,1630,1496,215,241,3877,3781,351,5414,1437,0
20:25:40,13522.02,Fox,7660,457,172,70,97,55,34,29,7660,7488,7418,5633,1630,1498,214,243,3877,3783,351,5415,1437,0
20:25:41,13522.62,Fox,7660,454,172,64,101,54,33,30,7660,7488,7424,5635,1630,1499,212,242,3877,3783,351,5418,1437,0
20:25:41,13523.22,Fox,7660,453,168,68,101,54,33,29,7660,7492,7424,5635,1630,1499,211,242,3877,3783,351,5418,1438,0
20:25:41,13524.12,Fox,7662,455,166,72,101,54,33,29,7662,7496,7424,5635,1630,1499,211,244,3877,3785,351,5418,1438,0
20:25:42,13524.42,Fox,7662,455,164,72,103,54,33,29,7662,7498,7426,5635,1630,1499,211,244,3877,3785,351,5418,1438,0
20:25:42,13525.02,Fox,7662,455,164,72,101,56,33,29,7662,7498,7426,5637,1630,1499,211,244,3877,3785,351,5418,1438,0
20:25:42,13525.92,Fox,7664,457,164,74,101,56,33,29,7664,7500,7426,5637,1630,1499,213,244,3879,3785,351,5418,1438,0
20:25:43,13526.52,Fox,7668,460,166,74,101,56,33,28,7666,7500,7426,5637,1630,1499,215,245,3882,3786,351,5418,1439,0
20:25:43,13527.12,Fox,7670,461,170,74,99,57,33,28,7670,7500,7426,5638,1630,1499,216,245,3884,3786,351,5419,1439,0
20:25:43,13527.72,Fox,7672,459,170,76,97,55,33,28,7672,7502,7426,5640,1630,1499,216,243,3885,3787,351,5423,1439,0
20:25:44,13528.32,Fox,7674,460,168,78,94,57,33,28,7672,7504,7426,5643,1630,1499,217,243,3886,3788,352,5423,1439,0
20:25:44,13528.92,Fox,7674,459,170,78,92,59,33,27,7674,7504,7426,5645,1630,1499,217,242,3886,3788,352,5423,1440,0
20:25:44,13529.52,Fox,7676,459,170,80,88,62,33,26,7676,7506,7426,5648,1630,1499,217,242,3887,3789,352,5424,1441,0
20:25:45,13530.12,Fox,7678,459,168,84,88,60,33,26,7678,7510,7426,5648,1630,1499,217,242,3888,3790,352,5426,1441,0
20:25:45,13530.42,Fox,7678,458,168,84,86,62,33,25,7678,7510,7426,5650,1630,1499,217,241,3888,3790,352,5426,1442,0
20:25:45,13531.32,Fox,7680,459,166,80,90,61,35,25,7678,7512,7432,5651,1632,1499,217,242,3889,3791,352,5427,1442,0
20:25:45,13531.62,Fox,7680,457,168,80,88,61,35,25,7680,7512,7432,5653,1632,1499,216,241,3889,3791,352,5429,1442,0
20:25:46,13532.52,Fox,7680,457,168,78,88,63,33,27,7680,7512,7434,5655,1632,1501,216,241,3889,3791,352,5429,1442,0
20:25:46,13533.12,Fox,7680,455,168,74,92,61,33,27,7680,7512,7438,5655,1632,1501,215,240,3889,3791,352,5431,1442,0
20:25:47,13533.72,Fox,7682,456,168,76,91,61,33,27,7682,7514,7438,5655,1632,1501,214,242,3889,3793,352,5432,1442,0
20:25:47,13534.32,Fox,7682,455,166,74,93,63,31,28,7682,7516,7442,5657,1632,1503,213,242,3889,3793,352,5432,1443,0
20:25:47,13535.22,Fox,7684,456,168,74,93,62,31,28,7684,7516,7442,5657,1632,1503,212,244,3889,3795,352,5433,1443,0
20:25:48,13535.82,Fox,7684,454,164,76,94,61,30,29,7684,7520,7444,5658,1632,1504,212,242,3889,3795,352,5435,1443,0
20:25:48,13536.42,Fox,7684,453,164,74,96,61,29,29,7684,7520,7446,5658,1632,1504,212,241,3889,3795,352,5436,1443,0
20:25:49,13537.32,Fox,7686,453,164,72,98,61,29,27,7684,7520,7448,5658,1632,1504,211,242,3889,3797,352,5436,1445,0
20:25:49,13537.92,Fox,7690,454,168,70,96,61,31,26,7688,7520,7450,5662,1634,1504,211,243,3890,3800,352,5438,1446,0
20:25:49,13538.52,Fox,7692,453,170,72,95,59,31,26,7692,7522,7450,5662,1634,1504,210,243,3891,3801,352,5441,1446,0
20:25:49,13539.12,Fox,7692,452,164,78,95,58,31,26,7692,7528,7450,5662,1634,1504,210,242,3891,3801,352,5442,1446,0
20:25:50,13539.72,Fox,7694,449,166,78,95,54,31,25,7694,7528,7450,5662,1634,1504,209,240,3891,3803,352,5446,1447,0
20:25:50,13540.32,Fox,7694,449,166,76,95,56,31,25,7694,7528,7452,5664,1634,1504,209,240,3891,3803,352,5446,1447,0
20:25:50,13540.92,Fox,7694,448,164,76,97,53,33,25,7694,7530,7454,5664,1636,1504,209,239,3891,3803,353,5446,1447,0
20:25:51,13541.52,Fox,7698,451,168,74,97,54,33,25,7698,7530,7456,5666,1636,1504,213,238,3895,3803,353,5447,1447,0
20:25:51,13542.12,Fox,7698,447,168,70,99,54,33,23,7698,7530,7460,5668,1636,1504,211,236,3895,3803,353,5449,1449,0
20:25:51,13542.72,Fox,7700,449,168,68,99,56,33,23,7698,7530,7462,5670,1636,1504,212,237,3896,3804,353,5449,1449,0
20:25:52,13543.02,Fox,7700,449,168,70,95,60,33,23,7700,7532,7462,5674,1636,1504,212,237,3896,3804,353,5449,1449,0
20:25:52,13543.62,Fox,7700,449,168,70,95,60,31,25,7700,7532,7462,5674,1636,1506,212,237,3896,3804,353,5449,1449,0
20:25:52,13544.52,Fox,7700,449,166,70,96,57,35,25,7700,7534,7464,5675,1640,1506,212,237,3896,3804,353,5449,1449,0
20:25:53,13545.12,Fox,7702,451,164,74,96,57,35,25,7702,7538,7464,5675,1640,1506,212,239,3896,3806,353,5449,1449,0
20:25:53,13546.02,Fox,7706,453,166,74,95,55,36,25,7704,7538,7464,5675,1641,1506,213,240,3898,3808,353,5451,1449,0
20:25:53,13546.62,Fox,7706,452,166,76,95,55,34,26,7706,7540,7464,5675,1641,1508,213,239,3898,3808,353,5451,1450,0
20:25:54,13547.22,Fox,7708,453,164,78,95,50,38,26,7706,7542,7464,5675,1645,1508,213,240,3899,3809,353,5452,1450,0
20:25:54,13547.82,Fox,7710,453,166,76,97,47,42,25,7710,7544,7468,5677,1649,1508,212,241,3900,3810,353,5453,1451,0
20:25:54,13548.42,Fox,7712,451,164,78,96,43,43,25,7710,7546,7468,5677,1650,1508,213,238,3902,3810,354,5456,1451,0
20:25:55,13549.02,Fox,7718,455,170,78,92,45,41,27,7716,7546,7468,5679,1650,1510,214,241,3905,3813,354,5458,1451,0
20:25:55,13549.62,Fox,7720,455,170,76,96,44,41,26,7718,7548,7472,5679,1651,1510,214,241,3907,3813,354,5459,1452,0
20:25:55,13549.92,Fox,7720,455,170,78,96,44,41,26,7720,7550,7472,5679,1651,1510,214,241,3907,3813,354,5459,1452,0
20:25:56,13550.82,Fox,7720,454,164,82,98,43,41,26,7720,7556,7474,5679,1651,1510,214,240,3907,3813,354,5460,1452,0
20:25:56,13551.42,Fox,7722,456,166,80,100,43,41,26,7722,7556,7476,5679,1651,1510,215,241,3908,3814,354,5460,1452,0
20:25:56,13552.02,Fox,7724,454,168,80,97,43,41,25,7724,7556,7476,5681,1651,1510,214,240,3909,3815,354,5463,1453,0
20:25:57,13553.52,Fox,7726,453,168,80,92,45,41,25,7724,7556,7476,5685,1651,1510,214,239,3910,3816,354,5466,1453,0
20:25:57,13554.12,Fox,7728,454,170,80,92,44,41,25,7726,7556,7476,5685,1651,1510,213,241,3910,3818,354,5467,1453,0
20:25:58,13554.72,Fox,7730,454,174,76,94,45,41,24,7730,7556,7480,5687,1651,1510,211,243,3910,3820,354,5469,1453,0
20:25:58,13555.32,Fox,7732,456,176,76,94,45,41,24,7732,7556,7480,5687,1651,1510,211,245,3910,3822,354,5469,1453,0
20:25:58,13555.92,Fox,7732,456,176,74,94,45,43,24,7732,7556,7482,5689,1653,1510,211,245,3910,3822,354,5469,1453,0
20:25:59,13556.52,Fox,7734,457,176,74,91,47,43,24,7732,7556,7482,5691,1653,1510,211,246,3911,3823,354,5470,1453,0
20:25:59,13556.82,Fox,7734,456,178,74,89,48,43,24,7734,7556,7482,5693,1653,1510,210,246,3911,3823,354,5471,1453,0
20:26:00,13558.32,Fox,7736,456,180,70,91,48,43,24,7736,7556,7486,5695,1653,1510,210,246,3913,3823,354,5473,1453,0
20:26:00,13558.62,Fox,7736,455,178,72,90,49,43,23,7736,7558,7486,5696,1653,1510,210,245,3913,3823,354,5473,1454,0
20:26:00,13559.52,Fox,7738,455,176,74,89,48,43,23,7736,7560,7486,5696,1653,1510,210,245,3914,3824,354,5475,1454,0
20:26:01,13560.12,Fox,7744,461,178,72,91,48,43,23,7738,7560,7488,5696,1653,1510,214,247,3918,3826,354,5475,1454,0
20:26:01,13560.72,Fox,7748,465,184,74,91,48,43,23,7746,7562,7488,5696,1653,1510,216,249,3920,3828,354,5475,1454,0
20:26:01,13561.32,Fox,7748,465,186,72,93,48,41,25,7748,7562,7490,5696,1653,1512,216,249,3920,3828,354,5475,1454,0
20:26:02,13561.92,Fox,7748,465,186,70,92,51,41,25,7748,7562,7492,5699,1653,1512,216,249,3920,3828,354,5475,1454,0
20:26:02,13562.52,Fox,7748,463,184,68,96,50,41,24,7748,7564,7496,5699,1653,1512,215,248,3920,3828,354,5476,1455,0
20:26:02,13562.82,Fox,7748,463,184,66,98,50,41,24,7748,7564,7498,5699,1653,1512,215,248,3920,3828,354,5476,1455,0
20:26:03,13563.72,Fox,7750,462,186,66,98,47,41,24,7750,7564,7498,5699,1653,1512,216,246,3921,3829,354,5479,1455,0
20:26:03,13564.02,Fox,7750,462,186,64,100,47,41,24,7750,7564,7500,5699,1653,1512,216,246,3921,3829,354,5479,1455,0
20:26:03,13564.92,Fox,7750,459,186,64,100,45,41,23,7750,7564,7500,5699,1653,1512,216,243,3921,3829,354,5481,1456,0
20:26:04,13566.12,Fox,7750,459,184,64,102,45,41,23,7750,7566,7502,5699,1653,1512,216,243,3921,3829,354,5481,1456,0
20:26:04,13566.72,Fox,7752,458,186,62,100,46,41,23,7752,7566,7504,5702,1653,1512,216,242,3922,3830,354,5484,1456,0
20:26:04,13567.02,Fox,7752,456,182,66,100,42,43,23,7752,7570,7504,5702,1655,1512,216,240,3922,3830,354,5486,1456,0
20:26:05,13567.92,Fox,7756,460,178,68,100,44,43,23,7752,7574,7506,5704,1655,1512,218,242,3924,3832,354,5486,1456,0
20:26:05,13568.52,Fox,7762,463,182,66,102,44,43,22,7758,7576,7510,5704,1655,1512,220,243,3928,3834,355,5487,1457,0
20:26:05,13569.12,Fox,7764,463,188,66,101,43,43,22,7764,7576,7510,5704,1655,1512,221,242,3930,3834,355,5489,1457,0
20:26:06,13569.72,Fox,7766,464,188,66,100,42,46,22,7766,7578,7512,5706,1658,1512,222,242,3932,3834,355,5490,1457,0
20:26:06,13570.62,Fox,7768,465,186,68,99,42,46,22,7766,7580,7512,5706,1658,1512,223,242,3934,3834,355,5491,1457,0
20:26:06,13571.22,Fox,7768,463,188,68,99,40,48,20,7768,7580,7512,5706,1660,1512,221,242,3934,3834,355,5491,1459,0
20:26:07,13571.82,Fox,7770,465,188,66,100,41,48,20,7768,7580,7514,5707,1660,1512,223,242,3936,3834,355,5491,1459,0
20:26:07,13572.12,Fox,7770,464,190,66,100,40,48,20,7770,7580,7514,5707,1660,1512,223,241,3936,3834,355,5492,1459,0
20:26:08,13573.02,Fox,7772,463,192,64,101,40,48,18,7772,7580,7516,5707,1660,1512,221,242,3936,3836,355,5493,1461,0
20:26:08,13573.32,Fox,7772,462,192,64,101,40,48,17,7772,7580,7516,5707,1660,1512,221,241,3936,3836,355,5493,1462,0
20:26:08,13574.22,Fox,7772,462,192,60,101,44,48,17,7772,7580,7520,5711,1660,1512,221,241,3936,3836,355,5493,1462,0
20:26:09,13574.82,Fox,7774,463,192,62,100,44,48,17,7774,7582,7520,5711,1660,1512,221,242,3937,3837,355,5494,1462,0
20:26:09,13575.42,Fox,7780,468,192,64,98,45,48,17,7776,7584,7520,5712,1660,1512,221,247,3938,3842,355,5495,1462,0
20:26:09,13575.72,Fox,7780,468,196,64,98,45,48,17,7780,7584,7520,5712,1660,1512,221,247,3938,3842,355,5495,1462,0
20:26:09,13576.32,Fox,7780,467,194,66,98,45,48,16,7780,7586,7520,5712,1660,1512,220,247,3938,3842,355,5495,1463,0
20:26:10,13577.22,Fox,7782,467,192,66,101,44,48,16,7782,7590,7524,5712,1660,1512,220,247,3939,3843,355,5497,1463,0
20:26:10,13577.82,Fox,7786,469,188,66,104,43,48,16,7782,7594,7528,5712,1660,1512,221,248,3942,3844,355,5499,1463,0
20:26:11,13578.42,Fox,7786,467,190,68,104,41,48,16,7786,7596,7528,5712,1660,1512,221,246,3942,3844,355,5501,1463,0
20:26:11,13579.02,Fox,7786,467,188,70,104,41,48,16,7786,7598,7528,5712,1660,1512,221,246,3942,3844,355,5501,1463,0
20:26:11,13579.92,Fox,7790,467,188,70,102,42,48,15,7788,7600,7530,5716,1660,1512,223,244,3945,3845,355,5504,1464,0
20:26:12,13580.22,Fox,7790,467,190,70,102,42,48,15,7790,7600,7530,5716,1660,1512,223,244,3945,3845,355,5504,1464,0
20:26:12,13581.12,Fox,7794,468,190,70,100,42,48,14,7790,7600,7530,5716,1660,1512,222,246,3946,3848,355,5506,1465,0
20:26:12,13581.72,Fox,7796,469,196,68,99,44,48,14,7796,7600,7532,5718,1660,1512,221,248,3946,3850,355,5507,1465,0
20:26:13,13582.32,Fox,7796,467,194,70,97,45,48,13,7796,7602,7532,5720,1660,1512,221,246,3946,3850,355,5508,1466,0
20:26:13,13582.92,Fox,7800,469,196,70,89,49,50,13,7798,7602,7532,5726,1662,1512,220,249,3947,3853,355,5510,1466,0
20:26:13,13583.52,Fox,7800,468,198,66,93,49,50,12,7800,7602,7536,5726,1662,1512,219,249,3947,3853,355,5510,1467,0
20:26:14,13584.12,Fox,7802,466,200,64,94,46,50,12,7802,7602,7538,5726,1662,1512,216,250,3947,3855,355,5514,1467,0
20:26:14,13584.72,Fox,7802,464,200,64,93,44,52,11,7802,7602,7538,5727,1664,1512,216,248,3947,3855,355,5515,1468,0
20:26:14,13585.32,Fox,7804,466,198,66,95,44,52,11,7804,7606,7540,5727,1664,1512,217,249,3948,3856,355,5515,1468,0
20:26:15,13585.92,Fox,7804,465,196,64,99,43,52,11,7804,7608,7544,5727,1664,1512,217,248,3948,3856,355,5516,1468,0
20:26:15,13586.22,Fox,7804,465,192,68,99,43,50,13,7804,7612,7544,5727,1664,1514,217,248,3948,3856,355,5516,1468,0
20:26:15,13587.12,Fox,7806,466,190,68,100,43,50,13,7804,7614,7546,5727,1664,1514,218,248,3950,3856,355,5517,1468,0
20:26:16,13587.72,Fox,7810,467,192,70,97,43,50,13,7808,7616,7546,5727,1664,1514,216,251,3951,3859,355,5520,1468,0
20:26:16,13588.32,Fox,7810,467,192,70,99,43,49,14,7810,7618,7548,5727,1664,1515,216,251,3951,3859,355,5520,1468,0
20:26:16,13588.92,Fox,7812,469,192,66,105,43,49,14,7812,7620,7554,5727,1664,1515,217,252,3952,3860,355,5520,1468,0
20:26:16,13589.22,Fox,7812,469,192,64,107,43,49,14,7812,7620,7556,5727,1664,1515,217,252,3952,3860,355,5520,1468,0
20:26:17,13590.12,Fox,7814,469,190,66,107,41,49,14,7812,7622,7556,5727,1664,1515,218,251,3953,3861,355,5522,1468,0
20:26:17,13590.72,Fox,7816,467,194,66,107,39,49,12,7816,7622,7556,5727,1664,1515,217,250,3954,3862,355,5524,1470,0
20:26:18,13591.32,Fox,7816,467,192,68,107,38,50,12,7816,7624,7556,5727,1665,1515,217,250,3954,3862,355,5524,1470,0
20:26:18,13591.92,Fox,7816,465,190,70,106,37,50,12,7816,7626,7556,5728,1665,1515,215,250,3954,3862,355,5526,1470,0
20:26:19,13593.12,Fox,7822,468,194,70,102,39,50,11,7820,7626,7556,5730,1665,1515,218,250,3960,3862,355,5528,1471,0
20:26:19,13593.72,Fox,7824,466,194,72,98,39,50,11,7822,7628,7556,5734,1665,1515,218,248,3960,3864,355,5532,1471,0
20:26:19,13594.32,Fox,7824,466,192,76,98,39,50,11,7824,7632,7556,5734,1665,1515,218,248,3960,3864,355,5532,1471,0
20:26:20,13595.22,Fox,7826,467,192,76,94,43,50,10,7824,7632,7556,5738,1665,1515,219,248,3961,3865,355,5532,1472,0
20:26:20,13595.82,Fox,7826,467,194,76,94,42,51,10,7826,7632,7556,5738,1666,1515,219,248,3961,3865,355,5532,1472,0
20:26:20,13596.42,Fox,7826,467,194,76,93,43,51,10,7826,7632,7556,5739,1666,1515,219,248,3961,3865,355,5532,1472,0
20:26:21,13597.32,Fox,7826,467,194,74,94,44,51,10,7826,7632,7558,5740,1666,1515,219,248,3961,3865,355,5532,1472,0
20:26:21,13597.92,Fox,7826,467,194,72,94,46,50,11,7826,7632,7560,5742,1666,1516,219,248,3961,3865,355,5532,1472,0
20:26:21,13598.52,Fox,7826,467,194,72,93,47,50,11,7826,7632,7560,5743,1666,1516,219,248,3961,3865,355,5532,1472,0
20:26:22,13599.42,Fox,7828,469,196,70,95,46,50,12,7828,7632,7562,5743,1667,1517,220,249,3962,3866,355,5532,1472,0
20:26:22,13600.32,Fox,7832,470,196,72,94,45,49,12,7830,7634,7562,5743,1667,1517,219,251,3964,3868,355,5535,1472,0
20:26:23,13600.92,Fox,7834,471,196,72,95,46,49,11,7832,7636,7564,5744,1667,1517,219,252,3965,3869,355,5536,1472,0
20:26:23,13601.52,Fox,7834,471,196,74,94,47,49,11,7834,7638,7564,5745,1667,1517,219,252,3965,3869,355,5536,1472,0
20:26:23,13602.12,Fox,7834,471,188,82,93,48,49,11,7834,7646,7564,5746,1667,1517,219,252,3965,3869,355,5536,1472,0
20:26:23,13602.72,Fox,7836,471,184,86,90,49,49,11,7834,7650,7564,5748,1667,1517,218,253,3965,3871,355,5538,1472,0
20:26:24,13603.32,Fox,7836,471,182,90,89,50,49,11,7836,7654,7564,5749,1667,1517,218,253,3965,3871,355,5538,1472,0
20:26:24,13603.92,Fox,7840,470,184,92,88,48,49,9,7840,7656,7564,5749,1667,1517,216,254,3966,3874,355,5542,1473,0
20:26:24,13604.52,Fox,7840,469,180,94,90,47,49,9,7840,7660,7566,5749,1667,1517,216,253,3966,3874,355,5543,1473,0
20:26:24,13604.82,Fox,7840,469,180,94,88,49,49,9,7840,7660,7566,5751,1667,1517,216,253,3966,3874,355,5543,1473,0
20:26:25,13605.72,Fox,7844,467,182,90,91,44,49,9,7842,7660,7570,5751,1667,1517,215,252,3968,3876,355,5549,1473,0
20:26:25,13606.32,Fox,7844,467,184,88,93,44,49,9,7844,7660,7572,5751,1667,1517,215,252,3968,3876,355,5549,1473,0
20:26:26,13606.92,Fox,7846,467,182,86,96,43,49,9,7844,7662,7576,5751,1667,1517,216,251,3970,3876,355,5551,1473,0
20:26:26,13607.52,Fox,7848,468,186,86,95,43,49,9,7848,7662,7576,5751,1667,1517,215,253,3970,3878,355,5552,1473,0
20:26:26,13608.12,Fox,7850,469,188,84,96,43,49,9,7850,7662,7578,5752,1667,1517,215,254,3971,3879,356,5552,1473,0
20:26:26,13608.42,Fox,7850,469,186,86,94,45,49,9,7850,7664,7578,5754,1667,1517,215,254,3971,3879,356,5552,1473,0
20:26:27,13609.32,Fox,7850,468,182,88,96,44,49,9,7850,7668,7580,5754,1667,1517,215,253,3971,3879,356,5553,1473,0
20:26:27,13609.92,Fox,7850,468,180,90,95,45,49,9,7850,7670,7580,5755,1667,1517,215,253,3971,3879,356,5553,1473,0
20:26:27,13610.22,Fox,7850,467,178,92,93,47,49,8,7850,7672,7580,5757,1667,1517,215,252,3971,3879,356,5553,1474,0
20:26:28,13611.42,Fox,7850,466,176,94,93,46,48,9,7850,7674,7580,5757,1667,1518,215,251,3971,3879,356,5554,1474,0
20:26:28,13612.02,Fox,7850,464,174,96,92,46,48,8,7850,7676,7580,5758,1667,1518,215,249,3971,3879,356,5555,1475,0
20:26:29,13612.62,Fox,7852,464,174,98,92,45,47,8,7852,7678,7580,5758,1667,1518,215,249,3972,3880,356,5557,1475,0
20:26:29,13613.52,Fox,7858,466,176,96,93,42,47,8,7854,7678,7582,5758,1667,1518,217,249,3976,3882,356,5561,1475,0
20:26:29,13614.12,Fox,7858,466,178,96,95,42,45,10,7858,7680,7584,5758,1667,1520,217,249,3976,3882,356,5561,1475,0
20:26:30,13615.32,Fox,7862,467,182,94,93,43,45,10,7862,7680,7586,5761,1667,1520,217,250,3977,3885,356,5564,1475,0
20:26:30,13615.92,Fox,7862,467,182,88,99,43,45,10,7862,7680,7592,5761,1667,1520,217,250,3977,3885,356,5564,1475,0
20:26:30,13616.22,Fox,7862,467,180,88,99,45,45,10,7862,7682,7594,5763,1667,1520,217,250,3977,3885,356,5564,1475,0
20:26:31,13617.42,Fox,7864,467,180,86,100,45,44,10,7862,7682,7596,5763,1667,1520,218,249,3979,3885,356,5566,1475,0
20:26:31,13618.02,Fox,7866,469,182,86,102,45,44,10,7866,7684,7598,5763,1667,1520,218,251,3979,3887,356,5566,1475,0
20:26:32,13618.62,Fox,7866,466,182,84,102,44,44,10,7866,7684,7600,5765,1667,1520,218,248,3979,3887,356,5569,1475,0
20:26:32,13618.92,Fox,7866,466,182,84,100,46,44,10,7866,7684,7600,5767,1667,1520,218,248,3979,3887,356,5569,1475,0
20:26:32,13619.82,Fox,7868,468,184,84,100,46,44,10,7868,7684,7600,5767,1667,1520,219,249,3980,3888,356,5569,1475,0
20:26:33,13620.42,Fox,7874,471,184,88,98,45,44,10,7872,7688,7600,5769,1667,1520,221,250,3982,3892,356,5572,1475,0
20:26:33,13621.02,Fox,7878,472,186,90,98,44,45,9,7878,7692,7602,5769,1668,1520,221,251,3984,3894,358,5572,1476,0
20:26:34,13622.22,Fox,7880,473,184,92,96,45,45,9,7878,7694,7602,5771,1668,1520,221,252,3984,3896,358,5573,1476,0
20:26:34,13622.82,Fox,7880,473,186,92,94,47,45,9,7880,7694,7602,5773,1668,1520,221,252,3984,3896,358,5573,1476,0
20:26:34,13623.42,Fox,7880,473,186,92,92,49,43,11,7880,7694,7602,5775,1668,1522,221,252,3984,3896,358,5573,1476,0
20:26:34,13624.02,Fox,7880,473,182,92,96,48,44,11,7880,7698,7606,5775,1669,1522,221,252,3984,3896,358,5573,1476,0
20:26:35,13624.62,Fox,7880,473,182,90,96,50,44,11,7880,7698,7608,5777,1669,1522,221,252,3984,3896,358,5573,1476,0
20:26:35,13625.22,Fox,7886,475,186,86,100,46,44,11,7884,7698,7612,5777,1669,1522,222,253,3986,3900,358,5577,1476,0
20:26:35,13625.82,Fox,7888,476,186,86,101,45,45,11,7886,7700,7614,5777,1670,1522,222,254,3987,3901,358,5578,1476,0
20:26:36,13626.42,Fox,7888,474,188,84,103,43,45,11,7888,7700,7616,5777,1670,1522,221,253,3987,3901,358,5580,1476,0
20:26:36,13627.02,Fox,7890,475,188,82,101,46,45,11,7888,7700,7618,5780,1670,1522,221,254,3988,3902,358,5581,1476,0
20:26:37,13627.62,Fox,7892,476,190,82,103,45,45,11,7892,7702,7620,5780,1670,1522,220,256,3988,3904,358,5582,1476,0
20:26:37,13628.22,Fox,7892,476,190,82,101,45,47,11,7892,7702,7620,5782,1672,1522,220,256,3988,3904,358,5582,1476,0
20:26:37,13628.82,Fox,7892,475,186,84,103,44,47,11,7892,7706,7622,5782,1672,1522,220,255,3988,3904,358,5583,1476,0
20:26:37,13629.12,Fox,7892,473,186,84,100,45,47,11,7892,7706,7622,5785,1672,1522,220,253,3988,3904,358,5585,1476,0
20:26:38,13630.32,Fox,7894,473,184,86,100,46,47,10,7894,7710,7624,5786,1672,1522,221,252,3990,3904,358,5586,1477,0
20:26:38,13630.62,Fox,7894,471,184,84,102,44,47,10,7894,7710,7626,5786,1672,1522,219,252,3990,3904,358,5588,1477,0
20:26:39,13631.52,Fox,7894,471,178,90,102,43,48,10,7894,7716,7626,5786,1673,1522,219,252,3990,3904,358,5588,1477,0
20:26:39,13632.12,Fox,7894,470,176,92,102,42,48,10,7894,7718,7626,5786,1673,1522,218,252,3990,3904,358,5589,1477,0
20:26:39,13632.72,Fox,7894,469,174,90,104,43,48,10,7894,7720,7630,5788,1673,1522,218,251,3990,3904,358,5590,1477,0
20:26:40,13633.32,Fox,7896,467,176,88,104,42,48,9,7896,7720,7632,5790,1673,1522,219,248,3992,3904,358,5593,1478,0
20:26:40,13633.92,Fox,7898,468,176,90,104,41,48,9,7898,7722,7632,5790,1673,1522,221,247,3994,3904,358,5594,1478,0
20:26:40,13634.52,Fox,7900,469,176,92,101,43,48,9,7900,7724,7632,5792,1673,1522,222,247,3996,3904,358,5595,1478,0
20:26:40,13634.82,Fox,7900,467,176,92,99,43,48,9,7900,7724,7632,5794,1673,1522,222,245,3996,3904,358,5597,1478,0
20:26:41,13636.02,Fox,7902,469,176,92,99,42,49,9,7900,7724,7632,5794,1674,1522,223,246,3997,3905,358,5597,1478,0
20:26:41,13636.62,Fox,7902,469,176,94,99,39,52,9,7902,7726,7632,5794,1677,1522,223,246,3997,3905,358,5597,1478,0
20:26:41,13637.22,Fox,7902,466,172,98,99,37,52,8,7902,7730,7632,5794,1677,1522,223,243,3997,3905,358,5599,1479,0
20:26:42,13637.82,Fox,7902,466,170,100,97,38,51,10,7902,7732,7632,5796,1678,1524,223,243,3997,3905,358,5599,1479,0
20:26:42,13638.42,Fox,7902,463,170,100,93,40,51,9,7902,7732,7632,5800,1678,1524,222,241,3997,3905,358,5601,1480,0
20:26:42,13638.72,Fox,7902,462,170,98,95,40,50,9,7902,7732,7634,5800,1678,1524,221,241,3997,3905,358,5602,1480,0
20:26:43,13639.62,Fox,7904,460,168,98,97,36,50,9,7902,7734,7636,5800,1678,1524,219,241,3997,3907,358,5606,1480,0
20:26:43,13640.22,Fox,7906,461,170,96,98,36,49,10,7904,7734,7638,5801,1678,1525,219,242,3998,3908,358,5607,1480,0
20:26:43,13640.82,Fox,7908,461,172,90,105,35,48,11,7908,7736,7646,5801,1678,1526,218,243,3998,3910,358,5609,1480,0
20:26:44,13641.42,Fox,7908,461,172,86,109,35,48,11,7908,7736,7650,5801,1678,1526,218,243,3998,3910,358,5609,1480,0
20:26:44,13642.32,Fox,7908,461,170,82,115,35,46,13,7908,7738,7656,5801,1678,1528,218,243,3998,3910,358,5609,1480,0
20:26:44,13642.92,Fox,7910,462,166,86,117,34,46,13,7910,7744,7658,5801,1678,1528,217,245,3998,3912,358,5610,1480,0
20:26:45,13643.52,Fox,7910,461,162,88,117,35,46,13,7910,7748,7660,5803,1678,1528,217,244,3998,3912,358,5611,1480,0
20:26:45,13644.12,Fox,7912,462,164,88,112,39,46,13,7912,7748,7660,5807,1678,1528,217,245,3999,3913,358,5612,1480,0
20:26:45,13644.72,Fox,7912,459,164,88,112,37,45,13,7912,7748,7660,5807,1678,1529,216,243,3999,3913,358,5614,1481,0
20:26:46,13645.32,Fox,7914,460,166,86,111,39,45,13,7914,7748,7662,5809,1678,1529,215,245,3999,3915,358,5615,1481,0
20:26:46,13646.22,Fox,7914,460,164,88,109,41,45,13,7914,7750,7662,5811,1678,1529,215,245,3999,3915,358,5615,1481,0
20:26:46,13646.52,Fox,7914,460,164,88,107,42,46,13,7914,7750,7662,5813,1679,1529,215,245,3999,3915,358,5615,1481,0
20:26:47,13647.42,Fox,7914,460,164,86,107,44,46,13,7914,7750,7664,5815,1679,1529,215,245,3999,3915,358,5615,1481,0
20:26:47,13648.02,Fox,7914,458,164,82,111,42,46,13,7914,7750,7668,5815,1679,1529,214,244,3999,3915,358,5617,1481,0
20:26:47,13648.62,Fox,7914,457,164,80,112,43,45,13,7914,7750,7670,5816,1679,1529,214,243,3999,3915,358,5618,1481,0
20:26:48,13649.22,Fox,7920,462,164,80,111,43,47,13,7916,7752,7672,5818,1681,1529,217,245,4003,3917,358,5619,1481,0
20:26:48,13649.82,Fox,7922,463,170,78,107,48,47,13,7922,7752,7674,5823,1681,1529,216,247,4003,3919,358,5620,1481,0
20:26:48,13650.42,Fox,7926,465,172,78,106,47,47,13,7924,7752,7674,5823,1681,1529,216,249,4004,3922,358,5622,1481,0
20:26:49,13651.02,Fox,7932,469,168,82,106,47,47,13,7926,7758,7676,5823,1681,1529,220,249,4010,3922,358,5624,1481,0
20:26:49,13651.62,Fox,7932,469,168,86,108,45,49,13,7932,7764,7678,5823,1683,1529,220,249,4010,3922,358,5624,1481,0
20:26:49,13652.22,Fox,7932,469,166,88,108,45,49,13,7932,7766,7678,5823,1683,1529,220,249,4010,3922,358,5624,1481,0
20:26:50,13652.82,Fox,7932,469,166,86,110,45,48,14,7932,7766,7680,5823,1683,1530,220,249,4010,3922,358,5624,1481,0
20:26:50,13653.42,Fox,7932,469,164,88,110,45,48,14,7932,7768,7680,5823,1683,1530,220,249,4010,3922,358,5624,1481,0
20:26:50,13654.32,Fox,7938,469,164,88,108,41,48,14,7932,7768,7680,5823,1683,1530,221,248,4013,3925,359,5629,1481,0
20:26:51,13654.92,Fox,7942,473,170,88,110,41,48,14,7940,7770,7682,5823,1683,1530,222,251,4014,3928,359,5629,1481,0
20:26:51,13655.52,Fox,7944,474,170,90,109,39,50,14,7942,7772,7682,5823,1685,1530,222,252,4015,3929,359,5630,1481,0
20:26:51,13656.12,Fox,7946,473,172,90,108,37,50,14,7944,7772,7682,5823,1685,1530,220,253,4016,3930,359,5633,1481,0
20:26:51,13656.42,Fox,7946,471,174,88,110,35,50,14,7946,7772,7684,5823,1685,1530,220,251,4016,3930,359,5635,1481,0
20:26:52,13657.62,Fox,7946,470,172,90,109,36,50,13,7946,7774,7684,5824,1685,1530,220,250,4016,3930,359,5636,1481,0
20:26:53,13658.22,Fox,7946,468,166,96,109,34,50,13,7946,7780,7684,5824,1685,1530,220,248,4016,3930,359,5638,1481,0
20:26:53,13658.82,Fox,7946,468,166,94,109,36,50,13,7946,7780,7686,5826,1685,1530,220,248,4016,3930,359,5638,1481,0
20:26:53,13659.42,Fox,7946,465,166,90,112,34,50,13,7946,7780,7690,5827,1685,1530,220,245,4016,3930,359,5641,1481,0
20:26:53,13660.02,Fox,7946,462,164,90,114,29,52,13,7946,7782,7692,5827,1687,1530,219,243,4016,3930,359,5644,1481,0
20:26:54,13660.92,Fox,7948,464,160,92,116,29,52,13,7946,7786,7694,5827,1687,1530,219,245,4016,3932,359,5644,1481,0
20:26:54,13661.52,Fox,7950,465,162,92,114,30,52,13,7948,7786,7694,5828,1687,1530,219,246,4017,3933,359,5645,1481,0
20:26:55,13662.12,Fox,7952,467,164,92,114,30,52,13,7950,7786,7694,5828,1687,1530,219,248,4017,3935,359,5645,1481,0
20:26:55,13662.72,Fox,7954,469,164,92,118,30,52,13,7954,7790,7698,5828,1687,1530,221,248,4019,3935,359,5645,1481,0
20:26:55,13663.62,Fox,7956,470,166,92,117,30,52,13,7956,7790,7698,5828,1687,1530,221,249,4020,3936,359,5646,1481,0
20:26:56,13664.22,Fox,7958,469,160,96,118,28,52,13,7956,7796,7700,5828,1687,1530,220,249,4022,3936,360,5648,1481,0
20:26:56,13664.82,Fox,7958,468,162,96,117,29,52,12,7958,7796,7700,5829,1687,1530,219,249,4022,3936,360,5648,1482,0
20:26:56,13665.72,Fox,7958,468,158,100,117,29,52,12,7958,7800,7700,5829,1687,1530,219,249,4022,3936,360,5648,1482,0
20:26:57,13666.32,Fox,7960,469,160,98,114,33,52,12,7960,7800,7702,5833,1687,1530,219,250,4023,3937,360,5649,1482,0
20:26:57,13666.62,Fox,7960,469,158,100,114,33,52,12,7960,7802,7702,5833,1687,1530,219,250,4023,3937,360,5649,1482,0
20:26:57,13667.52,Fox,7962,470,158,96,116,34,52,12,7960,7802,7706,5834,1687,1530,220,250,4025,3937,360,5650,1482,0
20:26:58,13668.12,Fox,7966,472,162,98,115,33,52,12,7966,7804,7706,5834,1687,1530,220,252,4026,3940,360,5652,1482,0
20:26:58,13668.72,Fox,7966,470,162,96,115,33,51,13,7966,7804,7708,5836,1687,1531,219,251,4026,3940,360,5654,1482,0
20:26:58,13669.32,Fox,7966,470,162,94,115,35,51,13,7966,7804,7710,5838,1687,1531,219,251,4026,3940,360,5654,1482,0
20:26:59,13669.92,Fox,7966,468,160,94,117,34,50,13,7966,7806,7712,5838,1687,1531,218,250,4026,3940,360,5656,1482,0
20:26:59,13670.52,Fox,7966,468,156,92,123,34,50,13,7966,7810,7718,5838,1687,1531,218,250,4026,3940,360,5656,1482,0
20:27:00,13671.42,Fox,7970,470,158,92,123,34,50,13,7970,7812,7720,5838,1687,1531,218,252,4028,3942,360,5658,1482,0
20:27:01,13672.32,Fox,7974,472,162,92,122,33,50,13,7974,7812,7720,5838,1687,1531,220,252,4032,3942,360,5660,1482,0
20:27:02,13672.92,Fox,7978,475,160,92,124,33,50,12,7974,7814,7722,5838,1687,1531,222,253,4035,3943,360,5660,1483,0
20:27:02,13673.52,Fox,7978,475,162,92,124,35,50,12,7978,7816,7724,5840,1687,1531,222,253,4035,3943,360,5660,1483,0
20:27:03,13674.42,Fox,7978,474,162,92,123,36,50,11,7978,7816,7724,5841,1687,1531,221,253,4035,3943,360,5660,1484,0
20:27:03,13675.02,Fox,7982,476,166,90,123,36,50,11,7982,7816,7726,5841,1687,1531,221,255,4037,3945,360,5662,1484,0
20:27:04,13675.62,Fox,7984,477,164,92,124,34,51,12,7984,7820,7728,5842,1689,1532,222,255,4038,3946,360,5663,1484,0
20:27:04,13676.22,Fox,7986,478,162,92,122,37,51,12,7984,7822,7730,5845,1689,1532,223,255,4040,3946,360,5664,1484,0
20:27:04,13676.52,Fox,7986,475,162,92,121,35,53,12,7986,7824,7732,5848,1691,1532,223,252,4040,3946,360,5667,1484,0
20:27:05,13677.42,Fox,7992,479,168,92,118,36,53,12,7992,7824,7732,5849,1691,1532,225,254,4044,3948,360,5669,1484,0
20:27:05,13678.02,Fox,7992,477,166,92,119,36,53,11,7992,7826,7734,5850,1691,1532,225,252,4044,3948,360,5670,1485,0
20:27:05,13678.62,Fox,7992,476,166,92,117,38,51,12,7992,7826,7734,5852,1691,1534,225,251,4044,3948,360,5670,1486,0
20:27:06,13679.22,Fox,7994,475,166,92,116,36,51,12,7992,7826,7734,5852,1691,1534,224,251,4046,3948,360,5673,1486,0
20:27:06,13679.82,Fox,7998,475,170,90,116,34,51,12,7996,7826,7736,5852,1691,1534,225,250,4049,3949,360,5677,1486,0
20:27:06,13680.12,Fox,7998,475,172,90,116,34,51,12,7998,7826,7736,5852,1691,1534,225,250,4049,3949,360,5677,1486,0
20:27:07,13681.32,Fox,8000,477,174,88,116,36,51,12,8000,7826,7738,5854,1691,1534,226,251,4050,3950,360,5677,1486,0
20:27:07,13681.92,Fox,8002,477,174,82,124,35,51,11,8002,7828,7746,5854,1691,1534,226,251,4051,3951,360,5678,1487,0
20:27:08,13682.52,Fox,8004,479,176,80,126,35,49,13,8004,7828,7748,5854,1691,1536,226,253,4051,3953,360,5678,1487,0
20:27:08,13683.12,Fox,8004,479,172,84,126,35,49,13,8004,7832,7748,5854,1691,1536,226,253,4051,3953,360,5678,1487,0
20:27:08,13683.72,Fox,8004,479,170,86,126,35,48,14,8004,7834,7748,5854,1691,1537,226,253,4051,3953,360,5678,1487,0
20:27:09,13684.32,Fox,8006,478,172,86,122,36,48,14,8006,7834,7748,5857,1691,1537,225,253,4052,3954,360,5681,1487,0
20:27:09,13684.92,Fox,8008,478,172,84,123,35,44,18,8006,7834,7750,5857,1691,1541,225,253,4053,3955,360,5683,1487,0
20:27:09,13685.52,Fox,8008,478,172,86,121,37,41,21,8008,7836,7750,5859,1691,1544,225,253,4053,3955,360,5683,1487,0
20:27:10,13686.12,Fox,8010,478,172,86,119,37,40,22,8008,7836,7750,5860,1691,1545,225,253,4054,3956,360,5685,1487,0
20:27:10,13686.72,Fox,8012,476,172,90,116,34,42,22,8012,7840,7750,5862,1693,1545,223,253,4054,3958,360,5689,1487,0
20:27:11,13687.32,Fox,8014,475,174,90,114,32,42,23,8014,7840,7750,5863,1694,1546,222,253,4054,3960,360,5692,1487,0
20:27:11,13687.92,Fox,8016,475,176,88,113,33,42,23,8016,7840,7752,5865,1694,1546,220,255,4054,3962,360,5694,1487,0
20:27:11,13688.52,Fox,8016,472,172,92,113,31,42,22,8016,7844,7752,5865,1694,1546,220,252,4054,3962,360,5696,1488,0
20:27:11,13689.12,Fox,8020,472,174,92,110,30,42,22,8018,7844,7752,5866,1694,1546,221,251,4057,3963,362,5698,1488,0
20:27:12,13689.72,Fox,8020,472,174,88,116,30,42,22,8020,7846,7758,5866,1694,1546,221,251,4057,3963,362,5698,1488,0
20:27:12,13690.32,Fox,8020,472,172,84,121,31,42,22,8020,7848,7764,5867,1694,1546,221,251,4057,3963,362,5698,1488,0
20:27:12,13690.92,Fox,8026,475,170,84,120,32,41,22,8020,7850,7766,5869,1694,1546,220,255,4059,3967,362,5701,1488,0
20:27:13,13691.52,Fox,8026,473,176,84,120,29,42,22,8026,7850,7766,5869,1695,1546,220,253,4059,3967,362,5703,1488,0
20:27:13,13692.12,Fox,8026,473,176,82,122,29,42,22,8026,7850,7768,5869,1695,1546,220,253,4059,3967,362,5703,1488,0
20:27:14,13693.02,Fox,8028,474,178,82,117,33,42,22,8028,7850,7768,5873,1695,1546,220,254,4060,3968,362,5704,1488,0
20:27:14,13693.32,Fox,8028,474,178,80,118,34,40,24,8028,7850,7770,5874,1695,1548,220,254,4060,3968,362,5704,1488,0
20:27:14,13694.52,Fox,8030,473,180,78,120,31,40,24,8030,7850,7772,5874,1695,1548,219,254,4061,3969,362,5707,1488,0
20:27:15,13695.12,Fox,8032,475,180,80,120,31,40,24,8032,7852,7772,5874,1695,1548,220,255,4062,3970,362,5707,1488,0
20:27:15,13695.72,Fox,8034,473,180,80,120,29,39,23,8032,7852,7772,5874,1695,1548,216,257,4062,3972,362,5710,1489,0
20:27:15,13696.32,Fox,8034,471,176,84,122,28,39,22,8034,7858,7774,5874,1695,1548,216,255,4062,3972,362,5711,1490,0
20:27:16,13696.92,Fox,8034,469,176,78,128,26,39,22,8034,7858,7780,5874,1695,1548,216,253,4062,3972,362,5713,1490,0
20:27:16,13697.82,Fox,8034,468,172,82,128,25,39,22,8034,7862,7780,5874,1695,1548,216,252,4062,3972,362,5714,1490,0
20:27:16,13698.42,Fox,8036,466,172,80,129,22,39,22,8034,7862,7782,5874,1695,1548,215,251,4063,3973,362,5718,1490,0
20:27:17,13699.02,Fox,8038,467,176,80,128,22,39,22,8038,7862,7782,5874,1695,1548,216,251,4065,3973,362,5719,1490,0
20:27:17,13699.32,Fox,8038,467,176,76,132,22,39,22,8038,7862,7786,5874,1695,1548,216,251,4065,3973,362,5719,1490,0
20:27:18,13700.52,Fox,8040,467,174,80,129,24,39,21,8040,7866,7786,5876,1695,1548,215,252,4066,3974,362,5720,1491,0
20:27:18,13701.12,Fox,8044,468,174,78,124,29,38,21,8040,7866,7788,5882,1695,1548,216,252,4069,3975,362,5723,1491,0
20:27:18,13701.72,Fox,8048,468,178,76,121,30,38,21,8044,7866,7790,5885,1695,1548,216,252,4071,3977,362,5727,1491,0
20:27:19,13702.32,Fox,8048,468,180,78,118,33,38,21,8048,7868,7790,5888,1695,1548,216,252,4071,3977,362,5727,1491,0
20:27:19,13702.92,Fox,8050,469,178,76,121,35,38,21,8050,7872,7796,5890,1695,1548,215,254,4071,3979,362,5728,1491,0
20:27:19,13703.52,Fox,8050,466,172,82,117,37,38,20,8050,7878,7796,5894,1695,1548,215,251,4071,3979,362,5730,1492,0
20:27:20,13704.12,Fox,8050,465,172,80,119,36,38,20,8050,7878,7798,5894,1695,1548,215,250,4071,3979,362,5731,1492,0
20:27:20,13704.42,Fox,8050,465,172,78,121,36,37,21,8050,7878,7800,5894,1695,1549,215,250,4071,3979,362,5731,1492,0
20:27:20,13705.32,Fox,8050,463,170,78,123,36,37,19,8050,7880,7802,5894,1695,1549,215,248,4071,3979,362,5731,1494,0
20:27:20,13705.62,Fox,8050,461,170,78,121,38,36,18,8050,7880,7802,5896,1695,1549,214,247,4071,3979,362,5732,1495,0
20:27:21,13706.82,Fox,8050,461,170,76,123,38,34,20,8050,7880,7804,5896,1695,1551,214,247,4071,3979,362,5732,1495,0
20:27:21,13707.42,Fox,8050,461,170,76,121,40,33,21,8050,7880,7804,5898,1695,1552,214,247,4071,3979,362,5732,1495,0
20:27:22,13708.02,Fox,8050,460,164,82,121,40,33,20,8050,7886,7804,5898,1695,1552,214,246,4071,3979,362,5733,1495,0
20:27:22,13708.62,Fox,8052,461,162,82,120,42,31,22,8050,7888,7806,5900,1695,1554,214,247,4072,3980,362,5734,1495,0
20:27:22,13709.22,Fox,8054,462,166,78,123,42,31,22,8054,7888,7810,5901,1695,1554,213,249,4072,3982,362,5735,1495,0
20:27:23,13709.82,Fox,8058,465,166,80,123,41,31,22,8056,7890,7810,5901,1695,1554,215,250,4075,3983,362,5736,1495,0
20:27:23,13710.42,Fox,8058,464,166,80,124,42,30,22,8058,7892,7812,5902,1695,1554,215,249,4075,3983,362,5737,1495,0
20:27:23,13711.02,Fox,8060,463,168,80,122,41,30,22,8060,7892,7812,5903,1695,1554,213,250,4076,3984,362,5740,1495,0
20:27:24,13711.62,Fox,8062,458,168,78,121,37,30,22,8060,7892,7814,5905,1695,1554,212,246,4077,3985,362,5747,1495,0
20:27:24,13712.22,Fox,8062,455,170,76,123,34,30,22,8062,7892,7816,5905,1695,1554,211,244,4077,3985,362,5750,1495,0
20:27:24,13713.12,Fox,8062,451,168,78,122,31,30,22,8062,7894,7816,5906,1695,1554,210,241,4077,3985,362,5754,1495,0
20:27:25,13714.02,Fox,8062,447,168,78,122,27,30,22,8062,7894,7816,5906,1695,1554,208,239,4077,3985,362,5758,1495,0
20:27:25,13714.62,Fox,8062,447,168,72,128,27,30,22,8062,7894,7822,5906,1695,1554,208,239,4077,3985,362,5758,1495,0
20:27:26,13715.22,Fox,8062,447,168,70,128,29,30,22,8062,7894,7824,5908,1695,1554,208,239,4077,3985,362,5758,1495,0
20:27:26,13716.12,Fox,8064,446,168,72,128,26,30,22,8064,7896,7824,5908,1695,1554,208,238,4078,3986,362,5761,1495,0
20:27:26,13716.72,Fox,8064,445,166,72,128,28,29,22,8064,7898,7826,5910,1695,1554,207,238,4078,3986,362,5762,1495,0
20:27:27,13717.02,Fox,8064,445,164,74,128,28,29,22,8064,7900,7826,5910,1695,1554,207,238,4078,3986,362,5762,1495,0
20:27:27,13718.22,Fox,8066,445,166,74,128,27,29,21,8066,7900,7826,5910,1695,1554,207,238,4079,3987,362,5763,1496,0
20:27:28,13718.82,Fox,8070,445,166,76,126,25,29,21,8068,7902,7826,5910,1695,1554,205,240,4080,3990,362,5767,1496,0
20:27:28,13719.42,Fox,8072,445,170,76,121,29,29,20,8072,7902,7826,5914,1695,1554,205,240,4081,3991,362,5768,1497,0
20:27:28,13720.02,Fox,8076,447,172,76,117,31,27,22,8074,7902,7826,5917,1695,1556,207,240,4084,3992,362,5770,1497,0
20:27:29,13720.62,Fox,8076,446,174,74,119,30,27,22,8076,7902,7828,5917,1695,1556,207,239,4084,3992,362,5771,1497,0
20:27:29,13721.52,Fox,8076,445,174,72,119,31,27,22,8076,7902,7830,5919,1695,1556,207,238,4084,3992,362,5772,1497,0
20:27:29,13722.12,Fox,8078,444,174,70,120,29,25,24,8076,7902,7832,5919,1695,1558,206,238,4085,3993,362,5775,1497,0
20:27:29,13722.42,Fox,8078,444,174,70,122,29,25,24,8078,7904,7834,5919,1695,1558,206,238,4085,3993,362,5775,1497,0
20:27:30,13723.32,Fox,8078,443,170,74,122,29,25,23,8078,7908,7834,5919,1695,1558,205,238,4085,3993,362,5775,1498,0
20:27:30,13723.92,Fox,8080,443,172,74,121,28,25,23,8080,7908,7834,5919,1695,1558,206,237,4087,3993,362,5777,1498,0
20:27:31,13724.52,Fox,8080,442,172,72,122,29,25,22,8080,7908,7836,5920,1695,1558,206,236,4087,3993,362,5777,1499,0
20:27:31,13725.12,Fox,8082,443,174,68,125,29,25,22,8082,7908,7840,5920,1695,1558,205,238,4087,3995,362,5778,1499,0
20:27:31,13725.72,Fox,8082,440,172,70,125,27,25,21,8082,7910,7840,5920,1695,1558,204,236,4087,3995,362,5780,1500,0
20:27:32,13726.32,Fox,8084,440,174,70,125,27,25,19,8084,7910,7840,5920,1695,1558,205,235,4089,3995,362,5780,1502,0
20:27:32,13726.92,Fox,8084,440,172,70,125,29,25,19,8084,7912,7842,5922,1695,1558,205,235,4089,3995,362,5780,1502,0
20:27:32,13727.52,Fox,8086,439,172,68,125,29,25,18,8084,7912,7844,5924,1695,1558,205,234,4090,3996,362,5783,1502,0
20:27:33,13728.12,Fox,8092,442,176,70,121,31,25,17,8090,7914,7844,5926,1695,1558,204,238,4092,4000,362,5786,1502,0
20:27:33,13728.72,Fox,8094,441,180,66,124,30,24,17,8094,7914,7848,5926,1695,1559,203,238,4093,4001,362,5788,1503,0
20:27:33,13729.32,Fox,8098,444,182,64,122,33,24,17,8096,7914,7850,5929,1695,1559,205,239,4096,4002,362,5789,1503,0
20:27:33,13729.92,Fox,8098,440,184,64,122,29,24,17,8098,7914,7850,5929,1695,1559,205,235,4096,4002,362,5793,1503,0
20:27:34,13730.52,Fox,8102,438,186,64,115,31,24,16,8100,7914,7850,5934,1695,1559,205,233,4099,4003,362,5798,1504,0
20:27:34,13730.82,Fox,8102,438,188,64,114,32,24,16,8102,7914,7850,5935,1695,1559,205,233,4099,4003,362,5798,1504,0
20:27:35,13731.72,Fox,8104,437,186,66,112,30,25,16,8102,7916,7850,5937,1697,1559,206,231,4101,4003,362,5801,1504,0
20:27:35,13732.32,Fox,8106,438,184,72,111,30,25,16,8106,7922,7850,5937,1697,1559,206,232,4102,4004,362,5802,1504,0
20:27:35,13733.22,Fox,8110,440,184,76,109,30,25,16,8110,7926,7850,5939,1697,1559,205,235,4103,4007,362,5804,1504,0
20:27:36,13733.82,Fox,8110,440,178,80,110,31,24,17,8110,7932,7852,5940,1697,1560,205,235,4103,4007,362,5804,1504,0
20:27:36,13735.02,Fox,8114,442,180,74,115,30,24,17,8112,7932,7858,5940,1697,1560,205,237,4104,4010,362,5806,1504,0
20:27:37,13735.62,Fox,8116,443,182,74,113,32,24,16,8114,7932,7858,5942,1697,1560,205,238,4104,4012,362,5806,1505,0
20:27:37,13736.22,Fox,8118,445,186,74,109,36,24,16,8118,7932,7858,5946,1697,1560,207,238,4106,4012,362,5806,1505,0
20:27:37,13736.82,Fox,8120,446,186,70,110,38,23,17,8118,7932,7862,5948,1697,1561,206,240,4106,4014,362,5807,1505,0
20:27:38,13737.42,Fox,8122,444,182,78,109,36,23,16,8122,7940,7862,5948,1697,1561,205,239,4106,4016,362,5810,1506,0
20:27:38,13738.02,Fox,8122,442,180,80,109,32,25,16,8122,7942,7862,5948,1699,1561,203,239,4106,4016,362,5812,1506,0
20:27:38,13738.62,Fox,8124,441,178,82,106,32,25,16,8122,7944,7862,5950,1699,1561,204,237,4108,4016,362,5815,1506,0
20:27:39,13739.22,Fox,8126,442,180,80,110,32,25,15,8126,7946,7866,5950,1699,1561,205,237,4109,4017,362,5815,1507,0
20:27:39,13739.82,Fox,8128,439,180,80,108,28,27,14,8126,7946,7866,5951,1701,1561,203,236,4110,4018,362,5819,1508,0
20:27:39,13740.12,Fox,8128,439,182,80,108,28,27,14,8128,7946,7866,5951,1701,1561,203,236,4110,4018,362,5819,1508,0
20:27:40,13741.32,Fox,8130,437,182,78,108,26,27,14,8128,7946,7868,5952,1701,1561,203,234,4111,4019,362,5823,1508,0
20:27:40,13741.92,Fox,8134,438,186,72,110,27,27,14,8132,7946,7874,5955,1701,1561,202,236,4113,4021,362,5826,1508,0
20:27:40,13742.52,Fox,8134,438,188,68,112,29,27,14,8134,7946,7878,5957,1701,1561,202,236,4113,4021,362,5826,1508,0
20:27:41,13743.12,Fox,8136,439,188,68,111,27,29,14,8134,7946,7878,5957,1703,1561,202,237,4114,4022,362,5827,1508,0
20:27:42,13743.72,Fox,8138,438,188,68,112,25,29,14,8136,7948,7880,5957,1703,1561,200,238,4114,4024,362,5830,1508,0
20:27:47,13744.32,Fox,8140,437,188,70,111,24,29,13,8138,7950,7880,5957,1703,1561,199,238,4114,4026,362,5832,1509,0
20:27:47,13744.92,Fox,8144,439,190,72,109,24,29,13,8142,7952,7880,5957,1703,1561,198,241,4115,4029,362,5834,1509,0
20:27:47,13745.22,Fox,8144,439,190,74,108,25,29,13,8144,7954,7880,5958,1703,1561,198,241,4115,4029,362,5834,1509,0
20:27:48,13746.12,Fox,8144,437,188,76,108,23,29,13,8144,7956,7880,5958,1703,1561,197,240,4115,4029,362,5836,1509,0
20:27:48,13746.72,Fox,8146,434,188,70,113,19,29,13,8144,7956,7886,5958,1703,1561,198,236,4117,4029,362,5841,1509,0
20:27:48,13747.32,Fox,8150,434,190,70,114,16,29,13,8148,7958,7888,5958,1703,1561,197,237,4118,4032,362,5845,1509,0
20:27:49,13747.92,Fox,8154,436,196,70,112,16,29,13,8154,7958,7888,5958,1703,1561,196,240,4119,4035,362,5847,1509,0
20:27:49,13748.52,Fox,8154,436,196,68,113,17,29,13,8154,7958,7890,5959,1703,1561,196,240,4119,4035,362,5847,1509,0
20:27:49,13749.12,Fox,8156,436,194,68,115,15,29,13,8154,7960,7892,5959,1703,1561,197,239,4121,4035,362,5849,1509,0
20:27:49,13749.72,Fox,8156,436,196,68,113,17,29,13,8156,7960,7892,5961,1703,1561,197,239,4121,4035,362,5849,1509,0
20:27:50,13750.32,Fox,8160,437,196,70,108,19,29,13,8158,7962,7892,5964,1703,1561,195,242,4122,4038,362,5852,1509,0
20:27:50,13750.62,Fox,8160,437,194,74,108,19,29,13,8160,7966,7892,5964,1703,1561,195,242,4122,4038,362,5852,1509,0
20:27:50,13751.82,Fox,8162,437,194,72,109,18,29,13,8160,7966,7894,5964,1703,1561,195,242,4123,4039,362,5854,1509,0
20:27:51,13752.42,Fox,8166,438,198,72,106,18,29,13,8164,7966,7894,5966,1703,1561,197,241,4126,4040,362,5857,1509,0
20:27:51,13753.02,Fox,8166,435,200,72,106,16,29,12,8166,7966,7894,5966,1703,1561,196,239,4126,4040,362,5859,1510,0
20:27:51,13753.92,Fox,8168,436,198,76,104,17,29,12,8168,7970,7894,5967,1703,1561,196,240,4127,4041,362,5860,1510,0
20:27:52,13754.82,Fox,8168,435,194,78,104,19,29,11,8168,7974,7896,5969,1703,1561,196,239,4127,4041,362,5860,1511,0
20:27:52,13755.12,Fox,8168,435,194,76,106,19,29,11,8168,7974,7898,5969,1703,1561,196,239,4127,4041,362,5860,1511,0
20:27:52,13755.72,Fox,8168,434,190,78,108,18,29,11,8168,7978,7900,5969,1703,1561,196,238,4127,4041,362,5861,1511,0
20:27:52,13756.32,Fox,8168,434,190,78,107,19,29,11,8168,7978,7900,5970,1703,1561,196,238,4127,4041,362,5861,1511,0
20:27:53,13757.22,Fox,8170,435,190,78,101,24,29,11,8168,7978,7900,5975,1703,1561,197,238,4129,4041,362,5862,1511,0
20:27:53,13757.52,Fox,8170,435,188,80,103,24,29,11,8170,7982,7902,5975,1703,1561,197,238,4129,4041,362,5862,1511,0
20:27:53,13758.42,Fox,8172,435,186,82,102,24,29,10,8170,7984,7902,5975,1703,1561,197,238,4130,4042,362,5863,1512,0
20:27:53,13759.02,Fox,8172,434,186,84,101,24,29,10,8172,7986,7902,5976,1703,1561,197,237,4130,4042,362,5864,1512,0
20:27:54,13759.92,Fox,8178,439,182,90,98,26,29,10,8174,7992,7902,5978,1703,1561,198,241,4132,4046,362,5865,1512,0
20:27:54,13760.52,Fox,8178,436,186,90,98,23,29,10,8178,7992,7902,5978,1703,1561,197,239,4132,4046,362,5868,1512,0
20:27:54,13761.12,Fox,8182,435,190,88,98,21,29,9,8182,7992,7904,5978,1703,1561,197,238,4134,4048,362,5872,1513,0
20:27:55,13761.72,Fox,8184,436,192,86,98,22,28,10,8184,7992,7906,5980,1703,1562,198,238,4136,4048,362,5873,1513,0
20:27:55,13762.32,Fox,8184,436,188,88,100,22,28,10,8184,7996,7908,5980,1703,1562,198,238,4136,4048,362,5873,1513,0
20:27:55,13762.92,Fox,8186,435,188,90,97,23,27,10,8186,7998,7908,5983,1703,1562,197,238,4138,4048,362,5876,1513,0
20:27:55,13763.22,Fox,8186,435,188,90,95,25,26,11,8186,7998,7908,5985,1703,1563,197,238,4138,4048,362,5876,1513,0
20:27:56,13764.12,Fox,8186,434,186,90,97,24,26,11,8186,8000,7910,5985,1703,1563,196,238,4138,4048,362,5877,1513,0
20:27:56,13764.72,Fox,8188,435,186,92,92,28,26,11,8188,8002,7910,5989,1703,1563,196,239,4139,4049,363,5877,1513,0
20:27:56,13765.32,Fox,8188,433,184,92,94,26,24,13,8188,8004,7912,5989,1703,1565,196,237,4139,4049,363,5879,1513,0
20:27:57,13765.92,Fox,8188,431,184,92,92,28,22,13,8188,8004,7912,5991,1703,1565,194,237,4139,4049,363,5881,1513,0
20:27:57,13766.82,Fox,8190,431,184,92,93,27,22,13,8190,8006,7914,5992,1703,1565,195,236,4141,4049,363,5883,1513,0
20:27:58,13767.72,Fox,8190,430,182,94,93,26,22,13,8190,8008,7914,5992,1703,1565,195,235,4141,4049,363,5884,1513,0
20:27:58,13768.62,Fox,8192,431,184,94,92,26,21,14,8192,8008,7914,5992,1703,1566,195,236,4142,4050,363,5885,1513,0
20:27:58,13769.22,Fox,8192,429,180,98,90,27,21,13,8192,8012,7914,5994,1703,1566,194,235,4142,4050,363,5886,1514,0
20:27:58,13769.82,Fox,8192,429,178,100,89,28,21,13,8192,8014,7914,5995,1703,1566,194,235,4142,4050,363,5886,1514,0
20:27:59,13770.42,Fox,8194,429,178,100,89,28,21,13,8194,8016,7916,5996,1703,1566,195,234,4144,4050,363,5888,1514,0
20:27:59,13771.02,Fox,8194,429,178,94,95,28,21,13,8194,8016,7922,5996,1703,1566,195,234,4144,4050,363,5888,1514,0
20:27:59,13771.62,Fox,8196,430,178,94,96,28,21,13,8196,8018,7924,5996,1703,1566,195,235,4145,4051,363,5889,1514,0
20:28:00,13772.22,Fox,8198,429,176,94,94,29,21,13,8196,8020,7926,5999,1703,1566,194,235,4146,4052,363,5892,1514,0
20:28:00,13772.52,Fox,8198,429,178,88,100,29,21,13,8198,8020,7932,5999,1703,1566,194,235,4146,4052,363,5892,1514,0
20:28:00,13773.42,Fox,8200,426,180,88,99,26,20,13,8200,8020,7932,5999,1703,1567,194,232,4148,4052,363,5896,1515,0
20:28:01,13774.02,Fox,8200,424,174,94,99,24,19,14,8200,8026,7932,5999,1703,1568,194,230,4148,4052,363,5898,1515,0
20:28:01,13774.92,Fox,8200,422,174,94,93,28,19,14,8200,8026,7932,6005,1703,1568,194,228,4148,4052,363,5900,1515,0
20:28:01,13775.52,Fox,8200,420,172,96,91,29,19,13,8200,8028,7932,6007,1703,1568,193,227,4148,4052,363,5901,1516,0
20:28:02,13776.12,Fox,8200,418,172,88,99,27,19,13,8200,8028,7940,6007,1703,1568,193,225,4148,4052,363,5903,1516,0
20:28:02,13776.42,Fox,8200,418,172,86,101,27,19,13,8200,8028,7942,6007,1703,1568,193,225,4148,4052,363,5903,1516,0
20:28:02,13777.32,Fox,8202,417,172,86,101,27,19,12,8202,8030,7944,6008,1703,1568,194,223,4150,4052,363,5905,1517,0
20:28:02,13777.62,Fox,8202,417,170,86,103,27,19,12,8202,8032,7946,6008,1703,1568,194,223,4150,4052,363,5905,1517,0
20:28:03,13778.52,Fox,8204,417,170,88,102,27,19,11,8204,8034,7946,6008,1703,1568,193,224,4150,4054,363,5906,1518,0
20:28:03,13779.72,Fox,8210,418,172,88,99,25,19,11,8206,8034,7946,6008,1703,1568,194,224,4154,4056,363,5911,1518,0
20:28:04,13780.32,Fox,8212,418,178,88,98,24,19,11,8212,8034,7946,6008,1703,1568,195,223,4156,4056,363,5913,1518,0
20:28:04,13781.22,Fox,8212,417,176,90,97,24,19,11,8212,8036,7946,6009,1703,1568,195,222,4156,4056,363,5914,1518,0
20:28:04,13781.82,Fox,8212,417,174,92,96,25,19,11,8212,8038,7946,6010,1703,1568,195,222,4156,4056,363,5914,1518,0
20:28:05,13782.42,Fox,8212,415,174,90,97,24,19,11,8212,8038,7948,6011,1703,1568,194,221,4156,4056,363,5916,1518,0
20:28:05,13783.02,Fox,8212,414,172,90,98,24,19,11,8212,8040,7950,6012,1703,1568,194,220,4156,4056,363,5917,1518,0
20:28:05,13783.62,Fox,8216,416,176,88,99,23,19,11,8216,8040,7952,6012,1703,1568,195,221,4159,4057,363,5919,1518,0
20:28:06,13784.22,Fox,8218,416,174,90,100,23,19,10,8218,8044,7954,6012,1703,1568,195,221,4160,4058,363,5920,1519,0
20:28:06,13784.82,Fox,8218,416,170,92,100,25,19,10,8218,8048,7956,6014,1703,1568,195,221,4160,4058,363,5920,1519,0
20:28:06,13785.42,Fox,8218,413,168,94,97,25,19,10,8218,8050,7956,6017,1703,1568,192,221,4160,4058,363,5923,1519,0
20:28:07,13786.02,Fox,8222,413,170,92,97,23,19,10,8220,8050,7958,6017,1703,1568,192,221,4162,4060,363,5927,1519,0
20:28:07,13786.62,Fox,8222,413,172,92,97,21,19,12,8222,8050,7958,6017,1705,1570,192,221,4162,4060,363,5927,1519,0
20:28:07,13787.52,Fox,8222,412,172,90,97,22,19,12,8222,8050,7960,6019,1705,1570,192,220,4162,4060,363,5928,1519,0
20:28:08,13789.02,Fox,8222,412,172,88,96,25,18,13,8222,8050,7962,6022,1705,1571,192,220,4162,4060,363,5928,1519,0
20:28:08,13789.62,Fox,8222,412,172,84,99,26,18,13,8222,8050,7966,6023,1705,1571,192,220,4162,4060,363,5928,1519,0
20:28:10,13791.72,Fox,8222,411,168,88,99,25,18,13,8222,8054,7966,6023,1705,1571,192,219,4162,4060,363,5929,1519,0
20:28:10,13792.62,Fox,8224,410,164,88,102,23,18,13,8222,8058,7970,6023,1705,1571,193,217,4164,4060,363,5932,1519,0
20:28:11,13793.22,Fox,8224,409,166,88,102,22,16,15,8224,8058,7970,6023,1705,1573,193,216,4164,4060,363,5933,1519,0
20:28:11,13793.52,Fox,8224,409,164,86,106,22,16,15,8224,8060,7974,6023,1705,1573,193,216,4164,4060,363,5933,1519,0
20:28:12,13794.42,Fox,8224,409,162,84,109,23,16,15,8224,8062,7978,6024,1705,1573,193,216,4164,4060,363,5933,1519,0
20:28:12,13795.32,Fox,8226,408,164,84,104,25,16,15,8226,8062,7978,6028,1705,1573,193,215,4165,4061,363,5936,1519,0
20:28:12,13796.22,Fox,8226,403,164,80,108,22,16,13,8226,8062,7982,6028,1705,1573,193,210,4165,4061,363,5939,1521,0
20:28:13,13796.82,Fox,8226,403,164,78,106,26,16,13,8226,8062,7984,6032,1705,1573,193,210,4165,4061,363,5939,1521,0
20:28:13,13797.72,Fox,8226,402,164,76,108,25,14,15,8226,8062,7986,6032,1705,1575,193,209,4165,4061,363,5940,1521,0
20:28:13,13798.02,Fox,8226,401,164,76,108,24,14,15,8226,8062,7986,6032,1705,1575,193,208,4165,4061,363,5941,1521,0
20:28:14,13798.62,Fox,8226,401,162,72,114,24,14,15,8226,8064,7992,6032,1705,1575,193,208,4165,4061,363,5941,1521,0
20:28:14,13799.52,Fox,8226,398,162,72,111,24,14,15,8226,8064,7992,6035,1705,1575,192,206,4165,4061,363,5944,1521,0
20:28:15,13801.02,Fox,8226,398,160,70,115,24,14,15,8226,8066,7996,6035,1705,1575,192,206,4165,4061,363,5944,1521,0
20:28:15,13801.62,Fox,8226,398,156,72,116,25,14,15,8226,8070,7998,6036,1705,1575,192,206,4165,4061,363,5944,1521,0
20:28:15,13802.22,Fox,8226,398,154,74,111,30,14,15,8226,8072,7998,6041,1705,1575,192,206,4165,4061,363,5944,1521,0
20:28:16,13802.82,Fox,8230,401,152,76,110,32,14,15,8228,8076,8000,6043,1705,1575,192,209,4166,4064,363,5945,1521,0
20:28:16,13803.42,Fox,8232,402,156,74,112,31,14,15,8232,8076,8002,6043,1705,1575,193,209,4168,4064,363,5946,1521,0
20:28:16,13804.02,Fox,8232,402,156,72,112,33,14,15,8232,8076,8004,6045,1705,1575,193,209,4168,4064,363,5946,1521,0
20:28:17,13804.92,Fox,8232,401,154,74,112,32,14,15,8232,8078,8004,6045,1705,1575,193,208,4168,4064,363,5947,1521,0
20:28:17,13805.82,Fox,8232,398,154,72,114,29,14,15,8232,8078,8006,6045,1705,1575,192,206,4168,4064,363,5950,1521,0
20:28:17,13806.42,Fox,8234,399,154,72,115,29,14,15,8234,8080,8008,6045,1705,1575,191,208,4168,4066,363,5951,1521,0
20:28:18,13807.02,Fox,8236,399,156,72,110,33,14,14,8236,8080,8008,6049,1705,1575,190,209,4168,4068,363,5952,1522,0
20:28:18,13807.62,Fox,8236,395,154,72,111,30,14,14,8236,8082,8010,6050,1705,1575,189,206,4168,4068,363,5956,1522,0
20:28:18,13807.92,Fox,8236,395,154,70,113,30,14,14,8236,8082,8012,6050,1705,1575,189,206,4168,4068,363,5956,1522,0
20:28:19,13808.82,Fox,8236,395,152,70,113,32,14,14,8236,8084,8014,6052,1705,1575,189,206,4168,4068,363,5956,1522,0
20:28:19,13809.42,Fox,8238,396,152,68,112,34,14,14,8236,8084,8016,6054,1705,1575,188,208,4168,4070,363,5957,1522,0
20:28:19,13810.02,Fox,8238,393,154,68,112,31,14,14,8238,8084,8016,6054,1705,1575,187,206,4168,4070,363,5960,1522,0
20:28:20,13810.62,Fox,8242,395,150,70,114,31,14,14,8240,8090,8020,6054,1705,1575,187,208,4170,4072,363,5962,1522,0
20:28:20,13811.22,Fox,8242,395,148,74,114,31,14,14,8242,8094,8020,6054,1705,1575,187,208,4170,4072,363,5962,1522,0
20:28:20,13811.82,Fox,8244,394,148,76,112,31,14,13,8244,8096,8020,6055,1705,1575,188,206,4172,4072,363,5964,1523,0
20:28:21,13812.42,Fox,8246,392,148,72,117,28,14,13,8246,8098,8026,6055,1705,1575,188,204,4174,4072,363,5968,1523,0
20:28:21,13813.02,Fox,8246,388,146,74,117,24,12,15,8246,8100,8026,6055,1705,1577,188,200,4174,4072,363,5972,1523,0
20:28:21,13813.62,Fox,8250,391,146,76,116,24,12,15,8248,8102,8026,6055,1705,1577,190,201,4177,4073,363,5973,1523,0
20:28:22,13814.22,Fox,8256,395,152,74,116,24,11,16,8254,8102,8028,6055,1705,1578,192,203,4181,4075,363,5975,1523,0
20:28:22,13814.82,Fox,8260,395,152,78,112,24,11,16,8258,8106,8028,6057,1705,1578,191,204,4182,4078,363,5979,1523,0
20:28:22,13815.42,Fox,8260,395,154,78,110,26,11,16,8260,8106,8028,6059,1705,1578,191,204,4182,4078,363,5979,1523,0
20:28:23,13815.72,Fox,8260,395,150,80,112,26,11,16,8260,8110,8030,6059,1705,1578,191,204,4182,4078,363,5979,1523,0
20:28:23,13816.62,Fox,8264,397,150,78,112,26,11,16,8260,8110,8032,6059,1705,1578,190,207,4183,4081,363,5981,1523,0
20:28:23,13817.22,Fox,8264,394,154,76,114,23,11,16,8264,8110,8034,6059,1705,1578,190,204,4183,4081,363,5984,1523,0
20:28:24,13817.82,Fox,8264,393,150,80,113,23,11,16,8264,8114,8034,6060,1705,1578,190,203,4183,4081,363,5985,1523,0
20:28:24,13818.42,Fox,8264,392,148,82,113,22,11,16,8264,8116,8034,6060,1705,1578,190,202,4183,4081,363,5986,1523,0
20:28:24,13818.72,Fox,8264,392,146,84,113,22,11,16,8264,8118,8034,6060,1705,1578,190,202,4183,4081,363,5986,1523,0
20:28:25,13819.62,Fox,8264,388,144,86,113,18,11,16,8264,8120,8034,6060,1705,1578,189,199,4183,4081,363,5990,1523,0
20:28:25,13820.22,Fox,8264,388,142,84,117,18,11,16,8264,8122,8038,6060,1705,1578,189,199,4183,4081,363,5990,1523,0
20:28:26,13821.72,Fox,8264,388,138,86,117,20,11,16,8264,8126,8040,6062,1705,1578,189,199,4183,4081,363,5990,1523,0
20:28:26,13822.32,Fox,8266,389,140,86,112,24,11,16,8266,8126,8040,6066,1705,1578,190,199,4185,4081,363,5991,1523,0
20:28:26,13822.62,Fox,8266,389,138,84,116,24,11,16,8266,8128,8044,6066,1705,1578,190,199,4185,4081,363,5991,1523,0
20:28:27,13823.52,Fox,8268,389,138,80,120,23,11,15,8266,8128,8048,6066,1705,1578,189,200,4186,4082,363,5992,1524,0
20:28:27,13824.12,Fox,8268,388,138,80,122,23,11,14,8268,8130,8050,6066,1705,1578,189,199,4186,4082,363,5992,1525,0
20:28:27,13824.72,Fox,8268,388,134,84,120,25,11,14,8268,8134,8050,6068,1705,1578,189,199,4186,4082,363,5992,1525,0
20:28:28,13825.62,Fox,8270,387,136,84,118,25,11,13,8270,8134,8050,6069,1705,1578,186,201,4186,4084,363,5994,1526,0
20:28:28,13825.92,Fox,8270,386,134,86,118,24,11,13,8270,8136,8050,6069,1705,1578,185,201,4186,4084,363,5995,1526,0
20:28:28,13826.82,Fox,8270,386,132,88,116,26,11,13,8270,8138,8050,6071,1705,1578,185,201,4186,4084,363,5995,1526,0
20:28:29,13827.42,Fox,8270,386,128,92,116,26,11,13,8270,8142,8050,6071,1705,1578,185,201,4186,4084,363,5995,1526,0
20:28:29,13827.72,Fox,8270,386,126,94,116,26,11,13,8270,8144,8050,6071,1705,1578,185,201,4186,4084,363,5995,1526,0
20:28:29,13828.62,Fox,8272,386,128,94,115,25,10,14,8272,8144,8050,6071,1705,1579,185,201,4187,4085,363,5997,1526,0
20:28:30,13829.22,Fox,8274,387,130,94,114,25,10,14,8274,8144,8050,6071,1705,1579,186,201,4189,4085,363,5998,1526,0
20:28:30,13829.82,Fox,8274,387,126,98,114,25,10,14,8274,8148,8050,6071,1705,1579,186,201,4189,4085,363,5998,1526,0
20:28:30,13830.42,Fox,8274,387,120,100,118,25,10,14,8274,8154,8054,6071,1705,1579,186,201,4189,4085,363,5998,1526,0
20:28:30,13831.02,Fox,8274,387,120,98,116,29,10,14,8274,8154,8056,6075,1705,1579,186,201,4189,4085,363,5998,1526,0
20:28:31,13831.62,Fox,8276,388,120,96,115,31,10,14,8274,8154,8058,6077,1705,1579,186,202,4190,4086,363,5999,1526,0
20:28:31,13832.22,Fox,8278,387,122,96,113,32,10,14,8278,8156,8060,6080,1705,1579,187,200,4192,4086,363,6002,1526,0
20:28:31,13832.82,Fox,8278,383,120,98,113,28,10,14,8278,8158,8060,6080,1705,1579,186,197,4192,4086,363,6006,1526,0
20:28:31,13833.12,Fox,8278,383,118,98,115,28,10,14,8278,8160,8062,6080,1705,1579,186,197,4192,4086,363,6006,1526,0
20:28:32,13834.02,Fox,8280,384,120,98,115,27,10,14,8280,8160,8062,6080,1705,1579,186,198,4193,4087,363,6007,1526,0
20:28:32,13834.92,Fox,8282,383,118,102,114,25,10,14,8282,8164,8062,6080,1705,1579,185,198,4193,4089,363,6010,1526,0
20:28:32,13835.22,Fox,8282,382,116,104,114,25,10,13,8282,8166,8062,6080,1705,1579,185,197,4193,4089,363,6010,1527,0
20:28:33,13836.42,Fox,8284,382,116,106,107,30,10,13,8284,8168,8062,6086,1705,1579,184,198,4193,4091,363,6012,1527,0
20:28:33,13837.02,Fox,8286,382,116,106,105,31,10,12,8284,8168,8062,6087,1705,1579,183,199,4193,4093,363,6013,1528,0
20:28:33,13837.62,Fox,8290,382,120,104,104,30,10,12,8288,8168,8064,6088,1705,1579,185,197,4197,4093,363,6017,1528,0
20:28:34,13837.92,Fox,8290,382,122,104,103,31,10,12,8290,8168,8064,6089,1705,1579,185,197,4197,4093,363,6017,1528,0
20:28:34,13839.71,Fox,8292,383,124,102,104,31,10,12,8292,8168,8066,6089,1705,1579,184,199,4197,4095,363,6018,1528,0
20:28:34,13840.31,Fox,8294,383,124,100,107,31,10,11,8294,8170,8070,6089,1705,1579,184,199,4198,4096,363,6020,1528,0
20:28:35,13840.91,Fox,8296,384,126,98,108,31,10,11,8296,8170,8072,6089,1705,1579,184,200,4199,4097,363,6021,1528,0
20:28:35,13841.51,Fox,8296,381,124,96,112,28,10,11,8296,8172,8076,6089,1705,1579,183,198,4199,4097,363,6024,1528,0
20:28:35,13841.81,Fox,8296,379,124,96,112,26,10,11,8296,8172,8076,6089,1705,1579,183,196,4199,4097,363,6026,1528,0
20:28:36,13842.71,Fox,8300,378,126,98,110,23,10,11,8300,8174,8076,6089,1705,1579,184,194,4202,4098,363,6031,1528,0
20:28:36,13843.01,Fox,8300,378,122,102,108,25,10,11,8300,8178,8076,6091,1705,1579,184,194,4202,4098,363,6031,1528,0
20:28:36,13843.91,Fox,8302,379,118,104,108,26,10,11,8300,8182,8078,6092,1705,1579,185,194,4204,4098,363,6032,1528,0
20:28:36,13844.51,Fox,8304,380,118,106,104,29,10,11,8302,8184,8078,6096,1705,1579,186,194,4206,4098,363,6033,1528,0
20:28:37,13845.11,Fox,8308,382,122,104,104,29,10,11,8306,8184,8080,6096,1705,1579,187,195,4209,4099,363,6035,1528,0
20:28:37,13845.71,Fox,8310,383,122,106,101,31,10,11,8308,8186,8080,6098,1705,1579,186,197,4209,4101,363,6036,1528,0
20:28:37,13846.31,Fox,8310,383,124,104,101,33,10,11,8310,8186,8082,6100,1705,1579,186,197,4209,4101,363,6036,1528,0
20:28:38,13846.91,Fox,8310,377,124,104,101,27,10,11,8310,8186,8082,6100,1705,1579,185,192,4209,4101,363,6042,1528,0
20:28:38,13847.51,Fox,8310,376,122,104,103,26,10,11,8310,8188,8084,6100,1705,1579,185,191,4209,4101,363,6043,1528,0
20:28:38,13848.11,Fox,8312,376,122,104,100,27,10,11,8310,8188,8084,6102,1705,1579,184,192,4209,4103,363,6045,1528,0
20:28:38,13848.41,Fox,8312,375,124,104,100,26,10,11,8312,8188,8084,6102,1705,1579,184,191,4209,4103,363,6046,1528,0
20:28:39,13849.31,Fox,8312,375,124,98,106,26,10,11,8312,8188,8090,6102,1705,1579,184,191,4209,4103,363,6046,1528,0
20:28:39,13849.91,Fox,8314,376,122,96,105,30,10,11,8312,8190,8094,6107,1705,1579,185,191,4211,4103,363,6047,1528,0
20:28:39,13850.51,Fox,8316,377,124,94,106,28,12,11,8314,8190,8096,6107,1707,1579,186,191,4213,4103,363,6048,1528,0
20:28:39,13851.11,Fox,8318,378,128,92,107,26,14,11,8318,8190,8098,6107,1709,1579,187,191,4215,4103,363,6049,1528,0
20:28:40,13851.71,Fox,8320,379,126,92,108,26,14,11,8318,8192,8100,6107,1709,1579,186,193,4215,4105,363,6050,1528,0
20:28:40,13852.31,Fox,8324,381,130,90,108,26,14,11,8322,8192,8102,6107,1709,1579,186,195,4217,4107,363,6052,1528,0
20:28:40,13852.91,Fox,8326,382,134,90,108,25,14,11,8326,8192,8102,6107,1709,1579,185,197,4217,4109,363,6053,1528,0
20:28:40,13853.51,Fox,8326,380,132,88,110,25,14,11,8326,8194,8106,6109,1709,1579,185,195,4217,4109,363,6055,1528,0
20:28:41,13854.11,Fox,8326,378,132,88,108,26,14,10,8326,8194,8106,6111,1709,1579,185,193,4217,4109,363,6056,1529,0
20:28:41,13854.71,Fox,8326,377,130,86,112,25,14,10,8326,8196,8110,6111,1709,1579,184,193,4217,4109,363,6057,1529,0
20:28:41,13855.31,Fox,8326,376,128,88,109,28,14,9,8326,8198,8110,6114,1709,1579,183,193,4217,4109,363,6057,1530,0
20:28:41,13855.61,Fox,8326,374,128,88,109,26,14,9,8326,8198,8110,6114,1709,1579,182,192,4217,4109,363,6059,1530,0
20:28:42,13856.51,Fox,8326,372,126,86,113,24,14,9,8326,8200,8114,6114,1709,1579,180,192,4217,4109,363,6061,1530,0
20:28:42,13857.11,Fox,8332,375,132,84,108,28,14,9,8332,8200,8116,6118,1709,1579,179,196,4219,4113,363,6064,1530,0
20:28:42,13857.41,Fox,8332,375,132,82,109,29,14,9,8332,8200,8118,6119,1709,1579,179,196,4219,4113,363,6064,1530,0
20:28:43,13858.61,Fox,8332,372,132,78,113,28,14,7,8332,8200,8122,6119,1709,1579,179,193,4219,4113,363,6065,1532,0
20:28:43,13859.51,Fox,8336,374,134,78,107,32,14,7,8334,8200,8122,6123,1709,1579,180,194,4222,4114,363,6067,1532,0
20:28:43,13860.11,Fox,8336,370,134,78,109,28,14,7,8336,8202,8124,6123,1709,1579,179,191,4222,4114,363,6071,1532,0
20:28:43,13860.41,Fox,8336,370,134,76,111,28,14,7,8336,8202,8126,6123,1709,1579,179,191,4222,4114,363,6071,1532,0
20:28:44,13861.61,Fox,8338,371,134,76,111,29,14,7,8338,8204,8128,6124,1709,1579,178,193,4222,4116,363,6072,1532,0
20:28:44,13862.21,Fox,8340,372,136,76,109,30,14,7,8340,8204,8128,6125,1709,1579,178,194,4223,4117,363,6073,1532,0
20:28:45,13862.81,Fox,8340,372,130,80,111,30,14,7,8340,8210,8130,6125,1709,1579,178,194,4223,4117,363,6073,1532,0
20:28:45,13863.41,Fox,8340,369,128,78,114,29,14,6,8340,8212,8134,6126,1709,1579,178,191,4223,4117,363,6075,1533,0
20:28:45,13863.71,Fox,8340,369,128,78,113,30,14,6,8340,8212,8134,6127,1709,1579,178,191,4223,4117,363,6075,1533,0
20:28:45,13864.61,Fox,8340,366,128,76,113,30,14,5,8340,8212,8136,6129,1709,1579,175,191,4223,4117,363,6077,1534,0
20:28:45,13865.21,Fox,8340,363,128,74,115,27,14,5,8340,8212,8138,6129,1709,1579,173,190,4223,4117,363,6080,1534,0
20:28:46,13866.11,Fox,8340,363,128,70,118,28,14,5,8340,8212,8142,6130,1709,1579,173,190,4223,4117,363,6080,1534,0
20:28:46,13866.41,Fox,8340,363,124,72,120,28,14,5,8340,8216,8144,6130,1709,1579,173,190,4223,4117,363,6080,1534,0
20:28:46,13867.01,Fox,8340,359,122,74,118,26,14,5,8340,8218,8144,6132,1709,1579,171,188,4223,4117,363,6084,1534,0
20:28:46,13867.61,Fox,8340,358,122,74,118,25,14,5,8340,8218,8144,6132,1709,1579,171,187,4223,4117,363,6085,1534,0
20:28:47,13868.51,Fox,8342,360,122,70,119,26,16,5,8340,8218,8148,6135,1711,1579,171,189,4223,4119,363,6085,1534,0
20:28:47,13869.11,Fox,8342,360,120,68,123,28,14,7,8342,8222,8154,6137,1711,1581,171,189,4223,4119,363,6085,1534,0
20:28:47,13869.71,Fox,8346,358,124,68,119,26,14,7,8346,8222,8154,6139,1711,1581,169,189,4225,4121,363,6091,1534,0
20:28:48,13870.61,Fox,8346,358,124,66,121,26,14,7,8346,8222,8156,6139,1711,1581,169,189,4225,4121,363,6091,1534,0
20:28:48,13871.51,Fox,8348,359,124,64,122,26,14,7,8346,8222,8158,6140,1711,1581,168,191,4225,4123,363,6092,1534,0
20:28:48,13872.11,Fox,8350,359,128,62,123,25,14,7,8350,8222,8160,6140,1711,1581,168,191,4226,4124,363,6094,1534,0
20:28:49,13873.31,Fox,8350,358,128,60,120,29,14,7,8350,8222,8162,6145,1711,1581,168,190,4226,4124,363,6095,1534,0
20:28:49,13873.91,Fox,8350,357,128,56,124,28,14,7,8350,8222,8166,6145,1711,1581,168,189,4226,4124,363,6096,1534,0
20:28:49,13874.81,Fox,8350,355,128,56,123,27,14,7,8350,8222,8166,6146,1711,1581,168,187,4226,4124,363,6098,1534,0
20:28:50,13875.41,Fox,8350,355,128,54,125,27,12,9,8350,8222,8168,6146,1711,1583,168,187,4226,4124,363,6098,1534,0
20:28:50,13876.01,Fox,8352,356,126,56,124,27,12,9,8350,8224,8168,6146,1711,1583,167,189,4226,4126,363,6099,1534,0
20:28:50,13876.31,Fox,8352,355,128,56,123,27,12,9,8352,8224,8168,6147,1711,1583,167,188,4226,4126,363,6100,1534,0
20:28:50,13877.21,Fox,8354,354,128,56,121,26,12,9,8352,8224,8168,6148,1711,1583,167,187,4228,4126,363,6103,1534,0
20:28:51,13877.81,Fox,8354,354,130,56,119,28,11,10,8354,8224,8168,6150,1711,1584,167,187,4228,4126,363,6103,1534,0
20:28:51,13878.41,Fox,8354,352,128,58,119,27,11,9,8354,8226,8168,6150,1711,1584,167,185,4228,4126,363,6104,1535,0
20:28:51,13878.71,Fox,8354,350,128,56,121,25,11,9,8354,8226,8170,6150,1711,1584,167,183,4228,4126,363,6106,1535,0
20:28:51,13879.61,Fox,8354,347,128,56,121,23,11,8,8354,8226,8170,6150,1711,1584,166,181,4228,4126,363,6108,1536,0
20:28:51,13879.91,Fox,8354,345,128,54,123,21,11,8,8354,8226,8172,6150,1711,1584,166,179,4228,4126,363,6110,1536,0
20:28:52,13880.81,Fox,8356,345,130,54,119,24,9,9,8356,8226,8172,6153,1711,1586,167,178,4230,4126,363,6111,1537,0
20:28:52,13881.41,Fox,8356,344,130,48,125,23,9,9,8356,8226,8178,6153,1711,1586,167,177,4230,4126,363,6112,1537,0
20:28:52,13882.31,Fox,8356,344,130,44,128,24,9,9,8356,8226,8182,6154,1711,1586,167,177,4230,4126,363,6112,1537,0
20:28:53,13883.17,Fox,8356,339,130,42,127,21,10,9,8356,8226,8184,6157,1712,1586,166,173,4230,4126,363,6117,1537,0
20:28:53,13883.77,Fox,8360,341,134,42,121,25,10,9,8360,8226,8184,6161,1712,1586,165,176,4231,4129,363,6119,1537,0
20:28:53,13884.07,Fox,8360,341,134,40,123,25,10,9,8360,8226,8186,6161,1712,1586,165,176,4231,4129,363,6119,1537,0
20:28:53,13884.97,Fox,8362,341,134,40,120,26,10,9,8360,8226,8186,6163,1712,1586,166,175,4233,4129,363,6121,1537,0
20:28:54,13885.57,Fox,8364,342,136,42,120,25,10,9,8364,8228,8186,6163,1712,1586,166,176,4234,4130,363,6122,1537,0
20:28:54,13886.17,Fox,8366,343,134,44,121,25,10,9,8366,8232,8188,6163,1712,1586,165,178,4234,4132,363,6123,1537,0
20:28:54,13886.47,Fox,8366,342,134,44,121,24,10,9,8366,8232,8188,6163,1712,1586,165,177,4234,4132,363,6124,1537,0
20:28:54,13887.37,Fox,8368,342,134,44,120,23,10,9,8366,8232,8188,6163,1712,1586,165,177,4235,4133,363,6126,1537,0
20:28:54,13887.97,Fox,8370,341,138,42,121,21,10,9,8370,8232,8190,6163,1712,1586,164,177,4235,4135,363,6129,1537,0
20:28:55,13889.47,Fox,8372,342,138,44,120,21,10,9,8372,8234,8190,6163,1712,1586,164,178,4236,4136,363,6130,1537,0
20:28:55,13889.77,Fox,8372,342,136,44,122,21,10,9,8372,8236,8192,6163,1712,1586,164,178,4236,4136,363,6130,1537,0
20:28:56,13890.97,Fox,8374,341,136,44,117,23,10,9,8372,8236,8192,6167,1712,1586,163,178,4237,4137,363,6133,1537,0
20:28:56,13891.57,Fox,8374,341,138,42,118,24,10,9,8374,8236,8194,6168,1712,1586,163,178,4237,4137,363,6133,1537,0
20:28:56,13891.87,Fox,8374,341,138,42,117,25,10,9,8374,8236,8194,6169,1712,1586,163,178,4237,4137,363,6133,1537,0
20:28:56,13892.76,Fox,8376,341,136,42,117,25,10,9,8374,8238,8196,6170,1712,1586,164,177,4239,4137,363,6135,1537,0
20:28:57,13893.36,Fox,8376,338,136,44,117,22,10,9,8376,8240,8196,6170,1712,1586,162,176,4239,4137,363,6138,1537,0
20:28:57,13893.96,Fox,8378,335,134,44,117,19,10,9,8376,8242,8198,6171,1712,1586,160,175,4240,4138,363,6143,1537,0
20:28:57,13894.56,Fox,8378,335,134,44,119,19,10,9,8378,8244,8200,6171,1712,1586,160,175,4240,4138,363,6143,1537,0
20:28:57,13895.16,Fox,8378,333,132,46,119,17,10,9,8378,8246,8200,6171,1712,1586,160,173,4240,4138,363,6145,1537,0
20:28:57,13895.46,Fox,8378,332,132,46,119,17,10,8,8378,8246,8200,6171,1712,1586,160,172,4240,4138,363,6145,1538,0
20:28:58,13896.65,Fox,8382,334,128,50,118,16,10,8,8378,8250,8200,6171,1712,1586,161,173,4243,4139,363,6147,1538,0
20:28:58,13897.25,Fox,8384,335,126,56,117,16,10,8,8382,8256,8200,6171,1712,1586,162,173,4245,4139,363,6148,1538,0
20:28:58,13897.84,Fox,8384,335,124,60,116,17,10,8,8384,8260,8200,6172,1712,1586,162,173,4245,4139,363,6148,1538,0
20:28:59,13898.44,Fox,8384,335,124,58,118,17,10,8,8384,8260,8202,6172,1712,1586,162,173,4245,4139,363,6148,1538,0
20:28:59,13899.91,Fox,8384,335,120,60,119,18,10,8,8384,8264,8204,6173,1712,1586,162,173,4245,4139,363,6148,1538,0
20:28:59,13900.79,Fox,8384,335,120,58,118,21,10,8,8384,8264,8206,6176,1712,1586,162,173,4245,4139,363,6148,1538,0
20:29:00,13901.39,Fox,8386,332,120,52,121,19,10,8,8384,8264,8212,6178,1712,1586,161,171,4246,4140,363,6153,1538,0
20:29:00,13901.99,Fox,8388,333,122,52,117,22,10,8,8386,8264,8212,6181,1712,1586,162,171,4248,4140,363,6154,1538,0
20:29:00,13902.29,Fox,8388,332,124,52,117,21,10,8,8388,8264,8212,6181,1712,1586,162,170,4248,4140,363,6155,1538,0
20:29:00,13903.49,Fox,8390,332,124,52,116,20,10,8,8388,8264,8212,6181,1712,1586,161,171,4248,4142,363,6157,1538,0
20:29:01,13904.09,Fox,8392,332,128,52,113,21,10,8,8392,8264,8212,6183,1712,1586,161,171,4249,4143,363,6159,1538,0
20:29:01,13904.97,Fox,8392,332,126,50,117,21,10,8,8392,8266,8216,6183,1712,1586,161,171,4249,4143,363,6159,1538,0
20:29:01,13905.56,Fox,8394,333,126,48,117,22,10,8,8392,8266,8218,6184,1712,1586,161,172,4250,4144,363,6160,1538,0
20:29:01,13905.86,Fox,8394,332,128,48,117,22,10,7,8394,8266,8218,6184,1712,1586,161,171,4250,4144,363,6160,1539,0
20:29:02,13906.76,Fox,8398,334,126,50,113,24,10,7,8394,8268,8218,6186,1712,1586,160,174,4251,4147,363,6162,1539,0
20:29:02,13907.36,Fox,8398,334,130,46,117,24,10,7,8398,8268,8222,6186,1712,1586,160,174,4251,4147,363,6162,1539,0
20:29:02,13907.95,Fox,8400,335,132,46,114,26,10,7,8400,8268,8222,6188,1712,1586,161,174,4253,4147,363,6163,1539,0
20:29:02,13908.22,Fox,8400,334,130,48,114,25,10,7,8400,8270,8222,6188,1712,1586,161,173,4253,4147,363,6164,1539,0
20:29:03,13909.42,Fox,8400,334,130,48,113,25,11,7,8400,8270,8222,6189,1713,1586,161,173,4253,4147,363,6164,1539,0
20:29:03,13910.02,Fox,8404,336,132,48,107,29,11,7,8402,8270,8222,6193,1713,1586,163,173,4257,4147,363,6166,1539,0
20:29:03,13910.32,Fox,8404,335,134,48,106,29,11,7,8404,8270,8222,6194,1713,1586,163,172,4257,4147,363,6167,1539,0
20:29:03,13911.22,Fox,8404,332,132,50,104,28,11,7,8404,8272,8222,6196,1713,1586,163,169,4257,4147,363,6170,1539,0
20:29:04,13911.82,Fox,8404,330,130,52,104,26,11,7,8404,8274,8222,6196,1713,1586,162,168,4257,4147,363,6172,1539,0
20:29:04,13912.42,Fox,8408,329,134,52,99,26,11,7,8408,8274,8222,6199,1713,1586,160,169,4259,4149,363,6177,1539,0
20:29:05,13913.92,Fox,8410,330,136,50,98,28,11,7,8410,8274,8224,6201,1713,1586,159,171,4259,4151,363,6178,1539,0
20:29:05,13914.8,Fox,8410,327,132,54,95,29,11,6,8410,8278,8224,6204,1713,1586,157,170,4259,4151,363,6180,1540,0
20:29:05,13915.98,Fox,8410,326,132,54,95,28,11,6,8410,8278,8224,6204,1713,1586,156,170,4259,4151,363,6181,1540,0
20:29:06,13916.87,Fox,8412,327,132,54,94,30,11,6,8412,8280,8226,6207,1713,1586,155,172,4259,4153,363,6182,1540,0
20:29:06,13917.47,Fox,8412,325,130,56,92,30,11,6,8412,8282,8226,6209,1713,1586,155,170,4259,4153,363,6184,1540,0
20:29:06,13917.77,Fox,8412,325,130,56,90,32,11,6,8412,8282,8226,6211,1713,1586,155,170,4259,4153,363,6184,1540,0
20:29:06,13918.61,Fox,8414,324,132,56,87,32,11,6,8414,8282,8226,6213,1713,1586,153,171,4260,4154,363,6187,1540,0
20:29:06,13919.17,Fox,8414,323,130,58,85,34,10,6,8414,8284,8226,6215,1713,1586,152,171,4260,4154,363,6188,1540,0
20:29:07,13919.74,Fox,8416,323,132,58,84,33,10,6,8416,8284,8226,6215,1713,1586,151,172,4260,4156,363,6190,1540,0
20:29:07,13920.3,Fox,8416,321,128,62,84,31,10,6,8416,8288,8226,6215,1713,1586,151,170,4260,4156,363,6192,1540,0
20:29:07,13920.87,Fox,8418,319,128,64,81,30,10,6,8418,8290,8226,6217,1713,1586,150,169,4260,4158,363,6196,1540,0
20:29:07,13921.45,Fox,8418,317,128,64,81,29,10,5,8418,8290,8226,6217,1713,1586,150,167,4260,4158,363,6197,1541,0
20:29:07,13922.03,Fox,8420,317,130,64,79,29,10,5,8420,8290,8226,6218,1713,1586,148,169,4260,4160,363,6199,1541,0
20:29:08,13922.61,Fox,8424,317,132,66,77,27,10,5,8424,8292,8226,6218,1713,1586,146,171,4262,4162,363,6203,1541,0
20:29:08,13923.2,Fox,8426,317,130,68,75,27,10,5,8424,8294,8226,6219,1713,1586,145,172,4262,4164,363,6205,1541,0
20:29:08,13923.78,Fox,8426,317,130,70,72,30,8,7,8426,8296,8226,6222,1713,1588,145,172,4262,4164,363,6205,1541,0
20:29:08,13924.35,Fox,8428,317,130,66,75,29,8,7,8426,8296,8230,6222,1713,1588,144,173,4262,4166,363,6207,1541,0
20:29:08,13924.95,Fox,8428,317,132,64,76,30,8,7,8428,8296,8232,6223,1713,1588,144,173,4262,4166,363,6207,1541,0
20:29:09,13925.54,Fox,8428,314,128,68,74,29,8,7,8428,8300,8232,6225,1713,1588,144,170,4262,4166,363,6210,1541,0
20:29:09,13926.42,Fox,8430,314,130,68,69,33,8,6,8430,8300,8232,6229,1713,1588,144,170,4263,4167,363,6211,1542,0
20:29:09,13927,Fox,8430,313,128,70,68,33,8,6,8430,8302,8232,6230,1713,1588,144,169,4263,4167,363,6212,1542,0
20:29:09,13927.58,Fox,8430,311,126,70,70,31,8,6,8430,8304,8234,6230,1713,1588,144,167,4263,4167,363,6214,1542,0
20:29:09,13928.17,Fox,8430,307,122,72,72,27,8,6,8430,8308,8236,6230,1713,1588,142,165,4263,4167,363,6218,1542,0
20:29:10,13928.74,Fox,8434,309,124,74,69,28,8,6,8434,8310,8236,6231,1713,1588,143,166,4266,4168,363,6220,1542,0
20:29:10,13929.32,Fox,8434,305,124,74,66,27,8,6,8434,8310,8236,6234,1713,1588,143,162,4266,4168,363,6224,1542,0
20:29:10,13929.62,Fox,8434,305,124,74,62,31,8,6,8434,8310,8236,6238,1713,1588,143,162,4266,4168,363,6224,1542,0
20:29:10,13931,Fox,8434,305,122,74,63,32,8,6,8434,8312,8238,6239,1713,1588,143,162,4266,4168,363,6224,1542,0
20:29:11,13931.6,Fox,8438,306,124,74,62,30,8,6,8436,8312,8238,6239,1713,1588,142,164,4267,4171,363,6227,1542,0
20:29:11,13932.19,Fox,8444,308,130,70,60,32,8,6,8442,8312,8242,6242,1713,1588,142,166,4270,4174,363,6231,1542,0
20:29:11,13932.79,Fox,8444,308,130,72,60,32,8,6,8444,8314,8242,6242,1713,1588,142,166,4270,4174,363,6231,1542,0
20:29:11,13933.36,Fox,8444,308,128,72,62,32,8,6,8444,8316,8244,6242,1713,1588,142,166,4270,4174,363,6231,1542,0
20:29:11,13933.94,Fox,8444,305,126,72,61,32,8,6,8444,8318,8246,6245,1713,1588,142,163,4270,4174,363,6234,1542,0
20:29:12,13934.53,Fox,8444,304,124,74,61,31,8,6,8444,8320,8246,6245,1713,1588,141,163,4270,4174,363,6235,1542,0
20:29:12,13935.11,Fox,8444,304,122,72,65,31,8,6,8444,8322,8250,6245,1713,1588,141,163,4270,4174,363,6235,1542,0
20:29:12,13935.61,Fox,8444,303,118,70,70,31,8,6,8444,8326,8256,6246,1713,1588,141,162,4270,4174,363,6236,1542,0
20:29:12,13936.2,Fox,8444,301,118,66,74,29,8,6,8444,8326,8260,6246,1713,1588,141,160,4270,4174,363,6238,1542,0
20:29:13,13937.07,Fox,8444,297,118,66,74,25,8,6,8444,8326,8260,6246,1713,1588,141,156,4270,4174,363,6242,1542,0
20:29:13,13937.65,Fox,8444,296,118,66,74,22,10,6,8444,8326,8260,6246,1715,1588,141,155,4270,4174,363,6243,1542,0
20:29:13,13937.93,Fox,8444,296,118,62,78,22,10,6,8444,8326,8264,6246,1715,1588,141,155,4270,4174,363,6243,1542,0
20:29:14,13939.33,Fox,8446,295,118,62,76,21,10,6,8444,8326,8264,6247,1715,1588,140,155,4270,4176,363,6246,1542,0
20:29:14,13939.91,Fox,8446,290,114,68,76,16,10,6,8446,8332,8264,6247,1715,1588,139,151,4270,4176,363,6251,1542,0
20:29:14,13940.46,Fox,8446,290,114,68,75,17,10,6,8446,8332,8264,6248,1715,1588,139,151,4270,4176,363,6251,1542,0
20:29:14,13941.55,Fox,8450,291,116,68,73,17,10,5,8448,8332,8264,6249,1715,1588,138,153,4272,4178,363,6253,1543,0
20:29:14,13942.11,Fox,8450,291,116,70,70,20,10,5,8450,8334,8264,6252,1715,1588,138,153,4272,4178,363,6253,1543,0
20:29:15,13942.64,Fox,8452,289,116,72,66,20,10,5,8452,8336,8264,6255,1715,1588,139,150,4274,4178,363,6257,1543,0
20:29:15,13943.7,Fox,8454,290,118,70,67,20,10,5,8454,8336,8266,6255,1715,1588,139,151,4275,4179,363,6258,1543,0
20:29:15,13944.56,Fox,8456,288,118,72,66,17,10,5,8456,8338,8266,6255,1715,1588,138,150,4276,4180,363,6262,1543,0
20:29:15,13944.86,Fox,8456,288,116,72,68,17,10,5,8456,8340,8268,6255,1715,1588,138,150,4276,4180,363,6262,1543,0
20:29:16,13945.71,Fox,8458,289,118,72,67,17,10,5,8458,8340,8268,6255,1715,1588,138,151,4277,4181,363,6263,1543,0
20:29:16,13946.24,Fox,8458,288,118,72,66,17,10,5,8458,8340,8268,6256,1715,1588,138,150,4277,4181,363,6264,1543,0
20:29:16,13946.81,Fox,8458,288,118,70,68,17,10,5,8458,8340,8270,6256,1715,1588,138,150,4277,4181,363,6264,1543,0
20:29:16,13948.37,Fox,8458,288,118,70,66,19,10,5,8458,8340,8270,6258,1715,1588,138,150,4277,4181,363,6264,1543,0
20:29:17,13949.22,Fox,8460,289,120,70,65,19,10,5,8460,8340,8270,6258,1715,1588,139,150,4279,4181,363,6265,1543,0
20:29:17,13949.8,Fox,8462,290,122,68,67,18,10,5,8462,8340,8272,6258,1715,1588,140,150,4281,4181,363,6266,1543,0
20:29:17,13950.38,Fox,8462,290,122,66,68,19,10,5,8462,8340,8274,6259,1715,1588,140,150,4281,4181,363,6266,1543,0
20:29:17,13950.85,Fox,8462,289,122,66,68,18,10,5,8462,8340,8274,6259,1715,1588,140,149,4281,4181,363,6267,1543,0
20:29:18,13951.4,Fox,8462,289,120,68,68,18,10,5,8462,8342,8274,6259,1715,1588,140,149,4281,4181,363,6267,1543,0
20:29:18,13952.21,Fox,8464,286,116,72,66,15,10,5,8462,8346,8274,6260,1715,1588,140,146,4282,4182,363,6272,1543,0
20:29:18,13952.5,Fox,8464,286,118,72,66,15,10,5,8464,8346,8274,6260,1715,1588,140,146,4282,4182,363,6272,1543,0
20:29:18,13953.36,Fox,8464,283,118,68,68,14,10,5,8464,8346,8278,6262,1715,1588,139,144,4282,4182,363,6275,1543,0
20:29:19,13954.44,Fox,8464,282,116,70,67,15,10,4,8464,8348,8278,6263,1715,1588,138,144,4282,4182,363,6275,1544,0
20:29:19,13954.71,Fox,8464,282,114,72,67,15,10,4,8464,8350,8278,6263,1715,1588,138,144,4282,4182,363,6275,1544,0
20:29:19,13955.55,Fox,8466,283,114,70,68,15,10,4,8464,8350,8280,6263,1715,1588,138,145,4283,4183,363,6276,1544,0
20:29:19,13956.13,Fox,8466,283,116,68,70,15,10,4,8466,8350,8282,6263,1715,1588,138,145,4283,4183,363,6276,1544,0
20:29:19,13956.67,Fox,8466,282,116,68,70,14,10,4,8466,8350,8282,6263,1715,1588,138,144,4283,4183,363,6277,1544,0
20:29:20,13957.51,Fox,8466,282,116,66,72,14,10,4,8466,8350,8284,6263,1715,1588,138,144,4283,4183,363,6277,1544,0
20:29:20,13958.52,Fox,8466,281,116,64,74,14,10,3,8466,8350,8286,6263,1715,1588,137,144,4283,4183,363,6277,1545,0
20:29:20,13959.05,Fox,8466,279,114,62,77,13,10,3,8466,8352,8290,6264,1715,1588,135,144,4283,4183,363,6279,1545,0
20:29:21,13960.13,Fox,8466,278,112,64,75,15,10,2,8466,8354,8290,6266,1715,1588,135,143,4283,4183,363,6279,1546,0
20:29:21,13960.87,Fox,8468,278,112,62,76,14,10,2,8466,8354,8292,6266,1715,1588,135,143,4284,4184,363,6281,1546,0
20:29:21,13961.43,Fox,8468,278,114,60,76,16,10,2,8468,8354,8294,6268,1715,1588,135,143,4284,4184,363,6281,1546,0
20:29:21,13961.93,Fox,8468,278,114,58,73,21,10,2,8468,8354,8296,6273,1715,1588,135,143,4284,4184,363,6281,1546,0
20:29:21,13962.39,Fox,8468,277,114,58,73,20,10,2,8468,8354,8296,6273,1715,1588,134,143,4284,4184,363,6282,1546,0
20:29:22,13963.7,Fox,8468,275,112,56,77,18,10,2,8468,8356,8300,6273,1715,1588,133,142,4284,4184,363,6284,1546,0
20:29:22,13964.81,Fox,8470,275,114,56,76,17,10,2,8470,8356,8300,6273,1715,1588,132,143,4284,4186,363,6286,1546,0
20:29:22,13965.35,Fox,8470,275,114,54,76,19,10,2,8470,8356,8302,6275,1715,1588,132,143,4284,4186,363,6286,1546,0
20:29:23,13966.06,Fox,8470,275,114,50,78,21,10,2,8470,8356,8306,6277,1715,1588,132,143,4284,4186,363,6286,1546,0
20:29:23,13966.51,Fox,8470,275,110,52,80,21,10,2,8470,8360,8308,6277,1715,1588,132,143,4284,4186,363,6286,1546,0
20:29:23,13967.07,Fox,8470,275,110,50,82,21,10,2,8470,8360,8310,6277,1715,1588,132,143,4284,4186,363,6286,1546,0
20:29:23,13967.79,Fox,8470,275,108,52,78,25,10,2,8470,8362,8310,6281,1715,1588,132,143,4284,4186,363,6286,1546,0
20:29:23,13968.01,Fox,8470,275,106,54,78,25,10,2,8470,8364,8310,6281,1715,1588,132,143,4284,4186,363,6286,1546,0
20:29:24,13968.96,Fox,8472,276,104,56,77,25,10,2,8470,8366,8310,6281,1715,1588,132,144,4285,4187,363,6287,1546,0
20:29:24,13969.44,Fox,8474,276,108,54,78,24,10,2,8474,8366,8312,6281,1715,1588,131,145,4286,4188,363,6289,1546,0
20:29:24,13970,Fox,8478,278,112,54,77,23,10,2,8478,8366,8312,6281,1715,1588,132,146,4289,4189,363,6291,1546,0
20:29:24,13970.57,Fox,8480,276,110,58,76,21,10,1,8480,8370,8312,6281,1715,1588,132,144,4290,4190,363,6294,1547,0
20:29:24,13971.4,Fox,8482,277,112,56,77,21,10,1,8482,8370,8314,6281,1715,1588,131,146,4290,4192,363,6295,1547,0
20:29:24,13971.95,Fox,8482,272,110,56,79,16,10,1,8482,8372,8316,6281,1715,1588,128,144,4290,4192,363,6300,1547,0
20:29:25,13972.25,Fox,8482,271,110,54,81,15,10,1,8482,8372,8318,6281,1715,1588,127,144,4290,4192,363,6301,1547,0
20:29:25,13973.33,Fox,8482,271,110,50,85,15,10,1,8482,8372,8322,6281,1715,1588,127,144,4290,4192,363,6301,1547,0
20:29:25,13973.82,Fox,8482,271,108,50,87,15,10,1,8482,8374,8324,6281,1715,1588,127,144,4290,4192,363,6301,1547,0
20:29:25,13974.09,Fox,8482,271,108,48,89,15,10,1,8482,8374,8326,6281,1715,1588,127,144,4290,4192,363,6301,1547,0
20:29:25,13974.84,Fox,8486,273,110,48,87,15,10,1,8484,8374,8326,6283,1715,1588,126,147,4291,4195,363,6303,1547,0
20:29:26,13975.38,Fox,8488,274,112,48,86,15,10,1,8486,8374,8326,6283,1715,1588,126,148,4292,4196,363,6304,1547,0
20:29:26,13975.68,Fox,8488,272,112,50,86,13,10,1,8488,8376,8326,6283,1715,1588,125,147,4292,4196,363,6306,1547,0
20:29:26,13976.24,Fox,8488,270,112,50,86,11,10,1,8488,8376,8326,6283,1715,1588,124,146,4292,4196,363,6308,1547,0
20:29:26,13976.79,Fox,8488,270,110,52,84,13,10,1,8488,8378,8326,6285,1715,1588,124,146,4292,4196,363,6308,1547,0
20:29:27,13978.32,Fox,8488,268,110,46,90,11,10,1,8488,8378,8332,6285,1715,1588,124,144,4292,4196,363,6310,1547,0
20:29:27,13979.52,Fox,8488,268,106,50,90,11,10,1,8488,8382,8332,6285,1715,1588,124,144,4292,4196,363,6310,1547,0
20:29:27,13980.03,Fox,8488,268,104,52,90,11,10,1,8488,8384,8332,6285,1715,1588,124,144,4292,4196,363,6310,1547,0
20:29:27,13980.49,Fox,8488,268,104,50,92,11,10,1,8488,8384,8334,6285,1715,1588,124,144,4292,4196,363,6310,1547,0
20:29:27,13980.96,Fox,8488,268,104,48,94,11,10,1,8488,8384,8336,6285,1715,1588,124,144,4292,4196,363,6310,1547,0
20:29:28,13982.79,Fox,8488,268,104,46,96,11,10,1,8488,8384,8338,6285,1715,1588,124,144,4292,4196,363,6310,1547,0
20:29:28,13983.32,Fox,8488,268,104,44,98,11,10,1,8488,8384,8340,6285,1715,1588,124,144,4292,4196,363,6310,1547,0
20:29:29,13984.65,Fox,8490,269,102,46,94,14,10,1,8488,8386,8340,6288,1715,1588,123,146,4292,4198,363,6311,1547,0
20:29:29,13984.89,Fox,8490,267,102,48,94,12,10,1,8490,8388,8340,6288,1715,1588,121,146,4292,4198,363,6313,1547,0
20:29:29,13986.25,Fox,8490,267,100,50,94,12,10,1,8490,8390,8340,6288,1715,1588,121,146,4292,4198,363,6313,1547,0
20:29:30,13986.69,Fox,8490,267,98,52,94,12,10,1,8490,8392,8340,6288,1715,1588,121,146,4292,4198,363,6313,1547,0
20:29:30,13987.7,Fox,8492,266,98,52,93,10,10,1,8490,8392,8340,6288,1715,1588,120,146,4293,4199,363,6316,1547,0
20:29:30,13988.22,Fox,8492,266,100,52,91,12,6,5,8492,8392,8340,6290,1715,1592,120,146,4293,4199,363,6316,1547,0
20:29:30,13988.48,Fox,8492,266,98,54,89,14,6,5,8492,8394,8340,6292,1715,1592,120,146,4293,4199,363,6316,1547,0
20:29:31,13989.98,Fox,8492,266,94,56,91,14,6,5,8492,8398,8342,6292,1715,1592,120,146,4293,4199,363,6316,1547,0
20:29:31,13990.56,Fox,8494,267,94,58,90,14,6,5,8494,8400,8342,6292,1715,1592,121,146,4295,4199,363,6317,1547,0
20:29:31,13990.83,Fox,8494,267,94,54,94,14,6,5,8494,8400,8346,6292,1715,1592,121,146,4295,4199,363,6317,1547,0
20:29:31,13991.38,Fox,8494,267,94,54,92,16,6,5,8494,8400,8346,6294,1715,1592,121,146,4295,4199,363,6317,1547,0
20:29:32,13992.39,Fox,8496,268,96,54,88,19,6,5,8496,8400,8346,6297,1715,1592,120,148,4295,4201,363,6318,1547,0
20:29:32,13992.95,Fox,8496,268,92,56,90,19,6,5,8496,8404,8348,6297,1715,1592,120,148,4295,4201,363,6318,1547,0
20:29:32,13993.5,Fox,8496,268,92,54,90,21,6,5,8496,8404,8350,6299,1715,1592,120,148,4295,4201,363,6318,1547,0
20:29:32,13994.01,Fox,8498,269,94,54,90,20,6,5,8498,8404,8350,6299,1715,1592,121,148,4297,4201,363,6319,1547,0
20:29:32,13995.1,Fox,8498,266,90,58,89,18,6,5,8498,8408,8350,6300,1715,1592,121,145,4297,4201,363,6322,1547,0
20:29:33,13995.88,Fox,8500,267,90,58,83,23,6,5,8498,8408,8350,6305,1715,1592,121,146,4298,4202,363,6323,1547,0
20:29:33,13996.38,Fox,8500,267,90,60,79,27,6,5,8500,8410,8350,6309,1715,1592,121,146,4298,4202,363,6323,1547,0
20:29:33,13996.68,Fox,8500,267,90,60,77,29,6,5,8500,8410,8350,6311,1715,1592,121,146,4298,4202,363,6323,1547,0
20:29:33,13997.41,Fox,8500,267,90,58,79,29,6,5,8500,8410,8352,6311,1715,1592,121,146,4298,4202,363,6323,1547,0
20:29:34,13998.41,Fox,8502,266,92,58,75,30,6,5,8502,8410,8352,6314,1715,1592,122,144,4300,4202,363,6326,1547,0
20:29:34,13998.67,Fox,8502,266,92,56,77,30,6,5,8502,8410,8354,6314,1715,1592,122,144,4300,4202,363,6326,1547,0
20:29:34,13999.42,Fox,8502,264,90,58,77,28,6,5,8502,8412,8354,6314,1715,1592,122,142,4300,4202,363,6328,1547,0
20:29:34,14000.42,Fox,8504,265,92,58,76,28,6,5,8504,8412,8354,6314,1715,1592,122,143,4301,4203,363,6329,1547,0
20:29:34,14001.23,Fox,8504,265,90,60,76,28,6,5,8504,8414,8354,6314,1715,1592,122,143,4301,4203,363,6329,1547,0
20:29:35,14002.03,Fox,8504,263,90,58,78,26,6,5,8504,8414,8356,6314,1715,1592,122,141,4301,4203,363,6331,1547,0
20:29:35,14002.56,Fox,8504,262,88,60,78,25,6,5,8504,8416,8356,6314,1715,1592,121,141,4301,4203,363,6332,1547,0
20:29:35,14003.35,Fox,8510,263,90,60,75,23,6,5,8506,8416,8356,6314,1715,1592,120,143,4303,4207,363,6337,1547,0
20:29:35,14003.95,Fox,8510,262,92,62,73,24,6,5,8510,8418,8356,6316,1715,1592,119,143,4303,4207,363,6338,1547,0
20:29:36,14004.49,Fox,8512,263,94,62,72,24,6,5,8512,8418,8356,6316,1715,1592,118,145,4303,4209,363,6339,1547,0
20:29:36,14005.03,Fox,8516,264,94,60,74,24,5,5,8514,8420,8360,6316,1715,1592,118,146,4305,4211,363,6342,1547,0
20:29:36,14005.58,Fox,8516,263,92,64,73,24,5,5,8516,8424,8360,6317,1715,1592,117,146,4305,4211,363,6343,1547,0
20:29:36,14006.11,Fox,8516,262,90,66,73,23,4,6,8516,8426,8360,6317,1715,1593,117,145,4305,4211,363,6344,1547,0
20:29:36,14006.66,Fox,8516,256,90,62,77,17,4,6,8516,8426,8364,6317,1715,1593,113,143,4305,4211,363,6350,1547,0
20:29:36,14007.18,Fox,8516,252,88,62,77,15,4,6,8516,8428,8366,6319,1715,1593,112,140,4305,4211,363,6354,1547,0
20:29:37,14008.43,Fox,8518,253,90,62,76,15,4,6,8518,8428,8366,6319,1715,1593,113,140,4307,4211,363,6355,1547,0
20:29:37,14008.94,Fox,8520,251,88,60,79,12,4,6,8518,8430,8370,6319,1715,1593,114,137,4309,4211,363,6359,1547,0
20:29:37,14009.22,Fox,8520,251,90,60,79,12,4,6,8520,8430,8370,6319,1715,1593,114,137,4309,4211,363,6359,1547,0
20:29:38,14010.55,Fox,8520,251,90,58,80,13,4,6,8520,8430,8372,6320,1715,1593,114,137,4309,4211,363,6359,1547,0
20:29:38,14011.02,Fox,8522,252,90,58,77,15,4,6,8520,8430,8372,6322,1715,1593,114,138,4310,4212,363,6360,1547,0
20:29:38,14011.56,Fox,8524,253,90,62,76,15,4,6,8524,8434,8372,6322,1715,1593,113,140,4310,4214,363,6361,1547,0
20:29:38,14012.36,Fox,8524,253,90,60,78,15,4,6,8524,8434,8374,6322,1715,1593,113,140,4310,4214,363,6361,1547,0
20:29:39,14013.57,Fox,8524,253,90,60,77,16,4,6,8524,8434,8374,6323,1715,1593,113,140,4310,4214,363,6361,1547,0
20:29:39,14014.23,Fox,8526,254,90,60,78,16,4,6,8526,8436,8376,6323,1715,1593,113,141,4311,4215,363,6362,1547,0
20:29:39,14014.79,Fox,8526,251,84,66,78,14,4,5,8526,8442,8376,6323,1715,1593,111,140,4311,4215,363,6364,1548,0
20:29:39,14015.34,Fox,8528,252,84,66,79,14,4,5,8528,8444,8378,6323,1715,1593,111,141,4312,4216,363,6365,1548,0
20:29:39,14015.85,Fox,8530,252,86,66,77,14,4,5,8530,8444,8378,6324,1715,1593,111,141,4313,4217,363,6367,1548,0
20:29:40,14016.62,Fox,8530,252,86,66,75,16,4,5,8530,8444,8378,6326,1715,1593,111,141,4313,4217,363,6367,1548,0
20:29:40,14017.58,Fox,8530,250,86,66,75,14,4,5,8530,8444,8378,6326,1715,1593,111,139,4313,4217,363,6369,1548,0
20:29:40,14018.16,Fox,8530,250,86,62,77,16,4,5,8530,8444,8382,6328,1715,1593,111,139,4313,4217,363,6369,1548,0
20:29:40,14018.94,Fox,8530,248,86,60,77,18,4,3,8530,8444,8384,6330,1715,1593,111,137,4313,4217,363,6369,1550,0
20:29:41,14019.45,Fox,8532,249,88,60,72,22,4,3,8532,8444,8384,6334,1715,1593,111,138,4314,4218,363,6370,1550,0
20:29:41,14020.79,Fox,8532,248,88,60,72,21,4,3,8532,8444,8384,6334,1715,1593,111,137,4314,4218,363,6371,1550,0
20:29:41,14021.32,Fox,8532,246,88,60,70,21,4,3,8532,8444,8384,6336,1715,1593,109,137,4314,4218,363,6373,1550,0
20:29:41,14021.82,Fox,8532,246,88,60,69,22,4,3,8532,8444,8384,6337,1715,1593,109,137,4314,4218,363,6373,1550,0
20:29:42,14022.33,Fox,8532,246,86,62,68,23,4,3,8532,8446,8384,6338,1715,1593,109,137,4314,4218,363,6373,1550,0
20:29:42,14022.77,Fox,8532,246,86,60,70,23,4,3,8532,8446,8386,6338,1715,1593,109,137,4314,4218,363,6373,1550,0
20:29:42,14023.21,Fox,8532,246,86,58,72,23,4,3,8532,8446,8388,6338,1715,1593,109,137,4314,4218,363,6373,1550,0
20:29:42,14024.16,Fox,8532,245,84,60,69,25,4,3,8532,8448,8388,6341,1715,1593,109,136,4314,4218,363,6374,1550,0
20:29:42,14024.41,Fox,8532,245,82,62,69,25,4,3,8532,8450,8388,6341,1715,1593,109,136,4314,4218,363,6374,1550,0
20:29:43,14025.21,Fox,8534,246,80,60,72,25,4,3,8532,8452,8392,6341,1715,1593,110,136,4316,4218,363,6375,1550,0
20:29:43,14025.72,Fox,8534,246,82,60,71,26,4,3,8534,8452,8392,6342,1715,1593,110,136,4316,4218,363,6375,1550,0
20:29:43,14026.24,Fox,8534,245,80,62,71,25,4,3,8534,8454,8392,6342,1715,1593,110,135,4316,4218,363,6376,1550,0
20:29:43,14027.01,Fox,8534,243,80,60,72,24,4,3,8534,8454,8394,6343,1715,1593,110,133,4316,4218,363,6378,1550,0
20:29:43,14027.49,Fox,8534,243,78,62,70,26,4,3,8534,8456,8394,6345,1715,1593,110,133,4316,4218,363,6378,1550,0
20:29:44,14028.52,Fox,8534,239,76,60,74,24,4,1,8534,8458,8398,6345,1715,1593,110,129,4316,4218,363,6380,1552,0
20:29:44,14028.99,Fox,8536,240,78,58,75,24,4,1,8536,8458,8400,6345,1715,1593,109,131,4316,4220,363,6381,1552,0
20:29:44,14029.25,Fox,8536,238,78,58,75,22,4,1,8536,8458,8400,6345,1715,1593,109,129,4316,4220,363,6383,1552,0
20:29:44,14030.02,Fox,8536,234,78,58,73,20,4,1,8536,8458,8400,6347,1715,1593,105,129,4316,4220,363,6387,1552,0
20:29:45,14031.26,Fox,8536,234,78,54,77,20,4,1,8536,8458,8404,6347,1715,1593,105,129,4316,4220,363,6387,1552,0
20:29:45,14031.7,Fox,8536,232,76,56,77,18,4,1,8536,8460,8404,6347,1715,1593,105,127,4316,4220,363,6389,1552,0
20:29:45,14032.63,Fox,8536,231,74,58,74,20,4,1,8536,8462,8404,6350,1715,1593,105,126,4316,4220,363,6390,1552,0
20:29:45,14032.87,Fox,8536,230,74,58,74,19,4,1,8536,8462,8404,6350,1715,1593,105,125,4316,4220,363,6391,1552,0
20:29:45,14033.84,Fox,8536,230,74,54,74,23,4,1,8536,8462,8408,6354,1715,1593,105,125,4316,4220,363,6391,1552,0
20:29:45,14034.06,Fox,8536,230,74,54,72,25,4,1,8536,8462,8408,6356,1715,1593,105,125,4316,4220,363,6391,1552,0
20:29:46,14034.7,Fox,8536,227,74,54,70,24,4,1,8536,8462,8408,6358,1715,1593,103,124,4316,4220,363,6394,1552,0
20:29:46,14035.16,Fox,8536,227,72,54,72,24,4,1,8536,8464,8410,6358,1715,1593,103,124,4316,4220,363,6394,1552,0
20:29:46,14035.93,Fox,8538,228,74,54,71,24,4,1,8538,8464,8410,6358,1715,1593,103,125,4317,4221,363,6395,1552,0
20:29:46,14036.19,Fox,8538,227,74,54,71,23,4,1,8538,8464,8410,6358,1715,1593,102,125,4317,4221,363,6396,1552,0
20:29:47,14037.13,Fox,8538,226,74,54,71,22,4,1,8538,8464,8410,6358,1715,1593,102,124,4317,4221,363,6397,1552,0
20:29:47,14038.18,Fox,8538,224,74,52,73,20,4,1,8538,8464,8412,6358,1715,1593,102,122,4317,4221,363,6399,1552,0
20:29:47,14038.67,Fox,8538,224,72,54,69,24,4,1,8538,8466,8412,6362,1715,1593,102,122,4317,4221,363,6399,1552,0
20:29:48,14039.91,Fox,8540,225,72,52,70,24,4,1,8538,8466,8414,6362,1715,1593,103,122,4319,4221,363,6400,1552,0
20:29:48,14040.4,Fox,8540,223,74,52,70,22,4,1,8540,8466,8414,6362,1715,1593,103,120,4319,4221,363,6402,1552,0
20:29:48,14041.1,Fox,8540,223,74,50,71,23,4,1,8540,8466,8416,6363,1715,1593,103,120,4319,4221,363,6402,1552,0
20:29:48,14041.36,Fox,8540,223,74,50,69,25,4,1,8540,8466,8416,6365,1715,1593,103,120,4319,4221,363,6402,1552,0
20:29:48,14041.82,Fox,8540,223,74,48,71,25,4,1,8540,8466,8418,6365,1715,1593,103,120,4319,4221,363,6402,1552,0
20:29:49,14042.73,Fox,8540,222,74,48,71,24,4,1,8540,8466,8418,6365,1715,1593,102,120,4319,4221,363,6403,1552,0
20:29:49,14043.16,Fox,8540,220,74,46,71,24,4,1,8540,8466,8420,6367,1715,1593,100,120,4319,4221,363,6405,1552,0
20:29:49,14043.85,Fox,8540,220,72,44,74,25,4,1,8540,8468,8424,6368,1715,1593,100,120,4319,4221,363,6405,1552,0
20:29:49,14044.29,Fox,8540,216,72,44,74,21,4,1,8540,8468,8424,6368,1715,1593,99,117,4319,4221,363,6409,1552,0
20:29:49,14044.55,Fox,8540,214,72,42,76,19,4,1,8540,8468,8426,6368,1715,1593,98,116,4319,4221,363,6411,1552,0
20:29:49,14045.01,Fox,8540,212,72,42,76,17,4,1,8540,8468,8426,6368,1715,1593,98,114,4319,4221,363,6413,1552,0
20:29:50,14045.99,Fox,8542,213,72,40,77,17,4,1,8540,8468,8428,6368,1715,1593,98,115,4320,4222,363,6414,1552,0
20:29:50,14046.45,Fox,8542,213,74,40,77,17,3,2,8542,8468,8428,6368,1715,1594,98,115,4320,4222,363,6414,1552,0
20:29:50,14046.94,Fox,8544,214,76,40,76,17,3,2,8544,8468,8428,6368,1715,1594,99,115,4322,4222,363,6415,1552,0
20:29:50,14047.63,Fox,8546,215,74,40,77,17,3,2,8544,8470,8430,6368,1715,1594,99,116,4323,4223,363,6416,1552,0
20:29:50,14047.86,Fox,8546,215,76,40,77,17,3,2,8546,8470,8430,6368,1715,1594,99,116,4323,4223,363,6416,1552,0
20:29:51,14049.14,Fox,8548,212,78,40,76,13,3,2,8548,8470,8430,6368,1715,1594,99,113,4324,4224,363,6421,1552,0
20:29:51,14049.98,Fox,8550,214,80,36,80,13,3,2,8550,8470,8434,6368,1715,1594,101,113,4326,4224,363,6421,1552,0
20:29:51,14050.58,Fox,8550,214,80,36,78,15,3,2,8550,8470,8434,6370,1715,1594,101,113,4326,4224,363,6421,1552,0
20:29:51,14051.41,Fox,8550,213,80,36,75,17,3,2,8550,8470,8434,6373,1715,1594,101,112,4326,4224,363,6422,1552,0
20:29:52,14052.07,Fox,8550,211,76,40,75,15,3,2,8550,8474,8434,6373,1715,1594,99,112,4326,4224,363,6424,1552,0
20:29:52,14052.75,Fox,8552,212,74,42,76,15,3,2,8552,8478,8436,6373,1715,1594,99,113,4327,4225,363,6425,1552,0
20:29:52,14053.21,Fox,8554,213,74,38,81,15,3,2,8554,8480,8442,6373,1715,1594,98,115,4327,4227,363,6426,1552,0
20:29:52,14053.68,Fox,8554,211,74,36,80,16,3,2,8554,8480,8444,6376,1715,1594,98,113,4327,4227,363,6428,1552,0
20:29:52,14053.89,Fox,8554,211,72,38,80,16,3,2,8554,8482,8444,6376,1715,1594,98,113,4327,4227,363,6428,1552,0
20:29:53,14054.52,Fox,8556,211,74,38,79,15,3,2,8556,8482,8444,6376,1715,1594,97,114,4327,4229,363,6430,1552,0
20:29:53,14056.69,Fox,8560,213,78,38,77,15,3,2,8560,8482,8444,6376,1715,1594,96,117,4328,4232,363,6432,1552,0
20:29:54,14057.45,Fox,8562,214,78,40,76,15,3,2,8562,8484,8444,6376,1715,1594,96,118,4329,4233,363,6433,1552,0
20:29:54,14057.94,Fox,8562,214,76,42,74,17,3,2,8562,8486,8444,6378,1715,1594,96,118,4329,4233,363,6433,1552,0
20:29:54,14058.18,Fox,8562,214,74,44,74,17,3,2,8562,8488,8444,6378,1715,1594,96,118,4329,4233,363,6433,1552,0
20:29:54,14059.02,Fox,8562,214,74,44,72,19,3,2,8562,8488,8444,6380,1715,1594,96,118,4329,4233,363,6433,1552,0
20:29:55,14060.72,Fox,8562,212,74,42,74,17,3,2,8562,8488,8446,6380,1715,1594,96,116,4329,4233,363,6435,1552,0
20:29:55,14061.63,Fox,8562,209,74,42,74,14,3,2,8562,8488,8446,6380,1715,1594,95,114,4329,4233,363,6438,1552,0
20:29:55,14062.23,Fox,8566,211,76,42,71,15,3,2,8564,8488,8446,6381,1715,1594,95,116,4331,4235,363,6440,1552,0
20:29:55,14062.69,Fox,8566,211,78,40,73,15,3,2,8566,8488,8448,6381,1715,1594,95,116,4331,4235,363,6440,1552,0
20:29:55,14062.9,Fox,8566,211,78,38,75,15,3,2,8566,8488,8450,6381,1715,1594,95,116,4331,4235,363,6440,1552,0
20:29:56,14064.04,Fox,8568,209,80,36,76,12,3,2,8568,8488,8452,6381,1715,1594,95,114,4332,4236,363,6444,1552,0
20:29:56,14064.73,Fox,8568,209,80,34,78,12,3,2,8568,8488,8454,6381,1715,1594,95,114,4332,4236,363,6444,1552,0
20:29:56,14065.62,Fox,8570,210,82,32,75,16,3,2,8570,8488,8456,6385,1715,1594,95,115,4333,4237,363,6445,1552,0
20:29:57,14066.83,Fox,8570,210,82,30,76,17,3,2,8570,8488,8458,6386,1715,1594,95,115,4333,4237,363,6445,1552,0
20:29:57,14067.02,Fox,8570,210,82,30,75,18,3,2,8570,8488,8458,6387,1715,1594,95,115,4333,4237,363,6445,1552,0
20:29:57,14067.59,Fox,8570,210,80,32,73,20,3,2,8570,8490,8458,6389,1715,1594,95,115,4333,4237,363,6445,1552,0
20:29:57,14068.52,Fox,8576,211,86,32,70,18,3,2,8576,8490,8458,6389,1715,1594,94,117,4335,4241,363,6450,1552,0
20:29:58,14069.4,Fox,8576,211,86,32,67,21,3,2,8576,8490,8458,6392,1715,1594,94,117,4335,4241,363,6450,1552,0
20:29:58,14069.58,Fox,8576,209,86,32,67,19,3,2,8576,8490,8458,6392,1715,1594,92,117,4335,4241,363,6452,1552,0
20:29:58,14070.41,Fox,8578,210,84,32,68,19,3,2,8576,8492,8460,6392,1715,1594,91,119,4335,4243,363,6453,1552,0
20:29:58,14070.84,Fox,8578,210,86,30,70,19,3,2,8578,8492,8462,6392,1715,1594,91,119,4335,4243,363,6453,1552,0
20:29:58,14071.23,Fox,8580,211,86,30,69,19,3,2,8578,8492,8462,6393,1715,1594,91,120,4336,4244,363,6454,1552,0
20:29:58,14071.53,Fox,8580,211,88,30,69,19,3,2,8580,8492,8462,6393,1715,1594,91,120,4336,4244,363,6454,1552,0
20:29:59,14072.89,Fox,8580,210,88,30,68,19,3,2,8580,8492,8462,6394,1715,1594,90,120,4336,4244,363,6455,1552,0
20:29:59,14073.1,Fox,8580,210,86,32,68,19,3,2,8580,8494,8462,6394,1715,1594,90,120,4336,4244,363,6455,1552,0
20:29:59,14073.48,Fox,8580,210,86,30,70,19,3,2,8580,8494,8464,6394,1715,1594,90,120,4336,4244,363,6455,1552,0
20:29:59,14074.93,Fox,8580,210,84,32,70,19,1,4,8580,8496,8464,6394,1715,1596,90,120,4336,4244,363,6455,1552,0
20:30:00,14075.76,Fox,8580,206,84,32,68,17,1,4,8580,8496,8464,6396,1715,1596,89,117,4336,4244,363,6459,1552,0
20:30:00,14076.54,Fox,8580,206,82,34,68,17,1,4,8580,8498,8464,6396,1715,1596,89,117,4336,4244,363,6459,1552,0
20:30:00,14077.16,Fox,8582,206,82,32,69,17,1,3,8580,8498,8466,6396,1715,1596,87,119,4336,4246,363,6460,1553,0
20:30:00,14077.63,Fox,8582,205,84,32,69,16,1,3,8582,8498,8466,6396,1715,1596,87,118,4336,4246,363,6461,1553,0
20:30:00,14078.09,Fox,8582,203,84,32,69,14,1,3,8582,8498,8466,6396,1715,1596,87,116,4336,4246,363,6463,1553,0
20:30:01,14078.73,Fox,8582,203,82,34,68,15,1,3,8582,8500,8466,6397,1715,1596,87,116,4336,4246,363,6463,1553,0
20:30:01,14079.31,Fox,8584,204,82,34,66,16,1,3,8582,8500,8466,6399,1715,1596,87,117,4337,4247,363,6464,1553,0
20:30:01,14079.76,Fox,8584,203,84,34,66,15,1,3,8584,8500,8466,6399,1715,1596,87,116,4337,4247,363,6465,1553,0
20:30:01,14079.95,Fox,8584,201,84,34,66,13,1,3,8584,8500,8466,6399,1715,1596,87,114,4337,4247,363,6467,1553,0
20:30:01,14081.06,Fox,8584,201,82,36,66,13,1,3,8584,8502,8466,6399,1715,1596,87,114,4337,4247,363,6467,1553,0
20:30:02,14081.65,Fox,8586,201,84,36,65,12,1,3,8586,8502,8466,6399,1715,1596,87,114,4338,4248,363,6469,1553,0
20:30:02,14082.08,Fox,8586,201,84,34,67,12,1,3,8586,8502,8468,6399,1715,1596,87,114,4338,4248,363,6469,1553,0
20:30:02,14082.91,Fox,8588,202,84,36,66,12,1,3,8588,8504,8468,6399,1715,1596,87,115,4339,4249,363,6470,1553,0
20:30:02,14083.31,Fox,8590,202,84,36,63,13,1,3,8588,8504,8468,6401,1715,1596,87,115,4340,4250,363,6472,1553,0
20:30:02,14083.53,Fox,8590,202,86,36,63,13,1,3,8590,8504,8468,6401,1715,1596,87,115,4340,4250,363,6472,1553,0
20:30:03,14085.27,Fox,8590,202,86,36,61,15,1,3,8590,8504,8468,6403,1715,1596,87,115,4340,4250,363,6472,1553,0
20:30:03,14085.81,Fox,8590,202,84,36,62,16,1,3,8590,8506,8470,6404,1715,1596,87,115,4340,4250,363,6472,1553,0
20:30:03,14086.31,Fox,8590,201,80,40,62,15,1,3,8590,8510,8470,6404,1715,1596,87,114,4340,4250,363,6473,1553,0
20:30:04,14087.15,Fox,8592,202,80,42,61,15,1,3,8592,8512,8470,6404,1715,1596,87,115,4341,4251,363,6474,1553,0
20:30:04,14087.55,Fox,8592,202,78,44,60,16,1,3,8592,8514,8470,6405,1715,1596,87,115,4341,4251,363,6474,1553,0
20:30:04,14087.76,Fox,8592,202,76,46,60,16,1,3,8592,8516,8470,6405,1715,1596,87,115,4341,4251,363,6474,1553,0
20:30:04,14088.53,Fox,8594,203,78,46,56,19,1,3,8594,8516,8470,6408,1715,1596,86,117,4341,4253,363,6475,1553,0
20:30:04,14088.93,Fox,8594,202,78,46,56,18,1,3,8594,8516,8470,6408,1715,1596,86,116,4341,4253,363,6476,1553,0
20:30:05,14089.79,Fox,8598,202,78,46,54,16,1,3,8594,8516,8470,6408,1715,1596,84,118,4343,4255,363,6480,1553,0
20:30:05,14090.21,Fox,8598,202,82,44,56,16,1,3,8598,8516,8472,6408,1715,1596,84,118,4343,4255,363,6480,1553,0
20:30:05,14090.64,Fox,8600,203,84,42,57,16,1,3,8600,8516,8474,6408,1715,1596,83,120,4343,4257,363,6481,1553,0
20:30:05,14091.25,Fox,8602,204,84,40,60,16,1,3,8602,8518,8478,6408,1715,1596,83,121,4344,4258,363,6482,1553,0
20:30:05,14091.73,Fox,8602,204,82,40,60,18,1,3,8602,8520,8480,6410,1715,1596,83,121,4344,4258,363,6482,1553,0
20:30:05,14092.14,Fox,8604,205,84,40,59,18,1,3,8604,8520,8480,6410,1715,1596,83,122,4345,4259,363,6483,1553,0
20:30:05,14092.58,Fox,8606,206,86,38,60,18,1,3,8606,8520,8482,6410,1715,1596,83,123,4346,4260,363,6484,1553,0
20:30:06,14093.89,Fox,8606,204,84,40,58,18,1,3,8606,8522,8482,6412,1715,1596,82,122,4346,4260,363,6486,1553,0
20:30:06,14094.11,Fox,8606,204,82,42,58,18,1,3,8606,8524,8482,6412,1715,1596,82,122,4346,4260,363,6486,1553,0
20:30:06,14095.39,Fox,8608,205,84,42,55,20,1,3,8608,8524,8482,6414,1715,1596,81,124,4346,4262,363,6487,1553,0
20:30:07,14096.06,Fox,8608,202,84,40,57,17,1,3,8608,8524,8484,6414,1715,1596,81,121,4346,4262,363,6490,1553,0
20:30:07,14096.27,Fox,8608,202,84,38,59,17,1,3,8608,8524,8486,6414,1715,1596,81,121,4346,4262,363,6490,1553,0
20:30:07,14096.91,Fox,8608,202,82,38,61,17,1,3,8608,8526,8488,6414,1715,1596,81,121,4346,4262,363,6490,1553,0
20:30:07,14097.49,Fox,8608,201,82,38,61,17,1,2,8608,8526,8488,6414,1715,1596,80,121,4346,4262,363,6490,1554,0
20:30:07,14097.9,Fox,8608,200,80,40,61,16,1,2,8608,8528,8488,6414,1715,1596,80,120,4346,4262,363,6491,1554,0
20:30:07,14098.31,Fox,8608,200,78,42,59,18,1,2,8608,8530,8488,6416,1715,1596,80,120,4346,4262,363,6491,1554,0
20:30:08,14099.07,Fox,8608,197,78,42,59,15,1,2,8608,8530,8488,6416,1715,1596,80,117,4346,4262,363,6494,1554,0
20:30:08,14100.07,Fox,8608,197,78,42,58,16,1,2,8608,8530,8488,6417,1715,1596,80,117,4346,4262,363,6494,1554,0
20:30:08,14101.25,Fox,8608,197,78,42,56,18,1,2,8608,8530,8488,6419,1715,1596,80,117,4346,4262,363,6494,1554,0
20:30:09,14102.29,Fox,8610,196,78,44,55,16,1,2,8610,8532,8488,6419,1715,1596,78,118,4347,4263,363,6497,1554,0
20:30:09,14102.79,Fox,8612,197,80,44,52,18,1,2,8612,8532,8488,6421,1715,1596,77,120,4347,4265,363,6498,1554,0
20:30:09,14103.56,Fox,8616,199,82,44,48,20,1,2,8614,8532,8488,6423,1715,1596,76,123,4348,4268,363,6500,1554,0
20:30:09,14103.77,Fox,8616,199,84,44,48,20,1,2,8616,8532,8488,6423,1715,1596,76,123,4348,4268,363,6500,1554,0
20:30:09,14104.17,Fox,8616,199,84,44,46,22,1,2,8616,8532,8488,6425,1715,1596,76,123,4348,4268,363,6500,1554,0
20:30:09,14104.53,Fox,8616,197,84,44,46,20,1,2,8616,8532,8488,6425,1715,1596,76,121,4348,4268,363,6502,1554,0
20:30:10,14104.89,Fox,8616,197,84,44,44,22,1,2,8616,8532,8488,6427,1715,1596,76,121,4348,4268,363,6502,1554,0
20:30:10,14105.64,Fox,8618,198,86,44,43,22,1,2,8618,8532,8488,6427,1715,1596,75,123,4348,4270,363,6503,1554,0
20:30:10,14106.12,Fox,8618,196,86,42,43,22,1,2,8618,8532,8490,6429,1715,1596,75,121,4348,4270,363,6505,1554,0
20:30:10,14106.94,Fox,8620,197,88,42,42,22,1,2,8620,8532,8490,6429,1715,1596,76,121,4350,4270,363,6506,1554,0
20:30:11,14107.92,Fox,8620,197,86,44,40,24,1,2,8620,8534,8490,6431,1715,1596,76,121,4350,4270,363,6506,1554,0
20:30:11,14109.06,Fox,8620,195,86,42,42,22,1,2,8620,8534,8492,6431,1715,1596,76,119,4350,4270,363,6508,1554,0
20:30:11,14110.31,Fox,8622,196,88,42,40,23,1,2,8622,8534,8492,6433,1715,1596,76,120,4351,4271,363,6509,1554,0
20:30:12,14110.76,Fox,8622,195,88,42,40,22,1,2,8622,8534,8492,6433,1715,1596,76,119,4351,4271,363,6510,1554,0
20:30:12,14111.79,Fox,8622,193,86,42,42,20,1,2,8622,8536,8494,6433,1715,1596,76,117,4351,4271,363,6512,1554,0
20:30:12,14112.25,Fox,8624,194,88,42,41,20,1,2,8624,8536,8494,6433,1715,1596,75,119,4351,4273,363,6513,1554,0
20:30:12,14113,Fox,8624,192,88,42,40,19,1,2,8624,8536,8494,6434,1715,1596,75,117,4351,4273,363,6515,1554,0
20:30:12,14113.36,Fox,8624,192,88,40,40,21,1,2,8624,8536,8496,6436,1715,1596,75,117,4351,4273,363,6515,1554,0
20:30:13,14113.97,Fox,8624,190,88,40,37,22,1,2,8624,8536,8496,6439,1715,1596,75,115,4351,4273,363,6517,1554,0
20:30:13,14114.96,Fox,8626,189,90,40,36,20,1,2,8626,8536,8496,6439,1715,1596,75,114,4352,4274,363,6520,1554,0
20:30:13,14115.18,Fox,8626,189,90,38,38,20,1,2,8626,8536,8498,6439,1715,1596,75,114,4352,4274,363,6520,1554,0
20:30:13,14115.6,Fox,8626,187,90,38,38,18,1,2,8626,8536,8498,6439,1715,1596,75,112,4352,4274,363,6522,1554,0
20:30:14,14116.86,Fox,8628,186,92,38,37,16,1,2,8628,8536,8498,6439,1715,1596,76,110,4354,4274,363,6525,1554,0
20:30:14,14117.2,Fox,8628,186,92,36,39,16,1,2,8628,8536,8500,6439,1715,1596,76,110,4354,4274,363,6525,1554,0
20:30:14,14118.38,Fox,8628,185,90,38,39,15,1,2,8628,8538,8500,6439,1715,1596,76,109,4354,4274,363,6526,1554,0
20:30:14,14118.98,Fox,8630,186,92,38,38,15,1,2,8630,8538,8500,6439,1715,1596,77,109,4356,4274,363,6527,1554,0
20:30:15,14119.61,Fox,8630,186,92,36,40,15,1,2,8630,8538,8502,6439,1715,1596,77,109,4356,4274,363,6527,1554,0
20:30:15,14120.67,Fox,8630,184,92,36,40,13,1,2,8630,8538,8502,6439,1715,1596,76,108,4356,4274,363,6529,1554,0
20:30:15,14121.06,Fox,8630,184,92,36,38,15,1,2,8630,8538,8502,6441,1715,1596,76,108,4356,4274,363,6529,1554,0
20:30:15,14121.42,Fox,8630,184,92,34,40,15,1,2,8630,8538,8504,6441,1715,1596,76,108,4356,4274,363,6529,1554,0
20:30:16,14123.01,Fox,8630,184,90,36,38,17,1,2,8630,8540,8504,6443,1715,1596,76,108,4356,4274,363,6529,1554,0
20:30:16,14123.32,Fox,8630,184,90,36,36,19,1,2,8630,8540,8504,6445,1715,1596,76,108,4356,4274,363,6529,1554,0
20:30:16,14123.85,Fox,8630,181,90,36,36,16,1,2,8630,8540,8504,6445,1715,1596,76,105,4356,4274,363,6532,1554,0
20:30:16,14124.42,Fox,8630,178,90,34,38,13,1,2,8630,8540,8506,6445,1715,1596,76,102,4356,4274,363,6535,1554,0
20:30:16,14124.58,Fox,8630,178,90,30,42,13,1,2,8630,8540,8510,6445,1715,1596,76,102,4356,4274,363,6535,1554,0
20:30:17,14125.49,Fox,8630,178,90,28,43,14,1,2,8630,8540,8512,6446,1715,1596,76,102,4356,4274,363,6535,1554,0
20:30:17,14126.22,Fox,8632,179,90,24,45,15,1,2,8630,8540,8516,6447,1715,1596,75,104,4356,4276,363,6536,1554,0
20:30:17,14126.43,Fox,8632,179,92,24,45,15,1,2,8632,8540,8516,6447,1715,1596,75,104,4356,4276,363,6536,1554,0
20:30:17,14127.2,Fox,8632,179,92,24,44,16,1,2,8632,8540,8516,6448,1715,1596,75,104,4356,4276,363,6536,1554,0
20:30:18,14127.94,Fox,8634,180,94,24,43,16,1,2,8634,8540,8516,6448,1715,1596,75,105,4357,4277,363,6537,1554,0
20:30:18,14128.7,Fox,8634,180,92,26,43,16,1,2,8634,8542,8516,6448,1715,1596,75,105,4357,4277,363,6537,1554,0
20:30:18,14129.56,Fox,8634,180,90,26,45,16,1,2,8634,8544,8518,6448,1715,1596,75,105,4357,4277,363,6537,1554,0
20:30:18,14130.14,Fox,8638,182,92,26,43,16,1,2,8636,8544,8518,6448,1715,1596,74,108,4358,4280,363,6539,1554,0
20:30:18,14130.35,Fox,8638,182,92,26,45,16,1,2,8638,8546,8520,6448,1715,1596,74,108,4358,4280,363,6539,1554,0
20:30:19,14131.3,Fox,8640,183,94,26,44,16,1,2,8640,8546,8520,6448,1715,1596,73,110,4358,4282,363,6540,1554,0
20:30:19,14131.67,Fox,8640,181,92,28,44,14,1,2,8640,8548,8520,6448,1715,1596,73,108,4358,4282,363,6542,1554,0
20:30:19,14132.49,Fox,8640,181,90,26,48,14,1,2,8640,8550,8524,6448,1715,1596,73,108,4358,4282,363,6542,1554,0
20:30:19,14133.83,Fox,8640,177,90,26,48,10,1,2,8640,8550,8524,6448,1715,1596,71,106,4358,4282,363,6546,1554,0
20:30:20,14134.26,Fox,8642,178,92,26,45,12,1,2,8642,8550,8524,6450,1715,1596,71,107,4359,4283,363,6547,1554,0
20:30:20,14135.04,Fox,8644,179,94,26,44,12,1,2,8644,8550,8524,6450,1715,1596,70,109,4359,4285,363,6548,1554,0
20:30:20,14135.24,Fox,8644,179,92,26,46,12,1,2,8644,8552,8526,6450,1715,1596,70,109,4359,4285,363,6548,1554,0
20:30:20,14135.64,Fox,8644,177,90,28,46,11,1,1,8644,8554,8526,6450,1715,1596,70,107,4359,4285,363,6549,1555,0
20:30:20,14136.63,Fox,8644,176,90,26,48,10,1,1,8644,8554,8528,6450,1715,1596,70,106,4359,4285,363,6550,1555,0
20:30:21,14136.99,Fox,8644,176,88,26,50,10,1,1,8644,8556,8530,6450,1715,1596,70,106,4359,4285,363,6550,1555,0
20:30:21,14137.36,Fox,8644,176,88,26,49,11,1,1,8644,8556,8530,6451,1715,1596,70,106,4359,4285,363,6550,1555,0
20:30:21,14137.7,Fox,8644,175,88,26,49,10,1,1,8644,8556,8530,6451,1715,1596,70,105,4359,4285,363,6551,1555,0
20:30:21,14138.27,Fox,8646,176,90,26,48,10,1,1,8646,8556,8530,6451,1715,1596,69,107,4359,4287,363,6552,1555,0
20:30:21,14139.18,Fox,8646,176,86,30,48,10,1,1,8646,8560,8530,6451,1715,1596,69,107,4359,4287,363,6552,1555,0
20:30:22,14140.06,Fox,8646,176,84,32,48,10,1,1,8646,8562,8530,6451,1715,1596,69,107,4359,4287,363,6552,1555,0
20:30:22,14140.39,Fox,8646,176,84,30,50,10,1,1,8646,8562,8532,6451,1715,1596,69,107,4359,4287,363,6552,1555,0
20:30:22,14142.68,Fox,8646,176,84,30,48,12,1,1,8646,8562,8532,6453,1715,1596,69,107,4359,4287,363,6552,1555,0
20:30:23,14144.71,Fox,8646,174,82,32,48,10,1,1,8646,8564,8532,6453,1715,1596,68,106,4359,4287,363,6554,1555,0
20:30:23,14145.23,Fox,8648,175,80,34,47,10,1,1,8646,8566,8532,6453,1715,1596,67,108,4359,4289,363,6555,1555,0
20:30:23,14145.42,Fox,8648,175,82,34,47,10,1,1,8648,8566,8532,6453,1715,1596,67,108,4359,4289,363,6555,1555,0
20:30:24,14146.53,Fox,8648,175,80,34,47,12,1,1,8648,8568,8534,6455,1715,1596,67,108,4359,4289,363,6555,1555,0
20:30:24,14147.85,Fox,8648,174,80,34,47,11,1,1,8648,8568,8534,6455,1715,1596,67,107,4359,4289,363,6556,1555,0
20:30:24,14148.22,Fox,8648,174,78,36,47,11,1,1,8648,8570,8534,6455,1715,1596,67,107,4359,4289,363,6556,1555,0
20:30:25,14150.05,Fox,8648,174,78,34,49,11,1,1,8648,8570,8536,6455,1715,1596,67,107,4359,4289,363,6556,1555,0
20:30:25,14150.66,Fox,8648,174,78,34,48,12,1,1,8648,8570,8536,6456,1715,1596,67,107,4359,4289,363,6556,1555,0
20:30:25,14150.95,Fox,8648,174,72,40,47,13,1,1,8648,8576,8536,6457,1715,1596,67,107,4359,4289,363,6556,1555,0
20:30:25,14151.41,Fox,8648,174,72,40,46,14,1,1,8648,8576,8536,6458,1715,1596,67,107,4359,4289,363,6556,1555,0
20:30:26,14152,Fox,8648,174,72,40,45,15,1,1,8648,8576,8536,6459,1715,1596,67,107,4359,4289,363,6556,1555,0
20:30:26,14153.09,Fox,8648,172,70,42,43,15,1,1,8648,8578,8536,6461,1715,1596,66,106,4359,4289,363,6558,1555,0
20:30:26,14153.96,Fox,8648,172,68,44,43,15,1,1,8648,8580,8536,6461,1715,1596,66,106,4359,4289,363,6558,1555,0
20:30:27,14156.24,Fox,8648,172,68,44,41,17,1,1,8648,8580,8536,6463,1715,1596,66,106,4359,4289,363,6558,1555,0
20:30:27,14156.55,Fox,8648,172,68,44,40,18,1,1,8648,8580,8536,6464,1715,1596,66,106,4359,4289,363,6558,1555,0
20:30:27,14156.86,Fox,8648,170,68,42,42,16,1,1,8648,8580,8538,6464,1715,1596,66,104,4359,4289,363,6560,1555,0
20:30:27,14157.21,Fox,8648,170,68,42,41,17,1,1,8648,8580,8538,6465,1715,1596,66,104,4359,4289,363,6560,1555,0
20:30:28,14159.58,Fox,8650,171,70,42,40,17,1,1,8650,8580,8538,6465,1715,1596,66,105,4360,4290,363,6561,1555,0
20:30:28,14160.01,Fox,8650,171,68,44,40,17,1,1,8650,8582,8538,6465,1715,1596,66,105,4360,4290,363,6561,1555,0
20:30:29,14161.32,Fox,8650,170,68,42,42,16,1,1,8650,8582,8540,6465,1715,1596,66,104,4360,4290,363,6562,1555,0
20:30:29,14161.47,Fox,8650,169,68,42,42,15,1,1,8650,8582,8540,6465,1715,1596,66,103,4360,4290,363,6563,1555,0
20:30:29,14162.1,Fox,8650,168,66,44,42,14,1,1,8650,8584,8540,6465,1715,1596,66,102,4360,4290,363,6564,1555,0
20:30:29,14162.59,Fox,8650,167,66,44,42,13,1,1,8650,8584,8540,6465,1715,1596,66,101,4360,4290,363,6565,1555,0
20:30:29,14163.6,Fox,8652,166,68,44,41,11,1,1,8652,8584,8540,6465,1715,1596,65,101,4360,4292,363,6568,1555,0
20:30:30,14164.38,Fox,8656,168,66,46,39,11,1,1,8652,8586,8540,6465,1715,1596,66,102,4363,4293,363,6570,1555,0
20:30:30,14164.56,Fox,8656,168,70,46,39,11,1,1,8656,8586,8540,6465,1715,1596,66,102,4363,4293,363,6570,1555,0
20:30:30,14165.46,Fox,8656,168,68,48,39,11,1,1,8656,8588,8540,6465,1715,1596,66,102,4363,4293,363,6570,1555,0
20:30:30,14166.04,Fox,8656,168,66,50,39,11,1,1,8656,8590,8540,6465,1715,1596,66,102,4363,4293,363,6570,1555,0
20:30:30,14166.31,Fox,8656,168,66,50,37,13,1,1,8656,8590,8540,6467,1715,1596,66,102,4363,4293,363,6570,1555,0
20:30:31,14166.89,Fox,8656,166,66,50,37,11,1,1,8656,8590,8540,6467,1715,1596,66,100,4363,4293,363,6572,1555,0
20:30:31,14167.2,Fox,8656,165,66,48,39,10,1,1,8656,8590,8542,6467,1715,1596,66,99,4363,4293,363,6573,1555,0
20:30:31,14167.89,Fox,8656,164,66,46,41,9,1,1,8656,8590,8544,6467,1715,1596,66,98,4363,4293,363,6574,1555,0
20:30:31,14168.25,Fox,8658,165,68,46,40,9,1,1,8658,8590,8544,6467,1715,1596,66,99,4364,4294,363,6575,1555,0
20:30:31,14168.96,Fox,8658,165,68,44,42,9,1,1,8658,8590,8546,6467,1715,1596,66,99,4364,4294,363,6575,1555,0
20:30:31,14169.59,Fox,8660,166,68,46,40,10,1,1,8660,8592,8546,6468,1715,1596,66,100,4365,4295,363,6576,1555,0
20:30:32,14170.08,Fox,8660,166,68,44,42,10,1,1,8660,8592,8548,6468,1715,1596,66,100,4365,4295,363,6576,1555,0
20:30:32,14171.01,Fox,8660,166,66,44,44,10,1,1,8660,8594,8550,6468,1715,1596,66,100,4365,4295,363,6576,1555,0
20:30:32,14171.99,Fox,8660,166,66,44,42,12,1,1,8660,8594,8550,6470,1715,1596,66,100,4365,4295,363,6576,1555,0
20:30:32,14172.57,Fox,8660,166,62,48,42,12,1,1,8660,8598,8550,6470,1715,1596,66,100,4365,4295,363,6576,1555,0
20:30:33,14173.1,Fox,8660,166,60,50,42,12,1,1,8660,8600,8550,6470,1715,1596,66,100,4365,4295,363,6576,1555,0
20:30:33,14173.65,Fox,8662,167,62,50,41,12,1,1,8662,8600,8550,6470,1715,1596,66,101,4366,4296,363,6577,1555,0
20:30:33,14174.06,Fox,8664,168,62,50,40,14,1,1,8664,8602,8552,6472,1715,1596,65,103,4366,4298,363,6578,1555,0
20:30:33,14174.24,Fox,8664,168,62,48,42,14,1,1,8664,8602,8554,6472,1715,1596,65,103,4366,4298,363,6578,1555,0
20:30:33,14174.77,Fox,8664,168,60,50,42,14,1,1,8664,8604,8554,6472,1715,1596,65,103,4366,4298,363,6578,1555,0
20:30:33,14175.13,Fox,8664,168,58,52,42,14,1,1,8664,8606,8554,6472,1715,1596,65,103,4366,4298,363,6578,1555,0
20:30:34,14175.48,Fox,8664,168,58,50,44,14,1,1,8664,8606,8556,6472,1715,1596,65,103,4366,4298,363,6578,1555,0
20:30:34,14176.02,Fox,8664,167,58,50,44,14,1,0,8664,8606,8556,6472,1715,1596,65,102,4366,4298,363,6578,1556,0
20:30:34,14176.96,Fox,8664,165,58,50,44,12,1,0,8664,8606,8556,6472,1715,1596,65,100,4366,4298,363,6580,1556,0
20:30:34,14177.48,Fox,8666,166,60,50,43,12,1,0,8666,8606,8556,6472,1715,1596,64,102,4366,4300,363,6581,1556,0
20:30:34,14177.79,Fox,8666,166,58,48,46,13,1,0,8666,8608,8560,6473,1715,1596,64,102,4366,4300,363,6581,1556,0
20:30:35,14178.46,Fox,8666,166,58,46,48,13,1,0,8666,8608,8562,6473,1715,1596,64,102,4366,4300,363,6581,1556,0
20:30:35,14179.02,Fox,8668,167,60,46,47,13,1,0,8668,8608,8562,6473,1715,1596,65,102,4368,4300,363,6582,1556,0
20:30:35,14180.06,Fox,8668,166,60,46,45,14,1,0,8668,8608,8562,6475,1715,1596,65,101,4368,4300,363,6583,1556,0
20:30:36,14181.85,Fox,8668,166,60,46,44,15,1,0,8668,8608,8562,6476,1715,1596,65,101,4368,4300,363,6583,1556,0
20:30:36,14182.58,Fox,8668,164,60,46,44,13,1,0,8668,8608,8562,6476,1715,1596,63,101,4368,4300,363,6585,1556,0
20:30:36,14183.07,Fox,8670,165,62,46,43,13,1,0,8670,8608,8562,6476,1715,1596,63,102,4369,4301,363,6586,1556,0
20:30:36,14183.49,Fox,8670,165,62,42,47,13,1,0,8670,8608,8566,6476,1715,1596,63,102,4369,4301,363,6586,1556,0
20:30:37,14184.42,Fox,8670,163,62,42,47,11,1,0,8670,8608,8566,6476,1715,1596,63,100,4369,4301,363,6588,1556,0
20:30:37,14184.97,Fox,8670,163,60,42,47,13,1,0,8670,8610,8568,6478,1715,1596,63,100,4369,4301,363,6588,1556,0
20:30:37,14185.29,Fox,8670,163,58,44,43,17,1,0,8670,8612,8568,6482,1715,1596,63,100,4369,4301,363,6588,1556,0
20:30:37,14186.04,Fox,8670,163,56,46,41,19,1,0,8670,8614,8568,6484,1715,1596,63,100,4369,4301,363,6588,1556,0
20:30:37,14186.53,Fox,8670,163,54,46,41,21,1,0,8670,8616,8570,6486,1715,1596,63,100,4369,4301,363,6588,1556,0
20:30:37,14186.67,Fox,8670,163,54,46,40,22,1,0,8670,8616,8570,6487,1715,1596,63,100,4369,4301,363,6588,1556,0
20:30:38,14188.13,Fox,8670,162,52,48,40,21,1,0,8670,8618,8570,6487,1715,1596,63,99,4369,4301,363,6589,1556,0
20:30:38,14189.5,Fox,8670,162,50,44,46,21,1,0,8670,8620,8576,6487,1715,1596,63,99,4369,4301,363,6589,1556,0
20:30:38,14190.07,Fox,8672,163,52,44,45,21,1,0,8672,8620,8576,6488,1715,1596,63,100,4370,4302,363,6590,1556,0
20:30:39,14190.44,Fox,8672,161,52,44,45,19,1,0,8672,8620,8576,6488,1715,1596,61,100,4370,4302,363,6592,1556,0
20:30:39,14190.76,Fox,8672,161,52,44,44,20,1,0,8672,8620,8576,6489,1715,1596,61,100,4370,4302,363,6592,1556,0
20:30:39,14191.62,Fox,8672,161,52,42,46,20,1,0,8672,8620,8578,6489,1715,1596,61,100,4370,4302,363,6592,1556,0
20:30:39,14192.49,Fox,8672,160,52,40,48,19,1,0,8672,8620,8580,6489,1715,1596,61,99,4370,4302,363,6593,1556,0
20:30:39,14192.98,Fox,8672,160,50,42,45,22,1,0,8672,8622,8580,6492,1715,1596,61,99,4370,4302,363,6593,1556,0
20:30:40,14193.66,Fox,8674,161,52,42,44,22,1,0,8674,8622,8580,6492,1715,1596,60,101,4370,4304,363,6594,1556,0
20:30:40,14194.76,Fox,8674,161,50,44,44,22,1,0,8674,8624,8580,6492,1715,1596,60,101,4370,4304,363,6594,1556,0
20:30:40,14195.34,Fox,8674,159,50,44,44,20,1,0,8674,8624,8580,6492,1715,1596,60,99,4370,4304,363,6596,1556,0
20:30:40,14195.67,Fox,8674,155,50,44,43,17,1,0,8674,8624,8580,6493,1715,1596,58,97,4370,4304,363,6600,1556,0
20:30:41,14196.48,Fox,8674,153,50,44,43,15,1,0,8674,8624,8580,6493,1715,1596,58,95,4370,4304,363,6602,1556,0
20:30:41,14196.99,Fox,8674,151,50,44,42,14,1,0,8674,8624,8580,6494,1715,1596,57,94,4370,4304,363,6604,1556,0
20:30:41,14197.48,Fox,8674,150,48,46,40,15,1,0,8674,8626,8580,6496,1715,1596,57,93,4370,4304,363,6605,1556,0
20:30:41,14198.49,Fox,8674,150,48,44,42,15,1,0,8674,8626,8582,6496,1715,1596,57,93,4370,4304,363,6605,1556,0
20:30:42,14199.36,Fox,8674,150,46,46,42,15,1,0,8674,8628,8582,6496,1715,1596,57,93,4370,4304,363,6605,1556,0
20:30:42,14200.47,Fox,8674,150,46,44,44,15,1,0,8674,8628,8584,6496,1715,1596,57,93,4370,4304,363,6605,1556,0
20:30:42,14200.92,Fox,8674,150,46,44,43,16,1,0,8674,8628,8584,6497,1715,1596,57,93,4370,4304,363,6605,1556,0
20:30:42,14201.23,Fox,8674,149,46,44,43,15,1,0,8674,8628,8584,6497,1715,1596,56,93,4370,4304,363,6606,1556,0
20:30:42,14201.57,Fox,8674,149,44,46,43,15,1,0,8674,8630,8584,6497,1715,1596,56,93,4370,4304,363,6606,1556,0
20:30:43,14202.71,Fox,8674,149,44,44,45,15,1,0,8674,8630,8586,6497,1715,1596,56,93,4370,4304,363,6606,1556,0
20:30:43,14203.27,Fox,8674,148,44,44,45,14,1,0,8674,8630,8586,6497,1715,1596,56,92,4370,4304,363,6607,1556,0
20:30:43,14203.56,Fox,8674,146,44,44,45,12,1,0,8674,8630,8586,6497,1715,1596,56,90,4370,4304,363,6609,1556,0
20:30:43,14203.91,Fox,8674,146,44,42,47,12,1,0,8674,8630,8588,6497,1715,1596,56,90,4370,4304,363,6609,1556,0
20:30:43,14204.52,Fox,8674,146,44,40,49,12,1,0,8674,8630,8590,6497,1715,1596,56,90,4370,4304,363,6609,1556,0
20:30:44,14205.99,Fox,8676,147,46,40,48,12,1,0,8676,8630,8590,6497,1715,1596,56,91,4371,4305,363,6610,1556,0
20:30:44,14206.28,Fox,8676,146,46,40,48,11,1,0,8676,8630,8590,6497,1715,1596,56,90,4371,4305,363,6611,1556,0
20:30:44,14206.96,Fox,8678,147,48,40,45,13,1,0,8678,8630,8590,6499,1715,1596,55,92,4371,4307,363,6612,1556,0
20:30:44,14207.41,Fox,8678,146,48,40,45,12,1,0,8678,8630,8590,6499,1715,1596,55,91,4371,4307,363,6613,1556,0
20:30:44,14207.92,Fox,8678,144,48,40,45,10,1,0,8678,8630,8590,6499,1715,1596,54,90,4371,4307,363,6615,1556,0
20:30:44,14208.24,Fox,8678,144,48,38,47,10,1,0,8678,8630,8592,6499,1715,1596,54,90,4371,4307,363,6615,1556,0
20:30:45,14209.17,Fox,8680,145,46,40,46,10,1,0,8678,8632,8592,6499,1715,1596,54,91,4372,4308,363,6616,1556,0
20:30:45,14209.49,Fox,8682,146,48,38,47,10,1,0,8680,8632,8594,6499,1715,1596,54,92,4373,4309,363,6617,1556,0
20:30:45,14209.72,Fox,8682,146,50,38,47,10,1,0,8682,8632,8594,6499,1715,1596,54,92,4373,4309,363,6617,1556,0
20:30:45,14210.59,Fox,8682,146,48,40,45,12,1,0,8682,8634,8594,6501,1715,1596,54,92,4373,4309,363,6617,1556,0
20:30:45,14211,Fox,8682,146,48,36,49,12,1,0,8682,8634,8598,6501,1715,1596,54,92,4373,4309,363,6617,1556,0
20:30:46,14211.59,Fox,8682,145,48,34,51,11,1,0,8682,8634,8600,6501,1715,1596,54,91,4373,4309,363,6618,1556,0
20:30:46,14212.46,Fox,8684,146,48,32,52,11,1,0,8682,8634,8602,6501,1715,1596,53,93,4373,4311,363,6619,1556,0
20:30:46,14212.64,Fox,8684,146,48,34,52,11,1,0,8684,8636,8602,6501,1715,1596,53,93,4373,4311,363,6619,1556,0
20:30:46,14213.16,Fox,8684,146,46,34,54,11,1,0,8684,8638,8604,6501,1715,1596,53,93,4373,4311,363,6619,1556,0
20:30:46,14213.78,Fox,8688,148,44,34,54,11,1,0,8684,8640,8606,6501,1715,1596,55,93,4377,4311,363,6621,1556,0
20:30:46,14213.94,Fox,8688,148,48,34,54,11,1,0,8688,8640,8606,6501,1715,1596,55,93,4377,4311,363,6621,1556,0
20:30:47,14216.39,Fox,8688,148,48,32,56,11,1,0,8688,8640,8608,6501,1715,1596,55,93,4377,4311,363,6621,1556,0
20:30:47,14216.7,Fox,8688,148,46,34,56,11,1,0,8688,8642,8608,6501,1715,1596,55,93,4377,4311,363,6621,1556,0
20:30:48,14217.54,Fox,8688,146,44,36,55,10,1,0,8688,8644,8608,6502,1715,1596,53,93,4377,4311,363,6623,1556,0
20:30:49,14220.71,Fox,8690,147,46,36,54,10,1,0,8690,8644,8608,6502,1715,1596,53,94,4378,4312,363,6624,1556,0
20:30:49,14221.02,Fox,8690,145,44,38,54,8,1,0,8690,8646,8608,6502,1715,1596,53,92,4378,4312,363,6626,1556,0
20:30:49,14221.65,Fox,8690,145,44,38,52,10,1,0,8690,8646,8608,6504,1715,1596,53,92,4378,4312,363,6626,1556,0
20:30:49,14222.64,Fox,8692,146,46,38,51,10,1,0,8692,8646,8608,6504,1715,1596,52,94,4378,4314,363,6627,1556,0
20:30:50,14223.39,Fox,8694,147,46,36,52,10,1,0,8692,8646,8610,6504,1715,1596,51,96,4378,4316,363,6628,1556,0
20:30:50,14223.72,Fox,8694,147,48,34,54,10,1,0,8694,8646,8612,6504,1715,1596,51,96,4378,4316,363,6628,1556,0
20:30:50,14224.69,Fox,8694,147,48,30,58,10,1,0,8694,8646,8616,6504,1715,1596,51,96,4378,4316,363,6628,1556,0
20:30:51,14226.32,Fox,8696,148,50,30,57,10,1,0,8696,8646,8616,6504,1715,1596,51,97,4379,4317,363,6629,1556,0
20:30:51,14226.69,Fox,8696,148,50,28,59,10,1,0,8696,8646,8618,6504,1715,1596,51,97,4379,4317,363,6629,1556,0
20:30:51,14227.83,Fox,8696,147,50,28,58,10,1,0,8696,8646,8618,6505,1715,1596,51,96,4379,4317,363,6630,1556,0
20:30:51,14227.97,Fox,8696,147,48,28,60,10,1,0,8696,8648,8620,6505,1715,1596,51,96,4379,4317,363,6630,1556,0
20:30:51,14228.45,Fox,8696,147,48,28,59,11,1,0,8696,8648,8620,6506,1715,1596,51,96,4379,4317,363,6630,1556,0
20:30:52,14229.35,Fox,8696,147,48,28,58,12,1,0,8696,8648,8620,6507,1715,1596,51,96,4379,4317,363,6630,1556,0
20:30:52,14229.99,Fox,8698,148,50,28,58,11,1,0,8698,8648,8620,6507,1715,1596,50,98,4379,4319,363,6631,1556,0
20:30:52,14230.61,Fox,8698,148,50,28,56,13,1,0,8698,8648,8620,6509,1715,1596,50,98,4379,4319,363,6631,1556,0
20:30:52,14231.17,Fox,8698,148,50,26,58,13,1,0,8698,8648,8622,6509,1715,1596,50,98,4379,4319,363,6631,1556,0
20:30:52,14231.46,Fox,8698,148,50,26,57,14,1,0,8698,8648,8622,6510,1715,1596,50,98,4379,4319,363,6631,1556,0
20:30:53,14232.3,Fox,8698,146,50,26,57,12,1,0,8698,8648,8622,6510,1715,1596,48,98,4379,4319,363,6633,1556,0
20:30:53,14233.19,Fox,8698,146,50,24,59,12,1,0,8698,8648,8624,6510,1715,1596,48,98,4379,4319,363,6633,1556,0
20:30:53,14234.27,Fox,8698,146,50,24,58,13,1,0,8698,8648,8624,6511,1715,1596,48,98,4379,4319,363,6633,1556,0
20:30:53,14234.69,Fox,8698,146,50,24,56,15,1,0,8698,8648,8624,6513,1715,1596,48,98,4379,4319,363,6633,1556,0
20:30:54,14236.04,Fox,8698,146,50,22,56,17,1,0,8698,8648,8626,6515,1715,1596,48,98,4379,4319,363,6633,1556,0
20:30:55,14237.89,Fox,8698,146,50,20,58,17,1,0,8698,8648,8628,6515,1715,1596,48,98,4379,4319,363,6633,1556,0
20:30:55,14238.27,Fox,8698,145,50,20,55,19,1,0,8698,8648,8628,6518,1715,1596,48,97,4379,4319,363,6634,1556,0
20:30:55,14239.09,Fox,8700,146,50,20,53,20,1,0,8698,8648,8628,6519,1715,1596,47,99,4379,4321,363,6635,1556,0
20:30:55,14239.25,Fox,8700,146,52,20,53,20,1,0,8700,8648,8628,6519,1715,1596,47,99,4379,4321,363,6635,1556,0
20:30:55,14240,Fox,8700,145,52,18,55,19,1,0,8700,8648,8630,6519,1715,1596,47,98,4379,4321,363,6636,1556,0
20:30:56,14241.14,Fox,8700,143,52,18,55,17,1,0,8700,8648,8630,6519,1715,1596,46,97,4379,4321,363,6638,1556,0
20:30:56,14242.07,Fox,8700,142,50,20,55,16,1,0,8700,8650,8630,6519,1715,1596,45,97,4379,4321,363,6639,1556,0
20:30:56,14242.67,Fox,8702,143,52,20,54,16,1,0,8702,8650,8630,6519,1715,1596,45,98,4380,4322,363,6640,1556,0
20:30:56,14243.67,Fox,8702,143,52,20,53,17,1,0,8702,8650,8630,6520,1715,1596,45,98,4380,4322,363,6640,1556,0
20:30:57,14243.97,Fox,8702,143,52,20,51,19,1,0,8702,8650,8630,6522,1715,1596,45,98,4380,4322,363,6640,1556,0
20:30:57,14244.8,Fox,8702,142,52,20,51,18,1,0,8702,8650,8630,6522,1715,1596,45,97,4380,4322,363,6641,1556,0
20:30:57,14245.48,Fox,8702,140,52,20,50,17,1,0,8702,8650,8630,6523,1715,1596,45,95,4380,4322,363,6643,1556,0
20:30:57,14246.11,Fox,8702,140,50,22,50,17,1,0,8702,8652,8630,6523,1715,1596,45,95,4380,4322,363,6643,1556,0
20:30:57,14246.48,Fox,8702,138,50,22,50,15,1,0,8702,8652,8630,6523,1715,1596,45,93,4380,4322,363,6645,1556,0
20:30:58,14247.07,Fox,8702,138,46,26,49,16,1,0,8702,8656,8630,6524,1715,1596,45,93,4380,4322,363,6645,1556,0
20:30:58,14247.45,Fox,8702,138,46,24,51,16,1,0,8702,8656,8632,6524,1715,1596,45,93,4380,4322,363,6645,1556,0
20:30:58,14248.75,Fox,8702,135,46,24,51,13,1,0,8702,8656,8632,6524,1715,1596,45,90,4380,4322,363,6648,1556,0
20:30:58,14249.01,Fox,8702,135,46,22,53,13,1,0,8702,8656,8634,6524,1715,1596,45,90,4380,4322,363,6648,1556,0
20:30:58,14249.45,Fox,8702,134,46,22,53,12,1,0,8702,8656,8634,6524,1715,1596,45,89,4380,4322,363,6649,1556,0
20:30:59,14249.91,Fox,8702,134,46,22,48,17,1,0,8702,8656,8634,6529,1715,1596,45,89,4380,4322,363,6649,1556,0
20:30:59,14250.74,Fox,8702,134,44,24,48,17,1,0,8702,8658,8634,6529,1715,1596,45,89,4380,4322,363,6649,1556,0
20:30:59,14251.34,Fox,8702,134,44,20,52,17,1,0,8702,8658,8638,6529,1715,1596,45,89,4380,4322,363,6649,1556,0
20:30:59,14252.32,Fox,8702,134,42,20,52,19,1,0,8702,8660,8640,6531,1715,1596,45,89,4380,4322,363,6649,1556,0
20:31:00,14253.04,Fox,8702,134,42,20,50,21,1,0,8702,8660,8640,6533,1715,1596,45,89,4380,4322,363,6649,1556,0
20:31:00,14254.24,Fox,8702,133,42,20,50,20,1,0,8702,8660,8640,6533,1715,1596,45,88,4380,4322,363,6650,1556,0
20:31:00,14254.57,Fox,8702,131,42,20,50,18,1,0,8702,8660,8640,6533,1715,1596,44,87,4380,4322,363,6652,1556,0
20:31:00,14255.08,Fox,8704,132,44,20,49,18,1,0,8704,8660,8640,6533,1715,1596,43,89,4380,4324,363,6653,1556,0
20:31:00,14255.28,Fox,8704,132,44,18,51,18,1,0,8704,8660,8642,6533,1715,1596,43,89,4380,4324,363,6653,1556,0
20:31:01,14256.11,Fox,8704,131,42,18,53,17,1,0,8704,8662,8644,6533,1715,1596,43,88,4380,4324,363,6654,1556,0
20:31:01,14256.49,Fox,8704,131,40,20,53,17,1,0,8704,8664,8644,6533,1715,1596,43,88,4380,4324,363,6654,1556,0
20:31:01,14257.55,Fox,8706,132,42,20,52,17,1,0,8706,8664,8644,6533,1715,1596,44,88,4382,4324,363,6655,1556,0
20:31:01,14257.71,Fox,8706,131,42,20,52,16,1,0,8706,8664,8644,6533,1715,1596,44,87,4382,4324,363,6656,1556,0
20:31:02,14258.95,Fox,8708,132,44,20,49,18,1,0,8708,8664,8644,6535,1715,1596,44,88,4383,4325,363,6657,1556,0
20:31:02,14259.22,Fox,8708,132,44,18,51,18,1,0,8708,8664,8646,6535,1715,1596,44,88,4383,4325,363,6657,1556,0
20:31:02,14259.93,Fox,8708,132,42,20,51,18,1,0,8708,8666,8646,6535,1715,1596,44,88,4383,4325,363,6657,1556,0
20:31:02,14260.5,Fox,8708,127,42,20,51,13,1,0,8708,8666,8646,6535,1715,1596,43,84,4383,4325,363,6662,1556,0
20:31:02,14261.14,Fox,8708,127,42,20,50,14,1,0,8708,8666,8646,6536,1715,1596,43,84,4383,4325,363,6662,1556,0
20:31:02,14261.5,Fox,8708,127,40,22,50,14,1,0,8708,8668,8646,6536,1715,1596,43,84,4383,4325,363,6662,1556,0
20:31:03,14262.68,Fox,8708,125,40,22,50,12,1,0,8708,8668,8646,6536,1715,1596,43,82,4383,4325,363,6664,1556,0
20:31:03,14263.18,Fox,8708,125,40,22,49,13,1,0,8708,8668,8646,6537,1715,1596,43,82,4383,4325,363,6664,1556,0
20:31:03,14263.47,Fox,8708,123,40,22,49,11,1,0,8708,8668,8646,6537,1715,1596,42,81,4383,4325,363,6666,1556,0
20:31:03,14264.46,Fox,8708,123,40,22,48,12,1,0,8708,8668,8646,6538,1715,1596,42,81,4383,4325,363,6666,1556,0
20:31:04,14265.03,Fox,8708,123,40,22,47,13,1,0,8708,8668,8646,6539,1715,1596,42,81,4383,4325,363,6666,1556,0
20:31:04,14265.5,Fox,8708,123,38,24,47,13,1,0,8708,8670,8646,6539,1715,1596,42,81,4383,4325,363,6666,1556,0
20:31:04,14266.4,Fox,8708,123,38,22,49,13,1,0,8708,8670,8648,6539,1715,1596,42,81,4383,4325,363,6666,1556,0
20:31:04,14266.8,Fox,8710,124,40,22,48,13,1,0,8710,8670,8648,6539,1715,1596,43,81,4385,4325,363,6667,1556,0
20:31:05,14268.55,Fox,8710,124,40,22,46,15,1,0,8710,8670,8648,6541,1715,1596,43,81,4385,4325,363,6667,1556,0
20:31:05,14269.43,Fox,8710,122,40,22,46,13,1,0,8710,8670,8648,6541,1715,1596,43,79,4385,4325,363,6669,1556,0
20:31:05,14269.94,Fox,8710,122,40,22,44,15,1,0,8710,8670,8648,6543,1715,1596,43,79,4385,4325,363,6669,1556,0
20:31:06,14271.54,Fox,8710,121,40,22,40,18,1,0,8710,8670,8648,6547,1715,1596,43,78,4385,4325,363,6670,1556,0
20:31:06,14272.12,Fox,8710,121,40,22,38,20,1,0,8710,8670,8648,6549,1715,1596,43,78,4385,4325,363,6670,1556,0
20:31:06,14272.74,Fox,8710,121,38,24,36,22,1,0,8710,8672,8648,6551,1715,1596,43,78,4385,4325,363,6670,1556,0
20:31:06,14273.76,Fox,8712,121,40,24,33,23,1,0,8712,8672,8648,6553,1715,1596,42,79,4385,4327,363,6672,1556,0
20:31:07,14274,Fox,8712,121,40,24,31,25,1,0,8712,8672,8648,6555,1715,1596,42,79,4385,4327,363,6672,1556,0
20:31:07,14275,Fox,8712,120,40,24,31,24,1,0,8712,8672,8648,6555,1715,1596,42,78,4385,4327,363,6673,1556,0
20:31:07,14275.58,Fox,8712,119,40,24,31,23,1,0,8712,8672,8648,6555,1715,1596,42,77,4385,4327,363,6674,1556,0
20:31:07,14276.34,Fox,8714,120,38,26,30,23,1,0,8712,8674,8648,6555,1715,1596,42,78,4386,4328,363,6675,1556,0
20:31:07,14276.46,Fox,8714,120,40,26,30,23,1,0,8714,8674,8648,6555,1715,1596,42,78,4386,4328,363,6675,1556,0
20:31:08,14276.87,Fox,8714,120,40,26,28,25,1,0,8714,8674,8648,6557,1715,1596,42,78,4386,4328,363,6675,1556,0
20:31:08,14277.61,Fox,8716,121,42,26,27,25,1,0,8716,8674,8648,6557,1715,1596,43,78,4388,4328,363,6676,1556,0
20:31:08,14279.18,Fox,8716,119,42,26,27,23,1,0,8716,8674,8648,6557,1715,1596,42,77,4388,4328,363,6678,1556,0
20:31:09,14280.54,Fox,8716,117,42,24,29,21,1,0,8716,8674,8650,6557,1715,1596,42,75,4388,4328,363,6680,1556,0
20:31:09,14282.09,Fox,8716,113,42,24,29,17,1,0,8716,8674,8650,6557,1715,1596,40,73,4388,4328,363,6684,1556,0
20:31:10,14282.59,Fox,8716,111,42,24,29,15,1,0,8716,8674,8650,6557,1715,1596,40,71,4388,4328,363,6686,1556,0
20:31:10,14283.3,Fox,8716,109,42,24,29,13,1,0,8716,8674,8650,6557,1715,1596,39,70,4388,4328,363,6688,1556,0
20:31:10,14283.73,Fox,8716,109,42,24,28,14,1,0,8716,8674,8650,6558,1715,1596,39,70,4388,4328,363,6688,1556,0
20:31:10,14284.24,Fox,8718,108,44,24,25,14,1,0,8718,8674,8650,6560,1715,1596,38,70,4389,4329,363,6691,1556,0
20:31:10,14284.61,Fox,8718,106,44,22,27,12,1,0,8718,8674,8652,6560,1715,1596,37,69,4389,4329,363,6693,1556,0
20:31:10,14285.24,Fox,8718,106,44,22,23,16,1,0,8718,8674,8652,6564,1715,1596,37,69,4389,4329,363,6693,1556,0
20:31:11,14285.7,Fox,8718,106,44,18,27,16,1,0,8718,8674,8656,6564,1715,1596,37,69,4389,4329,363,6693,1556,0
20:31:11,14287.12,Fox,8718,106,44,18,25,18,1,0,8718,8674,8656,6566,1715,1596,37,69,4389,4329,363,6693,1556,0
20:31:11,14287.35,Fox,8718,104,44,18,25,16,1,0,8718,8674,8656,6566,1715,1596,37,67,4389,4329,363,6695,1556,0
20:31:12,14288.47,Fox,8718,104,42,20,24,17,1,0,8718,8676,8656,6567,1715,1596,37,67,4389,4329,363,6695,1556,0
20:31:12,14289.23,Fox,8718,104,42,18,26,17,1,0,8718,8676,8658,6567,1715,1596,37,67,4389,4329,363,6695,1556,0
20:31:12,14289.49,Fox,8718,104,40,20,26,17,1,0,8718,8678,8658,6567,1715,1596,37,67,4389,4329,363,6695,1556,0
20:31:12,14290.14,Fox,8720,105,42,20,26,16,1,0,8720,8678,8658,6567,1715,1596,37,68,4390,4330,363,6696,1556,0
20:31:12,14290.6,Fox,8720,105,42,18,28,16,1,0,8720,8678,8660,6567,1715,1596,37,68,4390,4330,363,6696,1556,0
20:31:13,14291.64,Fox,8720,105,42,18,26,18,1,0,8720,8678,8660,6569,1715,1596,37,68,4390,4330,363,6696,1556,0
20:31:13,14291.88,Fox,8720,105,40,20,26,18,1,0,8720,8680,8660,6569,1715,1596,37,68,4390,4330,363,6696,1556,0
20:31:13,14292.24,Fox,8720,105,38,22,26,18,1,0,8720,8682,8660,6569,1715,1596,37,68,4390,4330,363,6696,1556,0
20:31:13,14292.7,Fox,8722,106,40,22,25,18,1,0,8722,8682,8660,6569,1715,1596,38,68,4392,4330,363,6697,1556,0
20:31:13,14293.07,Fox,8724,107,42,22,24,18,1,0,8724,8682,8660,6569,1715,1596,37,70,4392,4332,363,6698,1556,0
20:31:13,14293.34,Fox,8726,108,44,22,23,18,1,0,8726,8682,8660,6569,1715,1596,37,71,4393,4333,363,6699,1556,0
20:31:13,14293.75,Fox,8726,108,44,22,21,20,1,0,8726,8682,8660,6571,1715,1596,37,71,4393,4333,363,6699,1556,0
20:31:13,14294.29,Fox,8726,107,44,22,21,19,1,0,8726,8682,8660,6571,1715,1596,37,70,4393,4333,363,6700,1556,0
20:31:14,14294.75,Fox,8726,105,44,20,23,17,1,0,8726,8682,8662,6571,1715,1596,37,68,4393,4333,363,6702,1556,0
20:31:14,14295.13,Fox,8726,105,42,20,25,17,1,0,8726,8684,8664,6571,1715,1596,37,68,4393,4333,363,6702,1556,0
20:31:14,14295.59,Fox,8726,103,42,20,25,15,1,0,8726,8684,8664,6571,1715,1596,37,66,4393,4333,363,6704,1556,0
20:31:14,14295.88,Fox,8726,102,42,20,25,14,1,0,8726,8684,8664,6571,1715,1596,37,65,4393,4333,363,6705,1556,0
20:31:14,14296.48,Fox,8726,102,38,24,24,15,1,0,8726,8688,8664,6572,1715,1596,37,65,4393,4333,363,6705,1556,0
20:31:15,14297.66,Fox,8726,100,38,24,24,13,1,0,8726,8688,8664,6572,1715,1596,37,63,4393,4333,363,6707,1556,0
20:31:15,14298.42,Fox,8726,100,38,22,26,13,1,0,8726,8688,8666,6572,1715,1596,37,63,4393,4333,363,6707,1556,0
20:31:15,14298.96,Fox,8726,99,38,22,26,12,1,0,8726,8688,8666,6572,1715,1596,36,63,4393,4333,363,6708,1556,0
20:31:15,14299.99,Fox,8726,99,38,20,28,12,1,0,8726,8688,8668,6572,1715,1596,36,63,4393,4333,363,6708,1556,0
20:31:15,14300.38,Fox,8726,99,38,20,27,13,1,0,8726,8688,8668,6573,1715,1596,36,63,4393,4333,363,6708,1556,0
20:31:16,14302.3,Fox,8726,97,38,20,27,11,1,0,8726,8688,8668,6573,1715,1596,35,62,4393,4333,363,6710,1556,0
20:31:16,14303.23,Fox,8726,97,36,22,27,11,1,0,8726,8690,8668,6573,1715,1596,35,62,4393,4333,363,6710,1556,0
20:31:17,14304.02,Fox,8726,97,36,20,29,11,1,0,8726,8690,8670,6573,1715,1596,35,62,4393,4333,363,6710,1556,0
20:31:17,14304.24,Fox,8726,95,36,20,29,9,1,0,8726,8690,8670,6573,1715,1596,35,60,4393,4333,363,6712,1556,0
20:31:17,14305.17,Fox,8726,95,34,22,29,9,1,0,8726,8692,8670,6573,1715,1596,35,60,4393,4333,363,6712,1556,0
20:31:17,14306,Fox,8726,95,32,24,29,9,1,0,8726,8694,8670,6573,1715,1596,35,60,4393,4333,363,6712,1556,0
20:31:18,14306.97,Fox,8726,94,32,24,29,8,1,0,8726,8694,8670,6573,1715,1596,35,59,4393,4333,363,6713,1556,0
20:31:18,14307.87,Fox,8726,94,32,24,27,10,1,0,8726,8694,8670,6575,1715,1596,35,59,4393,4333,363,6713,1556,0
20:31:18,14308.66,Fox,8726,94,30,26,27,10,1,0,8726,8696,8670,6575,1715,1596,35,59,4393,4333,363,6713,1556,0
20:31:19,14309.41,Fox,8726,94,30,26,26,11,1,0,8726,8696,8670,6576,1715,1596,35,59,4393,4333,363,6713,1556,0
20:31:19,14309.93,Fox,8728,95,32,26,26,10,1,0,8728,8696,8670,6576,1715,1596,36,59,4395,4333,363,6714,1556,0
20:31:19,14311.06,Fox,8728,95,32,24,28,10,1,0,8728,8696,8672,6576,1715,1596,36,59,4395,4333,363,6714,1556,0
20:31:19,14311.53,Fox,8728,95,32,24,27,11,1,0,8728,8696,8672,6577,1715,1596,36,59,4395,4333,363,6714,1556,0
20:31:19,14311.84,Fox,8728,95,32,24,25,13,1,0,8728,8696,8672,6579,1715,1596,36,59,4395,4333,363,6714,1556,0
20:31:19,14312.35,Fox,8728,95,30,26,25,13,1,0,8728,8698,8672,6579,1715,1596,36,59,4395,4333,363,6714,1556,0
20:31:20,14312.73,Fox,8728,95,30,26,23,15,1,0,8728,8698,8672,6581,1715,1596,36,59,4395,4333,363,6714,1556,0
20:31:20,14314.62,Fox,8728,95,30,24,25,15,1,0,8728,8698,8674,6581,1715,1596,36,59,4395,4333,363,6714,1556,0
20:31:21,14315.68,Fox,8728,95,30,24,24,16,1,0,8728,8698,8674,6582,1715,1596,36,59,4395,4333,363,6714,1556,0
20:31:21,14316.48,Fox,8728,95,30,24,22,18,1,0,8728,8698,8674,6584,1715,1596,36,59,4395,4333,363,6714,1556,0
20:31:22,14318.5,Fox,8728,93,30,24,22,16,1,0,8728,8698,8674,6584,1715,1596,36,57,4395,4333,363,6716,1556,0
20:31:22,14319.69,Fox,8728,93,30,24,20,18,1,0,8728,8698,8674,6586,1715,1596,36,57,4395,4333,363,6716,1556,0
20:31:22,14320.03,Fox,8728,92,30,24,20,17,1,0,8728,8698,8674,6586,1715,1596,36,56,4395,4333,363,6717,1556,0
20:31:23,14321.68,Fox,8730,93,32,24,19,17,1,0,8730,8698,8674,6586,1715,1596,36,57,4396,4334,363,6718,1556,0
20:31:23,14321.78,Fox,8730,93,30,26,19,17,1,0,8730,8700,8674,6586,1715,1596,36,57,4396,4334,363,6718,1556,0
20:31:23,14322.42,Fox,8730,90,30,26,19,14,1,0,8730,8700,8674,6586,1715,1596,36,54,4396,4334,363,6721,1556,0
20:31:23,14323.36,Fox,8730,88,30,26,19,12,1,0,8730,8700,8674,6586,1715,1596,36,52,4396,4334,363,6723,1556,0
20:31:24,14325.13,Fox,8730,88,28,28,19,12,1,0,8730,8702,8674,6586,1715,1596,36,52,4396,4334,363,6723,1556,0
20:31:24,14326.29,Fox,8732,88,30,28,18,11,1,0,8732,8702,8674,6586,1715,1596,35,53,4396,4336,363,6725,1556,0
20:31:24,14327.05,Fox,8732,86,30,26,18,11,1,0,8732,8702,8676,6588,1715,1596,35,51,4396,4336,363,6727,1556,0
20:31:25,14327.94,Fox,8732,86,30,24,20,11,1,0,8732,8702,8678,6588,1715,1596,35,51,4396,4336,363,6727,1556,0
20:31:25,14330.35,Fox,8732,84,30,22,22,9,1,0,8732,8702,8680,6588,1715,1596,35,49,4396,4336,363,6729,1556,0
20:31:26,14330.72,Fox,8732,84,30,20,24,9,1,0,8732,8702,8682,6588,1715,1596,35,49,4396,4336,363,6729,1556,0
20:31:27,14333.62,Fox,8732,84,30,18,26,9,1,0,8732,8702,8684,6588,1715,1596,35,49,4396,4336,363,6729,1556,0
20:31:27,14334.95,Fox,8732,84,30,14,30,9,1,0,8732,8702,8688,6588,1715,1596,35,49,4396,4336,363,6729,1556,0
20:31:27,14335.62,Fox,8734,85,32,14,29,9,1,0,8734,8702,8688,6588,1715,1596,34,51,4396,4338,363,6730,1556,0
20:31:28,14337.51,Fox,8734,83,30,16,29,7,1,0,8734,8704,8688,6588,1715,1596,34,49,4396,4338,363,6732,1556,0
20:31:28,14338.83,Fox,8736,84,32,16,28,7,1,0,8736,8704,8688,6588,1715,1596,35,49,4398,4338,363,6733,1556,0
20:31:29,14340.05,Fox,8736,84,30,18,28,7,1,0,8736,8706,8688,6588,1715,1596,35,49,4398,4338,363,6733,1556,0
20:31:29,14340.91,Fox,8736,84,30,18,26,9,1,0,8736,8706,8688,6590,1715,1596,35,49,4398,4338,363,6733,1556,0
20:31:29,14341.42,Fox,8736,84,28,20,26,9,1,0,8736,8708,8688,6590,1715,1596,35,49,4398,4338,363,6733,1556,0
20:31:29,14341.82,Fox,8738,85,28,18,27,9,1,0,8736,8708,8690,6590,1715,1596,35,50,4399,4339,363,6734,1556,0
20:31:30,14341.96,Fox,8738,85,30,18,27,9,1,0,8738,8708,8690,6590,1715,1596,35,50,4399,4339,363,6734,1556,0
20:31:30,14343.69,Fox,8738,85,30,16,29,9,1,0,8738,8708,8692,6590,1715,1596,35,50,4399,4339,363,6734,1556,0
20:31:30,14344.49,Fox,8738,85,30,14,31,9,1,0,8738,8708,8694,6590,1715,1596,35,50,4399,4339,363,6734,1556,0
20:31:31,14345.06,Fox,8738,85,30,14,29,11,1,0,8738,8708,8694,6592,1715,1596,35,50,4399,4339,363,6734,1556,0
20:31:31,14346.04,Fox,8738,85,30,14,27,13,1,0,8738,8708,8694,6594,1715,1596,35,50,4399,4339,363,6734,1556,0
20:31:31,14347.12,Fox,8738,85,30,12,29,13,1,0,8738,8708,8696,6594,1715,1596,35,50,4399,4339,363,6734,1556,0
20:31:32,14348.79,Fox,8740,86,32,12,28,13,1,0,8740,8708,8696,6594,1715,1596,35,51,4400,4340,363,6735,1556,0
20:31:32,14349.35,Fox,8740,86,30,14,28,13,1,0,8740,8710,8696,6594,1715,1596,35,51,4400,4340,363,6735,1556,0
20:31:32,14349.81,Fox,8740,86,30,14,27,14,1,0,8740,8710,8696,6595,1715,1596,35,51,4400,4340,363,6735,1556,0
20:31:33,14351.05,Fox,8740,86,30,12,27,16,1,0,8740,8710,8698,6597,1715,1596,35,51,4400,4340,363,6735,1556,0
20:31:33,14351.56,Fox,8740,84,30,12,27,14,1,0,8740,8710,8698,6597,1715,1596,34,50,4400,4340,363,6737,1556,0
20:31:34,14355.07,Fox,8740,84,30,12,25,16,1,0,8740,8710,8698,6599,1715,1596,34,50,4400,4340,363,6737,1556,0
20:31:34,14355.51,Fox,8740,84,30,12,23,18,1,0,8740,8710,8698,6601,1715,1596,34,50,4400,4340,363,6737,1556,0
20:31:34,14355.71,Fox,8740,82,30,12,23,16,1,0,8740,8710,8698,6601,1715,1596,34,48,4400,4340,363,6739,1556,0
20:31:34,14356.24,Fox,8740,82,28,14,23,16,1,0,8740,8712,8698,6601,1715,1596,34,48,4400,4340,363,6739,1556,0
20:31:34,14356.64,Fox,8740,80,28,14,23,14,1,0,8740,8712,8698,6601,1715,1596,33,47,4400,4340,363,6741,1556,0
20:31:35,14359.03,Fox,8740,80,26,16,21,16,1,0,8740,8714,8698,6603,1715,1596,33,47,4400,4340,363,6741,1556,0
20:31:36,14360.22,Fox,8740,80,24,16,23,16,1,0,8740,8716,8700,6603,1715,1596,33,47,4400,4340,363,6741,1556,0
20:31:36,14360.3,Fox,8740,79,24,16,23,15,1,0,8740,8716,8700,6603,1715,1596,33,46,4400,4340,363,6742,1556,0
20:31:36,14360.56,Fox,8740,79,24,16,22,16,1,0,8740,8716,8700,6604,1715,1596,33,46,4400,4340,363,6742,1556,0
20:31:36,14361.71,Fox,8740,77,24,16,22,14,1,0,8740,8716,8700,6604,1715,1596,32,45,4400,4340,363,6744,1556,0
20:31:37,14363.59,Fox,8740,77,24,14,24,14,1,0,8740,8716,8702,6604,1715,1596,32,45,4400,4340,363,6744,1556,0
20:31:37,14364.53,Fox,8740,77,24,14,23,15,1,0,8740,8716,8702,6605,1715,1596,32,45,4400,4340,363,6744,1556,0
20:31:38,14365.86,Fox,8742,76,24,14,23,12,1,0,8740,8716,8702,6605,1715,1596,30,46,4400,4342,363,6747,1556,0
20:31:38,14366.08,Fox,8742,74,26,14,23,10,1,0,8742,8716,8702,6605,1715,1596,30,44,4400,4342,363,6749,1556,0
20:31:38,14366.76,Fox,8742,74,24,16,23,10,1,0,8742,8718,8702,6605,1715,1596,30,44,4400,4342,363,6749,1556,0
20:31:38,14368.63,Fox,8744,75,26,16,22,10,1,0,8744,8718,8702,6605,1715,1596,30,45,4401,4343,363,6750,1556,0
20:31:39,14369.5,Fox,8744,73,26,16,22,8,1,0,8744,8718,8702,6605,1715,1596,30,43,4401,4343,363,6752,1556,0
20:31:39,14371.53,Fox,8744,73,26,16,21,9,1,0,8744,8718,8702,6606,1715,1596,30,43,4401,4343,363,6752,1556,0
20:31:40,14372.78,Fox,8746,74,24,18,20,9,1,0,8744,8720,8702,6606,1715,1596,30,44,4402,4344,363,6753,1556,0
20:31:40,14372.9,Fox,8746,74,26,18,20,9,1,0,8746,8720,8702,6606,1715,1596,30,44,4402,4344,363,6753,1556,0
20:31:40,14373.81,Fox,8748,75,28,18,19,9,1,0,8748,8720,8702,6606,1715,1596,30,45,4403,4345,363,6754,1556,0
20:31:41,14375.21,Fox,8748,74,26,20,17,10,1,0,8748,8722,8702,6608,1715,1596,30,44,4403,4345,363,6755,1556,0
20:31:41,14375.64,Fox,8748,74,24,22,17,10,1,0,8748,8724,8702,6608,1715,1596,30,44,4403,4345,363,6755,1556,0
20:31:41,14375.85,Fox,8748,74,22,24,17,10,1,0,8748,8726,8702,6608,1715,1596,30,44,4403,4345,363,6755,1556,0
20:31:41,14376.08,Fox,8748,74,22,22,19,10,1,0,8748,8726,8704,6608,1715,1596,30,44,4403,4345,363,6755,1556,0
20:31:42,14378.49,Fox,8748,74,22,20,21,10,1,0,8748,8726,8706,6608,1715,1596,30,44,4403,4345,363,6755,1556,0
20:31:42,14379.97,Fox,8748,74,22,18,23,10,1,0,8748,8726,8708,6608,1715,1596,30,44,4403,4345,363,6755,1556,0
20:31:43,14382.23,Fox,8750,74,24,18,22,9,1,0,8750,8726,8708,6608,1715,1596,30,44,4404,4346,363,6757,1556,0
20:31:44,14385.78,Fox,8750,72,24,18,22,7,1,0,8750,8726,8708,6608,1715,1596,30,42,4404,4346,363,6759,1556,0
20:31:45,14387.41,Fox,8750,72,24,18,21,8,1,0,8750,8726,8708,6609,1715,1596,30,42,4404,4346,363,6759,1556,0
20:31:45,14387.82,Fox,8750,72,24,16,23,8,1,0,8750,8726,8710,6609,1715,1596,30,42,4404,4346,363,6759,1556,0
20:31:45,14388.49,Fox,8752,73,24,16,20,10,1,0,8750,8726,8710,6611,1715,1596,30,43,4405,4347,363,6760,1556,0
20:31:45,14388.58,Fox,8752,73,26,16,20,10,1,0,8752,8726,8710,6611,1715,1596,30,43,4405,4347,363,6760,1556,0
20:31:46,14390.82,Fox,8752,73,26,16,19,11,1,0,8752,8726,8710,6612,1715,1596,30,43,4405,4347,363,6760,1556,0
20:31:46,14391.13,Fox,8752,73,26,16,17,13,1,0,8752,8726,8710,6614,1715,1596,30,43,4405,4347,363,6760,1556,0
20:31:46,14392.43,Fox,8752,73,24,18,17,13,1,0,8752,8728,8710,6614,1715,1596,30,43,4405,4347,363,6760,1556,0
20:31:47,14394.12,Fox,8752,73,24,18,15,15,1,0,8752,8728,8710,6616,1715,1596,30,43,4405,4347,363,6760,1556,0
20:31:47,14394.75,Fox,8752,73,24,16,17,15,1,0,8752,8728,8712,6616,1715,1596,30,43,4405,4347,363,6760,1556,0
20:31:47,14395.41,Fox,8752,73,24,16,15,17,1,0,8752,8728,8712,6618,1715,1596,30,43,4405,4347,363,6760,1556,0
20:31:48,14397.44,Fox,8752,73,24,14,17,17,1,0,8752,8728,8714,6618,1715,1596,30,43,4405,4347,363,6760,1556,0
20:31:48,14398.06,Fox,8752,72,24,14,17,16,1,0,8752,8728,8714,6618,1715,1596,30,42,4405,4347,363,6761,1556,0
20:31:48,14398.57,Fox,8752,72,24,12,19,16,1,0,8752,8728,8716,6618,1715,1596,30,42,4405,4347,363,6761,1556,0
20:31:49,14399,Fox,8752,70,24,12,19,14,1,0,8752,8728,8716,6618,1715,1596,30,40,4405,4347,363,6763,1556,0
20:31:49,14401.57,Fox,8752,69,24,12,19,13,1,0,8752,8728,8716,6618,1715,1596,30,39,4405,4347,363,6764,1556,0
20:31:49,14401.74,Fox,8752,67,24,12,19,11,1,0,8752,8728,8716,6618,1715,1596,29,38,4405,4347,363,6766,1556,0
20:31:50,14402.22,Fox,8756,69,28,12,17,11,1,0,8756,8728,8716,6618,1715,1596,29,40,4407,4349,363,6768,1556,0
20:31:50,14402.32,Fox,8756,69,28,12,16,12,1,0,8756,8728,8716,6619,1715,1596,29,40,4407,4349,363,6768,1556,0
20:31:50,14404.13,Fox,8758,70,30,12,14,13,1,0,8758,8728,8716,6621,1715,1596,28,42,4407,4351,363,6769,1556,0
20:31:50,14404.25,Fox,8758,70,28,14,14,13,1,0,8758,8730,8716,6621,1715,1596,28,42,4407,4351,363,6769,1556,0
20:31:51,14404.72,Fox,8758,68,28,14,14,11,1,0,8758,8730,8716,6621,1715,1596,28,40,4407,4351,363,6771,1556,0
20:31:51,14404.98,Fox,8758,68,28,14,12,13,1,0,8758,8730,8716,6623,1715,1596,28,40,4407,4351,363,6771,1556,0
20:31:51,14405.24,Fox,8758,68,28,12,14,13,1,0,8758,8730,8718,6623,1715,1596,28,40,4407,4351,363,6771,1556,0
20:31:51,14406,Fox,8758,67,28,12,14,12,1,0,8758,8730,8718,6623,1715,1596,27,40,4407,4351,363,6772,1556,0
20:31:52,14407.61,Fox,8758,67,28,12,13,13,1,0,8758,8730,8718,6624,1715,1596,27,40,4407,4351,363,6772,1556,0
20:31:52,14408.83,Fox,8758,67,26,14,13,13,1,0,8758,8732,8718,6624,1715,1596,27,40,4407,4351,363,6772,1556,0
20:31:53,14411.12,Fox,8758,67,26,12,15,13,1,0,8758,8732,8720,6624,1715,1596,27,40,4407,4351,363,6772,1556,0
20:31:53,14411.35,Fox,8758,67,26,12,13,15,1,0,8758,8732,8720,6626,1715,1596,27,40,4407,4351,363,6772,1556,0
20:31:53,14412.75,Fox,8758,66,26,12,13,14,1,0,8758,8732,8720,6626,1715,1596,27,39,4407,4351,363,6773,1556,0
20:31:54,14413.73,Fox,8758,66,26,10,15,14,1,0,8758,8732,8722,6626,1715,1596,27,39,4407,4351,363,6773,1556,0
20:31:54,14414.01,Fox,8758,66,26,8,17,14,1,0,8758,8732,8724,6626,1715,1596,27,39,4407,4351,363,6773,1556,0
20:31:54,14414.35,Fox,8758,66,26,6,19,14,1,0,8758,8732,8726,6626,1715,1596,27,39,4407,4351,363,6773,1556,0
20:31:54,14414.72,Fox,8758,64,26,6,19,12,1,0,8758,8732,8726,6626,1715,1596,27,37,4407,4351,363,6775,1556,0
20:31:54,14415.62,Fox,8758,62,26,6,19,10,1,0,8758,8732,8726,6626,1715,1596,27,35,4407,4351,363,6777,1556,0
20:31:55,14418.15,Fox,8760,63,26,8,18,10,1,0,8760,8734,8726,6626,1715,1596,27,36,4408,4352,363,6778,1556,0
20:31:55,14418.33,Fox,8762,63,28,8,17,9,1,0,8762,8734,8726,6626,1715,1596,27,36,4409,4353,363,6780,1556,0
20:31:56,14420.73,Fox,8762,63,28,8,15,11,1,0,8762,8734,8726,6628,1715,1596,27,36,4409,4353,363,6780,1556,0
20:31:56,14421.32,Fox,8762,63,26,10,15,11,1,0,8762,8736,8726,6628,1715,1596,27,36,4409,4353,363,6780,1556,0
20:31:56,14421.96,Fox,8762,61,26,10,15,9,1,0,8762,8736,8726,6628,1715,1596,27,34,4409,4353,363,6782,1556,0
20:31:57,14424.09,Fox,8762,61,26,10,14,10,1,0,8762,8736,8726,6629,1715,1596,27,34,4409,4353,363,6782,1556,0
20:31:57,14424.53,Fox,8762,61,24,12,14,10,1,0,8762,8738,8726,6629,1715,1596,27,34,4409,4353,363,6782,1556,0
20:31:59,14430.89,Fox,8762,61,24,10,16,10,1,0,8762,8738,8728,6629,1715,1596,27,34,4409,4353,363,6782,1556,0
20:31:59,14431.33,Fox,8762,59,22,12,16,8,1,0,8762,8740,8728,6629,1715,1596,27,32,4409,4353,363,6784,1556,0
20:32:01,14434.62,Fox,8764,60,24,12,15,8,1,0,8764,8740,8728,6629,1715,1596,26,34,4409,4355,363,6785,1556,0
20:32:01,14434.71,Fox,8764,59,24,12,15,7,1,0,8764,8740,8728,6629,1715,1596,26,33,4409,4355,363,6786,1556,0
20:32:01,14436.58,Fox,8764,59,24,12,13,9,1,0,8764,8740,8728,6631,1715,1596,26,33,4409,4355,363,6786,1556,0
20:32:02,14437.37,Fox,8766,60,26,12,12,9,1,0,8766,8740,8728,6631,1715,1596,26,34,4410,4356,363,6787,1556,0
20:32:02,14439.03,Fox,8766,60,26,12,11,10,1,0,8766,8740,8728,6632,1715,1596,26,34,4410,4356,363,6787,1556,0
20:32:03,14440.46,Fox,8766,60,26,12,10,11,1,0,8766,8740,8728,6633,1715,1596,26,34,4410,4356,363,6787,1556,0
20:32:03,14442.64,Fox,8766,60,26,10,12,11,1,0,8766,8740,8730,6633,1715,1596,26,34,4410,4356,363,6787,1556,0
20:32:05,14447.16,Fox,8766,58,26,10,12,9,1,0,8766,8740,8730,6633,1715,1596,26,32,4410,4356,363,6789,1556,0
20:32:05,14447.31,Fox,8766,58,26,8,14,9,1,0,8766,8740,8732,6633,1715,1596,26,32,4410,4356,363,6789,1556,0
20:32:05,14448.28,Fox,8766,58,26,8,12,11,1,0,8766,8740,8732,6635,1715,1596,26,32,4410,4356,363,6789,1556,0
20:32:05,14448.46,Fox,8766,58,24,10,12,11,1,0,8766,8742,8732,6635,1715,1596,26,32,4410,4356,363,6789,1556,0
20:32:05,14449.21,Fox,8770,60,26,10,10,11,1,0,8768,8742,8732,6635,1715,1596,25,35,4411,4359,363,6791,1556,0
20:32:05,14449.32,Fox,8770,60,28,10,10,11,1,0,8770,8742,8732,6635,1715,1596,25,35,4411,4359,363,6791,1556,0
20:32:06,14449.66,Fox,8770,59,28,10,10,10,1,0,8770,8742,8732,6635,1715,1596,24,35,4411,4359,363,6792,1556,0
20:32:06,14451,Fox,8770,58,28,10,10,9,1,0,8770,8742,8732,6635,1715,1596,24,34,4411,4359,363,6793,1556,0
20:32:06,14451.21,Fox,8770,58,26,12,10,9,1,0,8770,8744,8732,6635,1715,1596,24,34,4411,4359,363,6793,1556,0
20:32:07,14452.37,Fox,8772,59,28,12,9,9,1,0,8772,8744,8732,6635,1715,1596,24,35,4412,4360,363,6794,1556,0
20:32:07,14455.26,Fox,8772,59,28,12,7,11,1,0,8772,8744,8732,6637,1715,1596,24,35,4412,4360,363,6794,1556,0
20:32:08,14455.41,Fox,8772,59,26,14,7,11,1,0,8772,8746,8732,6637,1715,1596,24,35,4412,4360,363,6794,1556,0
20:32:08,14456.24,Fox,8772,59,24,16,7,11,1,0,8772,8748,8732,6637,1715,1596,24,35,4412,4360,363,6794,1556,0
20:32:08,14456.62,Fox,8772,59,24,14,9,11,1,0,8772,8748,8734,6637,1715,1596,24,35,4412,4360,363,6794,1556,0
20:32:08,14457.96,Fox,8772,59,24,14,8,12,1,0,8772,8748,8734,6638,1715,1596,24,35,4412,4360,363,6794,1556,0
20:32:09,14458.94,Fox,8772,57,24,14,8,10,1,0,8772,8748,8734,6638,1715,1596,22,35,4412,4360,363,6796,1556,0
20:32:09,14459.09,Fox,8772,57,24,14,7,11,1,0,8772,8748,8734,6639,1715,1596,22,35,4412,4360,363,6796,1556,0
20:32:09,14459.81,Fox,8772,57,24,12,9,11,1,0,8772,8748,8736,6639,1715,1596,22,35,4412,4360,363,6796,1556,0
20:32:10,14462.9,Fox,8772,57,24,10,11,11,1,0,8772,8748,8738,6639,1715,1596,22,35,4412,4360,363,6796,1556,0
20:32:11,14464.84,Fox,8772,57,22,12,11,11,1,0,8772,8750,8738,6639,1715,1596,22,35,4412,4360,363,6796,1556,0
20:32:11,14465.82,Fox,8772,55,22,12,10,10,1,0,8772,8750,8738,6640,1715,1596,22,33,4412,4360,363,6798,1556,0
20:32:12,14468.61,Fox,8772,54,22,12,10,9,1,0,8772,8750,8738,6640,1715,1596,22,32,4412,4360,363,6799,1556,0
20:32:12,14469.84,Fox,8772,53,22,10,12,8,1,0,8772,8750,8740,6640,1715,1596,21,32,4412,4360,363,6800,1556,0
20:32:13,14471.11,Fox,8772,53,20,12,12,8,1,0,8772,8752,8740,6640,1715,1596,21,32,4412,4360,363,6800,1556,0
20:32:13,14471.68,Fox,8772,53,20,12,11,9,1,0,8772,8752,8740,6641,1715,1596,21,32,4412,4360,363,6800,1556,0
20:32:14,14474.33,Fox,8772,53,20,12,9,11,1,0,8772,8752,8740,6643,1715,1596,21,32,4412,4360,363,6800,1556,0
20:32:14,14474.52,Fox,8772,53,20,12,7,13,1,0,8772,8752,8740,6645,1715,1596,21,32,4412,4360,363,6800,1556,0
20:32:14,14474.8,Fox,8772,53,20,12,6,14,1,0,8772,8752,8740,6646,1715,1596,21,32,4412,4360,363,6800,1556,0
20:32:15,14476.3,Fox,8772,52,20,12,6,13,1,0,8772,8752,8740,6646,1715,1596,21,31,4412,4360,363,6801,1556,0
20:32:16,14481.21,Fox,8774,53,22,12,5,13,1,0,8774,8752,8740,6646,1715,1596,21,32,4413,4361,363,6802,1556,0
20:32:17,14482.24,Fox,8774,52,22,12,5,12,1,0,8774,8752,8740,6646,1715,1596,21,31,4413,4361,363,6803,1556,0
20:32:17,14484.6,Fox,8774,52,18,16,5,12,1,0,8774,8756,8740,6646,1715,1596,21,31,4413,4361,363,6803,1556,0
20:32:17,14484.82,Fox,8774,50,18,16,5,10,1,0,8774,8756,8740,6646,1715,1596,19,31,4413,4361,363,6805,1556,0
20:32:18,14485.15,Fox,8774,48,18,16,5,8,1,0,8774,8756,8740,6646,1715,1596,19,29,4413,4361,363,6807,1556,0
20:32:18,14485.45,Fox,8774,47,18,16,5,7,1,0,8774,8756,8740,6646,1715,1596,19,28,4413,4361,363,6808,1556,0
20:32:18,14486.62,Fox,8774,47,16,18,5,7,1,0,8774,8758,8740,6646,1715,1596,19,28,4413,4361,363,6808,1556,0
20:32:18,14486.97,Fox,8774,47,16,16,7,7,1,0,8774,8758,8742,6646,1715,1596,19,28,4413,4361,363,6808,1556,0
20:32:19,14489.66,Fox,8774,47,16,14,9,7,1,0,8774,8758,8744,6646,1715,1596,19,28,4413,4361,363,6808,1556,0
20:32:20,14491.42,Fox,8774,47,16,14,7,9,1,0,8774,8758,8744,6648,1715,1596,19,28,4413,4361,363,6808,1556,0
20:32:21,14493.87,Fox,8774,47,16,12,9,9,1,0,8774,8758,8746,6648,1715,1596,19,28,4413,4361,363,6808,1556,0
20:32:21,14494.79,Fox,8774,47,16,10,11,9,1,0,8774,8758,8748,6648,1715,1596,19,28,4413,4361,363,6808,1556,0
20:32:23,14500.69,Fox,8774,47,14,12,11,9,1,0,8774,8760,8748,6648,1715,1596,19,28,4413,4361,363,6808,1556,0
20:32:23,14500.8,Fox,8774,47,12,14,11,9,1,0,8774,8762,8748,6648,1715,1596,19,28,4413,4361,363,6808,1556,0
20:32:23,14502.03,Fox,8774,45,12,14,11,7,1,0,8774,8762,8748,6648,1715,1596,17,28,4413,4361,363,6810,1556,0
20:32:24,14503.13,Fox,8774,45,12,14,10,8,1,0,8774,8762,8748,6649,1715,1596,17,28,4413,4361,363,6810,1556,0
20:32:24,14503.24,Fox,8774,45,12,12,12,8,1,0,8774,8762,8750,6649,1715,1596,17,28,4413,4361,363,6810,1556,0
20:32:25,14506.85,Fox,8776,46,14,12,11,8,1,0,8776,8762,8750,6649,1715,1596,18,28,4415,4361,363,6811,1556,0
20:32:25,14507.9,Fox,8778,47,14,12,8,10,1,0,8776,8762,8750,6651,1715,1596,18,29,4416,4362,363,6812,1556,0
20:32:25,14507.97,Fox,8778,47,16,12,8,10,1,0,8778,8762,8750,6651,1715,1596,18,29,4416,4362,363,6812,1556,0
20:32:26,14509.56,Fox,8778,47,16,10,10,10,1,0,8778,8762,8752,6651,1715,1596,18,29,4416,4362,363,6812,1556,0
20:32:27,14513.79,Fox,8778,46,16,10,10,9,1,0,8778,8762,8752,6651,1715,1596,18,28,4416,4362,363,6813,1556,0
20:32:28,14517.1,Fox,8778,46,14,12,8,11,1,0,8778,8764,8752,6653,1715,1596,18,28,4416,4362,363,6813,1556,0
20:32:29,14518.42,Fox,8778,44,14,12,8,9,1,0,8778,8764,8752,6653,1715,1596,18,26,4416,4362,363,6815,1556,0
20:32:29,14519.86,Fox,8778,44,12,14,8,9,1,0,8778,8766,8752,6653,1715,1596,18,26,4416,4362,363,6815,1556,0
20:32:29,14520.25,Fox,8778,44,12,14,6,11,1,0,8778,8766,8752,6655,1715,1596,18,26,4416,4362,363,6815,1556,0
20:32:30,14522.04,Fox,8780,45,14,14,6,10,1,0,8780,8766,8752,6655,1715,1596,18,27,4417,4363,363,6816,1556,0
20:32:30,14523.14,Fox,8780,45,14,10,10,10,1,0,8780,8766,8756,6655,1715,1596,18,27,4417,4363,363,6816,1556,0
20:32:30,14523.45,Fox,8780,45,14,10,9,11,1,0,8780,8766,8756,6656,1715,1596,18,27,4417,4363,363,6816,1556,0
20:32:31,14525.11,Fox,8780,45,14,8,11,11,1,0,8780,8766,8758,6656,1715,1596,18,27,4417,4363,363,6816,1556,0
20:32:32,14527.74,Fox,8780,43,14,8,11,9,1,0,8780,8766,8758,6656,1715,1596,18,25,4417,4363,363,6818,1556,0
20:32:33,14530.31,Fox,8780,43,14,8,10,10,1,0,8780,8766,8758,6657,1715,1596,18,25,4417,4363,363,6818,1556,0
20:32:33,14530.92,Fox,8780,42,14,8,10,9,1,0,8780,8766,8758,6657,1715,1596,17,25,4417,4363,363,6819,1556,0
20:32:33,14531.7,Fox,8780,42,12,10,10,9,1,0,8780,8768,8758,6657,1715,1596,17,25,4417,4363,363,6819,1556,0
20:32:33,14531.8,Fox,8780,42,10,12,10,9,1,0,8780,8770,8758,6657,1715,1596,17,25,4417,4363,363,6819,1556,0
20:32:33,14532.12,Fox,8782,43,12,12,9,9,1,0,8782,8770,8758,6657,1715,1596,17,26,4418,4364,363,6820,1556,0
20:32:34,14534.07,Fox,8782,42,12,12,9,8,1,0,8782,8770,8758,6657,1715,1596,17,25,4418,4364,363,6821,1556,0
20:32:34,14534.87,Fox,8782,42,10,14,9,8,1,0,8782,8772,8758,6657,1715,1596,17,25,4418,4364,363,6821,1556,0
20:32:36,14539.18,Fox,8782,42,10,12,11,8,1,0,8782,8772,8760,6657,1715,1596,17,25,4418,4364,363,6821,1556,0
20:32:36,14539.36,Fox,8782,42,10,10,13,8,1,0,8782,8772,8762,6657,1715,1596,17,25,4418,4364,363,6821,1556,0
20:32:36,14540.26,Fox,8784,43,12,10,12,8,1,0,8784,8772,8762,6657,1715,1596,17,26,4419,4365,363,6822,1556,0
20:32:36,14540.65,Fox,8786,44,14,10,11,8,1,0,8786,8772,8762,6657,1715,1596,18,26,4421,4365,363,6823,1556,0
20:32:36,14540.87,Fox,8786,43,14,10,11,7,1,0,8786,8772,8762,6657,1715,1596,18,25,4421,4365,363,6824,1556,0
20:32:38,14546.73,Fox,8788,44,16,10,10,7,1,0,8788,8772,8762,6657,1715,1596,18,26,4422,4366,363,6825,1556,0
20:32:39,14547.45,Fox,8788,44,16,10,8,9,1,0,8788,8772,8762,6659,1715,1596,18,26,4422,4366,363,6825,1556,0
20:32:40,14550.21,Fox,8788,44,16,10,7,10,1,0,8788,8772,8762,6660,1715,1596,18,26,4422,4366,363,6825,1556,0
20:32:41,14554.36,Fox,8788,44,16,10,6,11,1,0,8788,8772,8762,6661,1715,1596,18,26,4422,4366,363,6825,1556,0
20:32:41,14555.21,Fox,8788,44,16,10,5,12,1,0,8788,8772,8762,6662,1715,1596,18,26,4422,4366,363,6825,1556,0
20:32:41,14555.61,Fox,8788,44,16,8,7,12,1,0,8788,8772,8764,6662,1715,1596,18,26,4422,4366,363,6825,1556,0
20:32:42,14558.1,Fox,8788,42,16,8,7,10,1,0,8788,8772,8764,6662,1715,1596,18,24,4422,4366,363,6827,1556,0
20:32:42,14558.36,Fox,8788,42,16,6,9,10,1,0,8788,8772,8766,6662,1715,1596,18,24,4422,4366,363,6827,1556,0
20:32:43,14560.77,Fox,8788,41,16,6,9,9,1,0,8788,8772,8766,6662,1715,1596,18,23,4422,4366,363,6828,1556,0
20:32:44,14563.32,Fox,8790,42,18,6,8,9,1,0,8790,8772,8766,6662,1715,1596,19,23,4424,4366,363,6829,1556,0
20:32:44,14563.77,Fox,8790,42,16,8,7,10,1,0,8790,8774,8766,6663,1715,1596,19,23,4424,4366,363,6829,1556,0
20:32:44,14565,Fox,8790,41,16,8,7,9,1,0,8790,8774,8766,6663,1715,1596,19,22,4424,4366,363,6830,1556,0
20:32:45,14565.85,Fox,8790,40,16,8,7,8,1,0,8790,8774,8766,6663,1715,1596,19,21,4424,4366,363,6831,1556,0
20:32:46,14569.12,Fox,8792,41,18,8,6,8,1,0,8792,8774,8766,6663,1715,1596,18,23,4424,4368,363,6832,1556,0
20:32:46,14570.2,Fox,8792,41,18,6,6,10,1,0,8792,8774,8768,6665,1715,1596,18,23,4424,4368,363,6832,1556,0
20:32:46,14570.3,Fox,8792,41,18,4,8,10,1,0,8792,8774,8770,6665,1715,1596,18,23,4424,4368,363,6832,1556,0
20:32:47,14573.41,Fox,8792,41,18,2,10,10,1,0,8792,8774,8772,6665,1715,1596,18,23,4424,4368,363,6832,1556,0
20:32:48,14574.36,Fox,8792,40,18,2,10,9,1,0,8792,8774,8772,6665,1715,1596,18,22,4424,4368,363,6833,1556,0
20:32:48,14575.07,Fox,8794,41,20,2,9,9,1,0,8794,8774,8772,6665,1715,1596,18,23,4425,4369,363,6834,1556,0
20:32:48,14576.21,Fox,8796,42,22,2,8,9,1,0,8796,8774,8772,6665,1715,1596,19,23,4427,4369,363,6835,1556,0
20:32:50,14580.75,Fox,8796,40,22,2,8,7,1,0,8796,8774,8772,6665,1715,1596,18,22,4427,4369,363,6837,1556,0
20:32:51,14583.62,Fox,8796,40,22,2,6,9,1,0,8796,8774,8772,6667,1715,1596,18,22,4427,4369,363,6837,1556,0
20:32:51,14585.56,Fox,8796,40,22,2,4,11,1,0,8796,8774,8772,6669,1715,1596,18,22,4427,4369,363,6837,1556,0
20:32:53,14589.34,Fox,8796,40,20,4,4,11,1,0,8796,8776,8772,6669,1715,1596,18,22,4427,4369,363,6837,1556,0
20:32:53,14590.49,Fox,8796,40,18,6,4,11,1,0,8796,8778,8772,6669,1715,1596,18,22,4427,4369,363,6837,1556,0
20:32:54,14594.27,Fox,8796,38,18,6,4,9,1,0,8796,8778,8772,6669,1715,1596,18,20,4427,4369,363,6839,1556,0
20:32:55,14596.25,Fox,8796,36,18,6,4,7,1,0,8796,8778,8772,6669,1715,1596,18,18,4427,4369,363,6841,1556,0
20:32:56,14599.65,Fox,8796,36,18,6,3,8,1,0,8796,8778,8772,6670,1715,1596,18,18,4427,4369,363,6841,1556,0
20:32:56,14599.79,Fox,8796,36,18,6,2,9,1,0,8796,8778,8772,6671,1715,1596,18,18,4427,4369,363,6841,1556,0
20:32:57,14602.14,Fox,8796,36,18,4,4,9,1,0,8796,8778,8774,6671,1715,1596,18,18,4427,4369,363,6841,1556,0
20:32:58,14604.56,Fox,8796,36,16,6,4,9,1,0,8796,8780,8774,6671,1715,1596,18,18,4427,4369,363,6841,1556,0
20:32:59,14607.38,Fox,8798,37,18,6,3,9,1,0,8798,8780,8774,6671,1715,1596,17,20,4427,4371,363,6842,1556,0
20:33:00,14610.28,Fox,8798,36,18,6,3,8,1,0,8798,8780,8774,6671,1715,1596,17,19,4427,4371,363,6843,1556,0
20:33:00,14610.46,Fox,8798,35,18,6,3,7,1,0,8798,8780,8774,6671,1715,1596,17,18,4427,4371,363,6844,1556,0
20:33:01,14614.44,Fox,8800,36,20,6,2,7,1,0,8800,8780,8774,6671,1715,1596,16,20,4427,4373,363,6845,1556,0
20:33:01,14614.62,Fox,8800,36,18,8,2,7,1,0,8800,8782,8774,6671,1715,1596,16,20,4427,4373,363,6845,1556,0
20:33:02,14616.15,Fox,8800,36,18,8,0,9,1,0,8800,8782,8774,6673,1715,1596,16,20,4427,4373,363,6845,1556,0
20:33:03,14618.89,Fox,8800,36,18,8,0,11,1,0,8800,8782,8774,6675,1715,1596,16,20,4427,4373,363,6845,1556,0
20:33:04,14622.76,Fox,8800,36,16,10,0,11,1,0,8800,8784,8774,6675,1715,1596,16,20,4427,4373,363,6845,1556,0
20:33:04,14623.16,Fox,8800,36,14,12,0,11,1,0,8800,8786,8774,6675,1715,1596,16,20,4427,4373,363,6845,1556,0
20:33:05,14626.73,Fox,8800,34,14,12,0,9,1,0,8800,8786,8774,6675,1715,1596,16,18,4427,4373,363,6847,1556,0
20:33:06,14627.84,Fox,8800,34,14,10,0,9,1,0,8800,8786,8776,6675,1715,1596,16,18,4427,4373,363,6847,1556,0
20:33:06,14628.96,Fox,8800,34,14,8,2,9,1,0,8800,8786,8778,6675,1715,1596,16,18,4427,4373,363,6847,1556,0
20:33:06,14629.23,Fox,8800,34,12,10,2,9,1,0,8800,8788,8778,6675,1715,1596,16,18,4427,4373,363,6847,1556,0
20:33:06,14629.48,Fox,8800,32,12,10,2,7,1,0,8800,8788,8778,6675,1715,1596,15,17,4427,4373,363,6849,1556,0
20:33:07,14630.68,Fox,8800,32,12,10,1,8,1,0,8800,8788,8778,6676,1715,1596,15,17,4427,4373,363,6849,1556,0
20:33:07,14630.77,Fox,8800,32,12,10,0,10,1,0,8800,8788,8778,6678,1715,1596,15,17,4427,4373,363,6849,1556,0
20:33:08,14633.87,Fox,8800,32,12,10,0,11,1,0,8800,8788,8778,6679,1715,1596,15,17,4427,4373,363,6849,1556,0
20:33:09,14638.14,Fox,8802,33,14,10,0,11,1,0,8802,8788,8778,6679,1715,1596,15,18,4428,4374,363,6850,1556,0
20:33:10,14641.31,Fox,8802,32,14,10,0,10,1,0,8802,8788,8778,6679,1715,1596,15,17,4428,4374,363,6851,1556,0
20:33:10,14641.42,Fox,8802,30,14,10,0,8,1,0,8802,8788,8778,6679,1715,1596,15,15,4428,4374,363,6853,1556,0
20:33:11,14643.02,Fox,8802,30,14,8,0,8,1,0,8802,8788,8780,6679,1715,1596,15,15,4428,4374,363,6853,1556,0
20:33:11,14644.48,Fox,8802,29,14,8,0,7,1,0,8802,8788,8780,6679,1715,1596,15,14,4428,4374,363,6854,1556,0
20:33:12,14645.83,Fox,8802,29,12,10,0,7,1,0,8802,8790,8780,6679,1715,1596,15,14,4428,4374,363,6854,1556,0
20:33:13,14651.56,Fox,8802,29,10,12,0,7,1,0,8802,8792,8780,6679,1715,1596,15,14,4428,4374,363,6854,1556,0
20:33:14,14653.17,Fox,8802,29,10,10,1,7,1,0,8802,8792,8782,6679,1715,1596,15,14,4428,4374,363,6854,1556,0
20:33:15,14657.57,Fox,8802,29,8,12,1,7,1,0,8802,8794,8782,6679,1715,1596,15,14,4428,4374,363,6854,1556,0
20:33:16,14658.65,Fox,8802,29,6,14,1,7,1,0,8802,8796,8782,6679,1715,1596,15,14,4428,4374,363,6854,1556,0
20:33:17,14661.25,Fox,8802,29,6,12,3,7,1,0,8802,8796,8784,6679,1715,1596,15,14,4428,4374,363,6854,1556,0
20:33:17,14661.66,Fox,8802,29,6,10,5,7,1,0,8802,8796,8786,6679,1715,1596,15,14,4428,4374,363,6854,1556,0
20:33:17,14662.66,Fox,8802,29,6,10,4,8,1,0,8802,8796,8786,6680,1715,1596,15,14,4428,4374,363,6854,1556,0
20:33:19,14667.18,Fox,8804,30,8,10,3,8,1,0,8804,8796,8786,6680,1715,1596,14,16,4428,4376,363,6855,1556,0
20:33:19,14667.76,Fox,8804,30,8,8,5,8,1,0,8804,8796,8788,6680,1715,1596,14,16,4428,4376,363,6855,1556,0
20:33:21,14673.29,Fox,8804,29,8,8,5,7,1,0,8804,8796,8788,6680,1715,1596,14,15,4428,4376,363,6856,1556,0
20:33:24,14684.36,Fox,8804,29,8,6,7,7,1,0,8804,8796,8790,6680,1715,1596,14,15,4428,4376,363,6856,1556,0
20:33:26,14688.37,Fox,8804,29,8,6,5,9,1,0,8804,8796,8790,6682,1715,1596,14,15,4428,4376,363,6856,1556,0
20:33:26,14689.47,Fox,8804,29,8,6,4,10,1,0,8804,8796,8790,6683,1715,1596,14,15,4428,4376,363,6856,1556,0
20:33:26,14689.87,Fox,8804,29,6,8,4,10,1,0,8804,8798,8790,6683,1715,1596,14,15,4428,4376,363,6856,1556,0
20:33:26,14690.05,Fox,8804,29,6,6,6,10,1,0,8804,8798,8792,6683,1715,1596,14,15,4428,4376,363,6856,1556,0
20:33:28,14696.09,Fox,8804,29,6,4,8,10,1,0,8804,8798,8794,6683,1715,1596,14,15,4428,4376,363,6856,1556,0
20:33:29,14697.15,Fox,8806,30,6,6,7,10,1,0,8806,8800,8794,6683,1715,1596,14,16,4429,4377,363,6857,1556,0
20:33:29,14697.2,Fox,8806,30,6,4,9,10,1,0,8806,8800,8796,6683,1715,1596,14,16,4429,4377,363,6857,1556,0
20:33:29,14698.97,Fox,8806,28,6,4,9,8,1,0,8806,8800,8796,6683,1715,1596,12,16,4429,4377,363,6859,1556,0
20:33:30,14700.13,Fox,8806,27,6,4,9,7,1,0,8806,8800,8796,6683,1715,1596,12,15,4429,4377,363,6860,1556,0
20:33:31,14703.53,Fox,8806,27,6,4,7,9,1,0,8806,8800,8796,6685,1715,1596,12,15,4429,4377,363,6860,1556,0
20:33:32,14705.77,Fox,8808,28,8,4,6,9,1,0,8808,8800,8796,6685,1715,1596,11,17,4429,4379,363,6861,1556,0
20:33:33,14709.64,Fox,8810,29,10,4,5,9,1,0,8810,8800,8796,6685,1715,1596,11,18,4430,4380,363,6862,1556,0
20:33:34,14713.62,Fox,8810,29,10,4,3,11,1,0,8810,8800,8796,6687,1715,1596,11,18,4430,4380,363,6862,1556,0
20:33:35,14714.25,Fox,8810,27,10,4,3,9,1,0,8810,8800,8796,6687,1715,1596,10,17,4430,4380,363,6864,1556,0
20:33:37,14720.66,Fox,8810,27,8,6,3,9,1,0,8810,8802,8796,6687,1715,1596,10,17,4430,4380,363,6864,1556,0
20:33:37,14721.83,Fox,8812,28,10,6,2,9,1,0,8812,8802,8796,6688,1715,1596,9,19,4430,4382,363,6865,1556,0
20:33:37,14722.21,Fox,8812,28,10,6,1,10,1,0,8812,8802,8796,6689,1715,1596,9,19,4430,4382,363,6865,1556,0
20:33:38,14724.26,Fox,8812,27,10,6,1,9,1,0,8812,8802,8796,6689,1715,1596,9,18,4430,4382,363,6866,1556,0
20:33:39,14728.27,Fox,8812,27,10,6,0,10,1,0,8812,8802,8796,6690,1715,1596,9,18,4430,4382,363,6866,1556,0
20:33:39,14728.37,Fox,8812,27,10,4,2,10,1,0,8812,8802,8798,6690,1715,1596,9,18,4430,4382,363,6866,1556,0
20:33:41,14732.41,Fox,8812,26,10,4,2,9,1,0,8812,8802,8798,6690,1715,1596,9,17,4430,4382,363,6867,1556,0
20:33:41,14732.81,Fox,8812,25,10,4,2,8,1,0,8812,8802,8798,6690,1715,1596,8,17,4430,4382,363,6868,1556,0
20:33:42,14735.46,Fox,8812,25,10,2,4,8,1,0,8812,8802,8800,6690,1715,1596,8,17,4430,4382,363,6868,1556,0
20:33:43,14738.87,Fox,8812,24,10,2,4,7,1,0,8812,8802,8800,6690,1715,1596,8,16,4430,4382,363,6869,1556,0
20:33:45,14744.8,Fox,8812,24,10,2,2,9,1,0,8812,8802,8800,6692,1715,1596,8,16,4430,4382,363,6869,1556,0
20:33:46,14749.71,Fox,8812,24,8,4,2,9,1,0,8812,8804,8800,6692,1715,1596,8,16,4430,4382,363,6869,1556,0
20:33:47,14750.54,Fox,8812,24,8,4,0,11,1,0,8812,8804,8800,6694,1715,1596,8,16,4430,4382,363,6869,1556,0
20:33:48,14755.47,Fox,8812,22,8,4,0,9,1,0,8812,8804,8800,6694,1715,1596,6,16,4430,4382,363,6871,1556,0
20:33:49,14756.58,Fox,8812,22,8,4,0,11,1,0,8812,8804,8800,6696,1715,1596,6,16,4430,4382,363,6871,1556,0
20:33:49,14757.67,Fox,8812,22,8,4,0,13,1,0,8812,8804,8800,6698,1715,1596,6,16,4430,4382,363,6871,1556,0
20:33:50,14759.17,Fox,8812,22,8,2,0,13,1,0,8812,8804,8802,6698,1715,1596,6,16,4430,4382,363,6871,1556,0
20:33:50,14761.23,Fox,8812,20,8,2,0,11,1,0,8812,8804,8802,6698,1715,1596,6,14,4430,4382,363,6873,1556,0
20:33:52,14767.22,Fox,8812,18,8,2,0,9,1,0,8812,8804,8802,6698,1715,1596,5,13,4430,4382,363,6875,1556,0
20:33:53,14768.32,Fox,8812,16,8,2,2,7,1,0,8812,8804,8802,6698,1715,1596,3,13,4430,4382,363,6877,1556,0
20:33:57,14779.57,Fox,8812,16,6,4,0,7,1,0,8812,8806,8802,6698,1715,1596,3,13,4430,4382,363,6877,1556,0
20:33:59,14788.26,Fox,8812,16,4,4,0,7,1,0,8812,8808,8804,6698,1715,1596,3,13,4430,4382,363,6877,1556,0
20:34:00,14788.91,Fox,8812,16,4,4,0,9,1,0,8812,8808,8804,6700,1715,1596,3,13,4430,4382,363,6877,1556,0
20:34:01,14792.15,Fox,8812,16,2,6,0,9,1,0,8812,8810,8804,6700,1715,1596,3,13,4430,4382,363,6877,1556,0
20:34:02,14795.96,Fox,8812,16,2,6,2,11,1,0,8812,8810,8804,6702,1715,1596,3,13,4430,4382,363,6877,1556,0
20:34:03,14799.52,Fox,8812,14,2,6,0,9,1,0,8812,8810,8804,6702,1715,1596,3,11,4430,4382,363,6879,1556,0
20:34:05,14804.32,Fox,8812,14,0,8,0,9,1,0,8812,8812,8804,6702,1715,1596,3,11,4430,4382,363,6879,1556,0
20:34:06,14806.59,Fox,8812,12,0,8,0,7,1,0,8812,8812,8804,6702,1715,1596,3,9,4430,4382,363,6881,1556,0
20:34:09,14818.08,Fox,8812,12,0,6,0,7,1,0,8812,8812,8806,6702,1715,1596,3,9,4430,4382,363,6881,1556,0
20:34:10,14819.67,Fox,8812,12,0,6,2,9,1,0,8812,8812,8806,6704,1715,1596,3,9,4430,4382,363,6881,1556,0
20:34:12,14826.75,Fox,8812,12,0,4,0,9,1,0,8812,8812,8808,6704,1715,1596,3,9,4430,4382,363,6881,1556,0
20:34:13,14830.3,Fox,8812,10,0,4,0,7,1,0,8812,8812,8808,6704,1715,1596,2,8,4430,4382,363,6883,1556,0
20:34:14,14830.61,Fox,8812,10,0,2,0,7,1,0,8812,8812,8810,6704,1715,1596,2,8,4430,4382,363,6883,1556,0
20:34:18,14842.81,Fox,8812,10,0,0,0,7,1,0,8812,8812,8812,6704,1715,1596,2,8,4430,4382,363,6883,1556,0
20:34:20,14848.68,Fox,8812,10,0,0,0,9,1,0,8812,8812,8812,6706,1715,1596,2,8,4430,4382,363,6883,1556,0
20:34:23,14859.36,Fox,8812,8,0,0,0,7,1,0,8812,8812,8812,6706,1715,1596,2,6,4430,4382,363,6885,1556,0
20:34:30,14878.56,Fox,8812,8,0,0,2,9,1,0,8812,8812,8812,6708,1715,1596,2,6,4430,4382,363,6885,1556,0
20:34:32,14887.27,Fox,8812,8,0,0,0,11,1,0,8812,8812,8812,6710,1715,1596,2,6,4430,4382,363,6885,1556,0
20:34:33,14889.22,Fox,8812,6,0,0,0,9,1,0,8812,8812,8812,6710,1715,1596,1,5,4430,4382,363,6887,1556,0
20:34:34,14891.12,Fox,8812,6,0,0,0,11,1,0,8812,8812,8812,6712,1715,1596,1,5,4430,4382,363,6887,1556,0
20:34:36,14897.45,Fox,8814,7,2,0,0,10,1,0,8814,8812,8812,6712,1715,1596,1,6,4431,4383,363,6888,1556,0
20:34:36,14897.92,Fox,8814,5,2,0,0,8,1,0,8814,8812,8812,6712,1715,1596,1,4,4431,4383,363,6890,1556,0
20:34:37,14901.77,Fox,8814,4,2,0,0,7,1,0,8814,8812,8812,6712,1715,1596,1,3,4431,4383,363,6891,1556,0
20:34:38,14903.32,Fox,8814,4,2,0,0,9,1,0,8814,8812,8812,6714,1715,1596,1,3,4431,4383,363,6891,1556,0
20:34:41,14913.97,Fox,8814,2,2,0,0,7,1,0,8814,8812,8812,6714,1715,1596,1,1,4431,4383,363,6893,1556,0
20:35:03,14979.93,Fox,8814,2,0,2,2,7,1,0,8814,8814,8812,6714,1715,1596,1,1,4431,4383,363,6893,1556,0
20:35:16,15018.44,Fox,8814,2,0,0,0,7,1,0,8814,8814,8814,6714,1715,1596,1,1,4431,4383,363,6893,1556,0
20:35:29,15056.09,Fox,8816,3,2,0,0,7,1,0,8816,8814,8814,6714,1715,1596,1,2,4432,4384,363,6894,1556,0
20:35:37,15078.92,Fox,8816,3,2,0,0,8,1,0,8816,8814,8814,6715,1715,1596,1,2,4432,4384,363,6894,1556,0
20:35:40,15089.58,Fox,8816,2,2,0,0,7,1,0,8816,8814,8814,6715,1715,1596,1,1,4432,4384,363,6895,1556,0
20:35:56,15138.58,Fox,8816,2,0,2,2,7,1,0,8816,8816,8814,6715,1715,1596,1,1,4432,4384,363,6895,1556,0
20:36:16,15177.09,Fox,8816,2,0,0,0,7,1,0,8816,8816,8816,6715,1715,1596,1,1,4432,4384,363,6895,1556,0
20:36:29,15215.23,Fox,8818,3,2,0,0,7,1,0,8818,8816,8816,6715,1715,1596,0,3,4432,4386,363,6896,1556,0
20:36:36,15237.6,Fox,8818,3,2,0,0,8,1,0,8818,8816,8816,6716,1715,1596,0,3,4432,4386,363,6896,1556,0
20:36:40,15248.23,Fox,8818,2,2,0,0,7,1,0,8818,8816,8816,6716,1715,1596,0,2,4432,4386,363,6897,1556,0
20:36:56,15297.75,Fox,8818,2,0,2,2,7,1,0,8818,8818,8816,6716,1715,1596,0,2,4432,4386,363,6897,1556,0
20:37:09,15336.2,Fox,8818,2,0,0,0,7,1,0,8818,8818,8818,6716,1715,1596,0,2,4432,4386,363,6897,1556,0
20:37:29,15396.68,Fox,8818,2,0,0,0,9,1,0,8818,8818,8818,6718,1715,1596,0,2,4432,4386,363,6897,1556,0
20:37:33,15407.41,Fox,8818,0,0,0,0,7,1,0,8818,8818,8818,6718,1715,1596,0,0,4432,4386,363,6899,1556,0
